Grade,Category,Year,# Total Days,# Days Absent,# Days Present,% Attendance,# Contributing 10+ Total Days and 1+ Pres Day,# Chronically Absent,% Chronically Absent
All Grades,All Students,2018-19,30887,2278,28609,92.6,192,47,24.5
All Grades,All Students,2019-20,21101,1500,19601,92.9,204,58,28.4
All Grades,All Students,2020-21,32686,3931,28755,88.0,199,84,42.2
All Grades,All Students,2021-22,31663,4751,26912,85.0,190,113,59.5
All Grades,All Students,2022-23,32663,4159,28504,87.3,206,104,50.5
PK in K-12 Schools,All Students,2018-19,2104,245,1859,88.4,15,7,46.7
PK in K-12 Schools,All Students,2019-20,1490,198,1292,86.7,15,10,66.7
PK in K-12 Schools,All Students,2020-21,2830,467,2363,83.5,18,10,55.6
PK in K-12 Schools,All Students,2021-22,2812,598,2214,78.7,18,12,66.7
PK in K-12 Schools,All Students,2022-23,2136,336,1800,84.3,13,10,76.9
0K,All Students,2018-19,3491,283,3208,91.9,22,6,27.3
0K,All Students,2019-20,3091,288,2803,90.7,30,15,50.0
0K,All Students,2020-21,4685,766,3919,83.6,29,15,51.7
0K,All Students,2021-22,5371,821,4550,84.7,32,22,68.8
0K,All Students,2022-23,6224,887,5337,85.7,37,16,43.2
1,All Students,2018-19,5857,543,5314,90.7,35,10,28.6
1,All Students,2019-20,2871,218,2653,92.4,28,9,32.1
1,All Students,2020-21,5012,735,4277,85.3,32,17,53.1
1,All Students,2021-22,4489,595,3894,86.7,26,12,46.2
1,All Students,2022-23,5353,741,4612,86.2,34,21,61.8
2,All Students,2018-19,5455,328,5127,94.0,34,4,11.8
2,All Students,2019-20,4274,260,4014,93.9,42,7,16.7
2,All Students,2020-21,4512,697,3815,84.6,27,14,51.9
2,All Students,2021-22,4356,596,3760,86.3,27,16,59.3
2,All Students,2022-23,4322,474,3848,89.0,28,11,39.3
3,All Students,2018-19,5278,299,4979,94.3,33,5,15.2
3,All Students,2019-20,3862,238,3624,93.8,37,8,21.6
3,All Students,2020-21,5277,391,4886,92.6,32,8,25.0
3,All Students,2021-22,3898,588,3310,84.9,23,15,65.2
3,All Students,2022-23,5095,552,4543,89.2,33,14,42.4
4,All Students,2018-19,3536,207,3329,94.1,23,5,21.7
4,All Students,2019-20,3304,193,3111,94.2,32,7,21.9
4,All Students,2020-21,5413,540,4873,90.0,32,13,40.6
4,All Students,2021-22,5711,819,4892,85.7,34,19,55.9
4,All Students,2022-23,3480,460,3020,86.8,25,16,64.0
5,All Students,2018-19,5166,373,4793,92.8,30,10,33.3
5,All Students,2019-20,2209,105,2104,95.2,20,2,10.0
5,All Students,2020-21,4957,335,4622,93.2,29,7,24.1
5,All Students,2021-22,5026,734,4292,85.4,30,17,56.7
5,All Students,2022-23,6053,709,5344,88.3,36,16,44.4
All Grades,All Students,2018-19,44723,3979,40744,91.1,265,87,32.8
All Grades,All Students,2019-20,27491,2242,25249,91.8,250,72,28.8
All Grades,All Students,2020-21,36681,2523,34158,93.1,213,50,23.5
All Grades,All Students,2021-22,31722,3843,27879,87.9,189,99,52.4
PK in K-12 Schools,All Students,2018-19,1855,202,1653,89.1,11,4,36.4
PK in K-12 Schools,All Students,2019-20,1922,198,1724,89.7,18,9,50.0
PK in K-12 Schools,All Students,2020-21,2269,172,2097,92.4,13,6,46.2
PK in K-12 Schools,All Students,2021-22,3001,392,2609,86.9,18,11,61.1
0K,All Students,2018-19,5205,476,4729,90.9,31,7,22.6
0K,All Students,2019-20,2983,260,2723,91.3,28,8,28.6
0K,All Students,2020-21,4019,277,3742,93.1,23,5,21.7
0K,All Students,2021-22,3896,455,3441,88.3,24,11,45.8
1,All Students,2018-19,6864,650,6214,90.5,41,15,36.6
1,All Students,2019-20,3140,210,2930,93.3,29,5,17.2
1,All Students,2020-21,4174,369,3805,91.2,25,10,40.0
1,All Students,2021-22,3098,402,2696,87.0,20,11,55.0
2,All Students,2018-19,7972,676,7296,91.5,49,13,26.5
2,All Students,2019-20,4508,437,4071,90.3,41,13,31.7
2,All Students,2020-21,4550,211,4339,95.4,26,3,11.5
2,All Students,2021-22,3894,499,3395,87.2,22,12,54.5
3,All Students,2018-19,7297,620,6677,91.5,42,14,33.3
3,All Students,2019-20,5141,433,4708,91.6,46,14,30.4
3,All Students,2020-21,6650,579,6071,91.3,38,10,26.3
3,All Students,2021-22,4349,518,3831,88.1,26,13,50.0
4,All Students,2018-19,7767,772,6995,90.1,44,21,47.7
4,All Students,2019-20,4845,286,4559,94.1,43,8,18.6
4,All Students,2020-21,7601,476,7125,93.7,44,8,18.2
4,All Students,2021-22,6197,699,5498,88.7,36,18,50.0
5,All Students,2018-19,7763,583,7180,92.5,47,13,27.7
5,All Students,2019-20,4952,418,4534,91.6,45,15,33.3
5,All Students,2020-21,7363,389,6974,94.7,43,7,16.3
5,All Students,2021-22,7287,878,6409,88.0,43,23,53.5
All Grades,All Students,2018-19,85659,6800,78859,92.1,520,165,31.7
All Grades,All Students,2019-20,53694,4762,48932,91.1,509,192,37.7
All Grades,All Students,2020-21,71138,5482,65656,92.3,425,99,23.3
All Grades,All Students,2021-22,60564,8563,52001,85.9,366,196,53.6
All Grades,All Students,2022-23,59180,7634,51546,87.1,389,223,57.3
PK in K-12 Schools,All Students,2018-19,7556,1075,6481,85.8,49,25,51.0
PK in K-12 Schools,All Students,2019-20,4718,584,4134,87.6,46,25,54.3
PK in K-12 Schools,All Students,2020-21,6144,436,5708,92.9,39,8,20.5
PK in K-12 Schools,All Students,2021-22,6681,949,5732,85.8,43,27,62.8
PK in K-12 Schools,All Students,2022-23,6264,884,5380,85.9,43,25,58.1
0K,All Students,2018-19,10989,1168,9821,89.4,70,31,44.3
0K,All Students,2019-20,7174,901,6273,87.4,68,33,48.5
0K,All Students,2020-21,9866,1009,8857,89.8,63,19,30.2
0K,All Students,2021-22,8663,1320,7343,84.8,53,32,60.4
0K,All Students,2022-23,8011,969,7042,87.9,52,26,50.0
1,All Students,2018-19,11894,991,10903,91.7,74,23,31.1
1,All Students,2019-20,6849,638,6211,90.7,66,25,37.9
1,All Students,2020-21,9028,864,8164,90.4,53,18,34.0
1,All Students,2021-22,8838,1189,7649,86.5,53,32,60.4
1,All Students,2022-23,9029,1397,7632,84.5,63,44,69.8
2,All Students,2018-19,13500,1099,12401,91.9,83,28,33.7
2,All Students,2019-20,8303,741,7562,91.1,81,33,40.7
2,All Students,2020-21,10332,643,9689,93.8,62,11,17.7
2,All Students,2021-22,7495,1415,6080,81.1,45,28,62.2
2,All Students,2022-23,10263,1103,9160,89.3,66,32,48.5
3,All Students,2018-19,11741,753,10988,93.6,70,16,22.9
3,All Students,2019-20,8886,749,8137,91.6,81,26,32.1
3,All Students,2020-21,11581,966,10615,91.7,67,17,25.4
3,All Students,2021-22,8432,881,7551,89.6,51,20,39.2
3,All Students,2022-23,7490,1143,6347,84.7,46,31,67.4
4,All Students,2018-19,16337,910,15427,94.4,94,23,24.5
4,All Students,2019-20,7428,487,6941,93.4,71,21,29.6
4,All Students,2020-21,12978,1103,11875,91.5,75,21,28.0
4,All Students,2021-22,8716,1327,7389,84.8,51,27,52.9
4,All Students,2022-23,9180,981,8199,89.3,59,30,50.8
5,All Students,2018-19,13642,804,12838,94.1,80,19,23.8
5,All Students,2019-20,10336,662,9674,93.6,96,29,30.2
5,All Students,2020-21,11209,461,10748,95.9,66,5,7.6
5,All Students,2021-22,11739,1482,10257,87.4,70,30,42.9
5,All Students,2022-23,8943,1157,7786,87.1,60,35,58.3
All Grades,All Students,2018-19,54863,6309,48554,88.5,329,158,48.0
All Grades,All Students,2019-20,33896,4360,29536,87.1,309,146,47.2
All Grades,All Students,2020-21,48074,5516,42558,88.5,286,116,40.6
All Grades,All Students,2021-22,46581,9173,37408,80.3,289,203,70.2
All Grades,All Students,2022-23,39453,7130,32323,81.9,256,171,66.8
PK in K-12 Schools,All Students,2018-19,2990,400,2590,86.6,19,11,57.9
PK in K-12 Schools,All Students,2019-20,1902,321,1581,83.1,17,11,64.7
PK in K-12 Schools,All Students,2020-21,2084,407,1677,80.5,14,9,64.3
PK in K-12 Schools,All Students,2021-22,3709,754,2955,79.7,25,17,68.0
PK in K-12 Schools,All Students,2022-23,4210,831,3379,80.3,29,24,82.8
0K,All Students,2018-19,4465,705,3760,84.2,25,15,60.0
0K,All Students,2019-20,2554,340,2214,86.7,24,12,50.0
0K,All Students,2020-21,3365,418,2947,87.6,20,9,45.0
0K,All Students,2021-22,3103,941,2162,69.7,20,16,80.0
0K,All Students,2022-23,2418,466,1952,80.7,16,12,75.0
1,All Students,2018-19,3669,481,3188,86.9,22,14,63.6
1,All Students,2019-20,2981,498,2483,83.3,26,13,50.0
1,All Students,2020-21,4426,654,3772,85.2,26,13,50.0
1,All Students,2021-22,3694,793,2901,78.5,22,18,81.8
1,All Students,2022-23,2829,550,2279,80.6,18,14,77.8
2,All Students,2018-19,3223,340,2883,89.5,20,8,40.0
2,All Students,2019-20,1726,207,1519,88.0,16,9,56.3
2,All Students,2020-21,4811,546,4265,88.7,28,9,32.1
2,All Students,2021-22,4667,915,3752,80.4,29,23,79.3
2,All Students,2022-23,3540,553,2987,84.4,21,13,61.9
3,All Students,2018-19,3918,537,3381,86.3,24,15,62.5
3,All Students,2019-20,2026,260,1766,87.2,19,10,52.6
3,All Students,2020-21,2819,246,2573,91.3,17,7,41.2
3,All Students,2021-22,4779,898,3881,81.2,27,19,70.4
3,All Students,2022-23,4482,737,3745,83.6,28,18,64.3
4,All Students,2018-19,7596,672,6924,91.2,44,15,34.1
4,All Students,2019-20,2421,452,1969,81.3,24,17,70.8
4,All Students,2020-21,2975,208,2767,93.0,17,3,17.6
4,All Students,2021-22,2880,485,2395,83.2,19,13,68.4
4,All Students,2022-23,4045,765,3280,81.1,28,18,64.3
5,All Students,2018-19,6881,816,6065,88.1,41,20,48.8
5,All Students,2019-20,4941,511,4430,89.7,43,17,39.5
5,All Students,2020-21,3934,512,3422,87.0,23,11,47.8
5,All Students,2021-22,3585,702,2883,80.4,22,17,77.3
5,All Students,2022-23,2250,341,1909,84.8,15,9,60.0
6,All Students,2018-19,7254,789,6465,89.1,45,22,48.9
6,All Students,2019-20,5063,564,4499,88.9,46,17,37.0
6,All Students,2020-21,8449,791,7658,90.6,50,15,30.0
6,All Students,2021-22,4961,968,3993,80.5,33,23,69.7
6,All Students,2022-23,4279,534,3745,87.5,28,13,46.4
7,All Students,2018-19,7709,808,6901,89.5,45,17,37.8
7,All Students,2019-20,4695,482,4213,89.7,43,18,41.9
7,All Students,2020-21,7476,932,6544,87.5,44,19,43.2
7,All Students,2021-22,8365,1493,6872,82.2,51,33,64.7
7,All Students,2022-23,3822,794,3028,79.2,26,19,73.1
8,All Students,2018-19,7158,761,6397,89.4,44,21,47.7
8,All Students,2019-20,5587,725,4862,87.0,51,22,43.1
8,All Students,2020-21,7735,802,6933,89.6,47,21,44.7
8,All Students,2021-22,6838,1224,5614,82.1,41,24,58.5
8,All Students,2022-23,7578,1559,6019,79.4,47,31,66.0
All Grades,All Students,2018-19,40842,3731,37111,90.9,251,83,33.1
All Grades,All Students,2019-20,26631,2494,24137,90.6,246,83,33.7
All Grades,All Students,2020-21,36697,2599,34098,92.9,222,57,25.7
All Grades,All Students,2021-22,32375,3895,28480,88.0,194,100,51.5
All Grades,All Students,2022-23,33156,3883,29273,88.3,203,103,50.7
PK in K-12 Schools,All Students,2018-19,4375,488,3887,88.8,28,11,39.3
PK in K-12 Schools,All Students,2019-20,3107,309,2798,90.1,30,12,40.0
PK in K-12 Schools,All Students,2020-21,3041,261,2780,91.4,20,7,35.0
PK in K-12 Schools,All Students,2021-22,4284,754,3530,82.4,27,19,70.4
PK in K-12 Schools,All Students,2022-23,5557,883,4674,84.1,34,25,73.5
0K,All Students,2018-19,7979,920,7059,88.5,48,21,43.8
0K,All Students,2019-20,4796,552,4244,88.5,46,20,43.5
0K,All Students,2020-21,6599,567,6032,91.4,38,11,28.9
0K,All Students,2021-22,4031,479,3552,88.1,23,13,56.5
0K,All Students,2022-23,3319,388,2931,88.3,21,10,47.6
1,All Students,2018-19,7630,695,6935,90.9,47,18,38.3
1,All Students,2019-20,3939,385,3554,90.2,35,12,34.3
1,All Students,2020-21,5493,497,4996,91.0,33,12,36.4
1,All Students,2021-22,5931,688,5243,88.4,35,18,51.4
1,All Students,2022-23,4488,601,3887,86.6,28,18,64.3
2,All Students,2018-19,4927,440,4487,91.1,30,8,26.7
2,All Students,2019-20,4401,402,3999,90.9,41,12,29.3
2,All Students,2020-21,5553,402,5151,92.8,35,10,28.6
2,All Students,2021-22,4803,620,4183,87.1,29,19,65.5
2,All Students,2022-23,5060,442,4618,91.3,33,11,33.3
3,All Students,2018-19,6910,568,6342,91.8,43,13,30.2
3,All Students,2019-20,3450,278,3172,91.9,30,8,26.7
3,All Students,2020-21,6006,407,5599,93.2,35,8,22.9
3,All Students,2021-22,5223,522,4701,90.0,31,11,35.5
3,All Students,2022-23,4520,472,4048,89.6,26,13,50.0
4,All Students,2018-19,4565,352,4213,92.3,27,7,25.9
4,All Students,2019-20,3675,371,3304,89.9,34,12,35.3
4,All Students,2020-21,4624,118,4506,97.4,29,4,13.8
4,All Students,2021-22,4601,538,4063,88.3,27,12,44.4
4,All Students,2022-23,5298,551,4747,89.6,31,14,45.2
5,All Students,2018-19,4456,268,4188,94.0,28,5,17.9
5,All Students,2019-20,3263,197,3066,94.0,30,7,23.3
5,All Students,2020-21,5381,347,5034,93.6,32,5,15.6
5,All Students,2021-22,3502,294,3208,91.6,22,8,36.4
5,All Students,2022-23,4914,546,4368,88.9,30,12,40.0
All Grades,All Students,2018-19,40702,4604,36098,88.7,243,117,48.1
All Grades,All Students,2019-20,27356,2544,24812,90.7,247,94,38.1
All Grades,All Students,2020-21,38761,4809,33952,87.6,233,112,48.1
All Grades,All Students,2021-22,37204,6361,30843,82.9,230,152,66.1
All Grades,All Students,2022-23,35289,4893,30396,86.1,232,126,54.3
PK in K-12 Schools,All Students,2018-19,3568,631,2937,82.3,23,17,73.9
PK in K-12 Schools,All Students,2019-20,3793,447,3346,88.2,35,16,45.7
PK in K-12 Schools,All Students,2020-21,3135,392,2743,87.5,19,11,57.9
PK in K-12 Schools,All Students,2021-22,4783,1263,3520,73.6,34,25,73.5
PK in K-12 Schools,All Students,2022-23,5186,1077,4109,79.2,34,29,85.3
0K,All Students,2018-19,7641,1165,6476,84.8,47,30,63.8
0K,All Students,2019-20,2660,287,2373,89.2,24,12,50.0
0K,All Students,2020-21,5127,789,4338,84.6,32,20,62.5
0K,All Students,2021-22,4253,776,3477,81.8,26,17,65.4
0K,All Students,2022-23,3747,618,3129,83.5,26,16,61.5
1,All Students,2018-19,5718,645,5073,88.7,35,19,54.3
1,All Students,2019-20,5204,607,4597,88.3,48,21,43.8
1,All Students,2020-21,4304,600,3704,86.1,25,13,52.0
1,All Students,2021-22,4174,523,3651,87.5,25,14,56.0
1,All Students,2022-23,4082,520,3562,87.3,26,12,46.2
2,All Students,2018-19,7398,880,6518,88.1,43,22,51.2
2,All Students,2019-20,3547,346,3201,90.2,32,15,46.9
2,All Students,2020-21,7465,812,6653,89.1,44,18,40.9
2,All Students,2021-22,4023,636,3387,84.2,25,16,64.0
2,All Students,2022-23,4218,418,3800,90.1,29,13,44.8
3,All Students,2018-19,5248,435,4813,91.7,31,12,38.7
3,All Students,2019-20,4836,383,4453,92.1,44,14,31.8
3,All Students,2020-21,5535,699,4836,87.4,35,16,45.7
3,All Students,2021-22,6945,953,5992,86.3,42,25,59.5
3,All Students,2022-23,3974,464,3510,88.3,29,13,44.8
4,All Students,2018-19,5287,444,4843,91.6,31,9,29.0
4,All Students,2019-20,3559,238,3321,93.3,31,9,29.0
4,All Students,2020-21,7514,841,6673,88.8,45,19,42.2
4,All Students,2021-22,5465,1078,4387,80.3,33,26,78.8
4,All Students,2022-23,6917,897,6020,87.0,41,22,53.7
5,All Students,2018-19,5842,404,5438,93.1,33,8,24.2
5,All Students,2019-20,3757,236,3521,93.7,33,7,21.2
5,All Students,2020-21,5681,676,5005,88.1,33,15,45.5
5,All Students,2021-22,7561,1132,6429,85.0,45,29,64.4
5,All Students,2022-23,7165,899,6266,87.5,47,21,44.7
All Grades,All Students,2018-19,64913,3960,60953,93.9,391,95,24.3
All Grades,All Students,2019-20,45069,2737,42332,93.9,408,79,19.4
All Grades,All Students,2020-21,64920,3930,60990,93.9,382,74,19.4
All Grades,All Students,2021-22,56812,5762,51050,89.9,343,142,41.4
All Grades,All Students,2022-23,51572,4987,46585,90.3,316,124,39.2
PK in K-12 Schools,All Students,2018-19,6096,570,5526,90.6,37,14,37.8
PK in K-12 Schools,All Students,2019-20,4042,320,3722,92.1,36,11,30.6
PK in K-12 Schools,All Students,2020-21,4612,162,4450,96.5,27,2,7.4
PK in K-12 Schools,All Students,2021-22,4240,550,3690,87.0,27,16,59.3
PK in K-12 Schools,All Students,2022-23,4234,515,3719,87.8,29,12,41.4
0K,All Students,2018-19,9829,681,9148,93.1,61,17,27.9
0K,All Students,2019-20,7943,622,7321,92.2,73,18,24.7
0K,All Students,2020-21,10478,793,9685,92.4,64,16,25.0
0K,All Students,2021-22,8891,1154,7737,87.0,54,29,53.7
0K,All Students,2022-23,7820,829,6991,89.4,47,22,46.8
1,All Students,2018-19,11762,910,10852,92.3,71,25,35.2
1,All Students,2019-20,7075,440,6635,93.8,64,11,17.2
1,All Students,2020-21,11077,801,10276,92.8,66,18,27.3
1,All Students,2021-22,8972,831,8141,90.7,56,21,37.5
1,All Students,2022-23,7667,826,6841,89.2,47,18,38.3
2,All Students,2018-19,9613,499,9114,94.8,59,10,16.9
2,All Students,2019-20,8302,531,7771,93.6,76,18,23.7
2,All Students,2020-21,10154,348,9806,96.6,60,7,11.7
2,All Students,2021-22,9480,945,8535,90.0,56,21,37.5
2,All Students,2022-23,7829,720,7109,90.8,47,20,42.6
3,All Students,2018-19,9396,450,8946,95.2,55,11,20.0
3,All Students,2019-20,5914,286,5628,95.2,55,8,14.5
3,All Students,2020-21,10877,888,9989,91.8,63,16,25.4
3,All Students,2021-22,8198,693,7505,91.5,50,17,34.0
3,All Students,2022-23,8357,749,7608,91.0,52,19,36.5
4,All Students,2018-19,8188,386,7802,95.3,50,9,18.0
4,All Students,2019-20,6152,276,5876,95.5,54,7,13.0
4,All Students,2020-21,8651,390,8261,95.5,50,5,10.0
4,All Students,2021-22,8840,888,7952,90.0,52,22,42.3
4,All Students,2022-23,7022,615,6407,91.2,42,13,31.0
5,All Students,2018-19,10029,464,9565,95.4,58,9,15.5
5,All Students,2019-20,5641,262,5379,95.4,50,6,12.0
5,All Students,2020-21,9071,548,8523,94.0,52,10,19.2
5,All Students,2021-22,8191,701,7490,91.4,48,16,33.3
5,All Students,2022-23,8643,733,7910,91.5,52,20,38.5
All Grades,All Students,2018-19,51585,5514,46071,89.3,318,153,48.1
All Grades,All Students,2019-20,28401,2692,25709,90.5,266,109,41.0
All Grades,All Students,2020-21,36644,5816,30828,84.1,219,120,54.8
All Grades,All Students,2021-22,31427,5140,26287,83.6,204,135,66.2
All Grades,All Students,2022-23,33879,4597,29282,86.4,225,140,62.2
PK in K-12 Schools,All Students,2018-19,2696,342,2354,87.3,18,12,66.7
PK in K-12 Schools,All Students,2019-20,1191,158,1033,86.7,13,8,61.5
PK in K-12 Schools,All Students,2020-21,1800,521,1279,71.1,12,9,75.0
PK in K-12 Schools,All Students,2021-22,3302,725,2577,78.0,24,18,75.0
PK in K-12 Schools,All Students,2022-23,4114,808,3306,80.4,30,24,80.0
0K,All Students,2018-19,8004,1195,6809,85.1,52,35,67.3
0K,All Students,2019-20,3439,381,3058,88.9,34,16,47.1
0K,All Students,2020-21,3333,631,2702,81.1,21,12,57.1
0K,All Students,2021-22,3754,559,3195,85.1,26,17,65.4
0K,All Students,2022-23,3724,524,3200,85.9,28,18,64.3
1,All Students,2018-19,6326,710,5616,88.8,40,21,52.5
1,All Students,2019-20,4850,579,4271,88.1,46,26,56.5
1,All Students,2020-21,5393,875,4518,83.8,31,19,61.3
1,All Students,2021-22,4515,764,3751,83.1,30,15,50.0
1,All Students,2022-23,4781,568,4213,88.1,31,17,54.8
2,All Students,2018-19,6659,772,5887,88.4,41,22,53.7
2,All Students,2019-20,3868,340,3528,91.2,35,13,37.1
2,All Students,2020-21,6621,1182,5439,82.1,40,28,70.0
2,All Students,2021-22,4203,652,3551,84.5,29,21,72.4
2,All Students,2022-23,4756,556,4200,88.3,33,16,48.5
3,All Students,2018-19,8485,718,7767,91.5,53,22,41.5
3,All Students,2019-20,4060,403,3657,90.1,38,15,39.5
3,All Students,2020-21,6318,621,5697,90.2,37,12,32.4
3,All Students,2021-22,5366,873,4493,83.7,33,22,66.7
3,All Students,2022-23,5320,632,4688,88.1,35,20,57.1
4,All Students,2018-19,9613,788,8825,91.8,56,16,28.6
4,All Students,2019-20,5043,397,4646,92.1,45,16,35.6
4,All Students,2020-21,5831,749,5082,87.2,35,16,45.7
4,All Students,2021-22,5302,843,4459,84.1,34,26,76.5
4,All Students,2022-23,5420,814,4606,85.0,34,23,67.6
5,All Students,2018-19,9802,989,8813,89.9,58,25,43.1
5,All Students,2019-20,5950,434,5516,92.7,55,15,27.3
5,All Students,2020-21,7348,1237,6111,83.2,43,24,55.8
5,All Students,2021-22,4985,724,4261,85.5,28,16,57.1
5,All Students,2022-23,5764,695,5069,87.9,34,22,64.7
All Grades,All Students,2018-19,67989,7814,60175,88.5,415,204,49.2
All Grades,All Students,2019-20,42614,4809,37805,88.7,402,191,47.5
All Grades,All Students,2020-21,61555,13060,48495,78.8,369,233,63.1
All Grades,All Students,2021-22,60149,13065,47084,78.3,372,297,79.8
All Grades,All Students,2022-23,58905,10782,48123,81.7,414,286,69.1
PK in K-12 Schools,All Students,2018-19,1883,368,1515,80.5,15,11,73.3
PK in K-12 Schools,All Students,2019-20,925,225,700,75.7,13,11,84.6
PK in K-12 Schools,All Students,2020-21,2204,s,s,s,s,s,s
PK in K-12 Schools,All Students,2021-22,2785,s,s,s,s,s,s
PK in K-12 Schools,All Students,2022-23,4730,1308,3422,72.3,36,31,86.1
0K,All Students,2018-19,5147,857,4290,83.3,30,20,66.7
0K,All Students,2019-20,2943,435,2508,85.2,29,18,62.1
0K,All Students,2020-21,3484,618,2866,82.3,21,10,47.6
0K,All Students,2021-22,4521,1014,3507,77.6,27,23,85.2
0K,All Students,2022-23,2715,s,s,s,s,s,s
1,All Students,2018-19,5880,813,5067,86.2,36,24,66.7
1,All Students,2019-20,3058,396,2662,87.1,27,14,51.9
1,All Students,2020-21,4495,1227,3268,72.7,26,22,84.6
1,All Students,2021-22,4314,927,3387,78.5,26,19,73.1
1,All Students,2022-23,4949,908,4041,81.7,36,27,75.0
2,All Students,2018-19,5621,679,4942,87.9,33,18,54.5
2,All Students,2019-20,3578,495,3083,86.2,33,24,72.7
2,All Students,2020-21,4412,677,3735,84.7,28,14,50.0
2,All Students,2021-22,4310,1148,3162,73.4,28,26,92.9
2,All Students,2022-23,3898,629,3269,83.9,30,16,53.3
3,All Students,2018-19,4652,688,3964,85.2,29,19,65.5
3,All Students,2019-20,3112,281,2831,91.0,28,11,39.3
3,All Students,2020-21,5696,1418,4278,75.1,35,27,77.1
3,All Students,2021-22,4769,947,3822,80.1,30,23,76.7
3,All Students,2022-23,4675,843,3832,82.0,37,24,64.9
4,All Students,2018-19,4539,461,4078,89.8,28,13,46.4
4,All Students,2019-20,3422,389,3033,88.6,33,15,45.5
4,All Students,2020-21,4357,608,3749,86.0,26,10,38.5
4,All Students,2021-22,5126,1093,4033,78.7,30,25,83.3
4,All Students,2022-23,5505,1111,4394,79.8,38,31,81.6
5,All Students,2018-19,4839,491,4348,89.9,29,13,44.8
5,All Students,2019-20,3354,325,3029,90.3,33,13,39.4
5,All Students,2020-21,5484,1184,4300,78.4,32,19,59.4
5,All Students,2021-22,4095,782,3313,80.9,24,19,79.2
5,All Students,2022-23,5229,1183,4046,77.4,38,32,84.2
6,All Students,2018-19,11504,1231,10273,89.3,68,28,41.2
6,All Students,2019-20,7677,785,6892,89.8,72,29,40.3
6,All Students,2020-21,9844,1097,8747,88.9,59,23,39.0
6,All Students,2021-22,10200,2141,8059,79.0,61,46,75.4
6,All Students,2022-23,7319,1156,6163,84.2,50,34,68.0
7,All Students,2018-19,12148,1012,11136,91.7,73,26,35.6
7,All Students,2019-20,6986,741,6245,89.4,65,28,43.1
7,All Students,2020-21,11379,2804,8575,75.4,67,52,77.6
7,All Students,2021-22,8699,1573,7126,81.9,58,43,74.1
7,All Students,2022-23,10612,1947,8665,81.7,66,45,68.2
8,All Students,2018-19,11776,1214,10562,89.7,74,32,43.2
8,All Students,2019-20,7559,737,6822,90.3,69,28,40.6
8,All Students,2020-21,10110,2565,7545,74.6,59,40,67.8
8,All Students,2021-22,11236,2618,8618,76.7,67,55,82.1
8,All Students,2022-23,9153,1290,7863,85.9,61,35,57.4
9,All Students,2020-21,90,s,s,s,s,s,s
9,All Students,2021-22,94,s,s,s,s,s,s
9,All Students,2022-23,120,s,s,s,s,s,s
All Grades,All Students,2018-19,62653,5790,56863,90.8,381,147,38.6
All Grades,All Students,2019-20,37704,3505,34199,90.7,350,134,38.3
All Grades,All Students,2020-21,56464,5402,51062,90.4,344,123,35.8
All Grades,All Students,2021-22,59093,8822,50271,85.1,361,228,63.2
All Grades,All Students,2022-23,61801,8240,53561,86.7,388,210,54.1
PK in K-12 Schools,All Students,2018-19,7525,892,6633,88.1,47,25,53.2
PK in K-12 Schools,All Students,2019-20,5918,608,5310,89.7,55,25,45.5
PK in K-12 Schools,All Students,2020-21,7500,994,6506,86.7,47,19,40.4
PK in K-12 Schools,All Students,2021-22,10789,1807,8982,83.3,69,50,72.5
PK in K-12 Schools,All Students,2022-23,12381,2254,10127,81.8,85,60,70.6
0K,All Students,2018-19,10298,1200,9098,88.3,65,35,53.8
0K,All Students,2019-20,6310,717,5593,88.6,60,25,41.7
0K,All Students,2020-21,9562,1062,8500,88.9,58,29,50.0
0K,All Students,2021-22,8784,1649,7135,81.2,53,35,66.0
0K,All Students,2022-23,7709,1097,6612,85.8,46,21,45.7
1,All Students,2018-19,9575,770,8805,92.0,61,17,27.9
1,All Students,2019-20,4847,454,4393,90.6,45,20,44.4
1,All Students,2020-21,8801,913,7888,89.6,54,23,42.6
1,All Students,2021-22,9251,1254,7997,86.4,55,31,56.4
1,All Students,2022-23,9072,1386,7686,84.7,56,35,62.5
2,All Students,2018-19,8781,805,7976,90.8,52,21,40.4
2,All Students,2019-20,5397,455,4942,91.6,49,17,34.7
2,All Students,2020-21,6632,531,6101,92.0,42,14,33.3
2,All Students,2021-22,7720,981,6739,87.3,50,26,52.0
2,All Students,2022-23,8154,743,7411,90.9,54,23,42.6
3,All Students,2018-19,9029,880,8149,90.3,54,24,44.4
3,All Students,2019-20,5048,439,4609,91.3,48,18,37.5
3,All Students,2020-21,8041,645,7396,92.0,49,13,26.5
3,All Students,2021-22,7463,1086,6377,85.4,45,30,66.7
3,All Students,2022-23,8367,934,7433,88.8,52,25,48.1
4,All Students,2018-19,7937,574,7363,92.8,48,9,18.8
4,All Students,2019-20,5292,468,4824,91.2,51,19,37.3
4,All Students,2020-21,8010,685,7325,91.4,48,14,29.2
4,All Students,2021-22,7756,934,6822,88.0,46,25,54.3
4,All Students,2022-23,7971,967,7004,87.9,47,26,55.3
5,All Students,2018-19,9508,669,8839,93.0,54,16,29.6
5,All Students,2019-20,4892,364,4528,92.6,43,11,25.6
5,All Students,2020-21,7918,572,7346,92.8,46,11,23.9
5,All Students,2021-22,7330,1111,6219,84.8,43,31,72.1
5,All Students,2022-23,8147,859,7288,89.5,48,20,41.7
All Grades,All Students,2018-19,121209,2936,118273,97.6,693,32,4.6
All Grades,All Students,2019-20,81485,2530,78955,96.9,731,46,6.3
All Grades,All Students,2020-21,125881,3404,122477,97.3,728,45,6.2
All Grades,All Students,2021-22,127325,4040,123285,96.8,738,45,6.1
All Grades,All Students,2022-23,130177,4937,125240,96.2,755,76,10.1
PK in K-12 Schools,All Students,2018-19,6372,261,6111,95.9,36,2,5.6
PK in K-12 Schools,All Students,2019-20,4071,308,3763,92.4,36,8,22.2
PK in K-12 Schools,All Students,2020-21,6294,43,6251,99.3,36,0,0.0
PK in K-12 Schools,All Students,2021-22,8830,497,8333,94.4,52,9,17.3
PK in K-12 Schools,All Students,2022-23,8869,849,8020,90.4,52,18,34.6
0K,All Students,2018-19,11110,439,10671,96.0,65,5,7.7
0K,All Students,2019-20,8633,354,8279,95.9,80,6,7.5
0K,All Students,2020-21,13013,604,12409,95.4,78,9,11.5
0K,All Students,2021-22,15244,655,14589,95.7,90,9,10.0
0K,All Students,2022-23,13698,808,12890,94.1,79,15,19.0
1,All Students,2018-19,11326,273,11053,97.6,64,2,3.1
1,All Students,2019-20,6553,243,6310,96.3,58,4,6.9
1,All Students,2020-21,12401,153,12248,98.8,71,1,1.4
1,All Students,2021-22,12435,410,12025,96.7,72,5,6.9
1,All Students,2022-23,15443,706,14737,95.4,88,8,9.1
2,All Students,2018-19,11629,220,11409,98.1,67,0,0.0
2,All Students,2019-20,7330,209,7121,97.1,68,2,2.9
2,All Students,2020-21,9456,221,9235,97.7,55,4,7.3
2,All Students,2021-22,12003,311,11692,97.4,71,4,5.6
2,All Students,2022-23,12295,491,11804,96.0,70,4,5.7
3,All Students,2018-19,9035,209,8826,97.7,52,2,3.8
3,All Students,2019-20,7174,200,6974,97.2,64,5,7.8
3,All Students,2020-21,10646,144,10502,98.6,61,0,0.0
3,All Students,2021-22,8901,269,8632,97.0,52,4,7.7
3,All Students,2022-23,12370,411,11959,96.7,74,4,5.4
4,All Students,2018-19,11707,220,11487,98.1,67,3,4.5
4,All Students,2019-20,5859,140,5719,97.6,53,2,3.8
4,All Students,2020-21,10441,214,10227,98.0,60,4,6.7
4,All Students,2021-22,10122,152,9970,98.5,58,0,0.0
4,All Students,2022-23,9221,242,8979,97.4,54,4,7.4
5,All Students,2018-19,11102,207,10895,98.1,63,2,3.2
5,All Students,2019-20,7109,110,6999,98.5,62,2,3.2
5,All Students,2020-21,9117,205,8912,97.8,53,3,5.7
5,All Students,2021-22,9784,239,9545,97.6,57,1,1.8
5,All Students,2022-23,10202,277,9925,97.3,60,5,8.3
6,All Students,2018-19,17976,358,17618,98.0,103,2,1.9
6,All Students,2019-20,11672,355,11317,97.0,105,4,3.8
6,All Students,2020-21,16910,382,16528,97.7,97,6,6.2
6,All Students,2021-22,15890,393,15497,97.5,91,3,3.3
6,All Students,2022-23,15450,391,15059,97.5,89,4,4.5
7,All Students,2018-19,15690,344,15346,97.8,90,6,6.7
7,All Students,2019-20,12576,259,12317,97.9,113,5,4.4
7,All Students,2020-21,18070,821,17249,95.5,105,10,9.5
7,All Students,2021-22,16985,389,16596,97.7,96,3,3.1
7,All Students,2022-23,15368,282,15086,98.2,89,5,5.6
8,All Students,2018-19,15262,405,14857,97.3,86,8,9.3
8,All Students,2019-20,10508,352,10156,96.7,92,8,8.7
8,All Students,2020-21,19533,617,18916,96.8,112,8,7.1
8,All Students,2021-22,17131,725,16406,95.8,99,7,7.1
8,All Students,2022-23,17195,458,16737,97.3,99,8,8.1
9,All Students,2022-23,6,s,s,s,s,s,s
10,All Students,2022-23,60,s,s,s,s,s,s
All Grades,All Students,2018-19,74415,9113,65302,87.8,483,249,51.6
All Grades,All Students,2019-20,45321,5271,40050,88.4,431,213,49.4
All Grades,All Students,2020-21,65521,10827,54694,83.5,409,217,53.1
All Grades,All Students,2021-22,69374,12850,56524,81.5,442,295,66.7
All Grades,All Students,2022-23,71118,11337,59781,84.1,528,302,57.2
PK in K-12 Schools,All Students,2018-19,3192,462,2730,85.5,21,12,57.1
PK in K-12 Schools,All Students,2019-20,1282,182,1100,85.8,16,10,62.5
PK in K-12 Schools,All Students,2020-21,1667,683,984,59.0,15,13,86.7
PK in K-12 Schools,All Students,2021-22,4186,988,3198,76.4,30,25,83.3
PK in K-12 Schools,All Students,2022-23,6169,1301,4868,78.9,57,40,70.2
0K,All Students,2018-19,4396,730,3666,83.4,29,20,69.0
0K,All Students,2019-20,3280,444,2836,86.5,34,20,58.8
0K,All Students,2020-21,3545,613,2932,82.7,29,19,65.5
0K,All Students,2021-22,5734,1291,4443,77.5,39,26,66.7
0K,All Students,2022-23,3091,600,2491,80.6,26,16,61.5
1,All Students,2018-19,7213,1047,6166,85.5,48,27,56.3
1,All Students,2019-20,2821,385,2436,86.4,27,15,55.6
1,All Students,2020-21,5423,1065,4358,80.4,35,23,65.7
1,All Students,2021-22,5484,946,4538,82.7,39,23,59.0
1,All Students,2022-23,5893,1257,4636,78.7,41,31,75.6
2,All Students,2018-19,5752,657,5095,88.6,35,20,57.1
2,All Students,2019-20,5388,791,4597,85.3,53,36,67.9
2,All Students,2020-21,5434,1048,4386,80.7,35,21,60.0
2,All Students,2021-22,6116,858,5258,86.0,38,21,55.3
2,All Students,2022-23,6223,949,5274,84.8,51,26,51.0
3,All Students,2018-19,8851,1037,7814,88.3,60,35,58.3
3,All Students,2019-20,3821,481,3340,87.4,37,21,56.8
3,All Students,2020-21,7461,1726,5735,76.9,46,31,67.4
3,All Students,2021-22,6310,1082,5228,82.9,44,27,61.4
3,All Students,2022-23,6984,1112,5872,84.1,53,30,56.6
4,All Students,2018-19,6652,761,5891,88.6,45,21,46.7
4,All Students,2019-20,5625,653,4972,88.4,54,28,51.9
4,All Students,2020-21,6426,1656,4770,74.2,37,30,81.1
4,All Students,2021-22,7094,1217,5877,82.8,43,32,74.4
4,All Students,2022-23,7025,1110,5915,84.2,51,29,56.9
5,All Students,2018-19,9789,1121,8668,88.5,62,30,48.4
5,All Students,2019-20,4494,510,3984,88.7,42,20,47.6
5,All Students,2020-21,8270,1731,6539,79.1,50,38,76.0
5,All Students,2021-22,6804,1423,5381,79.1,41,33,80.5
5,All Students,2022-23,7724,1131,6593,85.4,55,31,56.4
6,All Students,2018-19,8552,979,7573,88.6,57,29,50.9
6,All Students,2019-20,6436,596,5840,90.7,58,21,36.2
6,All Students,2020-21,8171,752,7419,90.8,50,15,30.0
6,All Students,2021-22,10157,1768,8389,82.6,61,38,62.3
6,All Students,2022-23,9157,1311,7846,85.7,66,34,51.5
7,All Students,2018-19,9868,1089,8779,89.0,62,27,43.5
7,All Students,2019-20,5478,557,4921,89.8,50,16,32.0
7,All Students,2020-21,10566,914,9652,91.3,61,17,27.9
7,All Students,2021-22,7596,1494,6102,80.3,48,29,60.4
7,All Students,2022-23,11001,1540,9461,86.0,72,38,52.8
8,All Students,2018-19,10150,1230,8920,87.9,64,28,43.8
8,All Students,2019-20,6696,672,6024,90.0,60,26,43.3
8,All Students,2020-21,8558,639,7919,92.5,51,10,19.6
8,All Students,2021-22,9893,1783,8110,82.0,59,41,69.5
8,All Students,2022-23,7851,1026,6825,86.9,56,27,48.2
All Grades,All Students,2018-19,32860,2691,30169,91.8,204,62,30.4
All Grades,All Students,2019-20,24672,2208,22464,91.1,231,86,37.2
All Grades,All Students,2020-21,51741,9998,41743,80.7,299,170,56.9
All Grades,All Students,2021-22,48442,11282,37160,76.7,299,196,65.6
All Grades,All Students,2022-23,43737,8019,35718,81.7,280,156,55.7
9,All Students,2018-19,11449,868,10581,92.4,71,19,26.8
9,All Students,2019-20,6977,625,6352,91.0,67,24,35.8
9,All Students,2020-21,18894,3216,15678,83.0,110,59,53.6
9,All Students,2021-22,13310,2968,10342,77.7,81,50,61.7
9,All Students,2022-23,10194,1405,8789,86.2,68,37,54.4
10,All Students,2018-19,11584,904,10680,92.2,73,22,30.1
10,All Students,2019-20,7143,664,6479,90.7,65,25,38.5
10,All Students,2020-21,10112,2237,7875,77.9,59,36,61.0
10,All Students,2021-22,15579,3155,12424,79.7,100,58,58.0
10,All Students,2022-23,12046,2560,9486,78.7,77,43,55.8
11,All Students,2018-19,5648,528,5120,90.7,35,13,37.1
11,All Students,2019-20,7079,548,6531,92.3,67,24,35.8
11,All Students,2020-21,11200,2302,8898,79.4,64,38,59.4
11,All Students,2021-22,9079,2447,6632,73.0,55,35,63.6
11,All Students,2022-23,13844,2423,11421,82.5,88,45,51.1
12,All Students,2018-19,4179,391,3788,90.6,25,8,32.0
12,All Students,2019-20,3473,371,3102,89.3,32,13,40.6
12,All Students,2020-21,11535,2243,9292,80.6,66,37,56.1
12,All Students,2021-22,10474,2712,7762,74.1,63,53,84.1
12,All Students,2022-23,7653,1631,6022,78.7,47,31,66.0
All Grades,All Students,2018-19,59136,3158,55978,94.7,342,51,14.9
All Grades,All Students,2019-20,37920,2199,35721,94.2,337,62,18.4
All Grades,All Students,2020-21,51850,2195,49655,95.8,309,35,11.3
All Grades,All Students,2021-22,54201,4429,49772,91.8,314,84,26.8
All Grades,All Students,2022-23,83130,8419,74711,89.9,489,182,37.2
PK in K-12 Schools,All Students,2018-19,6372,503,5869,92.1,36,9,25.0
PK in K-12 Schools,All Students,2019-20,4133,278,3855,93.3,36,9,25.0
PK in K-12 Schools,All Students,2020-21,5967,776,5191,87.0,36,14,38.9
PK in K-12 Schools,All Students,2021-22,6195,566,5629,90.9,35,12,34.3
PK in K-12 Schools,All Students,2022-23,11206,1478,9728,86.8,65,34,52.3
0K,All Students,2018-19,8801,637,8164,92.8,51,18,35.3
0K,All Students,2019-20,5644,474,5170,91.6,51,17,33.3
0K,All Students,2020-21,8392,346,8046,95.9,53,6,11.3
0K,All Students,2021-22,7696,871,6825,88.7,47,18,38.3
0K,All Students,2022-23,12703,1304,11399,89.7,74,32,43.2
1,All Students,2018-19,8887,500,8387,94.4,52,7,13.5
1,All Students,2019-20,5387,382,5005,92.9,48,9,18.8
1,All Students,2020-21,7704,256,7448,96.7,46,4,8.7
1,All Students,2021-22,9116,731,8385,92.0,52,12,23.1
1,All Students,2022-23,9632,1171,8461,87.8,60,22,36.7
2,All Students,2018-19,9089,428,8661,95.3,53,6,11.3
2,All Students,2019-20,5197,313,4884,94.0,47,11,23.4
2,All Students,2020-21,7537,390,7147,94.8,44,6,13.6
2,All Students,2021-22,8707,777,7930,91.1,50,15,30.0
2,All Students,2022-23,11388,971,10417,91.5,69,17,24.6
3,All Students,2018-19,8870,393,8477,95.6,51,1,2.0
3,All Students,2019-20,5980,332,5648,94.4,52,7,13.5
3,All Students,2020-21,7208,236,6972,96.7,43,4,9.3
3,All Students,2021-22,7370,550,6820,92.5,43,8,18.6
3,All Students,2022-23,13203,1183,12020,91.0,76,30,39.5
4,All Students,2018-19,9255,245,9010,97.4,53,4,7.5
4,All Students,2019-20,5310,167,5143,96.9,47,4,8.5
4,All Students,2020-21,8123,88,8035,98.9,47,0,0.0
4,All Students,2021-22,6794,444,6350,93.5,39,9,23.1
4,All Students,2022-23,11037,858,10179,92.2,64,15,23.4
5,All Students,2018-19,7862,452,7410,94.3,46,6,13.0
5,All Students,2019-20,6269,253,6016,96.0,56,5,8.9
5,All Students,2020-21,6919,103,6816,98.5,40,1,2.5
5,All Students,2021-22,8323,490,7833,94.1,48,10,20.8
5,All Students,2022-23,13961,1454,12507,89.6,81,32,39.5
All Grades,All Students,2018-19,37560,3110,34450,91.7,215,59,27.4
All Grades,All Students,2019-20,25217,2074,23143,91.8,224,60,26.8
All Grades,All Students,2020-21,36277,5484,30793,84.9,211,98,46.4
All Grades,All Students,2021-22,34068,5003,29065,85.3,205,112,54.6
All Grades,All Students,2022-23,30489,4908,25581,83.9,199,106,53.3
6,All Students,2018-19,12277,876,11401,92.9,70,14,20.0
6,All Students,2019-20,8179,676,7503,91.7,74,22,29.7
6,All Students,2020-21,11582,1721,9861,85.1,67,31,46.3
6,All Students,2021-22,10993,1373,9620,87.5,67,33,49.3
6,All Students,2022-23,7493,1107,6386,85.2,48,29,60.4
7,All Students,2018-19,13967,1159,12808,91.7,80,23,28.8
7,All Students,2019-20,8276,607,7669,92.7,72,17,23.6
7,All Students,2020-21,12375,1749,10626,85.9,71,30,42.3
7,All Students,2021-22,11549,1850,9699,84.0,70,36,51.4
7,All Students,2022-23,10633,1265,9368,88.1,74,34,45.9
8,All Students,2018-19,11316,1075,10241,90.5,65,22,33.8
8,All Students,2019-20,8762,791,7971,91.0,78,21,26.9
8,All Students,2020-21,12320,2014,10306,83.7,73,37,50.7
8,All Students,2021-22,11526,1780,9746,84.6,68,43,63.2
8,All Students,2022-23,12363,2536,9827,79.5,77,43,55.8
All Grades,All Students,2018-19,56369,4604,51765,91.8,333,91,27.3
All Grades,All Students,2019-20,38711,3204,35507,91.7,341,92,27.0
All Grades,All Students,2020-21,51863,4154,47709,92.0,313,75,24.0
All Grades,All Students,2021-22,48880,3827,45053,92.2,294,69,23.5
All Grades,All Students,2022-23,51440,5146,46294,90.0,338,142,42.0
PK in K-12 Schools,All Students,2018-19,6253,553,5700,91.2,38,13,34.2
PK in K-12 Schools,All Students,2019-20,4332,412,3920,90.5,38,13,34.2
PK in K-12 Schools,All Students,2020-21,4852,726,4126,85.0,32,16,50.0
PK in K-12 Schools,All Students,2021-22,5191,398,4793,92.3,35,6,17.1
PK in K-12 Schools,All Students,2022-23,6303,623,5680,90.1,38,17,44.7
0K,All Students,2018-19,9484,963,8521,89.8,58,20,34.5
0K,All Students,2019-20,7475,732,6743,90.2,67,23,34.3
0K,All Students,2020-21,8328,658,7670,92.1,51,14,27.5
0K,All Students,2021-22,7153,672,6481,90.6,44,16,36.4
0K,All Students,2022-23,6911,883,6028,87.2,44,23,52.3
1,All Students,2018-19,8360,684,7676,91.8,50,15,30.0
1,All Students,2019-20,5374,443,4931,91.8,47,11,23.4
1,All Students,2020-21,8946,783,8163,91.2,56,12,21.4
1,All Students,2021-22,8400,606,7794,92.8,49,10,20.4
1,All Students,2022-23,8341,845,7496,89.9,56,26,46.4
2,All Students,2018-19,9618,674,8944,93.0,55,10,18.2
2,All Students,2019-20,5221,405,4816,92.2,46,10,21.7
2,All Students,2020-21,8179,452,7727,94.5,48,7,14.6
2,All Students,2021-22,7763,609,7154,92.2,45,12,26.7
2,All Students,2022-23,8625,805,7820,90.7,60,26,43.3
3,All Students,2018-19,7699,802,6897,89.6,45,17,37.8
3,All Students,2019-20,5980,443,5537,92.6,52,13,25.0
3,All Students,2020-21,6664,502,6162,92.5,40,8,20.0
3,All Students,2021-22,6934,457,6477,93.4,42,7,16.7
3,All Students,2022-23,7769,832,6937,89.3,50,22,44.0
4,All Students,2018-19,8374,522,7852,93.8,50,10,20.0
4,All Students,2019-20,5158,413,4745,92.0,45,11,24.4
4,All Students,2020-21,7894,459,7435,94.2,46,7,15.2
4,All Students,2021-22,6201,410,5791,93.4,36,8,22.2
4,All Students,2022-23,6948,623,6325,91.0,48,14,29.2
5,All Students,2018-19,6581,406,6175,93.8,37,6,16.2
5,All Students,2019-20,5171,356,4815,93.1,46,11,23.9
5,All Students,2020-21,7000,574,6426,91.8,40,11,27.5
5,All Students,2021-22,7238,675,6563,90.7,43,10,23.3
5,All Students,2022-23,6543,535,6008,91.8,42,14,33.3
All Grades,All Students,2018-19,53994,3540,50454,93.4,312,61,19.6
All Grades,All Students,2019-20,34983,2231,32752,93.6,308,61,19.8
All Grades,All Students,2020-21,46981,1720,45261,96.3,275,25,9.1
All Grades,All Students,2021-22,43137,4226,38911,90.2,249,100,40.2
All Grades,All Students,2022-23,41367,4351,37016,89.5,240,116,48.3
PK in K-12 Schools,All Students,2018-19,6372,539,5833,91.5,36,10,27.8
PK in K-12 Schools,All Students,2019-20,4088,285,3803,93.0,36,7,19.4
PK in K-12 Schools,All Students,2020-21,4272,173,4099,96.0,25,1,4.0
PK in K-12 Schools,All Students,2021-22,4762,514,4248,89.2,28,13,46.4
PK in K-12 Schools,All Students,2022-23,2519,259,2260,89.7,16,8,50.0
0K,All Students,2018-19,7134,617,6517,91.4,44,14,31.8
0K,All Students,2019-20,5705,412,5293,92.8,50,12,24.0
0K,All Students,2020-21,8067,355,7712,95.6,48,7,14.6
0K,All Students,2021-22,6981,840,6141,88.0,40,21,52.5
0K,All Students,2022-23,6507,769,5738,88.2,38,21,55.3
1,All Students,2018-19,10089,674,9415,93.3,57,11,19.3
1,All Students,2019-20,4589,346,4243,92.5,41,12,29.3
1,All Students,2020-21,8053,244,7809,97.0,46,4,8.7
1,All Students,2021-22,6726,608,6118,91.0,38,13,34.2
1,All Students,2022-23,6737,722,6015,89.3,40,18,45.0
2,All Students,2018-19,7139,451,6688,93.7,41,8,19.5
2,All Students,2019-20,6266,468,5798,92.5,55,15,27.3
2,All Students,2020-21,5143,272,4871,94.7,32,6,18.8
2,All Students,2021-22,6681,647,6034,90.3,39,16,41.0
2,All Students,2022-23,7456,778,6678,89.6,43,21,48.8
3,All Students,2018-19,8539,542,7997,93.7,50,8,16.0
3,All Students,2019-20,4824,290,4534,94.0,42,7,16.7
3,All Students,2020-21,8414,264,8150,96.9,48,2,4.2
3,All Students,2021-22,5376,494,4882,90.8,31,11,35.5
3,All Students,2022-23,5972,554,5418,90.7,34,12,35.3
4,All Students,2018-19,7774,314,7460,96.0,44,4,9.1
4,All Students,2019-20,4945,211,4734,95.7,43,3,7.0
4,All Students,2020-21,6175,204,5971,96.7,36,3,8.3
4,All Students,2021-22,7490,660,6830,91.2,44,15,34.1
4,All Students,2022-23,4961,487,4474,90.2,28,13,46.4
5,All Students,2018-19,6947,403,6544,94.2,40,6,15.0
5,All Students,2019-20,4566,219,4347,95.2,41,5,12.2
5,All Students,2020-21,6857,208,6649,97.0,40,2,5.0
5,All Students,2021-22,5121,463,4658,91.0,29,11,37.9
5,All Students,2022-23,7215,782,6433,89.2,41,23,56.1
All Grades,All Students,2018-19,62151,4312,57839,93.1,358,87,24.3
All Grades,All Students,2019-20,39759,3197,36562,92.0,362,107,29.6
All Grades,All Students,2020-21,49983,3652,46331,92.7,297,75,25.3
All Grades,All Students,2021-22,42163,4596,37567,89.1,247,105,42.5
All Grades,All Students,2022-23,38242,4114,34128,89.2,227,106,46.7
PK in K-12 Schools,All Students,2018-19,6335,620,5715,90.2,36,17,47.2
PK in K-12 Schools,All Students,2019-20,3785,436,3349,88.5,38,16,42.1
PK in K-12 Schools,All Students,2020-21,3611,645,2966,82.1,23,14,60.9
PK in K-12 Schools,All Students,2021-22,4110,604,3506,85.3,24,15,62.5
PK in K-12 Schools,All Students,2022-23,3954,403,3551,89.8,23,8,34.8
0K,All Students,2018-19,10712,859,9853,92.0,61,18,29.5
0K,All Students,2019-20,6914,687,6227,90.1,62,24,38.7
0K,All Students,2020-21,6919,729,6190,89.5,43,15,34.9
0K,All Students,2021-22,4600,610,3990,86.7,29,16,55.2
0K,All Students,2022-23,5496,752,4744,86.3,32,20,62.5
1,All Students,2018-19,9783,668,9115,93.2,58,15,25.9
1,All Students,2019-20,6202,478,5724,92.3,55,12,21.8
1,All Students,2020-21,9028,742,8286,91.8,53,17,32.1
1,All Students,2021-22,5419,721,4698,86.7,32,17,53.1
1,All Students,2022-23,5185,652,4533,87.4,30,19,63.3
2,All Students,2018-19,8407,567,7840,93.3,48,11,22.9
2,All Students,2019-20,5848,394,5454,93.3,51,12,23.5
2,All Students,2020-21,7968,504,7464,93.7,46,12,26.1
2,All Students,2021-22,7480,764,6716,89.8,45,18,40.0
2,All Students,2022-23,4519,502,4017,88.9,28,15,53.6
3,All Students,2018-19,8543,612,7931,92.8,48,13,27.1
3,All Students,2019-20,5671,482,5189,91.5,51,19,37.3
3,All Students,2020-21,7260,284,6976,96.1,43,4,9.3
3,All Students,2021-22,6373,644,5729,89.9,36,14,38.9
3,All Students,2022-23,6173,563,5610,90.9,37,13,35.1
4,All Students,2018-19,10404,595,9809,94.3,61,9,14.8
4,All Students,2019-20,5165,283,4882,94.5,47,9,19.1
4,All Students,2020-21,7847,461,7386,94.1,47,8,17.0
4,All Students,2021-22,7101,579,6522,91.8,41,10,24.4
4,All Students,2022-23,6016,651,5365,89.2,34,16,47.1
5,All Students,2018-19,7967,391,7576,95.1,46,4,8.7
5,All Students,2019-20,6174,437,5737,92.9,58,15,25.9
5,All Students,2020-21,7350,287,7063,96.1,42,5,11.9
5,All Students,2021-22,7080,674,6406,90.5,40,15,37.5
5,All Students,2022-23,6899,591,6308,91.4,43,15,34.9
All Grades,All Students,2018-19,45685,4951,40734,89.2,277,114,41.2
All Grades,All Students,2019-20,23608,2220,21388,90.6,222,76,34.2
All Grades,All Students,2020-21,31655,1972,29683,93.8,190,38,20.0
All Grades,All Students,2021-22,29765,3572,26193,88.0,179,85,47.5
All Grades,All Students,2022-23,28801,3504,25297,87.8,204,107,52.5
6,All Students,2018-19,11650,1103,10547,90.5,71,24,33.8
6,All Students,2019-20,5418,510,4908,90.6,52,22,42.3
6,All Students,2020-21,12049,450,11599,96.3,71,9,12.7
6,All Students,2021-22,8956,994,7962,88.9,55,25,45.5
6,All Students,2022-23,7924,973,6951,87.7,61,35,57.4
7,All Students,2018-19,16080,2089,13991,87.0,100,44,44.0
7,All Students,2019-20,7760,814,6946,89.5,72,24,33.3
7,All Students,2020-21,8711,686,8025,92.1,54,12,22.2
7,All Students,2021-22,11106,1181,9925,89.4,66,29,43.9
7,All Students,2022-23,10169,1279,8890,87.4,73,39,53.4
8,All Students,2018-19,17955,1759,16196,90.2,106,46,43.4
8,All Students,2019-20,10430,896,9534,91.4,98,30,30.6
8,All Students,2020-21,10895,836,10059,92.3,65,17,26.2
8,All Students,2021-22,9703,1397,8306,85.6,58,31,53.4
8,All Students,2022-23,10708,1252,9456,88.3,70,33,47.1
All Grades,All Students,2018-19,80314,7057,73257,91.2,501,139,27.7
All Grades,All Students,2019-20,53962,4708,49254,91.3,500,129,25.8
All Grades,All Students,2020-21,98875,13805,85070,86.0,579,224,38.7
All Grades,All Students,2021-22,87390,14362,73028,83.6,529,282,53.3
All Grades,All Students,2022-23,78910,9591,69319,87.8,489,185,37.8
9,All Students,2018-19,21740,2006,19734,90.8,139,34,24.5
9,All Students,2019-20,13896,1505,12391,89.2,128,30,23.4
9,All Students,2020-21,27963,3020,24943,89.2,165,54,32.7
9,All Students,2021-22,19837,2253,17584,88.6,121,46,38.0
9,All Students,2022-23,19753,1576,18177,92.0,124,34,27.4
10,All Students,2018-19,23208,1869,21339,91.9,146,44,30.1
10,All Students,2019-20,13323,949,12374,92.9,127,30,23.6
10,All Students,2020-21,24427,3336,21091,86.3,145,51,35.2
10,All Students,2021-22,24094,3703,20391,84.6,147,77,52.4
10,All Students,2022-23,19875,2193,17682,89.0,122,36,29.5
11,All Students,2018-19,19315,1395,17920,92.8,119,25,21.0
11,All Students,2019-20,13624,851,12773,93.8,126,27,21.4
11,All Students,2020-21,23535,3511,20024,85.1,136,55,40.4
11,All Students,2021-22,21109,3413,17696,83.8,128,74,57.8
11,All Students,2022-23,19755,2087,17668,89.4,122,46,37.7
12,All Students,2018-19,16051,1787,14264,88.9,97,36,37.1
12,All Students,2019-20,13119,1403,11716,89.3,119,42,35.3
12,All Students,2020-21,22950,3938,19012,82.8,133,64,48.1
12,All Students,2021-22,22350,4993,17357,77.7,133,85,63.9
12,All Students,2022-23,19527,3735,15792,80.9,121,69,57.0
All Grades,All Students,2018-19,119652,6333,113319,94.7,685,81,11.8
All Grades,All Students,2019-20,77381,3742,73639,95.2,685,82,12.0
All Grades,All Students,2020-21,117665,2619,115046,97.8,685,26,3.8
All Grades,All Students,2021-22,123278,9623,113655,92.2,704,182,25.9
All Grades,All Students,2022-23,123293,7852,115441,93.6,712,140,19.7
6,All Students,2018-19,17816,749,17067,95.8,101,6,5.9
6,All Students,2019-20,11784,447,11337,96.2,105,10,9.5
6,All Students,2020-21,17370,276,17094,98.4,101,2,2.0
6,All Students,2021-22,20022,1565,18457,92.2,115,32,27.8
6,All Students,2022-23,18377,1233,17144,93.3,106,25,23.6
7,All Students,2018-19,18387,786,17601,95.7,104,9,8.7
7,All Students,2019-20,11912,623,11289,94.8,105,16,15.2
7,All Students,2020-21,17208,253,16955,98.5,100,1,1.0
7,All Students,2021-22,17437,1255,16182,92.8,102,23,22.5
7,All Students,2022-23,18971,1332,17639,93.0,110,25,22.7
8,All Students,2018-19,19157,872,18285,95.4,108,10,9.3
8,All Students,2019-20,12004,439,11565,96.3,106,10,9.4
8,All Students,2020-21,18061,490,17571,97.3,107,5,4.7
8,All Students,2021-22,17465,1144,16321,93.4,99,19,19.2
8,All Students,2022-23,17592,1051,16541,94.0,101,16,15.8
9,All Students,2018-19,16896,711,16185,95.8,98,10,10.2
9,All Students,2019-20,12072,504,11568,95.8,106,12,11.3
9,All Students,2020-21,17404,296,17108,98.3,101,1,1.0
9,All Students,2021-22,18056,1154,16902,93.6,102,19,18.6
9,All Students,2022-23,17387,880,16507,94.9,101,15,14.9
10,All Students,2018-19,16146,1508,14638,90.7,95,25,26.3
10,All Students,2019-20,10558,669,9889,93.7,95,13,13.7
10,All Students,2020-21,17791,465,17326,97.4,103,6,5.8
10,All Students,2021-22,16811,1368,15443,91.9,97,27,27.8
10,All Students,2022-23,17786,1111,16675,93.8,103,17,16.5
11,All Students,2018-19,15866,749,15117,95.3,90,8,8.9
11,All Students,2019-20,9061,613,8448,93.2,80,16,20.0
11,All Students,2020-21,16089,439,15650,97.3,93,6,6.5
11,All Students,2021-22,17363,1452,15911,91.6,98,29,29.6
11,All Students,2022-23,16343,847,15496,94.8,94,14,14.9
12,All Students,2018-19,15384,958,14426,93.8,89,13,14.6
12,All Students,2019-20,9990,447,9543,95.5,88,5,5.7
12,All Students,2020-21,13742,400,13342,97.1,80,5,6.3
12,All Students,2021-22,16124,1685,14439,89.5,91,33,36.3
12,All Students,2022-23,16837,1398,15439,91.7,97,28,28.9
All Grades,All Students,2018-19,20826,4217,16609,79.8,125,75,60.0
All Grades,All Students,2019-20,10547,1667,8880,84.2,98,49,50.0
9,All Students,2018-19,6152,1499,4653,75.6,35,18,51.4
9,All Students,2019-20,2761,600,2161,78.3,24,9,37.5
10,All Students,2018-19,4953,837,4116,83.1,30,14,46.7
10,All Students,2019-20,3261,518,2743,84.1,31,18,58.1
11,All Students,2018-19,4107,615,3492,85.0,25,13,52.0
11,All Students,2019-20,2203,156,2047,92.9,21,6,28.6
12,All Students,2018-19,5614,1266,4348,77.4,35,30,85.7
12,All Students,2019-20,2322,393,1929,83.1,22,16,72.7
All Grades,All Students,2018-19,304104,11901,292203,96.1,1759,117,6.7
All Grades,All Students,2019-20,203423,8589,194834,95.8,1814,158,8.7
All Grades,All Students,2020-21,313410,10409,303001,96.7,1797,123,6.8
All Grades,All Students,2021-22,284665,17112,267553,94.0,1645,247,15.0
All Grades,All Students,2022-23,279109,15926,263183,94.3,1639,230,14.0
0K,All Students,2018-19,17702,810,16892,95.4,100,8,8.0
0K,All Students,2019-20,11423,543,10880,95.2,100,7,7.0
0K,All Students,2020-21,17354,219,17135,98.7,100,2,2.0
0K,All Students,2021-22,17654,947,16707,94.6,100,14,14.0
0K,All Students,2022-23,17567,1174,16393,93.3,101,19,18.8
1,All Students,2018-19,20526,854,19672,95.8,116,6,5.2
1,All Students,2019-20,13204,677,12527,94.9,116,13,11.2
1,All Students,2020-21,19062,235,18827,98.8,110,1,0.9
1,All Students,2021-22,18719,983,17736,94.7,107,13,12.1
1,All Students,2022-23,19631,1166,18465,94.1,112,15,13.4
2,All Students,2018-19,21146,813,20333,96.2,119,6,5.0
2,All Students,2019-20,13757,640,13117,95.3,120,12,10.0
2,All Students,2020-21,20484,272,20212,98.7,117,0,0.0
2,All Students,2021-22,17746,905,16841,94.9,101,11,10.9
2,All Students,2022-23,19793,1003,18790,94.9,112,12,10.7
3,All Students,2018-19,26380,1058,25322,96.0,149,8,5.4
3,All Students,2019-20,13965,592,13373,95.8,123,7,5.7
3,All Students,2020-21,21281,316,20965,98.5,123,1,0.8
3,All Students,2021-22,19849,1084,18765,94.5,113,11,9.7
3,All Students,2022-23,19801,846,18955,95.7,112,9,8.0
4,All Students,2018-19,20654,678,19976,96.7,116,3,2.6
4,All Students,2019-20,16520,684,15836,95.9,146,11,7.5
4,All Students,2020-21,20365,222,20143,98.9,116,0,0.0
4,All Students,2021-22,18973,1216,17757,93.6,106,9,8.5
4,All Students,2022-23,19740,798,18942,96.0,112,7,6.3
5,All Students,2018-19,19434,469,18965,97.6,110,2,1.8
5,All Students,2019-20,13134,438,12696,96.7,115,8,7.0
5,All Students,2020-21,23741,378,23363,98.4,137,3,2.2
5,All Students,2021-22,19395,929,18466,95.2,110,6,5.5
5,All Students,2022-23,19272,812,18460,95.8,111,6,5.4
6,All Students,2018-19,25758,824,24934,96.8,146,8,5.5
6,All Students,2019-20,17364,709,16655,95.9,153,13,8.5
6,All Students,2020-21,25877,777,25100,97.0,147,5,3.4
6,All Students,2021-22,24499,1387,23112,94.3,139,14,10.1
6,All Students,2022-23,20461,1012,19449,95.1,117,12,10.3
7,All Students,2018-19,25098,729,24369,97.1,141,7,5.0
7,All Students,2019-20,16467,370,16097,97.8,145,4,2.8
7,All Students,2020-21,25334,936,24398,96.3,145,16,11.0
7,All Students,2021-22,20608,1289,19319,93.7,118,21,17.8
7,All Students,2022-23,21096,833,20263,96.1,122,7,5.7
8,All Students,2018-19,25381,906,24475,96.4,145,9,6.2
8,All Students,2019-20,15848,630,15218,96.0,139,8,5.8
8,All Students,2020-21,23819,360,23459,98.5,136,2,1.5
8,All Students,2021-22,23664,1413,22251,94.0,136,23,16.9
8,All Students,2022-23,19776,1345,18431,93.2,115,24,20.9
9,All Students,2018-19,27106,846,26260,96.9,164,5,3.0
9,All Students,2019-20,22218,752,21466,96.6,203,10,4.9
9,All Students,2020-21,30439,1086,29353,96.4,174,9,5.2
9,All Students,2021-22,17838,791,17047,95.6,107,12,11.2
9,All Students,2022-23,24472,1404,23068,94.3,151,19,12.6
10,All Students,2018-19,25287,1271,24016,95.0,154,13,8.4
10,All Students,2019-20,17831,845,16986,95.3,165,16,9.7
10,All Students,2020-21,35424,1834,33590,94.8,203,22,10.8
10,All Students,2021-22,27373,1503,25870,94.5,161,23,14.3
10,All Students,2022-23,19949,1017,18932,94.9,123,15,12.2
11,All Students,2018-19,26135,1160,24975,95.6,158,15,9.5
11,All Students,2019-20,14849,601,14248,96.0,135,14,10.4
11,All Students,2020-21,26665,1673,24992,93.7,152,15,9.9
11,All Students,2021-22,33086,2111,30975,93.6,197,37,18.8
11,All Students,2022-23,25766,1380,24386,94.6,158,22,13.9
12,All Students,2018-19,23497,1483,22014,93.7,141,27,19.1
12,All Students,2019-20,16843,1108,15735,93.4,154,35,22.7
12,All Students,2020-21,23565,2101,21464,91.1,137,47,34.3
12,All Students,2021-22,25261,2554,22707,89.9,150,53,35.3
12,All Students,2022-23,31785,3136,28649,90.1,193,63,32.6
All Grades,All Students,2018-19,102278,5062,97216,95.1,617,70,11.3
All Grades,All Students,2019-20,67431,2765,64666,95.9,619,62,10.0
All Grades,All Students,2020-21,110961,6418,104543,94.2,637,126,19.8
All Grades,All Students,2021-22,104896,10868,94028,89.6,618,233,37.7
All Grades,All Students,2022-23,92145,7224,84921,92.2,569,147,25.8
9,All Students,2018-19,28818,977,27841,96.6,174,11,6.3
9,All Students,2019-20,18063,736,17327,95.9,166,16,9.6
9,All Students,2020-21,26439,1424,25015,94.6,152,24,15.8
9,All Students,2021-22,25137,2097,23040,91.7,150,33,22.0
9,All Students,2022-23,22369,1334,21035,94.0,138,21,15.2
10,All Students,2018-19,27882,1407,26475,95.0,169,20,11.8
10,All Students,2019-20,18273,552,17721,97.0,168,9,5.4
10,All Students,2020-21,27703,1781,25922,93.6,159,37,23.3
10,All Students,2021-22,24887,1806,23081,92.7,145,27,18.6
10,All Students,2022-23,22712,1348,21364,94.1,143,28,19.6
11,All Students,2018-19,21196,1086,20110,94.9,128,15,11.7
11,All Students,2019-20,17987,835,17152,95.4,165,22,13.3
11,All Students,2020-21,29141,1488,27653,94.9,167,29,17.4
11,All Students,2021-22,26351,2941,23410,88.8,154,67,43.5
11,All Students,2022-23,22575,1708,20867,92.4,138,27,19.6
12,All Students,2018-19,24382,1592,22790,93.5,146,24,16.4
12,All Students,2019-20,13108,642,12466,95.1,120,15,12.5
12,All Students,2020-21,27678,1725,25953,93.8,159,36,22.6
12,All Students,2021-22,28521,4024,24497,85.9,169,106,62.7
12,All Students,2022-23,24489,2834,21655,88.4,150,71,47.3
All Grades,All Students,2018-19,64251,3160,61091,95.1,362,48,13.3
All Grades,All Students,2019-20,41267,2251,39016,94.5,365,51,14.0
All Grades,All Students,2020-21,61691,1967,59724,96.8,357,26,7.3
All Grades,All Students,2021-22,57768,4544,53224,92.1,337,97,28.8
All Grades,All Students,2022-23,56490,4182,52308,92.6,331,87,26.3
6,All Students,2018-19,21321,1111,20210,94.8,120,17,14.2
6,All Students,2019-20,13634,s,s,s,s,s,s
6,All Students,2020-21,21410,675,20735,96.8,124,8,6.5
6,All Students,2021-22,18539,1612,16927,91.3,110,38,34.5
6,All Students,2022-23,19813,1650,18163,91.7,114,36,31.6
7,All Students,2018-19,21573,864,20709,96.0,122,14,11.5
7,All Students,2019-20,13671,786,12885,94.3,120,18,15.0
7,All Students,2020-21,19726,685,19041,96.5,115,11,9.6
7,All Students,2021-22,19937,1548,18389,92.2,116,33,28.4
7,All Students,2022-23,18053,1231,16822,93.2,108,26,24.1
8,All Students,2018-19,21357,1185,20172,94.5,120,17,14.2
8,All Students,2019-20,13961,742,13219,94.7,122,18,14.8
8,All Students,2020-21,20555,607,19948,97.0,118,7,5.9
8,All Students,2021-22,19292,1384,17908,92.8,111,26,23.4
8,All Students,2022-23,18624,1301,17323,93.0,109,25,22.9
9,All Students,2019-20,1,s,s,s,s,s,s
All Grades,All Students,2018-19,52375,2992,49383,94.3,315,61,19.4
All Grades,All Students,2019-20,28925,1803,27122,93.8,268,58,21.6
All Grades,All Students,2020-21,41262,3356,37906,91.9,243,72,29.6
All Grades,All Students,2021-22,37930,5082,32848,86.6,237,115,48.5
All Grades,All Students,2022-23,35224,4538,30686,87.1,216,110,50.9
PK in K-12 Schools,All Students,2018-19,4912,479,4433,90.2,32,12,37.5
PK in K-12 Schools,All Students,2019-20,2196,271,1925,87.7,21,8,38.1
PK in K-12 Schools,All Students,2020-21,3818,375,3443,90.2,23,7,30.4
PK in K-12 Schools,All Students,2021-22,4484,790,3694,82.4,28,21,75.0
PK in K-12 Schools,All Students,2022-23,5651,1205,4446,78.7,34,23,67.6
0K,All Students,2018-19,6262,378,5884,94.0,40,7,17.5
0K,All Students,2019-20,3139,278,2861,91.1,31,9,29.0
0K,All Students,2020-21,5595,627,4968,88.8,34,14,41.2
0K,All Students,2021-22,5678,938,4740,83.5,35,20,57.1
0K,All Students,2022-23,3862,572,3290,85.2,25,17,68.0
1,All Students,2018-19,7052,466,6586,93.4,44,10,22.7
1,All Students,2019-20,4220,270,3950,93.6,41,13,31.7
1,All Students,2020-21,4725,403,4322,91.5,27,8,29.6
1,All Students,2021-22,4676,788,3888,83.1,30,15,50.0
1,All Students,2022-23,5599,718,4881,87.2,35,22,62.9
2,All Students,2018-19,7669,378,7291,95.1,46,5,10.9
2,All Students,2019-20,4326,214,4112,95.1,38,5,13.2
2,All Students,2020-21,6032,514,5518,91.5,37,11,29.7
2,All Students,2021-22,4020,469,3551,88.3,26,12,46.2
2,All Students,2022-23,4634,549,4085,88.2,30,13,43.3
3,All Students,2018-19,8495,431,8064,94.9,50,7,14.0
3,All Students,2019-20,4489,246,4243,94.5,41,7,17.1
3,All Students,2020-21,6643,569,6074,91.4,38,10,26.3
3,All Students,2021-22,5190,634,4556,87.8,35,16,45.7
3,All Students,2022-23,3434,405,3029,88.2,20,11,55.0
4,All Students,2018-19,8186,463,7723,94.3,48,10,20.8
4,All Students,2019-20,5450,236,5214,95.7,48,6,12.5
4,All Students,2020-21,6853,525,6328,92.3,40,12,30.0
4,All Students,2021-22,6511,689,5822,89.4,40,15,37.5
4,All Students,2022-23,6020,628,5392,89.6,36,14,38.9
5,All Students,2018-19,9799,397,9402,95.9,55,10,18.2
5,All Students,2019-20,5105,288,4817,94.4,48,10,20.8
5,All Students,2020-21,7596,343,7253,95.5,44,10,22.7
5,All Students,2021-22,7371,774,6597,89.5,43,16,37.2
5,All Students,2022-23,6024,461,5563,92.3,36,10,27.8
All Grades,All Students,2018-19,86880,3176,83704,96.3,516,69,13.4
All Grades,All Students,2019-20,51146,2390,48756,95.3,464,76,16.4
All Grades,All Students,2020-21,73438,4434,69004,94.0,428,74,17.3
All Grades,All Students,2021-22,63357,5320,58037,91.6,384,117,30.5
All Grades,All Students,2022-23,57669,3993,53676,93.1,347,89,25.6
PK in K-12 Schools,All Students,2018-19,3639,304,3335,91.6,28,8,28.6
PK in K-12 Schools,All Students,2019-20,3101,408,2693,86.8,31,17,54.8
PK in K-12 Schools,All Students,2020-21,4432,387,4045,91.3,27,9,33.3
PK in K-12 Schools,All Students,2021-22,2881,467,2414,83.8,19,13,68.4
PK in K-12 Schools,All Students,2022-23,1194,249,945,79.1,10,7,70.0
0K,All Students,2018-19,11180,674,10506,94.0,67,17,25.4
0K,All Students,2019-20,5958,403,5555,93.2,57,16,28.1
0K,All Students,2020-21,10582,777,9805,92.7,63,11,17.5
0K,All Students,2021-22,8514,1089,7425,87.2,57,28,49.1
0K,All Students,2022-23,7888,833,7055,89.4,50,22,44.0
1,All Students,2018-19,15379,631,14748,95.9,94,14,14.9
1,All Students,2019-20,6397,320,6077,95.0,58,11,19.0
1,All Students,2020-21,9269,859,8410,90.7,55,16,29.1
1,All Students,2021-22,10354,894,9460,91.4,62,21,33.9
1,All Students,2022-23,8326,696,7630,91.6,50,12,24.0
2,All Students,2018-19,11877,384,11493,96.8,70,8,11.4
2,All Students,2019-20,9842,392,9450,96.0,87,7,8.0
2,All Students,2020-21,10440,693,9747,93.4,60,12,20.0
2,All Students,2021-22,8974,790,8184,91.2,53,14,26.4
2,All Students,2022-23,9846,643,9203,93.5,58,14,24.1
3,All Students,2018-19,13971,440,13531,96.9,80,9,11.3
3,All Students,2019-20,7573,285,7288,96.2,68,8,11.8
3,All Students,2020-21,14463,522,13941,96.4,83,8,9.6
3,All Students,2021-22,9277,703,8574,92.4,55,17,30.9
3,All Students,2022-23,8328,539,7789,93.5,51,13,25.5
4,All Students,2018-19,14502,448,14054,96.9,85,10,11.8
4,All Students,2019-20,8908,273,8635,96.9,80,8,10.0
4,All Students,2020-21,11025,575,10450,94.8,63,7,11.1
4,All Students,2021-22,13552,761,12791,94.4,81,14,17.3
4,All Students,2022-23,8931,489,8442,94.5,53,12,22.6
5,All Students,2018-19,16332,295,16037,98.2,92,3,3.3
5,All Students,2019-20,9367,309,9058,96.7,83,9,10.8
5,All Students,2020-21,13227,621,12606,95.3,77,11,14.3
5,All Students,2021-22,9805,616,9189,93.7,57,10,17.5
5,All Students,2022-23,13156,544,12612,95.9,75,9,12.0
All Grades,All Students,2018-19,129885,8357,121528,93.6,749,154,20.6
All Grades,All Students,2019-20,81984,5202,76782,93.7,727,122,16.8
All Grades,All Students,2020-21,103425,3375,100050,96.7,619,54,8.7
All Grades,All Students,2021-22,100927,7904,93023,92.2,588,144,24.5
All Grades,All Students,2022-23,93138,7574,85564,91.9,552,154,27.9
PK in K-12 Schools,All Students,2018-19,9555,708,8847,92.6,54,13,24.1
PK in K-12 Schools,All Students,2019-20,7873,834,7039,89.4,72,27,37.5
PK in K-12 Schools,All Students,2020-21,8010,700,7310,91.3,52,17,32.7
PK in K-12 Schools,All Students,2021-22,9544,827,8717,91.3,54,18,33.3
PK in K-12 Schools,All Students,2022-23,7415,s,s,s,s,s,s
0K,All Students,2018-19,22248,1862,20386,91.6,130,45,34.6
0K,All Students,2019-20,13389,930,12459,93.1,120,24,20.0
0K,All Students,2020-21,16756,553,16203,96.7,100,9,9.0
0K,All Students,2021-22,15130,1393,13737,90.8,91,27,29.7
0K,All Students,2022-23,13929,1113,12816,92.0,86,25,29.1
1,All Students,2018-19,19886,1531,18355,92.3,115,29,25.2
1,All Students,2019-20,13369,909,12460,93.2,118,22,18.6
1,All Students,2020-21,15741,462,15279,97.1,94,9,9.6
1,All Students,2021-22,15041,1062,13979,92.9,86,14,16.3
1,All Students,2022-23,14243,1255,12988,91.2,83,25,30.1
2,All Students,2018-19,22121,1331,20790,94.0,128,22,17.2
2,All Students,2019-20,12172,772,11400,93.7,106,20,18.9
2,All Students,2020-21,15886,284,15602,98.2,93,2,2.2
2,All Students,2021-22,15316,1105,14211,92.8,89,21,23.6
2,All Students,2022-23,15191,1231,13960,91.9,88,24,27.3
3,All Students,2018-19,17953,1037,16916,94.2,103,17,16.5
3,All Students,2019-20,13812,716,13096,94.8,121,12,9.9
3,All Students,2020-21,15959,548,15411,96.6,95,8,8.4
3,All Students,2021-22,15096,1223,13873,91.9,88,26,29.5
3,All Students,2022-23,14572,1110,13462,92.4,88,19,21.6
4,All Students,2018-19,17600,801,16799,95.4,102,11,10.8
4,All Students,2019-20,10136,361,9775,96.4,90,5,5.6
4,All Students,2020-21,17706,450,17256,97.5,106,7,6.6
4,All Students,2021-22,15169,1064,14105,93.0,88,16,18.2
4,All Students,2022-23,13587,1077,12510,92.1,79,24,30.4
5,All Students,2018-19,20522,1087,19435,94.7,117,17,14.5
5,All Students,2019-20,11233,680,10553,93.9,100,12,12.0
5,All Students,2020-21,13367,378,12989,97.2,79,2,2.5
5,All Students,2021-22,15631,1230,14401,92.1,92,22,23.9
5,All Students,2022-23,14187,966,13221,93.2,82,16,19.5
6,All Students,2022-23,14,s,s,s,s,s,s
All Grades,All Students,2018-19,120976,5386,115590,95.5,700,53,7.6
All Grades,All Students,2019-20,74275,3310,70965,95.5,657,62,9.4
All Grades,All Students,2020-21,102577,2356,100221,97.7,608,29,4.8
All Grades,All Students,2021-22,101446,6266,95180,93.8,594,108,18.2
All Grades,All Students,2022-23,104408,7500,96908,92.8,599,142,23.7
PK in K-12 Schools,All Students,2018-19,16327,1066,15261,93.5,101,18,17.8
PK in K-12 Schools,All Students,2019-20,7859,489,7370,93.8,70,15,21.4
PK in K-12 Schools,All Students,2020-21,11492,645,10847,94.4,71,13,18.3
PK in K-12 Schools,All Students,2021-22,14664,1422,13242,90.3,86,34,39.5
PK in K-12 Schools,All Students,2022-23,17729,1613,16116,90.9,102,38,37.3
0K,All Students,2018-19,18756,965,17791,94.9,108,10,9.3
0K,All Students,2019-20,12500,757,11743,93.9,112,14,12.5
0K,All Students,2020-21,16502,471,16031,97.1,98,6,6.1
0K,All Students,2021-22,15976,1204,14772,92.5,95,26,27.4
0K,All Students,2022-23,17414,1455,15959,91.6,102,34,33.3
1,All Students,2018-19,19446,864,18582,95.6,112,7,6.3
1,All Students,2019-20,11474,535,10939,95.3,102,10,9.8
1,All Students,2020-21,16929,333,16596,98.0,102,4,3.9
1,All Students,2021-22,15921,834,15087,94.8,91,10,11.0
1,All Students,2022-23,16338,1144,15194,93.0,94,19,20.2
2,All Students,2018-19,17481,680,16801,96.1,101,5,5.0
2,All Students,2019-20,12102,597,11505,95.1,107,10,9.3
2,All Students,2020-21,15877,230,15647,98.6,92,1,1.1
2,All Students,2021-22,14361,802,13559,94.4,83,15,18.1
2,All Students,2022-23,14938,1046,13892,93.0,85,16,18.8
3,All Students,2018-19,16007,570,15437,96.4,91,2,2.2
3,All Students,2019-20,11049,432,10617,96.1,98,8,8.2
3,All Students,2020-21,15670,384,15286,97.5,91,2,2.2
3,All Students,2021-22,14369,643,13726,95.5,86,10,11.6
3,All Students,2022-23,12935,723,12212,94.4,74,11,14.9
4,All Students,2018-19,15344,346,14998,97.7,88,4,4.5
4,All Students,2019-20,9401,185,9216,98.0,82,1,1.2
4,All Students,2020-21,13957,185,13772,98.7,83,2,2.4
4,All Students,2021-22,14244,736,13508,94.8,83,6,7.2
4,All Students,2022-23,13195,703,12492,94.7,75,8,10.7
5,All Students,2018-19,17615,895,16720,94.9,99,7,7.1
5,All Students,2019-20,9890,315,9575,96.8,86,4,4.7
5,All Students,2020-21,12150,108,12042,99.1,71,1,1.4
5,All Students,2021-22,11911,625,11286,94.8,70,7,10.0
5,All Students,2022-23,11859,816,11043,93.1,67,16,23.9
All Grades,All Students,2018-19,158634,8156,150478,94.9,925,126,13.6
All Grades,All Students,2019-20,103724,5862,97862,94.3,934,157,16.8
All Grades,All Students,2020-21,138623,4680,133943,96.6,823,87,10.6
All Grades,All Students,2021-22,129471,9965,119506,92.3,752,190,25.3
All Grades,All Students,2022-23,135454,12791,122663,90.6,826,268,32.4
PK in K-12 Schools,All Students,2018-19,3204,118,3086,96.3,18,0,0.0
PK in K-12 Schools,All Students,2019-20,2049,112,1937,94.5,19,3,15.8
PK in K-12 Schools,All Students,2020-21,3132,115,3017,96.3,18,2,11.1
PK in K-12 Schools,All Students,2021-22,3090,269,2821,91.3,18,6,33.3
PK in K-12 Schools,All Students,2022-23,3186,286,2900,91.0,18,5,27.8
0K,All Students,2018-19,26813,1627,25186,93.9,159,28,17.6
0K,All Students,2019-20,16590,1173,15417,92.9,150,40,26.7
0K,All Students,2020-21,21796,831,20965,96.2,132,16,12.1
0K,All Students,2021-22,16827,1615,15212,90.4,97,33,34.0
0K,All Students,2022-23,18951,2079,16872,89.0,117,46,39.3
1,All Students,2018-19,24579,1352,23227,94.5,143,16,11.2
1,All Students,2019-20,18268,1268,17000,93.1,164,33,20.1
1,All Students,2020-21,23601,696,22905,97.1,141,14,9.9
1,All Students,2021-22,23098,1988,21110,91.4,137,41,29.9
1,All Students,2022-23,21469,2448,19021,88.6,135,59,43.7
2,All Students,2018-19,28024,1387,26637,95.1,162,21,13.0
2,All Students,2019-20,15408,819,14589,94.7,138,18,13.0
2,All Students,2020-21,24456,854,23602,96.5,145,15,10.3
2,All Students,2021-22,21191,1621,19570,92.4,122,28,23.0
2,All Students,2022-23,24083,2150,21933,91.1,144,44,30.6
3,All Students,2018-19,25708,1316,24392,94.9,149,19,12.8
3,All Students,2019-20,18713,959,17754,94.9,170,28,16.5
3,All Students,2020-21,19400,675,18725,96.5,114,11,9.6
3,All Students,2021-22,23260,1471,21789,93.7,134,23,17.2
3,All Students,2022-23,24240,2149,22091,91.1,149,43,28.9
4,All Students,2018-19,24525,1088,23437,95.6,145,23,15.9
4,All Students,2019-20,16396,538,15858,96.7,146,8,5.5
4,All Students,2020-21,24278,669,23609,97.2,145,10,6.9
4,All Students,2021-22,18206,1368,16838,92.5,106,25,23.6
4,All Students,2022-23,24351,1938,22413,92.0,147,31,21.1
5,All Students,2018-19,25781,1268,24513,95.1,149,19,12.8
5,All Students,2019-20,16300,993,15307,93.9,147,27,18.4
5,All Students,2020-21,21960,840,21120,96.2,128,19,14.8
5,All Students,2021-22,23799,1633,22166,93.1,138,34,24.6
5,All Students,2022-23,19174,1741,17433,90.9,116,40,34.5
All Grades,All Students,2018-19,113222,8035,105187,92.9,705,198,28.1
All Grades,All Students,2019-20,70604,4891,65713,93.1,661,164,24.8
All Grades,All Students,2020-21,96314,8754,87560,90.9,585,156,26.7
All Grades,All Students,2021-22,89218,8677,80541,90.3,528,188,35.6
All Grades,All Students,2022-23,104729,11695,93034,88.8,664,264,39.8
PK in K-12 Schools,All Students,2018-19,6187,s,s,s,s,s,s
PK in K-12 Schools,All Students,2019-20,3929,536,3393,86.4,37,25,67.6
PK in K-12 Schools,All Students,2020-21,5119,s,s,s,s,s,s
PK in K-12 Schools,All Students,2021-22,4892,761,4131,84.4,31,19,61.3
PK in K-12 Schools,All Students,2022-23,5959,s,s,s,s,s,s
0K,All Students,2018-19,14862,1170,13692,92.1,99,31,31.3
0K,All Students,2019-20,11540,927,10613,92.0,110,29,26.4
0K,All Students,2020-21,14221,1689,12532,88.1,93,34,36.6
0K,All Students,2021-22,12596,1319,11277,89.5,75,28,37.3
0K,All Students,2022-23,16064,2177,13887,86.4,105,53,50.5
1,All Students,2018-19,20037,1553,18484,92.2,124,40,32.3
1,All Students,2019-20,10528,657,9871,93.8,99,18,18.2
1,All Students,2020-21,17147,1439,15708,91.6,106,24,22.6
1,All Students,2021-22,15017,1615,13402,89.2,91,37,40.7
1,All Students,2022-23,15223,1652,13571,89.1,95,37,38.9
2,All Students,2018-19,17266,1121,16145,93.5,106,23,21.7
2,All Students,2019-20,12105,958,11147,92.1,114,31,27.2
2,All Students,2020-21,15297,1175,14122,92.3,90,17,18.9
2,All Students,2021-22,14124,1275,12849,91.0,81,22,27.2
2,All Students,2022-23,17141,1804,15337,89.5,112,42,37.5
3,All Students,2018-19,17164,1161,16003,93.2,111,31,27.9
3,All Students,2019-20,10296,578,9718,94.4,95,17,17.9
3,All Students,2020-21,17715,1842,15873,89.6,107,32,29.9
3,All Students,2021-22,14595,1221,13374,91.6,87,27,31.0
3,All Students,2022-23,18185,1768,16417,90.3,112,40,35.7
4,All Students,2018-19,19934,1122,18812,94.4,118,26,22.0
4,All Students,2019-20,10033,484,9549,95.2,92,15,16.3
4,All Students,2020-21,13859,1236,12623,91.1,81,22,27.2
4,All Students,2021-22,14679,1174,13505,92.0,85,24,28.2
4,All Students,2022-23,16495,1373,15122,91.7,103,27,26.2
5,All Students,2018-19,17769,1202,16567,93.2,107,29,27.1
5,All Students,2019-20,12173,751,11422,93.8,114,29,25.4
5,All Students,2020-21,12955,954,12001,92.6,76,19,25.0
5,All Students,2021-22,13315,1312,12003,90.1,78,31,39.7
5,All Students,2022-23,15324,1520,13804,90.1,95,35,36.8
6,All Students,2018-19,3,s,s,s,s,s,s
6,All Students,2020-21,1,s,s,s,s,s,s
6,All Students,2022-23,338,s,s,s,s,s,s
All Grades,All Students,2018-19,125326,5397,119929,95.7,728,60,8.2
All Grades,All Students,2019-20,80953,3896,77057,95.2,718,73,10.2
All Grades,All Students,2020-21,109851,3530,106321,96.8,651,29,4.5
All Grades,All Students,2021-22,106429,6681,99748,93.7,611,98,16.0
All Grades,All Students,2022-23,103877,6516,97361,93.7,605,116,19.2
PK in K-12 Schools,All Students,2018-19,6020,287,5733,95.2,38,5,13.2
PK in K-12 Schools,All Students,2019-20,2093,s,s,s,s,s,s
PK in K-12 Schools,All Students,2020-21,3150,s,s,s,s,s,s
PK in K-12 Schools,All Students,2021-22,3186,s,s,s,s,s,s
PK in K-12 Schools,All Students,2022-23,3186,234,2952,92.7,18,5,27.8
0K,All Students,2018-19,22276,1309,20967,94.1,129,22,17.1
0K,All Students,2019-20,13764,798,12966,94.2,124,22,17.7
0K,All Students,2020-21,18268,1085,17183,94.1,114,14,12.3
0K,All Students,2021-22,18382,1366,17016,92.6,107,26,24.3
0K,All Students,2022-23,15654,1270,14384,91.9,92,29,31.5
1,All Students,2018-19,24812,1059,23753,95.7,147,10,6.8
1,All Students,2019-20,14000,808,13192,94.2,125,18,14.4
1,All Students,2020-21,17546,493,17053,97.2,103,2,1.9
1,All Students,2021-22,17316,1284,16032,92.6,101,23,22.8
1,All Students,2022-23,16977,1131,15846,93.3,100,22,22.0
2,All Students,2018-19,21967,955,21012,95.7,125,7,5.6
2,All Students,2019-20,15135,775,14360,94.9,132,13,9.8
2,All Students,2020-21,16608,574,16034,96.5,98,4,4.1
2,All Students,2021-22,15974,906,15068,94.3,90,10,11.1
2,All Students,2022-23,17819,1134,16685,93.6,105,20,19.0
3,All Students,2018-19,16983,717,16266,95.8,99,8,8.1
3,All Students,2019-20,14496,640,13856,95.6,128,11,8.6
3,All Students,2020-21,19992,632,19360,96.8,117,5,4.3
3,All Students,2021-22,15225,945,14280,93.8,88,12,13.6
3,All Students,2022-23,15177,774,14403,94.9,88,8,9.1
4,All Students,2018-19,16386,380,16006,97.7,93,3,3.2
4,All Students,2019-20,11089,283,10806,97.4,98,3,3.1
4,All Students,2020-21,18300,459,17841,97.5,108,3,2.8
4,All Students,2021-22,18852,912,17940,95.2,108,11,10.2
4,All Students,2022-23,14497,838,13659,94.2,84,18,21.4
5,All Students,2018-19,16882,690,16192,95.9,97,5,5.2
5,All Students,2019-20,10360,508,9852,95.1,92,5,5.4
5,All Students,2020-21,15979,263,15716,98.4,93,1,1.1
5,All Students,2021-22,17430,992,16438,94.3,99,12,12.1
5,All Students,2022-23,20567,1135,19432,94.5,118,14,11.9
6,All Students,2019-20,16,s,s,s,s,s,s
6,All Students,2020-21,8,s,s,s,s,s,s
6,All Students,2021-22,64,s,s,s,s,s,s
All Grades,All Students,2018-19,123643,5138,118505,95.8,705,30,4.3
All Grades,All Students,2019-20,76762,3230,73532,95.8,672,45,6.7
All Grades,All Students,2020-21,92277,2349,89928,97.5,561,26,4.6
All Grades,All Students,2021-22,87477,5646,81831,93.5,501,92,18.4
All Grades,All Students,2022-23,86336,6078,80258,93.0,503,101,20.1
PK in K-12 Schools,All Students,2018-19,9553,489,9064,94.9,55,4,7.3
PK in K-12 Schools,All Students,2019-20,6122,s,s,s,s,s,s
PK in K-12 Schools,All Students,2020-21,7942,330,7612,95.8,49,4,8.2
PK in K-12 Schools,All Students,2021-22,11954,979,10975,91.8,68,21,30.9
PK in K-12 Schools,All Students,2022-23,11944,995,10949,91.7,70,22,31.4
0K,All Students,2018-19,19377,919,18458,95.3,112,6,5.4
0K,All Students,2019-20,13503,721,12782,94.7,118,14,11.9
0K,All Students,2020-21,12576,564,12012,95.5,80,10,12.5
0K,All Students,2021-22,13031,1016,12015,92.2,75,21,28.0
0K,All Students,2022-23,14893,1233,13660,91.7,85,22,25.9
1,All Students,2018-19,20054,949,19105,95.3,115,5,4.3
1,All Students,2019-20,11838,476,11362,96.0,104,7,6.7
1,All Students,2020-21,13827,338,13489,97.6,82,3,3.7
1,All Students,2021-22,10158,676,9482,93.3,58,11,19.0
1,All Students,2022-23,12336,863,11473,93.0,74,12,16.2
2,All Students,2018-19,17151,766,16385,95.5,98,4,4.1
2,All Students,2019-20,12527,531,11996,95.8,109,4,3.7
2,All Students,2020-21,14432,276,14156,98.1,85,2,2.4
2,All Students,2021-22,13101,667,12434,94.9,75,5,6.7
2,All Students,2022-23,9912,600,9312,93.9,56,7,12.5
3,All Students,2018-19,20696,838,19858,96.0,117,7,6.0
3,All Students,2019-20,10623,463,10160,95.6,93,5,5.4
3,All Students,2020-21,15060,311,14749,97.9,94,3,3.2
3,All Students,2021-22,12270,801,11469,93.5,70,12,17.1
3,All Students,2022-23,12555,909,11646,92.8,76,17,22.4
4,All Students,2018-19,16020,442,15578,97.2,90,1,1.1
4,All Students,2019-20,12142,242,11900,98.0,106,2,1.9
4,All Students,2020-21,13532,235,13297,98.3,81,2,2.5
4,All Students,2021-22,15399,844,14555,94.5,87,11,12.6
4,All Students,2022-23,11679,738,10941,93.7,68,13,19.1
5,All Students,2018-19,20792,735,20057,96.5,118,3,2.5
5,All Students,2019-20,10006,387,9619,96.1,88,5,5.7
5,All Students,2020-21,14908,295,14613,98.0,90,2,2.2
5,All Students,2021-22,11564,663,10901,94.3,68,11,16.2
5,All Students,2022-23,13017,740,12277,94.3,74,8,10.8
6,All Students,2019-20,1,s,s,s,s,s,s
All Grades,All Students,2018-19,102335,2947,99388,97.1,593,44,7.4
All Grades,All Students,2019-20,63561,2227,61334,96.5,574,51,8.9
All Grades,All Students,2020-21,94684,2204,92480,97.7,551,36,6.5
All Grades,All Students,2021-22,92862,7024,85838,92.4,542,145,26.8
All Grades,All Students,2022-23,86076,4332,81744,95.0,512,77,15.0
PK in K-12 Schools,All Students,2018-19,6875,471,6404,93.1,42,9,21.4
PK in K-12 Schools,All Students,2019-20,4755,356,4399,92.5,43,10,23.3
PK in K-12 Schools,All Students,2020-21,7527,683,6844,90.9,46,17,37.0
PK in K-12 Schools,All Students,2021-22,9311,s,s,s,s,s,s
PK in K-12 Schools,All Students,2022-23,8187,770,7417,90.6,50,17,34.0
0K,All Students,2018-19,14631,643,13988,95.6,87,11,12.6
0K,All Students,2019-20,10136,671,9465,93.4,92,19,20.7
0K,All Students,2020-21,14683,416,14267,97.2,88,6,6.8
0K,All Students,2021-22,16794,1122,15672,93.3,98,18,18.4
0K,All Students,2022-23,12274,967,11307,92.1,77,20,26.0
1,All Students,2018-19,18429,596,17833,96.8,108,10,9.3
1,All Students,2019-20,9028,337,8691,96.3,82,4,4.9
1,All Students,2020-21,13005,333,12672,97.4,75,5,6.7
1,All Students,2021-22,12337,1074,11263,91.3,73,23,31.5
1,All Students,2022-23,15803,671,15132,95.8,95,6,6.3
2,All Students,2018-19,17097,534,16563,96.9,99,6,6.1
2,All Students,2019-20,10908,360,10548,96.7,97,10,10.3
2,All Students,2020-21,13200,221,12979,98.3,77,3,3.9
2,All Students,2021-22,12433,1081,11352,91.3,71,21,29.6
2,All Students,2022-23,12086,666,11420,94.5,70,16,22.9
3,All Students,2018-19,16195,359,15836,97.8,92,6,6.5
3,All Students,2019-20,9943,245,9698,97.5,92,5,5.4
3,All Students,2020-21,16436,161,16275,99.0,94,0,0.0
3,All Students,2021-22,12334,691,11643,94.4,73,11,15.1
3,All Students,2022-23,11118,434,10684,96.1,66,7,10.6
4,All Students,2018-19,14342,177,14165,98.8,81,2,2.5
4,All Students,2019-20,10024,119,9905,98.8,89,1,1.1
4,All Students,2020-21,15330,257,15073,98.3,88,5,5.7
4,All Students,2021-22,14955,875,14080,94.1,85,17,20.0
4,All Students,2022-23,11999,396,11603,96.7,69,3,4.3
5,All Students,2018-19,14766,167,14599,98.9,84,0,0.0
5,All Students,2019-20,8767,139,8628,98.4,79,2,2.5
5,All Students,2020-21,14503,133,14370,99.1,83,0,0.0
5,All Students,2021-22,14647,878,13769,94.0,84,15,17.9
5,All Students,2022-23,14609,428,14181,97.1,85,8,9.4
6,All Students,2021-22,51,s,s,s,s,s,s
All Grades,All Students,2018-19,32337,3190,29147,90.1,204,72,35.3
All Grades,All Students,2019-20,25461,2461,23000,90.3,237,100,42.2
All Grades,All Students,2020-21,37827,6943,30884,81.6,226,125,55.3
All Grades,All Students,2021-22,39751,7958,31793,80.0,240,172,71.7
All Grades,All Students,2022-23,32078,5934,26144,81.5,209,131,62.7
9,All Students,2018-19,12433,876,11557,93.0,77,17,22.1
9,All Students,2019-20,9084,881,8203,90.3,86,36,41.9
9,All Students,2020-21,8025,1525,6500,81.0,50,31,62.0
9,All Students,2021-22,10479,1854,8625,82.3,64,40,62.5
9,All Students,2022-23,6521,1062,5459,83.7,47,27,57.4
10,All Students,2018-19,5465,556,4909,89.8,37,14,37.8
10,All Students,2019-20,7871,650,7221,91.7,72,23,31.9
10,All Students,2020-21,12912,2482,10430,80.8,77,45,58.4
10,All Students,2021-22,7309,1547,5762,78.8,44,33,75.0
10,All Students,2022-23,8527,1419,7108,83.4,56,31,55.4
11,All Students,2018-19,8110,763,7347,90.6,50,15,30.0
11,All Students,2019-20,3429,419,3010,87.8,32,17,53.1
11,All Students,2020-21,11865,1761,10104,85.2,70,30,42.9
11,All Students,2021-22,11065,2354,8711,78.7,67,51,76.1
11,All Students,2022-23,6659,1259,5400,81.1,42,31,73.8
12,All Students,2018-19,6329,995,5334,84.3,40,26,65.0
12,All Students,2019-20,5077,511,4566,89.9,47,24,51.1
12,All Students,2020-21,5025,1175,3850,76.6,29,19,65.5
12,All Students,2021-22,10898,2203,8695,79.8,65,48,73.8
12,All Students,2022-23,10371,2194,8177,78.8,64,42,65.6
All Grades,All Students,2018-19,85166,7162,78004,91.6,533,171,32.1
All Grades,All Students,2019-20,56362,4547,51815,91.9,526,157,29.8
All Grades,All Students,2020-21,81720,10039,71681,87.7,492,171,34.8
All Grades,All Students,2021-22,75684,9291,66393,87.7,470,221,47.0
All Grades,All Students,2022-23,82200,10531,71669,87.2,563,295,52.4
PK in K-12 Schools,All Students,2018-19,12536,1052,11484,91.6,75,20,26.7
PK in K-12 Schools,All Students,2019-20,8107,758,7349,90.7,76,30,39.5
PK in K-12 Schools,All Students,2020-21,8158,1294,6864,84.1,48,24,50.0
PK in K-12 Schools,All Students,2021-22,10142,1635,8507,83.9,63,38,60.3
PK in K-12 Schools,All Students,2022-23,11426,1992,9434,82.6,79,53,67.1
0K,All Students,2018-19,11347,1070,10277,90.6,77,31,40.3
0K,All Students,2019-20,8367,814,7553,90.3,79,29,36.7
0K,All Students,2020-21,14384,1738,12646,87.9,87,27,31.0
0K,All Students,2021-22,10215,1539,8676,84.9,65,36,55.4
0K,All Students,2022-23,11290,1630,9660,85.6,85,50,58.8
1,All Students,2018-19,13683,1552,12131,88.7,87,38,43.7
1,All Students,2019-20,8162,727,7435,91.1,78,25,32.1
1,All Students,2020-21,11442,1609,9833,85.9,70,29,41.4
1,All Students,2021-22,10573,1128,9445,89.3,67,27,40.3
1,All Students,2022-23,10168,1363,8805,86.6,74,39,52.7
2,All Students,2018-19,13262,1013,12249,92.4,85,26,30.6
2,All Students,2019-20,7999,708,7291,91.1,75,26,34.7
2,All Students,2020-21,11362,1413,9949,87.6,68,23,33.8
2,All Students,2021-22,9546,968,8578,89.9,57,19,33.3
2,All Students,2022-23,12773,1363,11410,89.3,85,36,42.4
3,All Students,2018-19,11459,875,10584,92.4,71,22,31.0
3,All Students,2019-20,9521,642,8879,93.3,90,18,20.0
3,All Students,2020-21,11548,1263,10285,89.1,69,24,34.8
3,All Students,2021-22,10753,1199,9554,88.8,66,31,47.0
3,All Students,2022-23,10940,1256,9684,88.5,71,31,43.7
4,All Students,2018-19,11487,802,10685,93.0,72,18,25.0
4,All Students,2019-20,6652,428,6224,93.6,60,15,25.0
4,All Students,2020-21,14988,1547,13441,89.7,92,24,26.1
4,All Students,2021-22,11225,1494,9731,86.7,67,31,46.3
4,All Students,2022-23,13552,1546,12006,88.6,89,46,51.7
5,All Students,2018-19,11392,798,10594,93.0,66,16,24.2
5,All Students,2019-20,7554,470,7084,93.8,68,14,20.6
5,All Students,2020-21,9838,1175,8663,88.1,58,20,34.5
5,All Students,2021-22,13230,1328,11902,90.0,85,39,45.9
5,All Students,2022-23,12051,1381,10670,88.5,80,40,50.0
All Grades,All Students,2018-19,106535,4584,101951,95.7,621,50,8.1
All Grades,All Students,2019-20,73658,3282,70376,95.5,663,68,10.3
All Grades,All Students,2020-21,99555,2791,96764,97.2,608,37,6.1
All Grades,All Students,2021-22,96036,7919,88117,91.8,584,148,25.3
All Grades,All Students,2022-23,92262,7383,84879,92.0,554,131,23.6
PK in K-12 Schools,All Students,2018-19,3560,211,3349,94.1,20,3,15.0
PK in K-12 Schools,All Students,2019-20,2249,138,2111,93.9,22,3,13.6
PK in K-12 Schools,All Students,2020-21,3090,194,2896,93.7,19,7,36.8
PK in K-12 Schools,All Students,2021-22,2976,323,2653,89.1,19,10,52.6
PK in K-12 Schools,All Students,2022-23,3204,295,2909,90.8,18,7,38.9
0K,All Students,2018-19,17892,971,16921,94.6,109,13,11.9
0K,All Students,2019-20,14561,909,13652,93.8,130,22,16.9
0K,All Students,2020-21,20242,995,19247,95.1,123,12,9.8
0K,All Students,2021-22,18383,1517,16866,91.7,110,32,29.1
0K,All Students,2022-23,15724,1477,14247,90.6,98,34,34.7
1,All Students,2018-19,19532,1022,18510,94.8,112,9,8.0
1,All Students,2019-20,11095,420,10675,96.2,101,8,7.9
1,All Students,2020-21,16866,455,16411,97.3,106,6,5.7
1,All Students,2021-22,19296,1713,17583,91.1,115,35,30.4
1,All Students,2022-23,17465,1492,15973,91.5,104,30,28.8
2,All Students,2018-19,18001,844,17157,95.3,105,9,8.6
2,All Students,2019-20,12433,602,11831,95.2,114,14,12.3
2,All Students,2020-21,13262,144,13118,98.9,81,0,0.0
2,All Students,2021-22,16781,1352,15429,91.9,105,22,21.0
2,All Students,2022-23,15193,1230,13963,91.9,91,21,23.1
3,All Students,2018-19,18653,663,17990,96.4,108,4,3.7
3,All Students,2019-20,10431,496,9935,95.2,92,9,9.8
3,All Students,2020-21,15491,369,15122,97.6,95,3,3.2
3,All Students,2021-22,11822,730,11092,93.8,72,9,12.5
3,All Students,2022-23,15240,1075,14165,92.9,95,15,15.8
4,All Students,2018-19,17268,389,16879,97.7,99,4,4.0
4,All Students,2019-20,11737,290,11447,97.5,106,6,5.7
4,All Students,2020-21,13933,333,13600,97.6,85,5,5.9
4,All Students,2021-22,14762,997,13765,93.2,86,15,17.4
4,All Students,2022-23,11409,774,10635,93.2,68,11,16.2
5,All Students,2018-19,11629,484,11145,95.8,68,8,11.8
5,All Students,2019-20,11152,427,10725,96.2,98,6,6.1
5,All Students,2020-21,16671,301,16370,98.2,99,4,4.0
5,All Students,2021-22,12016,1287,10729,89.3,77,25,32.5
5,All Students,2022-23,14027,1040,12987,92.6,80,13,16.3
All Grades,All Students,2018-19,63788,2070,61718,96.8,360,5,1.4
All Grades,All Students,2019-20,41531,1579,39952,96.2,363,27,7.4
All Grades,All Students,2020-21,60851,704,60147,98.8,351,0,0.0
All Grades,All Students,2021-22,61024,2723,58301,95.5,348,28,8.0
All Grades,All Students,2022-23,65502,3572,61930,94.5,373,43,11.5
0K,All Students,2018-19,8893,359,8534,96.0,50,1,2.0
0K,All Students,2019-20,5745,386,5359,93.3,51,14,27.5
0K,All Students,2020-21,8728,148,8580,98.3,50,0,0.0
0K,All Students,2021-22,8844,618,8226,93.0,50,12,24.0
0K,All Students,2022-23,11115,669,10446,94.0,64,9,14.1
1,All Students,2018-19,10680,377,10303,96.5,60,1,1.7
1,All Students,2019-20,7312,340,6972,95.4,64,5,7.8
1,All Students,2020-21,11091,94,10997,99.2,64,0,0.0
1,All Students,2021-22,10230,485,9745,95.3,59,3,5.1
1,All Students,2022-23,11219,623,10596,94.4,64,7,10.9
2,All Students,2018-19,11148,403,10745,96.4,64,1,1.6
2,All Students,2019-20,7351,255,7096,96.5,64,2,3.1
2,All Students,2020-21,11149,63,11086,99.4,64,0,0.0
2,All Students,2021-22,11238,501,10737,95.5,64,5,7.8
2,All Students,2022-23,11336,669,10667,94.1,65,8,12.3
3,All Students,2018-19,11351,412,10939,96.4,64,1,1.6
3,All Students,2019-20,7332,247,7085,96.6,64,2,3.1
3,All Students,2020-21,11083,134,10949,98.8,64,0,0.0
3,All Students,2021-22,11242,472,10770,95.8,65,5,7.7
3,All Students,2022-23,11328,525,10803,95.4,64,6,9.4
4,All Students,2018-19,11392,169,11223,98.5,64,1,1.6
4,All Students,2019-20,7121,138,6983,98.1,62,3,4.8
4,All Students,2020-21,9992,83,9909,99.2,58,0,0.0
4,All Students,2021-22,10620,338,10282,96.8,60,3,5.0
4,All Students,2022-23,10415,473,9942,95.5,59,5,8.5
5,All Students,2018-19,10324,350,9974,96.6,58,0,0.0
5,All Students,2019-20,6670,213,6457,96.8,58,1,1.7
5,All Students,2020-21,8808,182,8626,97.9,51,0,0.0
5,All Students,2021-22,8850,309,8541,96.5,50,0,0.0
5,All Students,2022-23,10089,613,9476,93.9,57,8,14.0
All Grades,All Students,2018-19,81023,3124,77899,96.1,470,19,4.0
All Grades,All Students,2019-20,52034,2366,49668,95.5,464,33,7.1
All Grades,All Students,2020-21,58216,2249,55967,96.1,354,31,8.8
All Grades,All Students,2021-22,60669,4323,56346,92.9,355,85,23.9
All Grades,All Students,2022-23,59861,3908,55953,93.5,350,52,14.9
PK in K-12 Schools,All Students,2018-19,6026,262,5764,95.7,35,1,2.9
PK in K-12 Schools,All Students,2019-20,4046,225,3821,94.4,36,1,2.8
PK in K-12 Schools,All Students,2020-21,4393,694,3699,84.2,27,14,51.9
PK in K-12 Schools,All Students,2021-22,6205,643,5562,89.6,36,16,44.4
PK in K-12 Schools,All Students,2022-23,6354,433,5921,93.2,37,7,18.9
0K,All Students,2018-19,16140,749,15391,95.4,97,5,5.2
0K,All Students,2019-20,9845,525,9320,94.7,91,11,12.1
0K,All Students,2020-21,9174,360,8814,96.1,58,8,13.8
0K,All Students,2021-22,11833,1002,10831,91.5,70,24,34.3
0K,All Students,2022-23,11708,972,10736,91.7,71,16,22.5
1,All Students,2018-19,16196,683,15513,95.8,94,7,7.4
1,All Students,2019-20,9656,459,9197,95.2,85,5,5.9
1,All Students,2020-21,10102,295,9807,97.1,61,2,3.3
1,All Students,2021-22,7781,526,7255,93.2,46,9,19.6
1,All Students,2022-23,10090,632,9458,93.7,59,9,15.3
2,All Students,2018-19,11312,443,10869,96.1,64,3,4.7
2,All Students,2019-20,9118,405,8713,95.6,81,9,11.1
2,All Students,2020-21,9762,241,9521,97.5,61,3,4.9
2,All Students,2021-22,10295,595,9700,94.2,59,7,11.9
2,All Students,2022-23,7491,408,7083,94.6,44,2,4.5
3,All Students,2018-19,8333,287,8046,96.6,49,0,0.0
3,All Students,2019-20,7197,340,6857,95.3,65,3,4.6
3,All Students,2020-21,8415,268,8147,96.8,50,1,2.0
3,All Students,2021-22,10121,701,9420,93.1,60,17,28.3
3,All Students,2022-23,8599,474,8125,94.5,50,3,6.0
4,All Students,2018-19,10556,264,10292,97.5,61,2,3.3
4,All Students,2019-20,5847,155,5692,97.3,51,0,0.0
4,All Students,2020-21,8607,194,8413,97.7,52,2,3.8
4,All Students,2021-22,7886,443,7443,94.4,46,5,10.9
4,All Students,2022-23,8298,452,7846,94.6,47,5,10.6
5,All Students,2018-19,12460,436,12024,96.5,70,1,1.4
5,All Students,2019-20,6325,257,6068,95.9,55,4,7.3
5,All Students,2020-21,7763,197,7566,97.5,45,1,2.2
5,All Students,2021-22,6548,413,6135,93.7,38,7,18.4
5,All Students,2022-23,7321,537,6784,92.7,42,10,23.8
All Grades,All Students,2018-19,198635,7026,191609,96.5,1150,105,9.1
All Grades,All Students,2019-20,126865,4546,122319,96.4,1129,102,9.0
All Grades,All Students,2020-21,177247,6809,170438,96.2,1042,110,10.6
All Grades,All Students,2021-22,159749,9448,150301,94.1,931,176,18.9
All Grades,All Students,2022-23,166662,12166,154496,92.7,1035,282,27.2
5,All Students,2022-23,2,s,s,s,s,s,s
6,All Students,2018-19,66438,1970,64468,97.0,387,27,7.0
6,All Students,2019-20,42729,1603,41126,96.2,383,36,9.4
6,All Students,2020-21,55418,1663,53755,97.0,329,27,8.2
6,All Students,2021-22,46746,s,s,s,s,s,s
6,All Students,2022-23,58615,3819,54796,93.5,368,85,23.1
7,All Students,2018-19,64630,1685,62945,97.4,373,27,7.2
7,All Students,2019-20,41920,1205,40715,97.1,370,28,7.6
7,All Students,2020-21,60535,2657,57878,95.6,356,43,12.1
7,All Students,2021-22,54186,3084,51102,94.3,319,57,17.9
7,All Students,2022-23,50232,s,s,s,s,s,s
8,All Students,2018-19,67567,3371,64196,95.0,390,51,13.1
8,All Students,2019-20,42216,1738,40478,95.9,376,38,10.1
8,All Students,2020-21,61294,2489,58805,95.9,357,40,11.2
8,All Students,2021-22,58815,4150,54665,92.9,338,78,23.1
8,All Students,2022-23,57813,4840,52973,91.6,356,124,34.8
9,All Students,2021-22,2,s,s,s,s,s,s
All Grades,All Students,2018-19,72539,6138,66401,91.5,473,177,37.4
All Grades,All Students,2019-20,49860,4323,45537,91.3,477,147,30.8
All Grades,All Students,2020-21,68539,7987,60552,88.3,427,153,35.8
All Grades,All Students,2021-22,58333,6768,51565,88.4,363,158,43.5
All Grades,All Students,2022-23,71759,10388,61371,85.5,505,289,57.2
PK in K-12 Schools,All Students,2018-19,8296,823,7473,90.1,55,25,45.5
PK in K-12 Schools,All Students,2019-20,5936,600,5336,89.9,57,25,43.9
PK in K-12 Schools,All Students,2020-21,4130,751,3379,81.8,26,15,57.7
PK in K-12 Schools,All Students,2021-22,6398,977,5421,84.7,42,26,61.9
PK in K-12 Schools,All Students,2022-23,7674,1802,5872,76.5,68,59,86.8
0K,All Students,2018-19,12023,1114,10909,90.7,81,33,40.7
0K,All Students,2019-20,7285,860,6425,88.2,74,33,44.6
0K,All Students,2020-21,10851,1502,9349,86.2,72,30,41.7
0K,All Students,2021-22,7602,1058,6544,86.1,48,31,64.6
0K,All Students,2022-23,11831,2059,9772,82.6,82,58,70.7
1,All Students,2018-19,9562,966,8596,89.9,64,24,37.5
1,All Students,2019-20,8001,693,7308,91.3,77,21,27.3
1,All Students,2020-21,10325,1167,9158,88.7,67,25,37.3
1,All Students,2021-22,8380,969,7411,88.4,53,19,35.8
1,All Students,2022-23,10931,1445,9486,86.8,78,43,55.1
2,All Students,2018-19,9233,788,8445,91.5,56,21,37.5
2,All Students,2019-20,6303,519,5784,91.8,61,19,31.1
2,All Students,2020-21,10759,1093,9666,89.8,66,20,30.3
2,All Students,2021-22,9089,902,8187,90.1,55,16,29.1
2,All Students,2022-23,9448,1191,8257,87.4,63,31,49.2
3,All Students,2018-19,12985,834,12151,93.6,83,24,28.9
3,All Students,2019-20,6865,505,6360,92.6,66,16,24.2
3,All Students,2020-21,8790,1036,7754,88.2,55,20,36.4
3,All Students,2021-22,9601,1017,8584,89.4,61,23,37.7
3,All Students,2022-23,10555,1316,9239,87.5,67,25,37.3
4,All Students,2018-19,10293,686,9607,93.3,67,17,25.4
4,All Students,2019-20,9099,663,8436,92.7,82,19,23.2
4,All Students,2020-21,10245,922,9323,91.0,62,16,25.8
4,All Students,2021-22,8067,916,7151,88.6,47,19,40.4
4,All Students,2022-23,11056,1073,9983,90.3,75,32,42.7
5,All Students,2018-19,10147,927,9220,90.9,67,33,49.3
5,All Students,2019-20,6371,483,5888,92.4,60,14,23.3
5,All Students,2020-21,13439,1516,11923,88.7,79,27,34.2
5,All Students,2021-22,9196,929,8267,89.9,57,24,42.1
5,All Students,2022-23,10264,1502,8762,85.4,72,41,56.9
All Grades,All Students,2018-19,80304,2106,78198,97.4,454,5,1.1
All Grades,All Students,2019-20,52602,1432,51170,97.3,459,12,2.6
All Grades,All Students,2020-21,75925,1460,74465,98.1,448,23,5.1
All Grades,All Students,2021-22,74055,2661,71394,96.4,428,29,6.8
All Grades,All Students,2022-23,74761,3304,71457,95.6,426,39,9.2
6,All Students,2018-19,26844,614,26230,97.7,151,0,0.0
6,All Students,2019-20,17824,535,17289,97.0,155,10,6.5
6,All Students,2020-21,24802,s,s,s,s,s,s
6,All Students,2021-22,25674,1057,24617,95.9,147,13,8.8
6,All Students,2022-23,24999,1077,23922,95.7,144,13,9.0
7,All Students,2018-19,26524,505,26019,98.1,151,1,0.7
7,All Students,2019-20,17402,335,17067,98.1,152,0,0.0
7,All Students,2020-21,26193,537,25656,97.9,156,11,7.1
7,All Students,2021-22,23099,658,22441,97.2,133,8,6.0
7,All Students,2022-23,26625,1124,25501,95.8,151,14,9.3
8,All Students,2018-19,26936,987,25949,96.3,152,4,2.6
8,All Students,2019-20,17376,562,16814,96.8,152,2,1.3
8,All Students,2020-21,24927,556,24371,97.8,144,6,4.2
8,All Students,2021-22,25282,946,24336,96.3,148,8,5.4
8,All Students,2022-23,23137,1103,22034,95.2,131,12,9.2
9,All Students,2020-21,3,s,s,s,s,s,s
All Grades,All Students,2018-19,88220,5058,83162,94.3,535,96,17.9
All Grades,All Students,2019-20,57111,3714,53397,93.5,525,115,21.9
All Grades,All Students,2020-21,70752,5237,65515,92.6,428,85,19.9
All Grades,All Students,2021-22,67121,6465,60656,90.4,415,158,38.1
All Grades,All Students,2022-23,68587,8689,59898,87.3,471,231,49.0
PK in K-12 Schools,All Students,2018-19,9450,837,8613,91.1,57,19,33.3
PK in K-12 Schools,All Students,2019-20,6140,419,5721,93.2,55,11,20.0
PK in K-12 Schools,All Students,2020-21,7358,707,6651,90.4,49,13,26.5
PK in K-12 Schools,All Students,2021-22,8451,916,7535,89.2,55,25,45.5
PK in K-12 Schools,All Students,2022-23,8563,983,7580,88.5,56,25,44.6
0K,All Students,2018-19,12828,909,11919,92.9,80,21,26.3
0K,All Students,2019-20,9453,725,8728,92.3,86,22,25.6
0K,All Students,2020-21,10438,1181,9257,88.7,64,20,31.3
0K,All Students,2021-22,9572,1137,8435,88.1,62,28,45.2
0K,All Students,2022-23,10195,1267,8928,87.6,69,32,46.4
1,All Students,2018-19,14847,774,14073,94.8,93,16,17.2
1,All Students,2019-20,6873,478,6395,93.0,67,20,29.9
1,All Students,2020-21,11775,1132,10643,90.4,69,14,20.3
1,All Students,2021-22,9587,894,8693,90.7,59,23,39.0
1,All Students,2022-23,11324,2139,9185,81.1,86,61,70.9
2,All Students,2018-19,12745,770,11975,94.0,78,15,19.2
2,All Students,2019-20,9715,601,9114,93.8,88,15,17.0
2,All Students,2020-21,8672,565,8107,93.5,53,10,18.9
2,All Students,2021-22,9984,950,9034,90.5,62,21,33.9
2,All Students,2022-23,10632,1249,9383,88.3,69,31,44.9
3,All Students,2018-19,11005,494,10511,95.5,67,7,10.4
3,All Students,2019-20,8279,585,7694,92.9,77,21,27.3
3,All Students,2020-21,11899,716,11183,94.0,72,12,16.7
3,All Students,2021-22,7450,641,6809,91.4,47,15,31.9
3,All Students,2022-23,8973,1063,7910,88.2,61,27,44.3
4,All Students,2018-19,14150,559,13591,96.0,82,8,9.8
4,All Students,2019-20,6896,361,6535,94.8,64,9,14.1
4,All Students,2020-21,12170,573,11597,95.3,72,11,15.3
4,All Students,2021-22,10268,667,9601,93.5,59,15,25.4
4,All Students,2022-23,7860,s,s,s,s,s,s
5,All Students,2018-19,13195,715,12480,94.6,78,10,12.8
5,All Students,2019-20,9755,545,9210,94.4,88,17,19.3
5,All Students,2020-21,8440,363,8077,95.7,49,5,10.2
5,All Students,2021-22,11809,1260,10549,89.3,71,31,43.7
5,All Students,2022-23,11007,1057,9950,90.4,73,26,35.6
6,All Students,2022-23,33,s,s,s,s,s,s
All Grades,All Students,2018-19,119382,2552,116830,97.9,686,25,3.6
All Grades,All Students,2019-20,77580,2236,75344,97.1,681,32,4.7
All Grades,All Students,2020-21,113591,1172,112419,99.0,659,6,0.9
All Grades,All Students,2021-22,105003,3865,101138,96.3,609,51,8.4
All Grades,All Students,2022-23,92363,2986,89377,96.8,545,28,5.1
PK in K-12 Schools,All Students,2018-19,10452,556,9896,94.7,61,12,19.7
PK in K-12 Schools,All Students,2019-20,7483,512,6971,93.2,68,11,16.2
PK in K-12 Schools,All Students,2020-21,10558,182,10376,98.3,62,2,3.2
PK in K-12 Schools,All Students,2021-22,11316,951,10365,91.6,70,20,28.6
PK in K-12 Schools,All Students,2022-23,7272,505,6767,93.1,47,10,21.3
0K,All Students,2018-19,16782,519,16263,96.9,97,6,6.2
0K,All Students,2019-20,11189,532,10657,95.2,98,10,10.2
0K,All Students,2020-21,17276,213,17063,98.8,103,2,1.9
0K,All Students,2021-22,16415,818,15597,95.0,95,10,10.5
0K,All Students,2022-23,15505,717,14788,95.4,94,8,8.5
1,All Students,2018-19,18486,358,18128,98.1,108,0,0.0
1,All Students,2019-20,10247,356,9891,96.5,90,4,4.4
1,All Students,2020-21,16412,134,16278,99.2,95,0,0.0
1,All Students,2021-22,15102,562,14540,96.3,88,8,9.1
1,All Students,2022-23,14511,498,14013,96.6,84,4,4.8
2,All Students,2018-19,20494,425,20069,97.9,118,4,3.4
2,All Students,2019-20,11999,263,11736,97.8,105,1,1.0
2,All Students,2020-21,15175,127,15048,99.2,88,0,0.0
2,All Students,2021-22,13466,390,13076,97.1,77,4,5.2
2,All Students,2022-23,14014,434,13580,96.9,82,3,3.7
3,All Students,2018-19,18787,274,18513,98.5,107,0,0.0
3,All Students,2019-20,13006,261,12745,98.0,114,4,3.5
3,All Students,2020-21,17323,156,17167,99.1,99,0,0.0
3,All Students,2021-22,14885,375,14510,97.5,85,3,3.5
3,All Students,2022-23,12123,289,11834,97.6,69,0,0.0
4,All Students,2018-19,17927,175,17752,99.0,102,2,2.0
4,All Students,2019-20,12041,152,11889,98.7,105,0,0.0
4,All Students,2020-21,18997,202,18795,98.9,110,1,0.9
4,All Students,2021-22,16020,342,15678,97.9,91,1,1.1
4,All Students,2022-23,13851,240,13611,98.3,81,1,1.2
5,All Students,2018-19,16454,245,16209,98.5,93,1,1.1
5,All Students,2019-20,11615,160,11455,98.6,101,2,2.0
5,All Students,2020-21,17850,158,17692,99.1,102,1,1.0
5,All Students,2021-22,17799,427,17372,97.6,103,5,4.9
5,All Students,2022-23,15087,303,14784,98.0,88,2,2.3
All Grades,All Students,2018-19,126567,4035,122532,96.8,735,86,11.7
All Grades,All Students,2019-20,82498,2659,79839,96.8,732,70,9.6
All Grades,All Students,2020-21,118250,4128,114122,96.5,689,61,8.9
All Grades,All Students,2021-22,105547,5222,100325,95.1,626,91,14.5
All Grades,All Students,2022-23,102482,5044,97438,95.1,604,104,17.2
PK in K-12 Schools,All Students,2018-19,3860,307,3553,92.0,25,9,36.0
PK in K-12 Schools,All Students,2019-20,3115,375,2740,88.0,29,14,48.3
PK in K-12 Schools,All Students,2020-21,4138,318,3820,92.3,24,4,16.7
PK in K-12 Schools,All Students,2021-22,3833,s,s,s,s,s,s
PK in K-12 Schools,All Students,2022-23,3698,608,3090,83.6,26,16,61.5
0K,All Students,2018-19,9437,537,8900,94.3,56,12,21.4
0K,All Students,2019-20,6194,323,5871,94.8,58,9,15.5
0K,All Students,2020-21,5424,319,5105,94.1,32,5,15.6
0K,All Students,2021-22,6812,546,6266,92.0,41,10,24.4
0K,All Students,2022-23,5867,557,5310,90.5,39,13,33.3
1,All Students,2018-19,11578,405,11173,96.5,68,7,10.3
1,All Students,2019-20,6416,245,6171,96.2,57,3,5.3
1,All Students,2020-21,9261,294,8967,96.8,55,4,7.3
1,All Students,2021-22,4904,288,4616,94.1,29,4,13.8
1,All Students,2022-23,4817,342,4475,92.9,30,5,16.7
2,All Students,2018-19,10055,500,9555,95.0,60,14,23.3
2,All Students,2019-20,6911,313,6598,95.5,62,9,14.5
2,All Students,2020-21,9390,455,8935,95.2,56,11,19.6
2,All Students,2021-22,7157,425,6732,94.1,43,8,18.6
2,All Students,2022-23,5137,296,4841,94.2,30,6,20.0
3,All Students,2018-19,9639,336,9303,96.5,57,4,7.0
3,All Students,2019-20,6587,233,6354,96.5,59,4,6.8
3,All Students,2020-21,9793,279,9514,97.2,56,4,7.1
3,All Students,2021-22,8397,502,7895,94.0,50,13,26.0
3,All Students,2022-23,8432,401,8031,95.2,49,8,16.3
4,All Students,2018-19,11143,280,10863,97.5,65,7,10.8
4,All Students,2019-20,6210,210,6000,96.6,54,5,9.3
4,All Students,2020-21,10073,410,9663,95.9,59,8,13.6
4,All Students,2021-22,8565,238,8327,97.2,51,3,5.9
4,All Students,2022-23,8123,444,7679,94.5,47,10,21.3
5,All Students,2018-19,10927,433,10494,96.0,64,11,17.2
5,All Students,2019-20,7613,184,7429,97.6,67,8,11.9
5,All Students,2020-21,9635,390,9245,96.0,56,6,10.7
5,All Students,2021-22,9500,494,9006,94.8,54,6,11.1
5,All Students,2022-23,9217,361,8856,96.1,54,6,11.1
6,All Students,2018-19,20397,418,19979,98.0,117,9,7.7
6,All Students,2019-20,13568,239,13329,98.2,119,4,3.4
6,All Students,2020-21,20591,644,19947,96.9,119,7,5.9
6,All Students,2021-22,18639,680,17959,96.4,112,10,8.9
6,All Students,2022-23,19999,658,19341,96.7,116,14,12.1
7,All Students,2018-19,20309,261,20048,98.7,115,4,3.5
7,All Students,2019-20,13091,261,12830,98.0,115,8,7.0
7,All Students,2020-21,20349,449,19900,97.8,117,6,5.1
7,All Students,2021-22,18181,744,17437,95.9,107,14,13.1
7,All Students,2022-23,19095,641,18454,96.6,110,12,10.9
8,All Students,2018-19,19222,558,18664,97.1,108,9,8.3
8,All Students,2019-20,12793,276,12517,97.8,112,6,5.4
8,All Students,2020-21,19596,570,19026,97.1,115,6,5.2
8,All Students,2021-22,19556,812,18744,95.8,113,10,8.8
8,All Students,2022-23,18097,736,17361,95.9,103,14,13.6
9,All Students,2021-22,3,s,s,s,s,s,s
All Grades,All Students,2018-19,153294,3100,150194,98.0,872,28,3.2
All Grades,All Students,2019-20,91189,3127,88062,96.6,803,59,7.3
All Grades,All Students,2020-21,130705,964,129741,99.3,757,7,0.9
All Grades,All Students,2021-22,113511,3490,110021,96.9,661,52,7.9
All Grades,All Students,2022-23,113318,5730,107588,94.9,691,106,15.3
PK in K-12 Schools,All Students,2018-19,6320,283,6037,95.5,36,2,5.6
PK in K-12 Schools,All Students,2019-20,4017,285,3732,92.9,37,9,24.3
PK in K-12 Schools,All Students,2020-21,6189,56,6133,99.1,37,0,0.0
PK in K-12 Schools,All Students,2021-22,3936,244,3692,93.8,23,5,21.7
PK in K-12 Schools,All Students,2022-23,5927,591,5336,90.0,36,13,36.1
0K,All Students,2018-19,21155,691,20464,96.7,120,5,4.2
0K,All Students,2019-20,12571,718,11853,94.3,111,14,12.6
0K,All Students,2020-21,20855,193,20662,99.1,122,3,2.5
0K,All Students,2021-22,14293,586,13707,95.9,84,9,10.7
0K,All Students,2022-23,13209,860,12349,93.5,84,16,19.0
1,All Students,2018-19,24680,552,24128,97.8,145,7,4.8
1,All Students,2019-20,14189,557,13632,96.1,125,12,9.6
1,All Students,2020-21,19126,130,18996,99.3,111,1,0.9
1,All Students,2021-22,19978,753,19225,96.2,119,14,11.8
1,All Students,2022-23,15606,1025,14581,93.4,99,22,22.2
2,All Students,2018-19,20823,412,20411,98.0,118,3,2.5
2,All Students,2019-20,15366,519,14847,96.6,135,10,7.4
2,All Students,2020-21,20866,159,20707,99.2,120,2,1.7
2,All Students,2021-22,17123,555,16568,96.8,99,6,6.1
2,All Students,2022-23,20802,970,19832,95.3,121,10,8.3
3,All Students,2018-19,21200,412,20788,98.1,120,6,5.0
3,All Students,2019-20,13914,393,13521,97.2,121,7,5.8
3,All Students,2020-21,22636,94,22542,99.6,131,0,0.0
3,All Students,2021-22,18750,532,18218,97.2,110,7,6.4
3,All Students,2022-23,16935,757,16178,95.5,103,15,14.6
4,All Students,2018-19,27750,320,27430,98.8,156,2,1.3
4,All Students,2019-20,13893,249,13644,98.2,122,2,1.6
4,All Students,2020-21,20035,150,19885,99.3,115,0,0.0
4,All Students,2021-22,20901,387,20514,98.1,120,4,3.3
4,All Students,2022-23,19777,816,18961,95.9,117,13,11.1
5,All Students,2018-19,31366,430,30936,98.6,177,3,1.7
5,All Students,2019-20,17239,406,16833,97.6,152,5,3.3
5,All Students,2020-21,20998,182,20816,99.1,121,1,0.8
5,All Students,2021-22,18530,433,18097,97.7,106,7,6.6
5,All Students,2022-23,21062,711,20351,96.6,131,17,13.0
All Grades,All Students,2018-19,71614,1928,69686,97.3,416,30,7.2
All Grades,All Students,2019-20,35574,1232,34342,96.5,323,34,10.5
All Grades,All Students,2020-21,44207,3770,40437,91.5,257,68,26.5
All Grades,All Students,2021-22,39977,2650,37327,93.4,236,57,24.2
All Grades,All Students,2022-23,44659,3434,41225,92.3,282,85,30.1
6,All Students,2018-19,17892,501,17391,97.2,104,8,7.7
6,All Students,2019-20,7054,216,6838,96.9,67,6,9.0
6,All Students,2020-21,12858,1337,11521,89.6,75,25,33.3
6,All Students,2021-22,13392,946,12446,92.9,82,23,28.0
6,All Students,2022-23,15456,1177,14279,92.4,96,30,31.3
7,All Students,2018-19,24041,660,23381,97.3,140,12,8.6
7,All Students,2019-20,12264,419,11845,96.6,111,14,12.6
7,All Students,2020-21,12236,799,11437,93.5,71,13,18.3
7,All Students,2021-22,13914,1019,12895,92.7,81,23,28.4
7,All Students,2022-23,15145,1169,13976,92.3,99,31,31.3
8,All Students,2018-19,29681,767,28914,97.4,172,10,5.8
8,All Students,2019-20,16256,597,15659,96.3,145,14,9.7
8,All Students,2020-21,19113,1634,17479,91.5,111,30,27.0
8,All Students,2021-22,12671,685,11986,94.6,73,11,15.1
8,All Students,2022-23,14058,1088,12970,92.3,87,24,27.6
All Grades,All Students,2018-19,43223,5932,37291,86.3,276,124,44.9
All Grades,All Students,2019-20,27853,3477,24376,87.5,263,112,42.6
All Grades,All Students,2020-21,46626,6439,40187,86.2,274,98,35.8
All Grades,All Students,2021-22,48382,10608,37774,78.1,301,213,70.8
All Grades,All Students,2022-23,47420,7791,39629,83.6,315,169,53.7
9,All Students,2018-19,12696,1756,10940,86.2,82,34,41.5
9,All Students,2019-20,7978,1009,6969,87.4,78,33,42.3
9,All Students,2020-21,14937,2313,12624,84.5,87,33,37.9
9,All Students,2021-22,15209,3009,12200,80.2,95,52,54.7
9,All Students,2022-23,13472,2499,10973,81.5,90,49,54.4
10,All Students,2018-19,11931,2093,9838,82.5,81,45,55.6
10,All Students,2019-20,7895,1138,6757,85.6,74,32,43.2
10,All Students,2020-21,11648,1916,9732,83.6,70,28,40.0
10,All Students,2021-22,13653,3314,10339,75.7,87,64,73.6
10,All Students,2022-23,15146,2544,12602,83.2,99,50,50.5
11,All Students,2018-19,9336,1064,8272,88.6,57,21,36.8
11,All Students,2019-20,5815,558,5257,90.4,54,22,40.7
11,All Students,2020-21,11049,1185,9864,89.3,65,19,29.2
11,All Students,2021-22,9480,1910,7570,79.9,57,43,75.4
11,All Students,2022-23,10837,1438,9399,86.7,73,39,53.4
12,All Students,2018-19,9260,1019,8241,89.0,56,24,42.9
12,All Students,2019-20,6165,772,5393,87.5,57,25,43.9
12,All Students,2020-21,8992,1025,7967,88.6,52,18,34.6
12,All Students,2021-22,10040,2375,7665,76.3,62,54,87.1
12,All Students,2022-23,7965,1310,6655,83.6,53,31,58.5
All Grades,All Students,2018-19,65374,9712,55662,85.1,409,221,54.0
All Grades,All Students,2019-20,45138,7002,38136,84.5,426,208,48.8
All Grades,All Students,2020-21,70366,16621,53745,76.4,407,259,63.6
All Grades,All Students,2021-22,65710,14018,51692,78.7,400,257,64.3
All Grades,All Students,2022-23,59501,11447,48054,80.8,377,218,57.8
9,All Students,2018-19,19171,2471,16700,87.1,118,56,47.5
9,All Students,2019-20,12515,2020,10495,83.9,119,50,42.0
9,All Students,2020-21,17163,5252,11911,69.4,98,63,64.3
9,All Students,2021-22,20054,3383,16671,83.1,121,55,45.5
9,All Students,2022-23,15179,2764,12415,81.8,100,56,56.0
10,All Students,2018-19,18306,2725,15581,85.1,115,57,49.6
10,All Students,2019-20,11736,2000,9736,83.0,113,71,62.8
10,All Students,2020-21,18380,3944,14436,78.5,108,69,63.9
10,All Students,2021-22,13918,2851,11067,79.5,85,53,62.4
10,All Students,2022-23,17284,2689,14595,84.4,108,54,50.0
11,All Students,2018-19,15118,2699,12419,82.1,97,58,59.8
11,All Students,2019-20,11619,1621,9998,86.0,109,49,45.0
11,All Students,2020-21,17692,3943,13749,77.7,101,64,63.4
11,All Students,2021-22,16326,3881,12445,76.2,100,69,69.0
11,All Students,2022-23,11914,2111,9803,82.3,76,47,61.8
12,All Students,2018-19,12779,1817,10962,85.8,79,50,63.3
12,All Students,2019-20,9268,1361,7907,85.3,85,38,44.7
12,All Students,2020-21,17131,3482,13649,79.7,100,63,63.0
12,All Students,2021-22,15412,3903,11509,74.7,94,80,85.1
12,All Students,2022-23,15124,3883,11241,74.3,93,61,65.6
All Grades,All Students,2018-19,32995,1245,31750,96.2,191,9,4.7
All Grades,All Students,2019-20,21839,965,20874,95.6,192,13,6.8
All Grades,All Students,2020-21,29692,1116,28576,96.2,182,16,8.8
All Grades,All Students,2021-22,27512,1720,25792,93.7,161,37,23.0
All Grades,All Students,2022-23,33579,2479,31100,92.6,195,47,24.1
PK in K-12 Schools,All Students,2018-19,3133,154,2979,95.1,18,0,0.0
PK in K-12 Schools,All Students,2019-20,2061,119,1942,94.2,19,3,15.8
PK in K-12 Schools,All Students,2020-21,3001,162,2839,94.6,18,3,16.7
PK in K-12 Schools,All Students,2021-22,3186,311,2875,90.2,18,8,44.4
PK in K-12 Schools,All Students,2022-23,5541,486,5055,91.2,33,10,30.3
0K,All Students,2018-19,4959,216,4743,95.6,28,3,10.7
0K,All Students,2019-20,3219,181,3038,94.4,29,4,13.8
0K,All Students,2020-21,4575,207,4368,95.5,29,5,17.2
0K,All Students,2021-22,4481,360,4121,92.0,27,8,29.6
0K,All Students,2022-23,8612,756,7856,91.2,50,14,28.0
1,All Students,2018-19,5181,158,5023,97.0,30,2,6.7
1,All Students,2019-20,2990,130,2860,95.7,26,0,0.0
1,All Students,2020-21,4823,244,4579,94.9,29,2,6.9
1,All Students,2021-22,4322,222,4100,94.9,26,4,15.4
1,All Students,2022-23,4250,278,3972,93.5,24,6,25.0
2,All Students,2018-19,5152,225,4927,95.6,30,1,3.3
2,All Students,2019-20,3565,148,3417,95.8,31,1,3.2
2,All Students,2020-21,3856,71,3785,98.2,23,0,0.0
2,All Students,2021-22,4557,266,4291,94.2,27,6,22.2
2,All Students,2022-23,4606,272,4334,94.1,27,6,22.2
3,All Students,2018-19,4961,177,4784,96.4,30,2,6.7
3,All Students,2019-20,3449,156,3293,95.5,30,2,6.7
3,All Students,2020-21,3968,119,3849,97.0,25,0,0.0
3,All Students,2021-22,4048,182,3866,95.5,23,3,13.0
3,All Students,2022-23,4073,338,3735,91.7,23,6,26.1
4,All Students,2018-19,5057,140,4917,97.2,29,1,3.4
4,All Students,2019-20,3450,98,3352,97.2,30,1,3.3
4,All Students,2020-21,4592,163,4429,96.5,29,3,10.3
4,All Students,2021-22,3373,132,3241,96.1,20,2,10.0
4,All Students,2022-23,3540,200,3340,94.4,20,3,15.0
5,All Students,2018-19,4552,175,4377,96.2,26,0,0.0
5,All Students,2019-20,3105,133,2972,95.7,27,2,7.4
5,All Students,2020-21,4877,150,4727,96.9,29,3,10.3
5,All Students,2021-22,3545,247,3298,93.0,20,6,30.0
5,All Students,2022-23,2957,149,2808,95.0,18,2,11.1
All Grades,All Students,2018-19,86607,5879,80728,93.2,504,111,22.0
All Grades,All Students,2019-20,54538,3774,50764,93.1,487,119,24.4
All Grades,All Students,2020-21,73673,6090,67583,91.7,436,95,21.8
All Grades,All Students,2021-22,66651,6427,60224,90.4,390,126,32.3
All Grades,All Students,2022-23,61983,6257,55726,89.9,366,128,35.0
PK in K-12 Schools,All Students,2018-19,10310,859,9451,91.7,59,20,33.9
PK in K-12 Schools,All Students,2019-20,7699,597,7102,92.2,71,22,31.0
PK in K-12 Schools,All Students,2020-21,7235,911,6324,87.4,45,18,40.0
PK in K-12 Schools,All Students,2021-22,8710,1011,7699,88.4,53,21,39.6
PK in K-12 Schools,All Students,2022-23,9234,1260,7974,86.4,55,29,52.7
0K,All Students,2018-19,11947,895,11052,92.5,69,18,26.1
0K,All Students,2019-20,9583,722,8861,92.5,87,24,27.6
0K,All Students,2020-21,11913,647,11266,94.6,72,10,13.9
0K,All Students,2021-22,10431,1052,9379,89.9,62,19,30.6
0K,All Students,2022-23,10756,938,9818,91.3,65,19,29.2
1,All Students,2018-19,10367,796,9571,92.3,63,17,27.0
1,All Students,2019-20,7147,529,6618,92.6,63,17,27.0
1,All Students,2020-21,11898,794,11104,93.3,70,12,17.1
1,All Students,2021-22,9532,795,8737,91.7,56,15,26.8
1,All Students,2022-23,8795,862,7933,90.2,54,17,31.5
2,All Students,2018-19,13982,830,13152,94.1,81,12,14.8
2,All Students,2019-20,6331,425,5906,93.3,56,11,19.6
2,All Students,2020-21,9688,965,8723,90.0,56,12,21.4
2,All Students,2021-22,8972,873,8099,90.3,52,17,32.7
2,All Students,2022-23,7901,571,7330,92.8,46,10,21.7
3,All Students,2018-19,12474,854,11620,93.2,74,16,21.6
3,All Students,2019-20,8867,518,8349,94.2,78,14,17.9
3,All Students,2020-21,9529,625,8904,93.4,56,10,17.9
3,All Students,2021-22,9230,925,8305,90.0,53,19,35.8
3,All Students,2022-23,7929,803,7126,89.9,45,20,44.4
4,All Students,2018-19,10909,773,10136,92.9,63,18,28.6
4,All Students,2019-20,7733,499,7234,93.5,68,14,20.6
4,All Students,2020-21,11860,904,10956,92.4,71,13,18.3
4,All Students,2021-22,9281,934,8347,89.9,53,16,30.2
4,All Students,2022-23,8876,973,7903,89.0,53,21,39.6
5,All Students,2018-19,16618,872,15746,94.8,95,10,10.5
5,All Students,2019-20,7178,484,6694,93.3,64,17,26.6
5,All Students,2020-21,11550,1244,10306,89.2,66,20,30.3
5,All Students,2021-22,10495,837,9658,92.0,61,19,31.1
5,All Students,2022-23,8492,850,7642,90.0,48,12,25.0
All Grades,All Students,2018-19,140312,6647,133665,95.3,821,78,9.5
All Grades,All Students,2019-20,92187,4767,87420,94.8,823,100,12.2
All Grades,All Students,2020-21,115928,3457,112471,97.0,703,35,5.0
All Grades,All Students,2021-22,114769,6848,107921,94.0,674,112,16.6
All Grades,All Students,2022-23,114029,7405,106624,93.5,665,109,16.4
PK in K-12 Schools,All Students,2018-19,12441,746,11695,94.0,76,12,15.8
PK in K-12 Schools,All Students,2019-20,7794,434,7360,94.4,70,13,18.6
PK in K-12 Schools,All Students,2020-21,10675,315,10360,97.0,66,4,6.1
PK in K-12 Schools,All Students,2021-22,11506,1076,10430,90.6,68,26,38.2
PK in K-12 Schools,All Students,2022-23,11227,s,s,s,s,s,s
0K,All Students,2018-19,23215,1292,21923,94.4,138,19,13.8
0K,All Students,2019-20,17519,1147,16372,93.5,158,24,15.2
0K,All Students,2020-21,21443,665,20778,96.9,130,8,6.2
0K,All Students,2021-22,19454,1231,18223,93.7,114,28,24.6
0K,All Students,2022-23,17351,1261,16090,92.7,105,24,22.9
1,All Students,2018-19,24017,1177,22840,95.1,138,11,8.0
1,All Students,2019-20,13726,779,12947,94.3,123,16,13.0
1,All Students,2020-21,18745,671,18074,96.4,119,7,5.9
1,All Students,2021-22,19910,1023,18887,94.9,117,12,10.3
1,All Students,2022-23,19308,1185,18123,93.9,111,15,13.5
2,All Students,2018-19,19313,996,18317,94.8,115,12,10.4
2,All Students,2019-20,14647,725,13922,95.1,131,15,11.5
2,All Students,2020-21,17143,332,16811,98.1,100,3,3.0
2,All Students,2021-22,17723,1050,16673,94.1,104,18,17.3
2,All Students,2022-23,18260,1113,17147,93.9,105,14,13.3
3,All Students,2018-19,21101,903,20198,95.7,122,9,7.4
3,All Students,2019-20,12096,693,11403,94.3,109,17,15.6
3,All Students,2020-21,17195,474,16721,97.2,106,4,3.8
3,All Students,2021-22,15972,845,15127,94.7,93,9,9.7
3,All Students,2022-23,16619,950,15669,94.3,98,14,14.3
4,All Students,2018-19,22183,655,21528,97.0,130,4,3.1
4,All Students,2019-20,12359,403,11956,96.7,109,9,8.3
4,All Students,2020-21,13689,454,13235,96.7,83,6,7.2
4,All Students,2021-22,16945,905,16040,94.7,100,12,12.0
4,All Students,2022-23,14807,818,13989,94.5,86,7,8.1
5,All Students,2018-19,18042,878,17164,95.1,102,11,10.8
5,All Students,2019-20,14046,586,13460,95.8,123,6,4.9
5,All Students,2020-21,17038,546,16492,96.8,99,3,3.0
5,All Students,2021-22,13259,718,12541,94.6,78,7,9.0
5,All Students,2022-23,16456,1098,15358,93.3,95,14,14.7
6,All Students,2022-23,1,s,s,s,s,s,s
All Grades,All Students,2018-19,244214,10018,234196,95.9,1409,127,9.0
All Grades,All Students,2019-20,155115,6589,148526,95.8,1378,135,9.8
All Grades,All Students,2020-21,222639,15210,207429,93.2,1302,263,20.2
All Grades,All Students,2021-22,202398,12638,189760,93.8,1187,218,18.4
All Grades,All Students,2022-23,180103,12107,167996,93.3,1069,220,20.6
5,All Students,2018-19,6,s,s,s,s,s,s
6,All Students,2018-19,82582,3474,79108,95.8,478,39,8.2
6,All Students,2019-20,49427,2203,47224,95.5,442,49,11.1
6,All Students,2020-21,78725,4288,74437,94.6,462,71,15.4
6,All Students,2021-22,69166,3634,65532,94.7,403,56,13.9
6,All Students,2022-23,46846,2659,44187,94.3,279,46,16.5
7,All Students,2018-19,79454,s,s,s,s,s,s
7,All Students,2019-20,54059,2033,52026,96.2,483,41,8.5
7,All Students,2020-21,68603,4203,64400,93.9,403,74,18.4
7,All Students,2021-22,68459,3953,64506,94.2,409,78,19.1
7,All Students,2022-23,66315,4300,62015,93.5,393,76,19.3
8,All Students,2018-19,82172,4201,77971,94.9,471,62,13.2
8,All Students,2019-20,51629,2353,49276,95.4,453,45,9.9
8,All Students,2020-21,75311,6719,68592,91.1,437,118,27.0
8,All Students,2021-22,64773,5051,59722,92.2,375,84,22.4
8,All Students,2022-23,66942,5148,61794,92.3,397,98,24.7
All Grades,All Students,2018-19,41112,2049,39063,95.0,235,22,9.4
All Grades,All Students,2019-20,26045,1008,25037,96.1,232,17,7.3
All Grades,All Students,2020-21,41822,1799,40023,95.7,241,30,12.4
All Grades,All Students,2021-22,39052,2581,36471,93.4,230,52,22.6
All Grades,All Students,2022-23,45068,2939,42129,93.5,259,57,22.0
6,All Students,2018-19,13695,570,13125,95.8,79,4,5.1
6,All Students,2019-20,8683,375,8308,95.7,78,6,7.7
6,All Students,2020-21,17149,718,16431,95.8,98,14,14.3
6,All Students,2021-22,14209,1006,13203,92.9,83,21,25.3
6,All Students,2022-23,17164,922,16242,94.6,98,15,15.3
7,All Students,2018-19,13932,519,13413,96.3,80,5,6.3
7,All Students,2019-20,8746,272,8474,96.9,78,4,5.1
7,All Students,2020-21,11689,566,11123,95.2,68,10,14.7
7,All Students,2021-22,15010,691,14319,95.4,89,15,16.9
7,All Students,2022-23,13252,910,12342,93.1,76,17,22.4
8,All Students,2018-19,13485,960,12525,92.9,76,13,17.1
8,All Students,2019-20,8616,361,8255,95.8,76,7,9.2
8,All Students,2020-21,12984,515,12469,96.0,75,6,8.0
8,All Students,2021-22,9833,884,8949,91.0,58,16,27.6
8,All Students,2022-23,14652,1107,13545,92.4,85,25,29.4
All Grades,All Students,2018-19,99049,3978,95071,96.0,579,39,6.7
All Grades,All Students,2019-20,69302,3278,66024,95.3,615,64,10.4
All Grades,All Students,2020-21,93552,2020,91532,97.8,555,13,2.3
All Grades,All Students,2021-22,90094,4625,85469,94.9,529,70,13.2
All Grades,All Students,2022-23,87217,4936,82281,94.3,515,73,14.2
PK in K-12 Schools,All Students,2018-19,7074,317,6757,95.5,41,2,4.9
PK in K-12 Schools,All Students,2019-20,4600,214,4386,95.3,40,3,7.5
PK in K-12 Schools,All Students,2020-21,6085,240,5845,96.1,37,3,8.1
PK in K-12 Schools,All Students,2021-22,6340,544,5796,91.4,36,12,33.3
PK in K-12 Schools,All Students,2022-23,6282,488,5794,92.2,36,12,33.3
0K,All Students,2018-19,17896,1025,16871,94.3,107,17,15.9
0K,All Students,2019-20,14236,871,13365,93.9,127,22,17.3
0K,All Students,2020-21,16617,402,16215,97.6,98,4,4.1
0K,All Students,2021-22,18431,1119,17312,93.9,111,19,17.1
0K,All Students,2022-23,15577,1032,14545,93.4,92,16,17.4
1,All Students,2018-19,15713,552,15161,96.5,92,4,4.3
1,All Students,2019-20,12270,555,11715,95.5,110,8,7.3
1,All Students,2020-21,15851,334,15517,97.9,95,1,1.1
1,All Students,2021-22,15604,777,14827,95.0,93,12,12.9
1,All Students,2022-23,16271,1007,15264,93.8,98,16,16.3
2,All Students,2018-19,16502,722,15780,95.6,98,8,8.2
2,All Students,2019-20,10367,531,9836,94.9,91,9,9.9
2,All Students,2020-21,14463,321,14142,97.8,85,1,1.2
2,All Students,2021-22,13357,569,12788,95.7,78,6,7.7
2,All Students,2022-23,13698,777,12921,94.3,82,11,13.4
3,All Students,2018-19,14133,462,13671,96.7,82,1,1.2
3,All Students,2019-20,9754,410,9344,95.8,86,8,9.3
3,All Students,2020-21,14300,204,14096,98.6,86,2,2.3
3,All Students,2021-22,11850,518,11332,95.6,70,7,10.0
3,All Students,2022-23,12327,562,11765,95.4,73,5,6.8
4,All Students,2018-19,14695,370,14325,97.5,84,1,1.2
4,All Students,2019-20,9108,279,8829,96.9,81,4,4.9
4,All Students,2020-21,13312,190,13122,98.6,78,0,0.0
4,All Students,2021-22,12588,546,12042,95.7,73,6,8.2
4,All Students,2022-23,11428,437,10991,96.2,66,3,4.5
5,All Students,2018-19,13036,530,12506,95.9,75,6,8.0
5,All Students,2019-20,8967,418,8549,95.3,80,10,12.5
5,All Students,2020-21,12924,329,12595,97.5,76,2,2.6
5,All Students,2021-22,11924,552,11372,95.4,68,8,11.8
5,All Students,2022-23,11634,633,11001,94.6,68,10,14.7
All Grades,All Students,2018-19,85953,4777,81176,94.4,506,78,15.4
All Grades,All Students,2019-20,56530,3348,53182,94.1,510,89,17.5
All Grades,All Students,2020-21,78555,2219,76336,97.2,477,35,7.3
All Grades,All Students,2021-22,74099,4824,69275,93.5,436,76,17.4
All Grades,All Students,2022-23,81762,6746,75016,91.7,479,148,30.9
PK in K-12 Schools,All Students,2018-19,9615,794,8821,91.7,58,19,32.8
PK in K-12 Schools,All Students,2019-20,5976,394,5582,93.4,52,10,19.2
PK in K-12 Schools,All Students,2020-21,7052,318,6734,95.5,43,6,14.0
PK in K-12 Schools,All Students,2021-22,8218,642,7576,92.2,49,11,22.4
PK in K-12 Schools,All Students,2022-23,8405,1028,7377,87.8,54,28,51.9
0K,All Students,2018-19,14404,888,13516,93.8,86,15,17.4
0K,All Students,2019-20,11275,787,10488,93.0,101,22,21.8
0K,All Students,2020-21,13798,487,13311,96.5,86,9,10.5
0K,All Students,2021-22,14353,961,13392,93.3,83,16,19.3
0K,All Students,2022-23,15712,1295,14417,91.8,91,26,28.6
1,All Students,2018-19,12014,606,11408,95.0,70,8,11.4
1,All Students,2019-20,8547,548,7999,93.6,76,13,17.1
1,All Students,2020-21,13764,328,13436,97.6,81,5,6.2
1,All Students,2021-22,12624,874,11750,93.1,73,13,17.8
1,All Students,2022-23,12069,1052,11017,91.3,70,23,32.9
2,All Students,2018-19,13126,611,12515,95.3,77,7,9.1
2,All Students,2019-20,7774,398,7376,94.9,73,13,17.8
2,All Students,2020-21,11549,340,11209,97.1,70,5,7.1
2,All Students,2021-22,13230,789,12441,94.0,76,13,17.1
2,All Students,2022-23,13273,1021,12252,92.3,78,20,25.6
3,All Students,2018-19,15696,974,14722,93.8,91,16,17.6
3,All Students,2019-20,7395,372,7023,95.0,67,8,11.9
3,All Students,2020-21,9711,216,9495,97.8,59,1,1.7
3,All Students,2021-22,10747,696,10051,93.5,64,8,12.5
3,All Students,2022-23,14231,1007,13224,92.9,81,20,24.7
4,All Students,2018-19,10111,375,9736,96.3,60,6,10.0
4,All Students,2019-20,9383,597,8786,93.6,84,17,20.2
4,All Students,2020-21,9054,179,8875,98.0,56,3,5.4
4,All Students,2021-22,6912,344,6568,95.0,44,8,18.2
4,All Students,2022-23,10515,702,9813,93.3,60,16,26.7
5,All Students,2018-19,10987,529,10458,95.2,64,7,10.9
5,All Students,2019-20,6180,252,5928,95.9,57,6,10.5
5,All Students,2020-21,13627,351,13276,97.4,82,6,7.3
5,All Students,2021-22,8015,518,7497,93.5,47,7,14.9
5,All Students,2022-23,7557,641,6916,91.5,45,15,33.3
All Grades,All Students,2018-19,64147,3341,60806,94.8,375,63,16.8
All Grades,All Students,2019-20,42241,2804,39437,93.4,373,81,21.7
All Grades,All Students,2020-21,56441,2389,54052,95.8,337,38,11.3
All Grades,All Students,2021-22,50965,4715,46250,90.7,304,107,35.2
All Grades,All Students,2022-23,56811,7701,49110,86.4,354,167,47.2
PK in K-12 Schools,All Students,2018-19,6180,560,5620,90.9,37,13,35.1
PK in K-12 Schools,All Students,2019-20,4073,435,3638,89.3,37,16,43.2
PK in K-12 Schools,All Students,2020-21,4899,374,4525,92.4,31,7,22.6
PK in K-12 Schools,All Students,2021-22,5544,671,4873,87.9,32,17,53.1
PK in K-12 Schools,All Students,2022-23,6179,808,5371,86.9,38,22,57.9
0K,All Students,2018-19,9484,631,8853,93.3,56,13,23.2
0K,All Students,2019-20,6389,575,5814,91.0,56,21,37.5
0K,All Students,2020-21,9801,835,8966,91.5,59,13,22.0
0K,All Students,2021-22,7764,888,6876,88.6,47,20,42.6
0K,All Students,2022-23,8487,1278,7209,84.9,52,26,50.0
1,All Students,2018-19,9579,559,9020,94.2,57,10,17.5
1,All Students,2019-20,6480,487,5993,92.5,57,10,17.5
1,All Students,2020-21,8380,188,8192,97.8,49,3,6.1
1,All Students,2021-22,8583,922,7661,89.3,49,22,44.9
1,All Students,2022-23,8843,1421,7422,83.9,58,36,62.1
2,All Students,2018-19,10558,501,10057,95.3,61,10,16.4
2,All Students,2019-20,6361,401,5960,93.7,56,13,23.2
2,All Students,2020-21,7592,154,7438,98.0,46,2,4.3
2,All Students,2021-22,7120,493,6627,93.1,43,13,30.2
2,All Students,2022-23,9275,1188,8087,87.2,57,27,47.4
3,All Students,2018-19,9228,397,8831,95.7,54,6,11.1
3,All Students,2019-20,6214,392,5822,93.7,55,12,21.8
3,All Students,2020-21,8530,142,8388,98.3,50,2,4.0
3,All Students,2021-22,6629,403,6226,93.9,39,8,20.5
3,All Students,2022-23,7782,978,6804,87.4,50,20,40.0
4,All Students,2018-19,10159,244,9915,97.6,59,4,6.8
4,All Students,2019-20,6031,236,5795,96.1,53,3,5.7
4,All Students,2020-21,9255,276,8979,97.0,54,3,5.6
4,All Students,2021-22,6874,504,6370,92.7,44,12,27.3
4,All Students,2022-23,8202,1125,7077,86.3,52,19,36.5
5,All Students,2018-19,8959,449,8510,95.0,51,7,13.7
5,All Students,2019-20,6693,278,6415,95.8,59,6,10.2
5,All Students,2020-21,7984,420,7564,94.7,48,8,16.7
5,All Students,2021-22,8451,834,7617,90.1,50,15,30.0
5,All Students,2022-23,8043,903,7140,88.8,47,17,36.2
All Grades,All Students,2018-19,109638,5455,104183,95.0,667,93,13.9
All Grades,All Students,2019-20,73331,3067,70264,95.8,670,73,10.9
All Grades,All Students,2020-21,107841,4339,103502,96.0,669,65,9.7
All Grades,All Students,2021-22,122435,9779,112656,92.0,764,206,27.0
All Grades,All Students,2022-23,125684,9037,116647,92.8,764,170,22.3
PK in K-12 Schools,All Students,2018-19,5780,381,5399,93.4,38,8,21.1
PK in K-12 Schools,All Students,2019-20,4545,242,4303,94.7,42,10,23.8
PK in K-12 Schools,All Students,2020-21,5560,253,5307,95.4,40,6,15.0
PK in K-12 Schools,All Students,2021-22,8828,1016,7812,88.5,56,27,48.2
PK in K-12 Schools,All Students,2022-23,8910,805,8105,91.0,54,19,35.2
0K,All Students,2018-19,16908,1113,15795,93.4,104,22,21.2
0K,All Students,2019-20,11090,587,10503,94.7,103,16,15.5
0K,All Students,2020-21,17712,1025,16687,94.2,111,21,18.9
0K,All Students,2021-22,18591,1557,17034,91.6,115,36,31.3
0K,All Students,2022-23,17571,1717,15854,90.2,107,40,37.4
1,All Students,2018-19,15814,693,15121,95.6,97,9,9.3
1,All Students,2019-20,11012,524,10488,95.2,98,10,10.2
1,All Students,2020-21,16074,617,15457,96.2,102,8,7.8
1,All Students,2021-22,18121,1486,16635,91.8,109,29,26.6
1,All Students,2022-23,19255,1374,17881,92.9,119,28,23.5
2,All Students,2018-19,12686,602,12084,95.3,79,9,11.4
2,All Students,2019-20,10359,364,9995,96.5,97,7,7.2
2,All Students,2020-21,15073,347,14726,97.7,92,3,3.3
2,All Students,2021-22,18140,1328,16812,92.7,113,25,22.1
2,All Students,2022-23,16793,1119,15674,93.3,102,16,15.7
3,All Students,2018-19,13002,602,12400,95.4,77,9,11.7
3,All Students,2019-20,8859,242,8617,97.3,81,4,4.9
3,All Students,2020-21,14663,375,14288,97.4,88,3,3.4
3,All Students,2021-22,15419,1037,14382,93.3,95,22,23.2
3,All Students,2022-23,16609,977,15632,94.1,101,17,16.8
4,All Students,2018-19,14673,564,14109,96.2,87,10,11.5
4,All Students,2019-20,7939,269,7670,96.6,74,7,9.5
4,All Students,2020-21,12613,351,12262,97.2,77,4,5.2
4,All Students,2021-22,14972,942,14030,93.7,91,17,18.7
4,All Students,2022-23,14278,665,13613,95.3,87,8,9.2
5,All Students,2018-19,15588,599,14989,96.2,89,6,6.7
5,All Students,2019-20,9093,393,8700,95.7,82,10,12.2
5,All Students,2020-21,10628,399,10229,96.2,63,5,7.9
5,All Students,2021-22,11286,693,10593,93.9,71,12,16.9
5,All Students,2022-23,15785,932,14853,94.1,95,14,14.7
6,All Students,2018-19,4819,375,4444,92.2,31,10,32.3
6,All Students,2019-20,3906,139,3767,96.4,35,2,5.7
6,All Students,2020-21,5611,448,5163,92.0,36,8,22.2
6,All Students,2021-22,5789,636,5153,89.0,39,14,35.9
6,All Students,2022-23,4781,252,4529,94.7,29,4,13.8
7,All Students,2018-19,5253,220,5033,95.8,33,5,15.2
7,All Students,2019-20,3050,s,s,s,s,s,s
7,All Students,2020-21,5370,124,5246,97.7,33,0,0.0
7,All Students,2021-22,5506,s,s,s,s,s,s
7,All Students,2022-23,5869,557,5312,90.5,34,9,26.5
8,All Students,2018-19,5115,306,4809,94.0,32,5,15.6
8,All Students,2019-20,3471,144,3327,95.9,31,3,9.7
8,All Students,2020-21,4537,400,4137,91.2,27,7,25.9
8,All Students,2021-22,5723,547,5176,90.4,38,10,26.3
8,All Students,2022-23,5833,639,5194,89.0,36,15,41.7
9,All Students,2019-20,7,s,s,s,s,s,s
9,All Students,2021-22,60,s,s,s,s,s,s
All Grades,All Students,2018-19,57337,3918,53419,93.2,327,72,22.0
All Grades,All Students,2019-20,38115,2503,35612,93.4,336,70,20.8
All Grades,All Students,2020-21,58920,2844,56076,95.2,347,52,15.0
All Grades,All Students,2021-22,56688,5166,51522,90.9,334,110,32.9
All Grades,All Students,2022-23,58805,5880,52925,90.0,364,137,37.6
PK in K-12 Schools,All Students,2018-19,6612,485,6127,92.7,39,11,28.2
PK in K-12 Schools,All Students,2019-20,4065,311,3754,92.3,37,10,27.0
PK in K-12 Schools,All Students,2020-21,5751,333,5418,94.2,36,5,13.9
PK in K-12 Schools,All Students,2021-22,5722,498,5224,91.3,35,9,25.7
PK in K-12 Schools,All Students,2022-23,6321,841,5480,86.7,39,19,48.7
0K,All Students,2018-19,8275,752,7523,90.9,47,13,27.7
0K,All Students,2019-20,5140,358,4782,93.0,47,12,25.5
0K,All Students,2020-21,7844,502,7342,93.6,48,12,25.0
0K,All Students,2021-22,6799,798,6001,88.3,43,18,41.9
0K,All Students,2022-23,7554,903,6651,88.0,46,21,45.7
1,All Students,2018-19,7212,427,6785,94.1,42,9,21.4
1,All Students,2019-20,4823,383,4440,92.1,42,13,31.0
1,All Students,2020-21,7350,299,7051,95.9,42,3,7.1
1,All Students,2021-22,7197,594,6603,91.7,41,14,34.1
1,All Students,2022-23,6796,763,6033,88.8,42,17,40.5
2,All Students,2018-19,5164,276,4888,94.7,29,5,17.2
2,All Students,2019-20,4531,284,4247,93.7,40,8,20.0
2,All Students,2020-21,6285,360,5925,94.3,38,8,21.1
2,All Students,2021-22,7343,529,6814,92.8,42,11,26.2
2,All Students,2022-23,6202,505,5697,91.9,38,10,26.3
3,All Students,2018-19,6625,372,6253,94.4,38,8,21.1
3,All Students,2019-20,3220,188,3032,94.2,28,4,14.3
3,All Students,2020-21,6825,287,6538,95.8,39,5,12.8
3,All Students,2021-22,5487,559,4928,89.8,31,12,38.7
3,All Students,2022-23,6741,512,6229,92.4,40,8,20.0
4,All Students,2018-19,6231,403,5828,93.5,35,8,22.9
4,All Students,2019-20,4485,253,4232,94.4,39,7,17.9
4,All Students,2020-21,4725,105,4620,97.8,27,1,3.7
4,All Students,2021-22,6079,548,5531,91.0,36,13,36.1
4,All Students,2022-23,6372,646,5726,89.9,36,16,44.4
5,All Students,2018-19,5339,298,5041,94.4,30,2,6.7
5,All Students,2019-20,4140,272,3868,93.4,36,6,16.7
5,All Students,2020-21,6759,309,6450,95.4,39,4,10.3
5,All Students,2021-22,4724,376,4348,92.0,27,7,25.9
5,All Students,2022-23,5688,508,5180,91.1,36,12,33.3
6,All Students,2018-19,5471,463,5008,91.5,31,8,25.8
6,All Students,2019-20,2999,184,2815,93.9,26,3,11.5
6,All Students,2020-21,4153,221,3932,94.7,24,5,20.8
6,All Students,2021-22,4599,315,4284,93.2,26,3,11.5
6,All Students,2022-23,4717,537,4180,88.6,36,18,50.0
7,All Students,2018-19,1958,78,1880,96.0,11,1,9.1
7,All Students,2019-20,3447,209,3238,93.9,30,6,20.0
7,All Students,2020-21,4317,180,4137,95.8,25,4,16.0
7,All Students,2021-22,4116,479,3637,88.4,26,10,38.5
7,All Students,2022-23,4692,306,4386,93.5,28,5,17.9
8,All Students,2018-19,4450,364,4086,91.8,25,7,28.0
8,All Students,2019-20,1265,61,1204,95.2,11,1,9.1
8,All Students,2020-21,4911,248,4663,95.0,29,5,17.2
8,All Students,2021-22,4622,470,4152,89.8,27,13,48.1
8,All Students,2022-23,3722,359,3363,90.4,23,11,47.8
All Grades,All Students,2018-19,114252,5050,109202,95.6,658,66,10.0
All Grades,All Students,2019-20,73258,3380,69878,95.4,649,70,10.8
All Grades,All Students,2020-21,79798,2497,77301,96.9,473,22,4.7
All Grades,All Students,2021-22,80480,4708,75772,94.2,464,80,17.2
All Grades,All Students,2022-23,83891,5489,78402,93.5,482,97,20.1
0K,All Students,2018-19,24020,1661,22359,93.1,139,33,23.7
0K,All Students,2019-20,13475,754,12721,94.4,123,23,18.7
0K,All Students,2020-21,13944,489,13455,96.5,81,4,4.9
0K,All Students,2021-22,17908,1265,16643,92.9,104,26,25.0
0K,All Students,2022-23,15512,1133,14379,92.7,89,24,27.0
1,All Students,2018-19,19451,878,18573,95.5,112,8,7.1
1,All Students,2019-20,13143,760,12383,94.2,117,17,14.5
1,All Students,2020-21,14648,460,14188,96.9,87,6,6.9
1,All Students,2021-22,12828,807,12021,93.7,75,16,21.3
1,All Students,2022-23,17366,1252,16114,92.8,101,25,24.8
2,All Students,2018-19,16780,810,15970,95.2,98,11,11.2
2,All Students,2019-20,13454,625,12829,95.4,118,8,6.8
2,All Students,2020-21,12664,443,12221,96.5,77,3,3.9
2,All Students,2021-22,14546,874,13672,94.0,83,14,16.9
2,All Students,2022-23,11926,716,11210,94.0,68,11,16.2
3,All Students,2018-19,19444,579,18865,97.0,114,6,5.3
3,All Students,2019-20,10733,366,10367,96.6,95,7,7.4
3,All Students,2020-21,14342,386,13956,97.3,86,3,3.5
3,All Students,2021-22,13256,818,12438,93.8,75,15,20.0
3,All Students,2022-23,14274,877,13397,93.9,82,11,13.4
4,All Students,2018-19,17825,425,17400,97.6,101,1,1.0
4,All Students,2019-20,11758,319,11439,97.3,103,2,1.9
4,All Students,2020-21,11652,337,11315,97.1,68,3,4.4
4,All Students,2021-22,12343,493,11850,96.0,72,4,5.6
4,All Students,2022-23,13508,796,12712,94.1,77,13,16.9
5,All Students,2018-19,16732,697,16035,95.8,94,7,7.4
5,All Students,2019-20,10695,556,10139,94.8,93,13,14.0
5,All Students,2020-21,12548,382,12166,97.0,74,3,4.1
5,All Students,2021-22,9599,451,9148,95.3,55,5,9.1
5,All Students,2022-23,11305,715,10590,93.7,65,13,20.0
All Grades,All Students,2018-19,70026,1954,68072,97.2,396,11,2.8
All Grades,All Students,2019-20,43851,1375,42476,96.9,384,19,4.9
All Grades,All Students,2020-21,63034,1185,61849,98.1,363,12,3.3
All Grades,All Students,2021-22,60005,2519,57486,95.8,342,31,9.1
All Grades,All Students,2022-23,63799,3325,60474,94.8,371,51,13.7
6,All Students,2018-19,24044,696,23348,97.1,136,5,3.7
6,All Students,2019-20,14465,454,14011,96.9,127,5,3.9
6,All Students,2020-21,21575,297,21278,98.6,124,1,0.8
6,All Students,2021-22,22042,907,21135,95.9,126,9,7.1
6,All Students,2022-23,24064,1251,22813,94.8,142,16,11.3
7,All Students,2018-19,22808,374,22434,98.4,129,1,0.8
7,All Students,2019-20,14699,262,14437,98.2,129,3,2.3
7,All Students,2020-21,19246,281,18965,98.5,111,3,2.7
7,All Students,2021-22,19941,645,19296,96.8,114,7,6.1
7,All Students,2022-23,20683,815,19868,96.1,120,12,10.0
8,All Students,2018-19,23174,884,22290,96.2,131,5,3.8
8,All Students,2019-20,14687,659,14028,95.5,128,11,8.6
8,All Students,2020-21,22213,607,21606,97.3,128,8,6.3
8,All Students,2021-22,18022,967,17055,94.6,102,15,14.7
8,All Students,2022-23,19052,1259,17793,93.4,109,23,21.1
All Grades,All Students,2018-19,124910,5000,119910,96.0,730,66,9.0
All Grades,All Students,2019-20,85998,3571,82427,95.8,780,77,9.9
All Grades,All Students,2020-21,136556,7265,129291,94.7,796,117,14.7
All Grades,All Students,2021-22,132395,10884,121511,91.8,774,195,25.2
All Grades,All Students,2022-23,133485,9756,123729,92.7,798,178,22.3
6,All Students,2018-19,17388,344,17044,98.0,98,0,0.0
6,All Students,2019-20,11087,203,10884,98.2,98,0,0.0
6,All Students,2020-21,16470,179,16291,98.9,95,1,1.1
6,All Students,2021-22,15576,956,14620,93.9,89,13,14.6
6,All Students,2022-23,16825,877,15948,94.8,97,12,12.4
7,All Students,2018-19,17328,333,16995,98.1,98,2,2.0
7,All Students,2019-20,10801,193,10608,98.2,95,3,3.2
7,All Students,2020-21,16800,279,16521,98.3,99,2,2.0
7,All Students,2021-22,16654,702,15952,95.8,95,8,8.4
7,All Students,2022-23,15887,748,15139,95.3,91,6,6.6
8,All Students,2018-19,17449,582,16867,96.7,99,3,3.0
8,All Students,2019-20,10971,293,10678,97.3,97,1,1.0
8,All Students,2020-21,16367,718,15649,95.6,95,11,11.6
8,All Students,2021-22,17050,929,16121,94.6,97,12,12.4
8,All Students,2022-23,17121,799,16322,95.3,98,8,8.2
9,All Students,2018-19,20377,711,19666,96.5,123,8,6.5
9,All Students,2019-20,14226,514,13712,96.4,131,11,8.4
9,All Students,2020-21,22498,1035,21463,95.4,132,13,9.8
9,All Students,2021-22,19329,1404,17925,92.7,115,18,15.7
9,All Students,2022-23,20664,1049,19615,94.9,129,13,10.1
10,All Students,2018-19,21520,820,20700,96.2,129,13,10.1
10,All Students,2019-20,13800,624,13176,95.5,127,11,8.7
10,All Students,2020-21,22100,1292,20808,94.2,129,21,16.3
10,All Students,2021-22,22595,1832,20763,91.9,133,34,25.6
10,All Students,2022-23,21518,1348,20170,93.7,131,14,10.7
11,All Students,2018-19,17346,1085,16261,93.7,103,15,14.6
11,All Students,2019-20,13875,679,13196,95.1,129,18,14.0
11,All Students,2020-21,20584,1244,19340,94.0,120,24,20.0
11,All Students,2021-22,21266,2069,19197,90.3,127,36,28.3
11,All Students,2022-23,21529,1548,19981,92.8,131,22,16.8
12,All Students,2018-19,13502,1125,12377,91.7,80,25,31.3
12,All Students,2019-20,11238,1065,10173,90.5,103,33,32.0
12,All Students,2020-21,21737,2518,19219,88.4,126,45,35.7
12,All Students,2021-22,19925,2992,16933,85.0,118,74,62.7
12,All Students,2022-23,19941,3387,16554,83.0,121,103,85.1
All Grades,All Students,2018-19,74384,3363,71021,95.5,442,39,8.8
All Grades,All Students,2019-20,50613,2415,48198,95.2,456,41,9.0
All Grades,All Students,2020-21,68189,1542,66647,97.7,426,22,5.2
All Grades,All Students,2021-22,67761,4372,63389,93.5,395,70,17.7
All Grades,All Students,2022-23,63117,4097,59020,93.5,389,87,22.4
0K,All Students,2018-19,16075,789,15286,95.1,99,12,12.1
0K,All Students,2019-20,9962,531,9431,94.7,92,8,8.7
0K,All Students,2020-21,12603,335,12268,97.3,82,6,7.3
0K,All Students,2021-22,15432,970,14462,93.7,91,16,17.6
0K,All Students,2022-23,11242,884,10358,92.1,70,23,32.9
1,All Students,2018-19,14786,755,14031,94.9,88,8,9.1
1,All Students,2019-20,9559,467,9092,95.1,87,10,11.5
1,All Students,2020-21,10521,339,10182,96.8,66,5,7.6
1,All Students,2021-22,12122,683,11439,94.4,71,11,15.5
1,All Students,2022-23,12482,699,11783,94.4,78,13,16.7
2,All Students,2018-19,12841,553,12288,95.7,76,4,5.3
2,All Students,2019-20,9933,489,9444,95.1,91,7,7.7
2,All Students,2020-21,12585,243,12342,98.1,79,3,3.8
2,All Students,2021-22,8881,690,8191,92.2,52,15,28.8
2,All Students,2022-23,10719,680,10039,93.7,64,12,18.8
3,All Students,2018-19,11657,503,11154,95.7,68,7,10.3
3,All Students,2019-20,8198,417,7781,94.9,72,8,11.1
3,All Students,2020-21,11733,190,11543,98.4,73,4,5.5
3,All Students,2021-22,12308,813,11495,93.4,73,12,16.4
3,All Students,2022-23,8638,548,8090,93.7,53,10,18.9
4,All Students,2018-19,9475,379,9096,96.0,57,6,10.5
4,All Students,2019-20,7261,267,6994,96.3,64,5,7.8
4,All Students,2020-21,10618,194,10424,98.2,65,1,1.5
4,All Students,2021-22,9277,531,8746,94.3,53,5,9.4
4,All Students,2022-23,10531,686,9845,93.5,65,16,24.6
5,All Students,2018-19,9550,384,9166,96.0,54,2,3.7
5,All Students,2019-20,5700,244,5456,95.7,50,3,6.0
5,All Students,2020-21,10129,241,9888,97.6,61,3,4.9
5,All Students,2021-22,9741,685,9056,93.0,55,11,20.0
5,All Students,2022-23,9505,600,8905,93.7,59,13,22.0
All Grades,All Students,2018-19,151439,6840,144599,95.5,880,79,9.0
All Grades,All Students,2019-20,98268,4145,94123,95.8,875,81,9.3
All Grades,All Students,2020-21,135899,3151,132748,97.7,821,47,5.7
All Grades,All Students,2021-22,128649,8562,120087,93.3,758,158,20.8
All Grades,All Students,2022-23,126930,8338,118592,93.4,738,150,20.3
PK in K-12 Schools,All Students,2018-19,3183,228,2955,92.8,19,3,15.8
PK in K-12 Schools,All Students,2019-20,2010,102,1908,94.9,18,2,11.1
PK in K-12 Schools,All Students,2020-21,3024,210,2814,93.1,21,7,33.3
PK in K-12 Schools,All Students,2021-22,3186,255,2931,92.0,18,7,38.9
PK in K-12 Schools,All Students,2022-23,3186,304,2882,90.5,18,9,50.0
0K,All Students,2018-19,17815,1093,16722,93.9,100,14,14.0
0K,All Students,2019-20,11518,660,10858,94.3,102,18,17.6
0K,All Students,2020-21,14137,380,13757,97.3,90,7,7.8
0K,All Students,2021-22,13543,1109,12434,91.8,82,24,29.3
0K,All Students,2022-23,14586,952,13634,93.5,86,16,18.6
1,All Students,2018-19,15682,766,14916,95.1,93,9,9.7
1,All Students,2019-20,10166,497,9669,95.1,91,12,13.2
1,All Students,2020-21,12645,266,12379,97.9,79,2,2.5
1,All Students,2021-22,12579,791,11788,93.7,76,17,22.4
1,All Students,2022-23,13239,988,12251,92.5,76,15,19.7
2,All Students,2018-19,16588,675,15913,95.9,97,5,5.2
2,All Students,2019-20,9589,480,9109,95.0,85,12,14.1
2,All Students,2020-21,13269,274,12995,97.9,80,4,5.0
2,All Students,2021-22,13398,784,12614,94.1,81,10,12.3
2,All Students,2022-23,12713,709,12004,94.4,75,11,14.7
3,All Students,2018-19,15395,706,14689,95.4,91,5,5.5
3,All Students,2019-20,10858,415,10443,96.2,96,3,3.1
3,All Students,2020-21,11552,210,11342,98.2,73,2,2.7
3,All Students,2021-22,12214,941,11273,92.3,70,13,18.6
3,All Students,2022-23,12680,748,11932,94.1,77,14,18.2
4,All Students,2018-19,16884,507,16377,97.0,98,5,5.1
4,All Students,2019-20,10255,312,9943,97.0,91,2,2.2
4,All Students,2020-21,14948,252,14696,98.3,89,2,2.2
4,All Students,2021-22,11386,630,10756,94.5,67,13,19.4
4,All Students,2022-23,12299,856,11443,93.0,71,13,18.3
5,All Students,2018-19,16059,656,15403,95.9,95,6,6.3
5,All Students,2019-20,10999,348,10651,96.8,99,4,4.0
5,All Students,2020-21,16548,234,16314,98.6,98,1,1.0
5,All Students,2021-22,14804,858,13946,94.2,86,12,14.0
5,All Students,2022-23,11433,895,10538,92.2,67,17,25.4
6,All Students,2018-19,17055,874,16181,94.9,99,13,13.1
6,All Students,2019-20,11226,532,10694,95.3,99,13,13.1
6,All Students,2020-21,17274,270,17004,98.4,99,3,3.0
6,All Students,2021-22,15912,980,14932,93.8,94,14,14.9
6,All Students,2022-23,17048,1078,15970,93.7,98,21,21.4
7,All Students,2018-19,16517,522,15995,96.8,96,9,9.4
7,All Students,2019-20,10627,276,10351,97.4,96,3,3.1
7,All Students,2020-21,16899,332,16567,98.0,101,6,5.9
7,All Students,2021-22,14657,811,13846,94.5,85,13,15.3
7,All Students,2022-23,15133,768,14365,94.9,86,13,15.1
8,All Students,2018-19,16261,813,15448,95.0,92,10,10.9
8,All Students,2019-20,11020,523,10497,95.3,98,12,12.2
8,All Students,2020-21,15603,723,14880,95.4,91,13,14.3
8,All Students,2021-22,16970,1403,15567,91.7,99,35,35.4
8,All Students,2022-23,14613,1040,13573,92.9,84,21,25.0
All Grades,All Students,2018-19,68104,7225,60879,89.4,431,147,34.1
All Grades,All Students,2019-20,48848,5759,43089,88.2,458,187,40.8
All Grades,All Students,2020-21,80273,15101,65172,81.2,465,234,50.3
All Grades,All Students,2021-22,78284,15013,63271,80.8,480,285,59.4
All Grades,All Students,2022-23,63394,10527,52867,83.4,406,200,49.3
9,All Students,2018-19,19739,1866,17873,90.5,122,30,24.6
9,All Students,2019-20,12607,1430,11177,88.7,121,44,36.4
9,All Students,2020-21,19242,3874,15368,79.9,112,58,51.8
9,All Students,2021-22,19220,3869,15351,79.9,120,78,65.0
9,All Students,2022-23,13529,2273,11256,83.2,89,42,47.2
10,All Students,2018-19,17129,2092,15037,87.8,117,56,47.9
10,All Students,2019-20,13009,1393,11616,89.3,124,46,37.1
10,All Students,2020-21,22610,4051,18559,82.1,133,63,47.4
10,All Students,2021-22,17298,4272,13026,75.3,110,71,64.5
10,All Students,2022-23,18470,2948,15522,84.0,122,59,48.4
11,All Students,2018-19,15305,1843,13462,88.0,96,32,33.3
11,All Students,2019-20,10758,1432,9326,86.7,99,50,50.5
11,All Students,2020-21,18032,2553,15479,85.8,103,38,36.9
11,All Students,2021-22,17812,4068,13744,77.2,108,74,68.5
11,All Students,2022-23,14197,2974,11223,79.1,90,54,60.0
12,All Students,2018-19,15931,1424,14507,91.1,96,29,30.2
12,All Students,2019-20,12474,1504,10970,87.9,114,47,41.2
12,All Students,2020-21,20389,4623,15766,77.3,117,75,64.1
12,All Students,2021-22,23954,2804,21150,88.3,142,62,43.7
12,All Students,2022-23,17198,2332,14866,86.4,105,45,42.9
All Grades,All Students,2018-19,59999,3135,56864,94.8,363,56,15.4
All Grades,All Students,2019-20,48950,3004,45946,93.9,453,69,15.2
All Grades,All Students,2020-21,78278,3537,74741,95.5,482,55,11.4
All Grades,All Students,2021-22,80617,5577,75040,93.1,488,109,22.3
All Grades,All Students,2022-23,84060,6715,77345,92.0,523,138,26.4
PK in K-12 Schools,All Students,2018-19,6296,362,5934,94.3,38,7,18.4
PK in K-12 Schools,All Students,2019-20,8111,615,7496,92.4,74,22,29.7
PK in K-12 Schools,All Students,2020-21,12152,663,11489,94.5,77,12,15.6
PK in K-12 Schools,All Students,2021-22,12180,1188,10992,90.2,77,29,37.7
PK in K-12 Schools,All Students,2022-23,12147,1060,11087,91.3,73,26,35.6
0K,All Students,2018-19,13256,893,12363,93.3,80,14,17.5
0K,All Students,2019-20,11198,851,10347,92.4,106,23,21.7
0K,All Students,2020-21,15181,963,14218,93.7,94,18,19.1
0K,All Students,2021-22,14418,1027,13391,92.9,86,22,25.6
0K,All Students,2022-23,15314,1323,13991,91.4,96,27,28.1
1,All Students,2018-19,13592,672,12920,95.1,83,11,13.3
1,All Students,2019-20,7118,406,6712,94.3,65,7,10.8
1,All Students,2020-21,13959,768,13191,94.5,87,10,11.5
1,All Students,2021-22,13775,1114,12661,91.9,82,22,26.8
1,All Students,2022-23,12670,1080,11590,91.5,80,24,30.0
2,All Students,2018-19,8994,459,8535,94.9,54,8,14.8
2,All Students,2019-20,7888,427,7461,94.6,73,7,9.6
2,All Students,2020-21,10224,319,9905,96.9,60,4,6.7
2,All Students,2021-22,11051,618,10433,94.4,68,11,16.2
2,All Students,2022-23,13050,1370,11680,89.5,83,25,30.1
3,All Students,2018-19,7005,307,6698,95.6,41,6,14.6
3,All Students,2019-20,5808,260,5548,95.5,55,5,9.1
3,All Students,2020-21,10296,280,10016,97.3,65,3,4.6
3,All Students,2021-22,10263,697,9566,93.2,63,9,14.3
3,All Students,2022-23,11410,698,10712,93.9,67,9,13.4
4,All Students,2018-19,5182,227,4955,95.6,34,5,14.7
4,All Students,2019-20,5152,295,4857,94.3,46,2,4.3
4,All Students,2020-21,9454,318,9136,96.6,56,4,7.1
4,All Students,2021-22,9931,428,9503,95.7,58,5,8.6
4,All Students,2022-23,9874,655,9219,93.4,63,14,22.2
5,All Students,2018-19,5674,215,5459,96.2,33,5,15.2
5,All Students,2019-20,3675,150,3525,95.9,34,3,8.8
5,All Students,2020-21,7012,226,6786,96.8,43,4,9.3
5,All Students,2021-22,8999,505,8494,94.4,54,11,20.4
5,All Students,2022-23,9595,529,9066,94.5,61,13,21.3
All Grades,All Students,2018-19,64810,7016,57794,89.2,413,136,32.9
All Grades,All Students,2019-20,47623,4779,42844,90.0,446,145,32.5
All Grades,All Students,2020-21,84195,15735,68460,81.3,492,275,55.9
All Grades,All Students,2021-22,85733,15764,69969,81.6,528,305,57.8
All Grades,All Students,2022-23,83868,11357,72511,86.5,531,225,42.4
9,All Students,2018-19,19922,2282,17640,88.5,129,43,33.3
9,All Students,2019-20,15216,1677,13539,89.0,144,44,30.6
9,All Students,2020-21,25330,4776,20554,81.1,150,87,58.0
9,All Students,2021-22,24618,3603,21015,85.4,152,65,42.8
9,All Students,2022-23,21541,2225,19316,89.7,137,39,28.5
10,All Students,2018-19,19243,2262,16981,88.2,125,39,31.2
10,All Students,2019-20,12209,1092,11117,91.1,114,36,31.6
10,All Students,2020-21,23544,4584,18960,80.5,137,69,50.4
10,All Students,2021-22,23544,4714,18830,80.0,147,93,63.3
10,All Students,2022-23,22637,2132,20505,90.6,143,51,35.7
11,All Students,2018-19,14606,1334,13272,90.9,92,31,33.7
11,All Students,2019-20,11198,958,10240,91.4,105,26,24.8
11,All Students,2020-21,18506,3637,14869,80.3,108,66,61.1
11,All Students,2021-22,20206,3446,16760,82.9,123,66,53.7
11,All Students,2022-23,20995,3764,17231,82.1,134,73,54.5
12,All Students,2018-19,11039,1138,9901,89.7,67,23,34.3
12,All Students,2019-20,9000,1052,7948,88.3,83,39,47.0
12,All Students,2020-21,16815,2738,14077,83.7,97,53,54.6
12,All Students,2021-22,17365,4001,13364,77.0,106,81,76.4
12,All Students,2022-23,18695,3236,15459,82.7,117,62,53.0
All Grades,All Students,2018-19,61993,7408,54585,88.1,394,165,41.9
All Grades,All Students,2019-20,41845,4582,37263,89.1,398,140,35.2
All Grades,All Students,2020-21,72143,13113,59030,81.8,408,164,40.2
All Grades,All Students,2021-22,72009,13469,58540,81.3,440,243,55.2
All Grades,All Students,2022-23,69326,9233,60093,86.7,447,194,43.4
9,All Students,2018-19,21014,2780,18234,86.8,135,56,41.5
9,All Students,2019-20,13544,1810,11734,86.6,135,50,37.0
9,All Students,2020-21,23392,5591,17801,76.1,130,63,48.5
9,All Students,2021-22,21280,4151,17129,80.5,129,76,58.9
9,All Students,2022-23,20966,2685,18281,87.2,133,48,36.1
10,All Students,2018-19,15311,1835,13476,88.0,98,43,43.9
10,All Students,2019-20,11752,1168,10584,90.1,108,35,32.4
10,All Students,2020-21,19509,4039,15470,79.3,111,49,44.1
10,All Students,2021-22,18826,3470,15356,81.6,119,59,49.6
10,All Students,2022-23,18845,2926,15919,84.5,126,67,53.2
11,All Students,2018-19,13154,1473,11681,88.8,83,37,44.6
11,All Students,2019-20,8165,620,7545,92.4,77,21,27.3
11,All Students,2020-21,16951,2046,14905,87.9,97,29,29.9
11,All Students,2021-22,15197,2549,12648,83.2,92,42,45.7
11,All Students,2022-23,15498,1840,13658,88.1,100,38,38.0
12,All Students,2018-19,12514,1320,11194,89.5,78,29,37.2
12,All Students,2019-20,8384,984,7400,88.3,78,34,43.6
12,All Students,2020-21,12291,1437,10854,88.3,70,23,32.9
12,All Students,2021-22,16706,3299,13407,80.3,100,66,66.0
12,All Students,2022-23,14017,1782,12235,87.3,88,41,46.6
All Grades,All Students,2018-19,50422,1551,48871,96.9,287,18,6.3
All Grades,All Students,2019-20,31735,955,30780,97.0,280,18,6.4
All Grades,All Students,2020-21,45908,1060,44848,97.7,266,11,4.1
All Grades,All Students,2021-22,41403,2427,38976,94.1,238,41,17.2
All Grades,All Students,2022-23,42195,2000,40195,95.3,243,27,11.1
6,All Students,2018-19,17454,484,16970,97.2,100,8,8.0
6,All Students,2019-20,10347,319,10028,96.9,93,5,5.4
6,All Students,2020-21,15587,256,15331,98.4,90,2,2.2
6,All Students,2021-22,12733,534,12199,95.8,72,7,9.7
6,All Students,2022-23,15799,826,14973,94.8,91,11,12.1
7,All Students,2018-19,16544,402,16142,97.6,94,5,5.3
7,All Students,2019-20,10699,260,10439,97.6,94,5,5.3
7,All Students,2020-21,14362,483,13879,96.6,84,6,7.1
7,All Students,2021-22,14917,938,13979,93.7,87,13,14.9
7,All Students,2022-23,12254,391,11863,96.8,70,3,4.3
8,All Students,2018-19,16424,665,15759,96.0,93,5,5.4
8,All Students,2019-20,10689,376,10313,96.5,93,8,8.6
8,All Students,2020-21,15959,321,15638,98.0,92,3,3.3
8,All Students,2021-22,13753,955,12798,93.1,79,21,26.6
8,All Students,2022-23,14142,783,13359,94.5,82,13,15.9
All Grades,All Students,2018-19,106782,4736,102046,95.6,619,42,6.8
All Grades,All Students,2019-20,65561,3034,62527,95.4,584,48,8.2
All Grades,All Students,2020-21,79524,2239,77285,97.2,506,59,11.7
All Grades,All Students,2021-22,73348,4160,69188,94.3,432,63,14.6
All Grades,All Students,2022-23,76403,5057,71346,93.4,444,100,22.5
PK in K-12 Schools,All Students,2018-19,6691,573,6118,91.4,38,8,21.1
PK in K-12 Schools,All Students,2019-20,6100,388,5712,93.6,54,9,16.7
PK in K-12 Schools,All Students,2020-21,8104,575,7529,92.9,49,12,24.5
PK in K-12 Schools,All Students,2021-22,11254,1070,10184,90.5,70,25,35.7
PK in K-12 Schools,All Students,2022-23,11768,1116,10652,90.5,69,33,47.8
0K,All Students,2018-19,17605,859,16746,95.1,105,8,7.6
0K,All Students,2019-20,9832,578,9254,94.1,89,14,15.7
0K,All Students,2020-21,12013,389,11624,96.8,77,12,15.6
0K,All Students,2021-22,11885,728,11157,93.9,69,11,15.9
0K,All Students,2022-23,11605,904,10701,92.2,68,17,25.0
1,All Students,2018-19,18200,852,17348,95.3,105,8,7.6
1,All Students,2019-20,10351,421,9930,95.9,94,7,7.4
1,All Students,2020-21,9854,173,9681,98.2,67,8,11.9
1,All Students,2021-22,10046,691,9355,93.1,59,11,18.6
1,All Students,2022-23,12384,844,11540,93.2,71,13,18.3
2,All Students,2018-19,14560,623,13937,95.7,85,5,5.9
2,All Students,2019-20,10567,478,10089,95.5,93,4,4.3
2,All Students,2020-21,12638,268,12370,97.9,78,5,6.4
2,All Students,2021-22,7858,321,7537,95.9,46,4,8.7
2,All Students,2022-23,9879,655,9224,93.4,58,16,27.6
3,All Students,2018-19,17175,735,16440,95.7,98,5,5.1
3,All Students,2019-20,8868,392,8476,95.6,79,5,6.3
3,All Students,2020-21,13044,236,12808,98.2,84,6,7.1
3,All Students,2021-22,9836,397,9439,96.0,57,3,5.3
3,All Students,2022-23,8230,378,7852,95.4,49,5,10.2
4,All Students,2018-19,16039,552,15487,96.6,93,5,5.4
4,All Students,2019-20,10400,411,9989,96.0,92,5,5.4
4,All Students,2020-21,10637,306,10331,97.1,69,8,11.6
4,All Students,2021-22,12555,454,12101,96.4,75,4,5.3
4,All Students,2022-23,9786,471,9315,95.2,56,6,10.7
5,All Students,2018-19,16512,542,15970,96.7,95,3,3.2
5,All Students,2019-20,9443,366,9077,96.1,83,4,4.8
5,All Students,2020-21,13234,292,12942,97.8,82,8,9.8
5,All Students,2021-22,9914,499,9415,95.0,56,5,8.9
5,All Students,2022-23,12751,689,12062,94.6,73,10,13.7
All Grades,All Students,2018-19,55531,6233,49298,88.8,337,105,31.2
All Grades,All Students,2019-20,37382,4092,33290,89.1,348,132,37.9
All Grades,All Students,2020-21,64313,9896,54417,84.6,373,165,44.2
All Grades,All Students,2021-22,61555,9581,51974,84.4,364,172,47.3
All Grades,All Students,2022-23,58328,9313,49015,84.0,364,176,48.4
9,All Students,2018-19,15496,1508,13988,90.3,94,19,20.2
9,All Students,2019-20,9716,905,8811,90.7,95,32,33.7
9,All Students,2020-21,18138,3048,15090,83.2,105,45,42.9
9,All Students,2021-22,15433,1719,13714,88.9,94,41,43.6
9,All Students,2022-23,15304,2215,13089,85.5,94,40,42.6
10,All Students,2018-19,15951,1561,14390,90.2,95,27,28.4
10,All Students,2019-20,9480,887,8593,90.6,87,23,26.4
10,All Students,2020-21,15484,2312,13172,85.1,91,39,42.9
10,All Students,2021-22,17817,2516,15301,85.9,105,41,39.0
10,All Students,2022-23,14986,1914,13072,87.2,97,42,43.3
11,All Students,2018-19,12803,1768,11035,86.2,77,27,35.1
11,All Students,2019-20,10638,1080,9558,89.8,96,37,38.5
11,All Students,2020-21,14442,1841,12601,87.3,83,31,37.3
11,All Students,2021-22,13789,2432,11357,82.4,83,43,51.8
11,All Students,2022-23,15677,2520,13157,83.9,97,43,44.3
12,All Students,2018-19,11281,1396,9885,87.6,71,32,45.1
12,All Students,2019-20,7548,1220,6328,83.8,70,40,57.1
12,All Students,2020-21,16249,2695,13554,83.4,94,50,53.2
12,All Students,2021-22,14516,2914,11602,79.9,82,47,57.3
12,All Students,2022-23,12361,2664,9697,78.4,76,51,67.1
All Grades,All Students,2018-19,61706,9663,52043,84.3,383,158,41.3
All Grades,All Students,2019-20,36774,7327,29447,80.1,344,166,48.3
All Grades,All Students,2020-21,54746,16293,38453,70.2,300,216,72.0
All Grades,All Students,2021-22,39911,8018,31893,79.9,257,150,58.4
All Grades,All Students,2022-23,34147,9374,24773,72.5,234,174,74.4
9,All Students,2018-19,18656,3383,15273,81.9,114,47,41.2
9,All Students,2019-20,10747,2942,7805,72.6,103,51,49.5
9,All Students,2020-21,15832,5711,10121,63.9,82,54,65.9
9,All Students,2021-22,9402,2158,7244,77.0,64,36,56.3
9,All Students,2022-23,9229,3016,6213,67.3,66,57,86.4
10,All Students,2018-19,17958,2735,15223,84.8,116,44,37.9
10,All Students,2019-20,9943,1863,8080,81.3,94,50,53.2
10,All Students,2020-21,13682,4995,8687,63.5,75,67,89.3
10,All Students,2021-22,10249,1888,8361,81.6,66,36,54.5
10,All Students,2022-23,9872,3189,6683,67.7,70,55,78.6
11,All Students,2018-19,11410,1558,9852,86.3,72,32,44.4
11,All Students,2019-20,8108,862,7246,89.4,74,27,36.5
11,All Students,2020-21,12008,2310,9698,80.8,68,32,47.1
11,All Students,2021-22,7890,1079,6811,86.3,50,26,52.0
11,All Students,2022-23,6645,1322,5323,80.1,45,24,53.3
12,All Students,2018-19,13682,1987,11695,85.5,81,35,43.2
12,All Students,2019-20,7976,1660,6316,79.2,73,38,52.1
12,All Students,2020-21,13224,3277,9947,75.2,75,63,84.0
12,All Students,2021-22,12370,2893,9477,76.6,77,52,67.5
12,All Students,2022-23,8401,1847,6554,78.0,53,38,71.7
All Grades,All Students,2018-19,99851,5713,94138,94.3,588,92,15.6
All Grades,All Students,2019-20,97451,5903,91548,93.9,888,159,17.9
All Grades,All Students,2020-21,142875,10700,132175,92.5,834,174,20.9
All Grades,All Students,2021-22,106544,9014,97530,91.5,628,175,27.9
All Grades,All Students,2022-23,85244,11045,74199,87.0,527,255,48.4
6,All Students,2018-19,60332,3590,56742,94.0,356,62,17.4
6,All Students,2019-20,34493,2079,32414,94.0,315,58,18.4
6,All Students,2020-21,42221,3763,38458,91.1,246,61,24.8
6,All Students,2021-22,24994,1779,23215,92.9,149,28,18.8
6,All Students,2022-23,20997,2510,18487,88.0,135,72,53.3
7,All Students,2018-19,39519,2123,37396,94.6,232,30,12.9
7,All Students,2019-20,37096,1952,35144,94.7,336,46,13.7
7,All Students,2020-21,47440,2699,44741,94.3,277,47,17.0
7,All Students,2021-22,36579,3207,33372,91.2,221,68,30.8
7,All Students,2022-23,25836,2854,22982,89.0,161,67,41.6
8,All Students,2019-20,25862,1872,23990,92.8,237,55,23.2
8,All Students,2020-21,53214,4238,48976,92.0,311,66,21.2
8,All Students,2021-22,44971,4028,40943,91.0,258,79,30.6
8,All Students,2022-23,38411,5681,32730,85.2,231,116,50.2
All Grades,All Students,2018-19,94024,12130,81894,87.1,605,275,45.5
All Grades,All Students,2019-20,60554,7472,53082,87.7,585,234,40.0
All Grades,All Students,2020-21,101644,26068,75576,74.4,591,352,59.6
All Grades,All Students,2021-22,97015,19660,77355,79.7,614,394,64.2
All Grades,All Students,2022-23,87154,17614,69540,79.8,567,357,63.0
9,All Students,2018-19,25625,2294,23331,91.0,162,45,27.8
9,All Students,2019-20,15211,2200,13011,85.5,154,69,44.8
9,All Students,2020-21,29046,4663,24383,83.9,170,67,39.4
9,All Students,2021-22,27331,4503,22828,83.5,171,90,52.6
9,All Students,2022-23,23144,3727,19417,83.9,152,86,56.6
10,All Students,2018-19,23914,3369,20545,85.9,159,76,47.8
10,All Students,2019-20,18000,1952,16048,89.2,169,53,31.4
10,All Students,2020-21,23719,8164,15555,65.6,139,93,66.9
10,All Students,2021-22,25606,4577,21029,82.1,164,88,53.7
10,All Students,2022-23,22615,5167,17448,77.2,150,97,64.7
11,All Students,2018-19,22894,2946,19948,87.1,146,64,43.8
11,All Students,2019-20,13496,1572,11924,88.4,132,51,38.6
11,All Students,2020-21,27536,6489,21047,76.4,159,92,57.9
11,All Students,2021-22,18595,5175,13420,72.2,121,95,78.5
11,All Students,2022-23,24379,3904,20475,84.0,156,80,51.3
12,All Students,2018-19,21591,3521,18070,83.7,138,90,65.2
12,All Students,2019-20,13847,1748,12099,87.4,130,61,46.9
12,All Students,2020-21,21343,6752,14591,68.4,123,100,81.3
12,All Students,2021-22,25483,5405,20078,78.8,158,121,76.6
12,All Students,2022-23,17016,4816,12200,71.7,109,94,86.2
All Grades,All Students,2018-19,48918,9030,39888,81.5,313,152,48.6
All Grades,All Students,2019-20,28333,4776,23557,83.1,265,119,44.9
All Grades,All Students,2020-21,43891,6884,37007,84.3,261,117,44.8
All Grades,All Students,2021-22,40222,7218,33004,82.1,255,155,60.8
All Grades,All Students,2022-23,36379,6426,29953,82.3,242,131,54.1
9,All Students,2018-19,12065,1890,10175,84.3,75,27,36.0
9,All Students,2019-20,7142,1285,5857,82.0,67,32,47.8
9,All Students,2020-21,12877,1801,11076,86.0,75,33,44.0
9,All Students,2021-22,7888,1137,6751,85.6,53,28,52.8
9,All Students,2022-23,7459,1043,6416,86.0,51,26,51.0
10,All Students,2018-19,11533,2261,9272,80.4,73,32,43.8
10,All Students,2019-20,7585,1145,6440,84.9,72,27,37.5
10,All Students,2020-21,11286,2164,9122,80.8,68,33,48.5
10,All Students,2021-22,11849,1856,9993,84.3,74,39,52.7
10,All Students,2022-23,9139,1629,7510,82.2,61,30,49.2
11,All Students,2018-19,12871,2526,10345,80.4,83,49,59.0
11,All Students,2019-20,6982,1178,5804,83.1,63,25,39.7
11,All Students,2020-21,10895,1703,9192,84.4,64,25,39.1
11,All Students,2021-22,10730,2444,8286,77.2,67,46,68.7
11,All Students,2022-23,11530,1875,9655,83.7,74,35,47.3
12,All Students,2018-19,12449,2353,10096,81.1,82,44,53.7
12,All Students,2019-20,6624,1168,5456,82.4,63,35,55.6
12,All Students,2020-21,8833,1216,7617,86.2,54,26,48.1
12,All Students,2021-22,9755,1781,7974,81.7,61,42,68.9
12,All Students,2022-23,8251,1879,6372,77.2,56,40,71.4
All Grades,All Students,2018-19,60243,11917,48326,80.2,382,217,56.8
All Grades,All Students,2019-20,38303,6532,31771,82.9,366,191,52.2
All Grades,All Students,2020-21,57083,10764,46319,81.1,342,191,55.8
All Grades,All Students,2021-22,55791,11468,44323,79.4,349,220,63.0
All Grades,All Students,2022-23,49583,10902,38681,78.0,325,210,64.6
9,All Students,2018-19,15248,3841,11407,74.8,98,58,59.2
9,All Students,2019-20,11807,2085,9722,82.3,111,48,43.2
9,All Students,2020-21,20172,3619,16553,82.1,120,57,47.5
9,All Students,2021-22,15620,2465,13155,84.2,99,47,47.5
9,All Students,2022-23,9896,2738,7158,72.3,67,51,76.1
10,All Students,2018-19,14669,3518,11151,76.0,95,57,60.0
10,All Students,2019-20,9229,1941,7288,79.0,92,57,62.0
10,All Students,2020-21,16136,3032,13104,81.2,97,54,55.7
10,All Students,2021-22,15649,2525,13124,83.9,96,48,50.0
10,All Students,2022-23,15016,2600,12416,82.7,98,56,57.1
11,All Students,2018-19,17027,2136,14891,87.5,106,44,41.5
11,All Students,2019-20,6389,984,5405,84.6,63,31,49.2
11,All Students,2020-21,10417,2138,8279,79.5,64,35,54.7
11,All Students,2021-22,12837,3010,9827,76.6,81,60,74.1
11,All Students,2022-23,13502,2657,10845,80.3,88,49,55.7
12,All Students,2018-19,13299,2422,10877,81.8,83,58,69.9
12,All Students,2019-20,10878,1522,9356,86.0,100,55,55.0
12,All Students,2020-21,10358,1975,8383,80.9,61,45,73.8
12,All Students,2021-22,11685,3468,8217,70.3,73,65,89.0
12,All Students,2022-23,11169,2907,8262,74.0,72,54,75.0
All Grades,All Students,2018-19,52368,7687,44681,85.3,333,157,47.1
All Grades,All Students,2019-20,35214,4761,30453,86.5,328,146,44.5
All Grades,All Students,2020-21,59080,7179,51901,87.8,350,156,44.6
All Grades,All Students,2021-22,55960,11495,44465,79.5,344,201,58.4
All Grades,All Students,2022-23,46836,9330,37506,80.1,309,175,56.6
8,All Students,2022-23,4,s,s,s,s,s,s
9,All Students,2018-19,18935,2938,15997,84.5,118,50,42.4
9,All Students,2019-20,11713,1871,9842,84.0,111,51,45.9
9,All Students,2020-21,19199,2337,16862,87.8,114,49,43.0
9,All Students,2021-22,14846,2615,12231,82.4,93,43,46.2
9,All Students,2022-23,10951,s,s,s,s,s,s
10,All Students,2018-19,12649,1937,10712,84.7,84,45,53.6
10,All Students,2019-20,10014,1188,8826,88.1,93,33,35.5
10,All Students,2020-21,16120,1867,14253,88.4,95,43,45.3
10,All Students,2021-22,15020,2952,12068,80.3,92,55,59.8
10,All Students,2022-23,12345,2287,10058,81.5,84,46,54.8
11,All Students,2018-19,11732,1657,10075,85.9,76,33,43.4
11,All Students,2019-20,6696,915,5781,86.3,62,33,53.2
11,All Students,2020-21,13775,1398,12377,89.9,82,29,35.4
11,All Students,2021-22,13417,3135,10282,76.6,83,55,66.3
11,All Students,2022-23,12454,2708,9746,78.3,84,51,60.7
12,All Students,2018-19,9052,1155,7897,87.2,55,29,52.7
12,All Students,2019-20,6791,787,6004,88.4,62,29,46.8
12,All Students,2020-21,9986,1577,8409,84.2,59,35,59.3
12,All Students,2021-22,12677,2793,9884,78.0,76,48,63.2
12,All Students,2022-23,11082,2168,8914,80.4,69,42,60.9
All Grades,All Students,2018-19,48846,6264,42582,87.2,304,136,44.7
All Grades,All Students,2019-20,34278,5252,29026,84.7,322,160,49.7
All Grades,All Students,2020-21,58742,9413,49329,84.0,341,185,54.3
All Grades,All Students,2021-22,55636,11886,43750,78.6,354,236,66.7
All Grades,All Students,2022-23,52496,11133,41363,78.8,332,205,61.7
9,All Students,2018-19,16420,2838,13582,82.7,102,56,54.9
9,All Students,2019-20,11793,1770,10023,85.0,112,52,46.4
9,All Students,2020-21,19027,3369,15658,82.3,111,60,54.1
9,All Students,2021-22,15129,2397,12732,84.2,96,47,49.0
9,All Students,2022-23,12203,2437,9766,80.0,77,45,58.4
10,All Students,2018-19,12351,1444,10907,88.3,78,31,39.7
10,All Students,2019-20,8328,1558,6770,81.3,81,44,54.3
10,All Students,2020-21,18316,2897,15419,84.2,107,55,51.4
10,All Students,2021-22,16426,3809,12617,76.8,108,72,66.7
10,All Students,2022-23,14664,2941,11723,79.9,92,53,57.6
11,All Students,2018-19,11015,921,10094,91.6,71,23,32.4
11,All Students,2019-20,7123,1115,6008,84.3,65,36,55.4
11,All Students,2020-21,10724,1572,9152,85.3,62,33,53.2
11,All Students,2021-22,13037,2808,10229,78.5,81,59,72.8
11,All Students,2022-23,12213,2533,9680,79.3,79,47,59.5
12,All Students,2018-19,9060,1061,7999,88.3,53,26,49.1
12,All Students,2019-20,7034,809,6225,88.5,64,28,43.8
12,All Students,2020-21,10675,1575,9100,85.2,61,37,60.7
12,All Students,2021-22,11044,2872,8172,74.0,69,58,84.1
12,All Students,2022-23,13416,3222,10194,76.0,84,60,71.4
All Grades,All Students,2018-19,100161,1792,98369,98.2,565,12,2.1
All Grades,All Students,2019-20,69269,1455,67814,97.9,606,16,2.6
All Grades,All Students,2020-21,99712,1502,98210,98.5,574,8,1.4
All Grades,All Students,2021-22,94386,3330,91056,96.5,542,41,7.6
All Grades,All Students,2022-23,92540,3746,88794,96.0,538,43,8.0
6,All Students,2018-19,35023,630,34393,98.2,197,2,1.0
6,All Students,2019-20,27708,715,26993,97.4,243,8,3.3
6,All Students,2020-21,30450,421,30029,98.6,175,3,1.7
6,All Students,2021-22,31190,1074,30116,96.6,180,10,5.6
6,All Students,2022-23,32711,1090,31621,96.7,191,14,7.3
7,All Students,2018-19,31980,431,31549,98.7,181,4,2.2
7,All Students,2019-20,20842,262,20580,98.7,182,3,1.6
7,All Students,2020-21,37624,523,37101,98.6,217,3,1.4
7,All Students,2021-22,26885,854,26031,96.8,155,12,7.7
7,All Students,2022-23,32424,1166,31258,96.4,190,13,6.8
8,All Students,2018-19,33158,731,32427,97.8,187,6,3.2
8,All Students,2019-20,20719,478,20241,97.7,181,5,2.8
8,All Students,2020-21,31638,558,31080,98.2,182,2,1.1
8,All Students,2021-22,36311,1402,34909,96.1,207,19,9.2
8,All Students,2022-23,27405,1490,25915,94.6,157,16,10.2
All Grades,All Students,2018-19,29916,5632,24284,81.2,194,102,52.6
All Grades,All Students,2019-20,19356,4259,15097,78.0,177,104,58.8
All Grades,All Students,2020-21,24715,7490,17225,69.7,146,99,67.8
All Grades,All Students,2021-22,18948,4179,14769,77.9,121,85,70.2
All Grades,All Students,2022-23,14038,2702,11336,80.8,95,69,72.6
9,All Students,2018-19,8139,1931,6208,76.3,54,31,57.4
9,All Students,2019-20,5697,1501,4196,73.7,53,34,64.2
9,All Students,2020-21,6241,2586,3655,58.6,38,29,76.3
9,All Students,2021-22,5202,831,4371,84.0,34,14,41.2
9,All Students,2022-23,2655,565,2090,78.7,21,15,71.4
10,All Students,2018-19,7065,1302,5763,81.6,46,25,54.3
10,All Students,2019-20,5043,996,4047,80.2,46,25,54.3
10,All Students,2020-21,6992,2103,4889,69.9,42,30,71.4
10,All Students,2021-22,2852,560,2292,80.4,19,16,84.2
10,All Students,2022-23,4492,534,3958,88.1,30,14,46.7
11,All Students,2018-19,8000,1336,6664,83.3,52,23,44.2
11,All Students,2019-20,3498,761,2737,78.2,32,15,46.9
11,All Students,2020-21,6306,1340,4966,78.8,36,24,66.7
11,All Students,2021-22,4984,1019,3965,79.6,32,25,78.1
11,All Students,2022-23,2116,423,1693,80.0,15,14,93.3
12,All Students,2018-19,6712,1063,5649,84.2,42,23,54.8
12,All Students,2019-20,5118,1001,4117,80.4,46,30,65.2
12,All Students,2020-21,5176,1461,3715,71.8,30,16,53.3
12,All Students,2021-22,5910,1769,4141,70.1,36,30,83.3
12,All Students,2022-23,4775,1180,3595,75.3,29,26,89.7
All Grades,All Students,2018-19,60147,3242,56905,94.6,346,46,13.3
All Grades,All Students,2019-20,46016,2495,43521,94.6,408,50,12.3
All Grades,All Students,2020-21,61721,2114,59607,96.6,365,34,9.3
All Grades,All Students,2021-22,59856,3968,55888,93.4,352,70,19.9
All Grades,All Students,2022-23,61070,5850,55220,90.4,369,126,34.1
PK in K-12 Schools,All Students,2018-19,12594,937,11657,92.6,73,18,24.7
PK in K-12 Schools,All Students,2019-20,8204,486,7718,94.1,73,10,13.7
PK in K-12 Schools,All Students,2020-21,9266,898,8368,90.3,55,23,41.8
PK in K-12 Schools,All Students,2021-22,12516,1210,11306,90.3,73,30,41.1
PK in K-12 Schools,All Students,2022-23,12648,1347,11301,89.4,72,30,41.7
0K,All Students,2018-19,13194,844,12350,93.6,75,12,16.0
0K,All Students,2019-20,8074,579,7495,92.8,72,15,20.8
0K,All Students,2020-21,10174,210,9964,97.9,60,1,1.7
0K,All Students,2021-22,8670,538,8132,93.8,50,9,18.0
0K,All Students,2022-23,7979,959,7020,88.0,52,27,51.9
1,All Students,2018-19,10116,575,9541,94.3,59,9,15.3
1,All Students,2019-20,7754,463,7291,94.0,68,11,16.2
1,All Students,2020-21,8436,218,8218,97.4,52,3,5.8
1,All Students,2021-22,8213,411,7802,95.0,49,4,8.2
1,All Students,2022-23,9524,949,8575,90.0,56,18,32.1
2,All Students,2018-19,10469,367,10102,96.5,60,2,3.3
2,All Students,2019-20,6336,370,5966,94.2,57,8,14.0
2,All Students,2020-21,10867,353,10514,96.8,63,3,4.8
2,All Students,2021-22,6738,451,6287,93.3,41,9,22.0
2,All Students,2022-23,8831,543,8288,93.9,54,9,16.7
3,All Students,2018-19,7525,379,7146,95.0,43,4,9.3
3,All Students,2019-20,6766,296,6470,95.6,59,3,5.1
3,All Students,2020-21,8279,171,8108,97.9,50,2,4.0
3,All Students,2021-22,9148,457,8691,95.0,54,6,11.1
3,All Students,2022-23,5460,490,4970,91.0,33,7,21.2
4,All Students,2018-19,6249,140,6109,97.8,36,1,2.8
4,All Students,2019-20,4869,144,4725,97.0,44,1,2.3
4,All Students,2020-21,7897,129,7768,98.4,46,1,2.2
4,All Students,2021-22,7371,463,6908,93.7,43,6,14.0
4,All Students,2022-23,7991,630,7361,92.1,47,10,21.3
5,All Students,2019-20,4013,157,3856,96.1,35,2,5.7
5,All Students,2020-21,6802,135,6667,98.0,39,1,2.6
5,All Students,2021-22,7200,438,6762,93.9,42,6,14.3
5,All Students,2022-23,8637,932,7705,89.2,55,25,45.5
All Grades,All Students,2018-19,82392,3591,78801,95.6,485,34,7.0
All Grades,All Students,2019-20,52683,2524,50159,95.2,474,47,9.9
All Grades,All Students,2020-21,72746,2077,70669,97.1,436,33,7.6
All Grades,All Students,2021-22,65379,4810,60569,92.6,388,100,25.8
All Grades,All Students,2022-23,56797,3612,53185,93.6,335,67,20.0
PK in K-12 Schools,All Students,2018-19,6248,362,5886,94.2,37,5,13.5
PK in K-12 Schools,All Students,2019-20,3982,265,3717,93.3,37,8,21.6
PK in K-12 Schools,All Students,2020-21,9585,697,8888,92.7,59,15,25.4
PK in K-12 Schools,All Students,2021-22,8090,814,7276,89.9,48,19,39.6
PK in K-12 Schools,All Students,2022-23,4834,462,4372,90.4,29,14,48.3
0K,All Students,2018-19,17181,1022,16159,94.1,107,11,10.3
0K,All Students,2019-20,9878,567,9311,94.3,90,10,11.1
0K,All Students,2020-21,10911,497,10414,95.4,67,12,17.9
0K,All Students,2021-22,11556,1068,10488,90.8,68,26,38.2
0K,All Students,2022-23,9558,782,8776,91.8,58,14,24.1
1,All Students,2018-19,14620,606,14014,95.9,85,6,7.1
1,All Students,2019-20,8569,491,8078,94.3,77,9,11.7
1,All Students,2020-21,10212,283,9929,97.2,60,3,5.0
1,All Students,2021-22,8135,661,7474,91.9,49,17,34.7
1,All Students,2022-23,10472,767,9705,92.7,61,18,29.5
2,All Students,2018-19,12658,535,12123,95.8,73,4,5.5
2,All Students,2019-20,8668,330,8338,96.2,80,7,8.8
2,All Students,2020-21,9407,124,9283,98.7,58,0,0.0
2,All Students,2021-22,10239,732,9507,92.9,62,16,25.8
2,All Students,2022-23,6687,419,6268,93.7,40,10,25.0
3,All Students,2018-19,12067,537,11530,95.5,70,5,7.1
3,All Students,2019-20,7701,370,7331,95.2,67,5,7.5
3,All Students,2020-21,10733,148,10585,98.6,64,1,1.6
3,All Students,2021-22,7549,445,7104,94.1,45,6,13.3
3,All Students,2022-23,8588,427,8161,95.0,51,4,7.8
4,All Students,2018-19,10492,206,10286,98.0,60,0,0.0
4,All Students,2019-20,7163,178,6985,97.5,63,1,1.6
4,All Students,2020-21,11530,167,11363,98.6,68,1,1.5
4,All Students,2021-22,9475,405,9070,95.7,55,4,7.3
4,All Students,2022-23,7166,403,6763,94.4,41,6,14.6
5,All Students,2018-19,9126,323,8803,96.5,53,3,5.7
5,All Students,2019-20,6722,323,6399,95.2,60,7,11.7
5,All Students,2020-21,10368,161,10207,98.4,60,1,1.7
5,All Students,2021-22,10335,685,9650,93.4,61,12,19.7
5,All Students,2022-23,9492,352,9140,96.3,55,1,1.8
All Grades,All Students,2018-19,35234,3395,31839,90.4,212,93,43.9
All Grades,All Students,2019-20,21244,2077,19167,90.2,196,80,40.8
All Grades,All Students,2020-21,33739,3937,29802,88.3,202,86,42.6
All Grades,All Students,2021-22,32408,4912,27496,84.8,192,123,64.1
All Grades,All Students,2022-23,32038,3333,28705,89.6,198,70,35.4
PK in K-12 Schools,All Students,2018-19,10208,956,9252,90.6,63,25,39.7
PK in K-12 Schools,All Students,2019-20,6894,700,6194,89.8,65,30,46.2
PK in K-12 Schools,All Students,2020-21,8880,1482,7398,83.3,57,31,54.4
PK in K-12 Schools,All Students,2021-22,7578,1010,6568,86.7,47,31,66.0
PK in K-12 Schools,All Students,2022-23,7296,827,6469,88.7,46,19,41.3
0K,All Students,2018-19,3211,363,2848,88.7,19,9,47.4
0K,All Students,2019-20,2300,287,2013,87.5,20,11,55.0
0K,All Students,2020-21,3678,492,3186,86.6,21,12,57.1
0K,All Students,2021-22,3413,611,2802,82.1,20,15,75.0
0K,All Students,2022-23,2209,228,1981,89.7,14,6,42.9
1,All Students,2018-19,3612,382,3230,89.4,21,11,52.4
1,All Students,2019-20,1380,116,1264,91.6,12,4,33.3
1,All Students,2020-21,3156,446,2710,85.9,18,7,38.9
1,All Students,2021-22,3683,614,3069,83.3,21,12,57.1
1,All Students,2022-23,4215,447,3768,89.4,27,7,25.9
2,All Students,2018-19,2240,212,2028,90.5,15,6,40.0
2,All Students,2019-20,2112,187,1925,91.1,19,7,36.8
2,All Students,2020-21,1915,131,1784,93.2,11,2,18.2
2,All Students,2021-22,2649,391,2258,85.2,14,5,35.7
2,All Students,2022-23,3104,358,2746,88.5,19,9,47.4
3,All Students,2018-19,3701,237,3464,93.6,21,3,14.3
3,All Students,2019-20,1186,98,1088,91.7,12,4,33.3
3,All Students,2020-21,3286,337,2949,89.7,19,10,52.6
3,All Students,2021-22,1887,215,1672,88.6,11,6,54.5
3,All Students,2022-23,2839,301,2538,89.4,16,4,25.0
4,All Students,2018-19,2003,205,1798,89.8,13,7,53.8
4,All Students,2019-20,1971,129,1842,93.5,19,3,15.8
4,All Students,2020-21,2121,84,2037,96.0,13,3,23.1
4,All Students,2021-22,3543,567,2976,84.0,21,15,71.4
4,All Students,2022-23,1608,158,1450,90.2,10,4,40.0
5,All Students,2018-19,1736,178,1558,89.7,11,6,54.5
5,All Students,2019-20,1096,87,1009,92.1,10,4,40.0
5,All Students,2020-21,3150,278,2872,91.2,18,5,27.8
5,All Students,2021-22,1578,169,1409,89.3,9,5,55.6
5,All Students,2022-23,3787,397,3390,89.5,23,9,39.1
6,All Students,2018-19,2901,306,2595,89.5,17,10,58.8
6,All Students,2019-20,1449,151,1298,89.6,14,4,28.6
6,All Students,2020-21,2762,223,2539,91.9,16,4,25.0
6,All Students,2021-22,2899,329,2570,88.7,17,9,52.9
6,All Students,2022-23,1829,167,1662,90.9,11,2,18.2
7,All Students,2018-19,1780,225,1555,87.4,10,7,70.0
7,All Students,2019-20,1591,153,1438,90.4,14,7,50.0
7,All Students,2020-21,2100,218,1882,89.6,12,4,33.3
7,All Students,2021-22,2828,424,2404,85.0,17,12,70.6
7,All Students,2022-23,2400,143,2257,94.0,15,3,20.0
8,All Students,2018-19,3842,331,3511,91.4,22,9,40.9
8,All Students,2019-20,1265,169,1096,86.6,11,6,54.5
8,All Students,2020-21,2625,223,2402,91.5,15,7,46.7
8,All Students,2021-22,2350,582,1768,75.2,15,13,86.7
8,All Students,2022-23,2751,307,2444,88.8,17,7,41.2
All Grades,All Students,2018-19,75961,11920,64041,84.3,463,222,47.9
All Grades,All Students,2019-20,48630,5918,42712,87.8,443,168,37.9
All Grades,All Students,2020-21,82849,6375,76474,92.3,484,101,20.9
All Grades,All Students,2021-22,87498,16055,71443,81.7,533,336,63.0
All Grades,All Students,2022-23,83041,12381,70660,85.1,521,277,53.2
9,All Students,2018-19,21882,3405,18477,84.4,131,47,35.9
9,All Students,2019-20,15430,1752,13678,88.6,139,37,26.6
9,All Students,2020-21,31035,1898,29137,93.9,180,31,17.2
9,All Students,2021-22,27503,4189,23314,84.8,168,91,54.2
9,All Students,2022-23,22497,2588,19909,88.5,140,53,37.9
10,All Students,2018-19,18160,2535,15625,86.0,114,53,46.5
10,All Students,2019-20,12597,1350,11247,89.3,116,45,38.8
10,All Students,2020-21,20608,1643,18965,92.0,122,25,20.5
10,All Students,2021-22,26142,5363,20779,79.5,160,112,70.0
10,All Students,2022-23,24804,3476,21328,86.0,155,81,52.3
11,All Students,2018-19,18333,2411,15922,86.8,113,51,45.1
11,All Students,2019-20,8702,835,7867,90.4,82,32,39.0
11,All Students,2020-21,16782,1307,15475,92.2,97,22,22.7
11,All Students,2021-22,18015,3666,14349,79.7,110,73,66.4
11,All Students,2022-23,19880,3272,16608,83.5,128,78,60.9
12,All Students,2018-19,17586,3569,14017,79.7,105,71,67.6
12,All Students,2019-20,11901,1981,9920,83.4,106,54,50.9
12,All Students,2020-21,14412,1524,12888,89.4,84,22,26.2
12,All Students,2021-22,15838,2837,13001,82.1,95,60,63.2
12,All Students,2022-23,15860,3045,12815,80.8,98,65,66.3
All Grades,All Students,2018-19,77064,3943,73121,94.9,469,53,11.3
All Grades,All Students,2019-20,50939,2631,48308,94.8,468,63,13.5
All Grades,All Students,2020-21,80511,6079,74432,92.4,489,100,20.4
All Grades,All Students,2021-22,79274,7568,71706,90.5,470,153,32.6
All Grades,All Students,2022-23,73957,6224,67733,91.6,458,122,26.6
9,All Students,2018-19,21590,647,20943,97.0,131,3,2.3
9,All Students,2019-20,13243,439,12804,96.7,122,10,8.2
9,All Students,2020-21,21564,1764,19800,91.8,130,28,21.5
9,All Students,2021-22,18761,1832,16929,90.2,112,34,30.4
9,All Students,2022-23,19151,1534,17617,92.0,120,30,25.0
10,All Students,2018-19,20608,1012,19596,95.1,125,14,11.2
10,All Students,2019-20,13966,452,13514,96.8,127,4,3.1
10,All Students,2020-21,19822,1359,18463,93.1,119,21,17.6
10,All Students,2021-22,20818,1620,19198,92.2,123,32,26.0
10,All Students,2022-23,16927,1211,15716,92.8,104,24,23.1
11,All Students,2018-19,16754,788,15966,95.3,102,11,10.8
11,All Students,2019-20,13060,808,12252,93.8,120,21,17.5
11,All Students,2020-21,20716,1591,19125,92.3,124,26,21.0
11,All Students,2021-22,19635,2028,17607,89.7,117,37,31.6
11,All Students,2022-23,19919,1557,18362,92.2,124,29,23.4
12,All Students,2018-19,18112,1496,16616,91.7,111,25,22.5
12,All Students,2019-20,10670,932,9738,91.3,99,28,28.3
12,All Students,2020-21,18409,1365,17044,92.6,116,25,21.6
12,All Students,2021-22,20060,2088,17972,89.6,118,50,42.4
12,All Students,2022-23,17960,1922,16038,89.3,110,39,35.5
All Grades,All Students,2022-23,81530,10424,71106,87.2,566,298,52.7
PK in K-12 Schools,All Students,2022-23,81519,s,s,s,s,s,s
0K,All Students,2022-23,11,s,s,s,s,s,s
All Grades,All Students,2018-19,68871,10306,58565,85.0,437,207,47.4
All Grades,All Students,2019-20,44347,6249,38098,85.9,415,166,40.0
All Grades,All Students,2020-21,65898,8863,57035,86.6,409,136,33.3
All Grades,All Students,2021-22,66237,15360,50877,76.8,409,313,76.5
All Grades,All Students,2022-23,61575,9165,52410,85.1,402,207,51.5
9,All Students,2018-19,17243,2520,14723,85.4,117,57,48.7
9,All Students,2019-20,11022,1500,9522,86.4,105,41,39.0
9,All Students,2020-21,18546,2823,15723,84.8,115,47,40.9
9,All Students,2021-22,17877,3037,14840,83.0,111,70,63.1
9,All Students,2022-23,16470,2200,14270,86.6,110,49,44.5
10,All Students,2018-19,19531,2715,16816,86.1,122,60,49.2
10,All Students,2019-20,10821,1155,9666,89.3,103,36,35.0
10,All Students,2020-21,15190,2095,13095,86.2,97,34,35.1
10,All Students,2021-22,17457,3843,13614,78.0,112,83,74.1
10,All Students,2022-23,15990,1966,14024,87.7,107,54,50.5
11,All Students,2018-19,17176,2693,14483,84.3,105,45,42.9
11,All Students,2019-20,12057,1828,10229,84.8,112,46,41.1
11,All Students,2020-21,15883,2226,13657,86.0,98,29,29.6
11,All Students,2021-22,15130,3311,11819,78.1,93,76,81.7
11,All Students,2022-23,15058,2349,12709,84.4,97,48,49.5
12,All Students,2018-19,14921,2378,12543,84.1,93,45,48.4
12,All Students,2019-20,10447,1766,8681,83.1,95,43,45.3
12,All Students,2020-21,16279,1719,14560,89.4,99,26,26.3
12,All Students,2021-22,15773,5169,10604,67.2,93,84,90.3
12,All Students,2022-23,14057,2650,11407,81.1,88,56,63.6
All Grades,All Students,2018-19,71238,10490,60748,85.3,445,224,50.3
All Grades,All Students,2019-20,47069,7583,39486,83.9,444,257,57.9
All Grades,All Students,2020-21,76896,15981,60915,79.2,458,219,47.8
All Grades,All Students,2021-22,77120,14784,62336,80.8,482,304,63.1
All Grades,All Students,2022-23,69549,13603,55946,80.4,457,310,67.8
9,All Students,2018-19,21997,3609,18388,83.6,139,80,57.6
9,All Students,2019-20,14007,2107,11900,85.0,136,74,54.4
9,All Students,2020-21,25606,4782,20824,81.3,153,67,43.8
9,All Students,2021-22,24950,5276,19674,78.9,161,101,62.7
9,All Students,2022-23,19522,4624,14898,76.3,132,95,72.0
10,All Students,2018-19,18940,3081,15859,83.7,120,56,46.7
10,All Students,2019-20,13268,2481,10787,81.3,122,76,62.3
10,All Students,2020-21,19141,3316,15825,82.7,116,50,43.1
10,All Students,2021-22,20346,3545,16801,82.6,127,79,62.2
10,All Students,2022-23,19042,3494,15548,81.7,129,78,60.5
11,All Students,2018-19,16545,1775,14770,89.3,102,39,38.2
11,All Students,2019-20,10078,1545,8533,84.7,95,58,61.1
11,All Students,2020-21,16810,4236,12574,74.8,98,47,48.0
11,All Students,2021-22,16843,2730,14113,83.8,105,58,55.2
11,All Students,2022-23,16514,2717,13797,83.5,106,68,64.2
12,All Students,2018-19,13756,2025,11731,85.3,84,49,58.3
12,All Students,2019-20,9716,1450,8266,85.1,91,49,53.8
12,All Students,2020-21,15339,3647,11692,76.2,91,55,60.4
12,All Students,2021-22,14981,3233,11748,78.4,89,66,74.2
12,All Students,2022-23,14471,2768,11703,80.9,90,69,76.7
All Grades,All Students,2018-19,99073,4927,94146,95.0,577,62,10.7
All Grades,All Students,2019-20,64333,3383,60950,94.7,574,81,14.1
All Grades,All Students,2020-21,84776,4006,80770,95.3,510,54,10.6
All Grades,All Students,2021-22,77135,5195,71940,93.3,456,90,19.7
All Grades,All Students,2022-23,76186,5233,70953,93.1,447,80,17.9
PK in K-12 Schools,All Students,2018-19,3204,153,3051,95.2,18,1,5.6
PK in K-12 Schools,All Students,2019-20,2070,152,1918,92.7,18,6,33.3
PK in K-12 Schools,All Students,2020-21,2990,119,2871,96.0,18,0,0.0
PK in K-12 Schools,All Students,2021-22,3051,272,2779,91.1,20,4,20.0
PK in K-12 Schools,All Students,2022-23,3186,249,2937,92.2,18,3,16.7
0K,All Students,2018-19,11855,721,11134,93.9,70,12,17.1
0K,All Students,2019-20,7570,554,7016,92.7,71,17,23.9
0K,All Students,2020-21,9774,653,9121,93.3,60,7,11.7
0K,All Students,2021-22,7843,522,7321,93.3,47,12,25.5
0K,All Students,2022-23,8218,662,7556,91.9,50,16,32.0
1,All Students,2018-19,11756,662,11094,94.4,70,10,14.3
1,All Students,2019-20,6827,396,6431,94.2,60,10,16.7
1,All Students,2020-21,8752,364,8388,95.8,55,5,9.1
1,All Students,2021-22,8415,586,7829,93.0,50,9,18.0
1,All Students,2022-23,7117,464,6653,93.5,43,6,14.0
2,All Students,2018-19,11329,451,10878,96.0,66,1,1.5
2,All Students,2019-20,7071,351,6720,95.0,62,8,12.9
2,All Students,2020-21,8119,224,7895,97.2,48,3,6.3
2,All Students,2021-22,7321,625,6696,91.5,42,13,31.0
2,All Students,2022-23,7353,497,6856,93.2,43,8,18.6
3,All Students,2018-19,11079,471,10608,95.7,63,4,6.3
3,All Students,2019-20,6558,283,6275,95.7,57,2,3.5
3,All Students,2020-21,8774,399,8375,95.5,54,5,9.3
3,All Students,2021-22,8045,399,7646,95.0,48,7,14.6
3,All Students,2022-23,6303,436,5867,93.1,37,7,18.9
4,All Students,2018-19,9507,366,9141,96.2,56,3,5.4
4,All Students,2019-20,6959,221,6738,96.8,63,3,4.8
4,All Students,2020-21,7982,276,7706,96.5,50,3,6.0
4,All Students,2021-22,7370,288,7082,96.1,44,3,6.8
4,All Students,2022-23,8439,501,7938,94.1,48,8,16.7
5,All Students,2018-19,8009,415,7594,94.8,46,2,4.3
5,All Students,2019-20,6609,405,6204,93.9,58,12,20.7
5,All Students,2020-21,8729,299,8430,96.6,52,2,3.8
5,All Students,2021-22,7340,469,6871,93.6,43,9,20.9
5,All Students,2022-23,7195,547,6648,92.4,43,3,7.0
6,All Students,2018-19,10961,500,10461,95.4,64,8,12.5
6,All Students,2019-20,6631,301,6330,95.5,61,8,13.1
6,All Students,2020-21,9629,340,9289,96.5,56,4,7.1
6,All Students,2021-22,9683,538,9145,94.4,56,8,14.3
6,All Students,2022-23,10744,622,10122,94.2,62,10,16.1
7,All Students,2018-19,10749,462,10287,95.7,62,7,11.3
7,All Students,2019-20,7138,257,6881,96.4,64,6,9.4
7,All Students,2020-21,10026,579,9447,94.2,59,11,18.6
7,All Students,2021-22,8815,588,8227,93.3,52,8,15.4
7,All Students,2022-23,9750,669,9081,93.1,56,11,19.6
8,All Students,2018-19,10624,726,9898,93.2,62,14,22.6
8,All Students,2019-20,6900,463,6437,93.3,60,9,15.0
8,All Students,2020-21,10001,753,9248,92.5,58,14,24.1
8,All Students,2021-22,9252,908,8344,90.2,54,17,31.5
8,All Students,2022-23,7881,586,7295,92.6,47,8,17.0
All Grades,All Students,2018-19,49033,8122,40911,83.4,311,148,47.6
All Grades,All Students,2019-20,29884,4857,25027,83.7,292,115,39.4
All Grades,All Students,2020-21,41261,10888,30373,73.6,241,143,59.3
All Grades,All Students,2021-22,34949,7702,27247,78.0,224,143,63.8
All Grades,All Students,2022-23,23438,5803,17635,75.2,157,101,64.3
9,All Students,2018-19,16431,1823,14608,88.9,102,32,31.4
9,All Students,2019-20,8163,757,7406,90.7,81,23,28.4
9,All Students,2020-21,7503,1168,6335,84.4,45,23,51.1
9,All Students,2021-22,4898,626,4272,87.2,32,12,37.5
9,All Students,2022-23,3279,713,2566,78.3,26,16,61.5
10,All Students,2018-19,7561,1483,6078,80.4,50,29,58.0
10,All Students,2019-20,9298,1765,7533,81.0,91,43,47.3
10,All Students,2020-21,11876,2947,8929,75.2,68,42,61.8
10,All Students,2021-22,7612,1421,6191,81.3,50,31,62.0
10,All Students,2022-23,4319,861,3458,80.1,27,12,44.4
11,All Students,2018-19,11400,2008,9392,82.4,72,32,44.4
11,All Students,2019-20,4713,893,3820,81.1,47,19,40.4
11,All Students,2020-21,13210,3640,9570,72.4,76,43,56.6
11,All Students,2021-22,10693,2529,8164,76.3,69,54,78.3
11,All Students,2022-23,6848,1614,5234,76.4,43,25,58.1
12,All Students,2018-19,13641,2808,10833,79.4,87,55,63.2
12,All Students,2019-20,7710,1442,6268,81.3,73,30,41.1
12,All Students,2020-21,8672,3133,5539,63.9,52,35,67.3
12,All Students,2021-22,11746,3126,8620,73.4,73,46,63.0
12,All Students,2022-23,8992,2615,6377,70.9,61,48,78.7
All Grades,All Students,2018-19,185268,25303,159965,86.3,1169,419,35.8
All Grades,All Students,2019-20,123835,14568,109267,88.2,1160,399,34.4
All Grades,All Students,2020-21,204032,20445,183587,90.0,1189,284,23.9
All Grades,All Students,2021-22,184164,37092,147072,79.9,1128,649,57.5
All Grades,All Students,2022-23,173001,26402,146599,84.7,1105,487,44.1
9,All Students,2018-19,47985,3711,44274,92.3,301,68,22.6
9,All Students,2019-20,30982,3009,27973,90.3,295,86,29.2
9,All Students,2020-21,56565,2547,54018,95.5,328,35,10.7
9,All Students,2021-22,41563,5816,35747,86.0,259,117,45.2
9,All Students,2022-23,40110,4743,35367,88.2,262,96,36.6
10,All Students,2018-19,52112,5943,46169,88.6,331,97,29.3
10,All Students,2019-20,33356,3746,29610,88.8,313,109,34.8
10,All Students,2020-21,48368,5949,42419,87.7,282,74,26.2
10,All Students,2021-22,53921,7290,46631,86.5,324,144,44.4
10,All Students,2022-23,41667,5649,36018,86.4,270,100,37.0
11,All Students,2018-19,44080,6273,37807,85.8,283,113,39.9
11,All Students,2019-20,32593,3613,28980,88.9,302,91,30.1
11,All Students,2020-21,50912,6913,43999,86.4,296,97,32.8
11,All Students,2021-22,42539,9322,33217,78.1,266,161,60.5
11,All Students,2022-23,50795,5716,45079,88.7,321,113,35.2
12,All Students,2018-19,41091,9376,31715,77.2,254,141,55.5
12,All Students,2019-20,26904,4200,22704,84.4,250,113,45.2
12,All Students,2020-21,48184,5033,43151,89.6,283,78,27.6
12,All Students,2021-22,46141,14664,31477,68.2,279,227,81.4
12,All Students,2022-23,40429,10294,30135,74.5,252,178,70.6
All Grades,All Students,2018-19,82933,5323,77610,93.6,486,63,13.0
All Grades,All Students,2019-20,54387,3397,50990,93.8,488,65,13.3
All Grades,All Students,2020-21,85904,4213,81691,95.1,496,62,12.5
All Grades,All Students,2021-22,85803,5965,79838,93.0,502,95,18.9
All Grades,All Students,2022-23,84803,6626,78177,92.2,495,99,20.0
6,All Students,2018-19,11682,350,11332,97.0,66,2,3.0
6,All Students,2019-20,7643,240,7403,96.9,67,2,3.0
6,All Students,2020-21,11856,370,11486,96.9,69,3,4.3
6,All Students,2021-22,10197,547,9650,94.6,62,7,11.3
6,All Students,2022-23,10460,833,9627,92.0,63,10,15.9
7,All Students,2018-19,12503,550,11953,95.6,71,5,7.0
7,All Students,2019-20,7820,339,7481,95.7,70,5,7.1
7,All Students,2020-21,12135,201,11934,98.3,70,2,2.9
7,All Students,2021-22,12284,668,11616,94.6,72,8,11.1
7,All Students,2022-23,11274,581,10693,94.8,67,10,14.9
8,All Students,2018-19,12590,660,11930,94.8,72,6,8.3
8,All Students,2019-20,8664,497,8167,94.3,76,10,13.2
8,All Students,2020-21,12420,477,11943,96.2,72,7,9.7
8,All Students,2021-22,12818,837,11981,93.5,74,12,16.2
8,All Students,2022-23,13339,842,12497,93.7,76,10,13.2
9,All Students,2018-19,11148,506,10642,95.5,68,7,10.3
9,All Students,2019-20,7392,348,7044,95.3,69,8,11.6
9,All Students,2020-21,13634,861,12773,93.7,79,14,17.7
9,All Students,2021-22,12285,878,11407,92.9,71,15,21.1
9,All Students,2022-23,12168,851,11317,93.0,70,9,12.9
10,All Students,2018-19,12085,1012,11073,91.6,73,14,19.2
10,All Students,2019-20,7508,488,7020,93.5,70,13,18.6
10,All Students,2020-21,11983,631,11352,94.7,70,12,17.1
10,All Students,2021-22,13972,1317,12655,90.6,82,22,26.8
10,All Students,2022-23,11553,1073,10480,90.7,70,23,32.9
11,All Students,2018-19,11278,1049,10229,90.7,68,17,25.0
11,All Students,2019-20,7886,564,7322,92.8,71,13,18.3
11,All Students,2020-21,11537,583,10954,94.9,66,8,12.1
11,All Students,2021-22,12560,905,11655,92.8,74,18,24.3
11,All Students,2022-23,14300,1325,12975,90.7,82,20,24.4
12,All Students,2018-19,11647,1196,10451,89.7,68,12,17.6
12,All Students,2019-20,7474,921,6553,87.7,65,14,21.5
12,All Students,2020-21,12339,1090,11249,91.2,70,16,22.9
12,All Students,2021-22,11687,813,10874,93.0,67,13,19.4
12,All Students,2022-23,11709,1121,10588,90.4,67,17,25.4
All Grades,All Students,2018-19,95452,5983,89469,93.7,567,99,17.5
All Grades,All Students,2019-20,64009,5082,58927,92.1,584,144,24.7
All Grades,All Students,2020-21,97643,3420,94223,96.5,569,56,9.8
All Grades,All Students,2021-22,96336,9063,87273,90.6,564,187,33.2
All Grades,All Students,2022-23,86740,9151,77589,89.5,545,200,36.7
6,All Students,2018-19,5467,287,5180,94.8,32,4,12.5
6,All Students,2019-20,3876,201,3675,94.8,34,4,11.8
6,All Students,2020-21,4807,85,4722,98.2,28,1,3.6
6,All Students,2021-22,4872,441,4431,90.9,28,8,28.6
6,All Students,2022-23,5213,446,4767,91.4,30,8,26.7
7,All Students,2018-19,9979,529,9450,94.7,58,10,17.2
7,All Students,2019-20,3420,142,3278,95.8,30,1,3.3
7,All Students,2020-21,5730,93,5637,98.4,33,1,3.0
7,All Students,2021-22,5198,313,4885,94.0,30,3,10.0
7,All Students,2022-23,4861,412,4449,91.5,30,7,23.3
8,All Students,2018-19,6231,312,5919,95.0,36,4,11.1
8,All Students,2019-20,6037,424,5613,93.0,53,11,20.8
8,All Students,2020-21,5476,59,5417,98.9,33,1,3.0
8,All Students,2021-22,5250,486,4764,90.7,30,6,20.0
8,All Students,2022-23,5658,536,5122,90.5,33,8,24.2
9,All Students,2018-19,20250,867,19383,95.7,121,13,10.7
9,All Students,2019-20,13812,807,13005,94.2,127,19,15.0
9,All Students,2020-21,23956,759,23197,96.8,141,10,7.1
9,All Students,2021-22,20073,1532,18541,92.4,117,30,25.6
9,All Students,2022-23,16595,1318,15277,92.1,108,28,25.9
10,All Students,2018-19,16704,964,15740,94.2,99,16,16.2
10,All Students,2019-20,13306,1031,12275,92.3,124,33,26.6
10,All Students,2020-21,20697,664,20033,96.8,120,9,7.5
10,All Students,2021-22,21147,2273,18874,89.3,127,54,42.5
10,All Students,2022-23,17893,1802,16091,89.9,114,38,33.3
11,All Students,2018-19,19980,1231,18749,93.8,120,19,15.8
11,All Students,2019-20,11043,987,10056,91.1,102,30,29.4
11,All Students,2020-21,20233,795,19438,96.1,117,14,12.0
11,All Students,2021-22,19779,1659,18120,91.6,116,34,29.3
11,All Students,2022-23,18545,2304,16241,87.6,119,50,42.0
12,All Students,2018-19,16841,1793,15048,89.4,101,33,32.7
12,All Students,2019-20,12515,1490,11025,88.1,114,46,40.4
12,All Students,2020-21,16744,965,15779,94.2,97,20,20.6
12,All Students,2021-22,20017,2359,17658,88.2,116,52,44.8
12,All Students,2022-23,17975,2333,15642,87.0,111,61,55.0
All Grades,All Students,2018-19,79289,2989,76300,96.2,476,40,8.4
All Grades,All Students,2019-20,53660,2318,51342,95.7,491,49,10.0
All Grades,All Students,2020-21,83315,3244,80071,96.1,496,43,8.7
All Grades,All Students,2021-22,81750,4880,76870,94.0,483,85,17.6
All Grades,All Students,2022-23,79815,5931,73884,92.6,490,111,22.7
9,All Students,2018-19,19946,423,19523,97.9,120,2,1.7
9,All Students,2019-20,13295,492,12803,96.3,122,6,4.9
9,All Students,2020-21,20538,765,19773,96.3,125,11,8.8
9,All Students,2021-22,21667,1084,20583,95.0,128,16,12.5
9,All Students,2022-23,19270,1274,17996,93.4,118,23,19.5
10,All Students,2018-19,21208,671,20537,96.8,127,5,3.9
10,All Students,2019-20,13418,506,12912,96.2,123,8,6.5
10,All Students,2020-21,21079,711,20368,96.6,126,10,7.9
10,All Students,2021-22,20485,933,19552,95.4,121,11,9.1
10,All Students,2022-23,20494,1473,19021,92.8,128,31,24.2
11,All Students,2018-19,19296,572,18724,97.0,116,8,6.9
11,All Students,2019-20,14324,580,13744,96.0,131,12,9.2
11,All Students,2020-21,20232,657,19575,96.8,119,6,5.0
11,All Students,2021-22,20221,1153,19068,94.3,120,18,15.0
11,All Students,2022-23,20494,1299,19195,93.7,125,23,18.4
12,All Students,2018-19,18839,1323,17516,93.0,113,25,22.1
12,All Students,2019-20,12623,740,11883,94.1,115,23,20.0
12,All Students,2020-21,21466,1111,20355,94.8,126,16,12.7
12,All Students,2021-22,19377,1710,17667,91.2,114,40,35.1
12,All Students,2022-23,19557,1885,17672,90.4,119,34,28.6
All Grades,All Students,2018-19,78461,4562,73899,94.2,474,69,14.6
All Grades,All Students,2019-20,56510,2432,54078,95.7,522,62,11.9
All Grades,All Students,2020-21,84445,2982,81463,96.5,486,41,8.4
All Grades,All Students,2021-22,82570,9093,73477,89.0,491,213,43.4
All Grades,All Students,2022-23,76382,5706,70676,92.5,470,116,24.7
9,All Students,2018-19,18496,545,17951,97.1,113,3,2.7
9,All Students,2019-20,17570,472,17098,97.3,162,6,3.7
9,All Students,2020-21,18862,339,18523,98.2,109,4,3.7
9,All Students,2021-22,20343,1649,18694,91.9,120,37,30.8
9,All Students,2022-23,16712,939,15773,94.4,104,12,11.5
10,All Students,2018-19,19631,1056,18575,94.6,119,13,10.9
10,All Students,2019-20,12867,511,12356,96.0,119,13,10.9
10,All Students,2020-21,26777,673,26104,97.5,153,8,5.2
10,All Students,2021-22,17774,1326,16448,92.5,107,27,25.2
10,All Students,2022-23,18805,1107,17698,94.1,115,23,20.0
11,All Students,2018-19,21701,1109,20592,94.9,131,15,11.5
11,All Students,2019-20,12117,581,11536,95.2,113,12,10.6
11,All Students,2020-21,19762,394,19368,98.0,115,6,5.2
11,All Students,2021-22,24971,2575,22396,89.7,148,57,38.5
11,All Students,2022-23,16920,1055,15865,93.8,104,15,14.4
12,All Students,2018-19,18633,1852,16781,90.1,111,38,34.2
12,All Students,2019-20,13956,868,13088,93.8,128,31,24.2
12,All Students,2020-21,19044,1576,17468,91.7,109,23,21.1
12,All Students,2021-22,19482,3543,15939,81.8,116,92,79.3
12,All Students,2022-23,23945,2605,21340,89.1,147,66,44.9
All Grades,All Students,2018-19,130531,5773,124758,95.6,756,82,10.8
All Grades,All Students,2019-20,81662,3787,77875,95.4,724,80,11.0
All Grades,All Students,2020-21,127611,8501,119110,93.3,736,136,18.5
All Grades,All Students,2021-22,126924,8648,118276,93.2,733,127,17.3
All Grades,All Students,2022-23,126120,8531,117589,93.2,750,145,19.3
6,All Students,2018-19,17885,595,17290,96.7,102,7,6.9
6,All Students,2019-20,10628,326,10302,96.9,94,4,4.3
6,All Students,2020-21,18990,623,18367,96.7,109,10,9.2
6,All Students,2021-22,17897,1074,16823,94.0,105,12,11.4
6,All Students,2022-23,16041,1109,14932,93.1,93,22,23.7
7,All Students,2018-19,17250,446,16804,97.4,97,4,4.1
7,All Students,2019-20,10891,356,10535,96.7,96,7,7.3
7,All Students,2020-21,15702,782,14920,95.0,92,13,14.1
7,All Students,2021-22,17880,846,17034,95.3,102,8,7.8
7,All Students,2022-23,17889,1000,16889,94.4,104,14,13.5
8,All Students,2018-19,18721,628,18093,96.6,106,8,7.5
8,All Students,2019-20,10758,401,10357,96.3,96,5,5.2
8,All Students,2020-21,16212,583,15629,96.4,93,6,6.5
8,All Students,2021-22,13468,964,12504,92.8,79,13,16.5
8,All Students,2022-23,18332,1043,17289,94.3,105,12,11.4
9,All Students,2018-19,20149,734,19415,96.4,119,8,6.7
9,All Students,2019-20,12766,580,12186,95.5,114,12,10.5
9,All Students,2020-21,20767,1622,19145,92.2,121,27,22.3
9,All Students,2021-22,21084,1780,19304,91.6,121,29,24.0
9,All Students,2022-23,18345,1295,17050,92.9,116,28,24.1
10,All Students,2018-19,18626,1048,17578,94.4,110,12,10.9
10,All Students,2019-20,12614,467,12147,96.3,112,13,11.6
10,All Students,2020-21,19370,1162,18208,94.0,110,14,12.7
10,All Students,2021-22,20808,1123,19685,94.6,120,12,10.0
10,All Students,2022-23,19185,1486,17699,92.3,115,25,21.7
11,All Students,2018-19,19020,791,18229,95.8,111,15,13.5
11,All Students,2019-20,11696,733,10963,93.7,104,18,17.3
11,All Students,2020-21,18730,1581,17149,91.6,109,29,26.6
11,All Students,2021-22,18412,970,17442,94.7,106,15,14.2
11,All Students,2022-23,19189,1071,18118,94.4,115,16,13.9
12,All Students,2018-19,18880,1531,17349,91.9,111,28,25.2
12,All Students,2019-20,12309,924,11385,92.5,108,21,19.4
12,All Students,2020-21,17840,2148,15692,88.0,102,37,36.3
12,All Students,2021-22,17375,1891,15484,89.1,100,38,38.0
12,All Students,2022-23,17139,1527,15612,91.1,102,28,27.5
All Grades,All Students,2018-19,74848,5075,69773,93.2,455,91,20.0
All Grades,All Students,2019-20,49870,3319,46551,93.3,459,81,17.6
All Grades,All Students,2020-21,75510,3828,71682,94.9,442,56,12.7
All Grades,All Students,2021-22,83550,5346,78204,93.6,500,103,20.6
All Grades,All Students,2022-23,82099,2195,79904,97.3,491,20,4.1
9,All Students,2018-19,20853,900,19953,95.7,126,14,11.1
9,All Students,2019-20,12281,638,11643,94.8,117,18,15.4
9,All Students,2020-21,21085,1053,20032,95.0,125,17,13.6
9,All Students,2021-22,28131,1808,26323,93.6,169,32,18.9
9,All Students,2022-23,20625,594,20031,97.1,127,5,3.9
10,All Students,2018-19,19139,1499,17640,92.2,117,23,19.7
10,All Students,2019-20,13158,790,12368,94.0,120,17,14.2
10,All Students,2020-21,16972,879,16093,94.8,99,10,10.1
10,All Students,2021-22,20956,1163,19793,94.5,126,17,13.5
10,All Students,2022-23,24157,648,23509,97.3,144,9,6.3
11,All Students,2018-19,18982,854,18128,95.5,116,13,11.2
11,All Students,2019-20,11891,722,11169,93.9,110,17,15.5
11,All Students,2020-21,19637,738,18899,96.2,115,12,10.4
11,All Students,2021-22,16363,988,15375,94.0,97,18,18.6
11,All Students,2022-23,20661,391,20270,98.1,122,3,2.5
12,All Students,2018-19,15874,1822,14052,88.5,96,41,42.7
12,All Students,2019-20,12540,1169,11371,90.7,112,29,25.9
12,All Students,2020-21,17816,1158,16658,93.5,103,17,16.5
12,All Students,2021-22,18100,1387,16713,92.3,108,36,33.3
12,All Students,2022-23,16656,562,16094,96.6,98,3,3.1
All Grades,All Students,2018-19,87690,2654,85036,97.0,532,27,5.1
All Grades,All Students,2019-20,59443,1797,57646,97.0,544,26,4.8
All Grades,All Students,2020-21,95010,4054,90956,95.7,547,51,9.3
All Grades,All Students,2021-22,91423,5155,86268,94.4,540,80,14.8
All Grades,All Students,2022-23,89287,5068,84219,94.3,545,83,15.2
9,All Students,2018-19,21862,480,21382,97.8,133,2,1.5
9,All Students,2019-20,15102,325,14777,97.8,140,2,1.4
9,All Students,2020-21,24511,671,23840,97.3,141,7,5.0
9,All Students,2021-22,21537,994,20543,95.4,127,13,10.2
9,All Students,2022-23,21847,1310,20537,94.0,135,23,17.0
10,All Students,2018-19,22482,405,22077,98.2,136,1,0.7
10,All Students,2019-20,14831,405,14426,97.3,135,6,4.4
10,All Students,2020-21,24012,944,23068,96.1,138,9,6.5
10,All Students,2021-22,24412,808,23604,96.7,145,8,5.5
10,All Students,2022-23,22104,1008,21096,95.4,136,17,12.5
11,All Students,2018-19,22195,464,21731,97.9,135,1,0.7
11,All Students,2019-20,14811,477,14334,96.8,135,7,5.2
11,All Students,2020-21,23171,912,22259,96.1,134,12,9.0
11,All Students,2021-22,23230,1392,21838,94.0,137,12,8.8
11,All Students,2022-23,22936,784,22152,96.6,139,5,3.6
12,All Students,2018-19,21151,1305,19846,93.8,128,23,18.0
12,All Students,2019-20,14699,590,14109,96.0,134,11,8.2
12,All Students,2020-21,23316,1527,21789,93.5,134,23,17.2
12,All Students,2021-22,22244,1961,20283,91.2,131,47,35.9
12,All Students,2022-23,22400,1966,20434,91.2,135,38,28.1
All Grades,All Students,2018-19,113364,3196,110168,97.2,687,40,5.8
All Grades,All Students,2019-20,74146,1557,72589,97.9,675,28,4.1
All Grades,All Students,2020-21,121690,2912,118778,97.6,700,33,4.7
All Grades,All Students,2021-22,109704,6242,103462,94.3,649,117,18.0
All Grades,All Students,2022-23,107485,4344,103141,96.0,667,55,8.2
9,All Students,2018-19,34930,537,34393,98.5,211,6,2.8
9,All Students,2019-20,16610,239,16371,98.6,151,6,4.0
9,All Students,2020-21,33492,661,32831,98.0,193,6,3.1
9,All Students,2021-22,22949,1084,21865,95.3,137,17,12.4
9,All Students,2022-23,31158,1226,29932,96.1,195,15,7.7
10,All Students,2018-19,27685,433,27252,98.4,167,4,2.4
10,All Students,2019-20,22412,391,22021,98.3,204,8,3.9
10,All Students,2020-21,26050,729,25321,97.2,150,11,7.3
10,All Students,2021-22,31385,1388,29997,95.6,186,19,10.2
10,All Students,2022-23,25810,1209,24601,95.3,162,18,11.1
11,All Students,2018-19,27378,676,26702,97.5,167,8,4.8
11,All Students,2019-20,17377,260,17117,98.5,158,4,2.5
11,All Students,2020-21,34719,547,34172,98.4,200,6,3.0
11,All Students,2021-22,22780,624,22156,97.3,134,8,6.0
11,All Students,2022-23,28790,734,28056,97.5,176,6,3.4
12,All Students,2018-19,23371,1550,21821,93.4,142,22,15.5
12,All Students,2019-20,17747,667,17080,96.2,162,10,6.2
12,All Students,2020-21,27429,975,26454,96.4,157,10,6.4
12,All Students,2021-22,32590,3146,29444,90.3,192,73,38.0
12,All Students,2022-23,21727,1175,20552,94.6,134,16,11.9
All Grades,All Students,2018-19,54397,10760,43637,80.2,340,208,61.2
All Grades,All Students,2019-20,36871,5954,30917,83.9,351,175,49.9
All Grades,All Students,2020-21,59592,18006,41586,69.8,368,305,82.9
All Grades,All Students,2021-22,58154,16437,41717,71.7,364,308,84.6
All Grades,All Students,2022-23,54626,11283,43343,79.3,373,245,65.7
9,All Students,2018-19,12550,2725,9825,78.3,78,40,51.3
9,All Students,2019-20,12982,2232,10750,82.8,124,63,50.8
9,All Students,2020-21,18286,4991,13295,72.7,112,88,78.6
9,All Students,2021-22,14083,3260,10823,76.9,90,66,73.3
9,All Students,2022-23,11704,2318,9386,80.2,93,55,59.1
10,All Students,2018-19,14139,2482,11657,82.4,88,47,53.4
10,All Students,2019-20,7682,1410,6272,81.6,75,44,58.7
10,All Students,2020-21,18301,4742,13559,74.1,112,90,80.4
10,All Students,2021-22,17326,4587,12739,73.5,107,88,82.2
10,All Students,2022-23,14828,2734,12094,81.6,101,61,60.4
11,All Students,2018-19,13008,2175,10833,83.3,83,51,61.4
11,All Students,2019-20,8145,939,7206,88.5,78,32,41.0
11,All Students,2020-21,10573,3555,7018,66.4,67,57,85.1
11,All Students,2021-22,17153,5261,11892,69.3,108,97,89.8
11,All Students,2022-23,14145,3149,10996,77.7,91,63,69.2
12,All Students,2018-19,14700,3378,11322,77.0,91,70,76.9
12,All Students,2019-20,8062,1373,6689,83.0,74,36,48.6
12,All Students,2020-21,12432,4718,7714,62.0,77,70,90.9
12,All Students,2021-22,9592,3329,6263,65.3,59,57,96.6
12,All Students,2022-23,13949,3082,10867,77.9,88,66,75.0
All Grades,All Students,2018-19,300205,23800,276405,92.1,1881,432,23.0
All Grades,All Students,2019-20,200071,15911,184160,92.0,1867,433,23.2
All Grades,All Students,2020-21,300183,59075,241108,80.3,1781,787,44.2
All Grades,All Students,2021-22,286539,36346,250193,87.3,1737,668,38.5
All Grades,All Students,2022-23,255526,23094,232432,91.0,1664,492,29.6
9,All Students,2018-19,81517,7890,73627,90.3,516,125,24.2
9,All Students,2019-20,50698,4797,45901,90.5,481,112,23.3
9,All Students,2020-21,79081,17527,61554,77.8,464,207,44.6
9,All Students,2021-22,70132,10543,59589,85.0,432,183,42.4
9,All Students,2022-23,65570,5813,59757,91.1,448,119,26.6
10,All Students,2018-19,79552,5628,73924,92.9,509,111,21.8
10,All Students,2019-20,54452,4417,50035,91.9,510,118,23.1
10,All Students,2020-21,71683,12199,59484,83.0,428,173,40.4
10,All Students,2021-22,75998,9791,66207,87.1,466,168,36.1
10,All Students,2022-23,64784,6311,58473,90.3,430,141,32.8
11,All Students,2018-19,75543,4739,70804,93.7,462,77,16.7
11,All Students,2019-20,48802,3359,45443,93.1,451,90,20.0
11,All Students,2020-21,77294,14344,62950,81.4,460,191,41.5
11,All Students,2021-22,69941,7948,61993,88.6,419,145,34.6
11,All Students,2022-23,63407,5060,58347,92.0,406,102,25.1
12,All Students,2018-19,63593,5543,58050,91.3,394,119,30.2
12,All Students,2019-20,46119,3338,42781,92.8,425,113,26.6
12,All Students,2020-21,72125,15005,57120,79.2,429,216,50.3
12,All Students,2021-22,70468,8064,62404,88.6,420,172,41.0
12,All Students,2022-23,61765,5910,55855,90.4,380,130,34.2
All Grades,All Students,2018-19,91198,10775,80423,88.2,565,206,36.5
All Grades,All Students,2019-20,64251,7481,56770,88.4,604,232,38.4
All Grades,All Students,2020-21,104704,11921,92783,88.6,619,211,34.1
All Grades,All Students,2021-22,95313,14405,80908,84.9,582,292,50.2
All Grades,All Students,2022-23,82306,11735,70571,85.7,543,237,43.6
6,All Students,2018-19,7221,605,6616,91.6,42,13,31.0
6,All Students,2019-20,10137,785,9352,92.3,91,24,26.4
6,All Students,2020-21,16254,794,15460,95.1,95,12,12.6
6,All Students,2021-22,14317,1590,12727,88.9,86,34,39.5
6,All Students,2022-23,13121,1230,11891,90.6,90,29,32.2
7,All Students,2018-19,9348,810,8538,91.3,54,10,18.5
7,All Students,2019-20,5544,496,5048,91.1,51,16,31.4
7,All Students,2020-21,15568,1393,14175,91.1,92,30,32.6
7,All Students,2021-22,12830,1335,11495,89.6,76,28,36.8
7,All Students,2022-23,12365,1062,11303,91.4,81,21,25.9
8,All Students,2018-19,13352,1306,12046,90.2,79,23,29.1
8,All Students,2019-20,6794,611,6183,91.0,66,18,27.3
8,All Students,2020-21,8554,982,7572,88.5,50,17,34.0
8,All Students,2021-22,14046,1951,12095,86.1,82,44,53.7
8,All Students,2022-23,12466,1449,11017,88.4,79,33,41.8
9,All Students,2018-19,20932,3174,17758,84.8,133,51,38.3
9,All Students,2019-20,13638,2007,11631,85.3,130,58,44.6
9,All Students,2020-21,14220,1450,12770,89.8,85,27,31.8
9,All Students,2021-22,12408,2333,10075,81.2,75,40,53.3
9,All Students,2022-23,11594,2797,8797,75.9,83,52,62.7
10,All Students,2018-19,15522,1940,13582,87.5,102,44,43.1
10,All Students,2019-20,12550,1691,10859,86.5,119,47,39.5
10,All Students,2020-21,19739,3390,16349,82.8,117,50,42.7
10,All Students,2021-22,13607,2605,11002,80.9,90,50,55.6
10,All Students,2022-23,12697,2215,10482,82.6,83,43,51.8
11,All Students,2018-19,11871,1504,10367,87.3,75,31,41.3
11,All Students,2019-20,7500,682,6818,90.9,71,27,38.0
11,All Students,2020-21,16704,1509,15195,91.0,99,25,25.3
11,All Students,2021-22,13583,2226,11357,83.6,84,45,53.6
11,All Students,2022-23,7650,977,6673,87.2,51,24,47.1
12,All Students,2018-19,12952,1436,11516,88.9,80,34,42.5
12,All Students,2019-20,8088,1209,6879,85.1,77,43,55.8
12,All Students,2020-21,13660,2398,11262,82.4,81,50,61.7
12,All Students,2021-22,14522,2365,12157,83.7,89,51,57.3
12,All Students,2022-23,12413,2005,10408,83.8,76,35,46.1
All Grades,All Students,2018-19,76109,12659,63450,83.4,470,234,49.8
All Grades,All Students,2019-20,39449,6839,32610,82.7,368,173,47.0
All Grades,All Students,2020-21,50377,4745,45632,90.6,293,62,21.2
All Grades,All Students,2021-22,46808,11123,35685,76.2,282,205,72.7
All Grades,All Students,2022-23,45654,8703,36951,80.9,294,172,58.5
9,All Students,2018-19,17760,3720,14040,79.1,111,58,52.3
9,All Students,2019-20,8541,1352,7189,84.2,79,37,46.8
9,All Students,2020-21,14592,1834,12758,87.4,84,23,27.4
9,All Students,2021-22,15276,2633,12643,82.8,94,60,63.8
9,All Students,2022-23,13967,2712,11255,80.6,96,57,59.4
10,All Students,2018-19,18816,2943,15873,84.4,116,46,39.7
10,All Students,2019-20,9684,2115,7569,78.2,93,49,52.7
10,All Students,2020-21,11135,1484,9651,86.7,66,18,27.3
10,All Students,2021-22,11965,2959,9006,75.3,70,49,70.0
10,All Students,2022-23,16757,2620,14137,84.4,106,58,54.7
11,All Students,2018-19,15758,1787,13971,88.7,100,37,37.0
11,All Students,2019-20,8670,928,7742,89.3,81,27,33.3
11,All Students,2020-21,10211,504,9707,95.1,59,6,10.2
11,All Students,2021-22,7709,1489,6220,80.7,48,28,58.3
11,All Students,2022-23,6962,1290,5672,81.5,44,23,52.3
12,All Students,2018-19,23775,4209,19566,82.3,143,93,65.0
12,All Students,2019-20,12554,2444,10110,80.5,115,60,52.2
12,All Students,2020-21,14439,923,13516,93.6,84,15,17.9
12,All Students,2021-22,11858,4042,7816,65.9,70,68,97.1
12,All Students,2022-23,7968,2081,5887,73.9,48,34,70.8
All Grades,All Students,2018-19,38406,5231,33175,86.4,259,116,44.8
All Grades,All Students,2019-20,23561,2978,20583,87.4,223,96,43.0
All Grades,All Students,2020-21,32364,5295,27069,83.6,195,78,40.0
All Grades,All Students,2021-22,34862,6285,28577,82.0,232,127,54.7
All Grades,All Students,2022-23,44910,7791,37119,82.7,333,207,62.2
8,All Students,2022-23,8,s,s,s,s,s,s
9,All Students,2018-19,8040,1420,6620,82.3,59,26,44.1
9,All Students,2019-20,7371,799,6572,89.2,74,21,28.4
9,All Students,2020-21,7268,1670,5598,77.0,46,22,47.8
9,All Students,2021-22,12467,2376,10091,80.9,94,50,53.2
9,All Students,2022-23,18930,4240,14690,77.6,168,117,69.6
10,All Students,2018-19,11830,1477,10353,87.5,86,40,46.5
10,All Students,2019-20,5212,762,4450,85.4,48,25,52.1
10,All Students,2020-21,10085,1502,8583,85.1,60,20,33.3
10,All Students,2021-22,7360,1247,6113,83.1,48,20,41.7
10,All Students,2022-23,12372,1721,10651,86.1,80,41,51.3
11,All Students,2018-19,8060,846,7214,89.5,50,16,32.0
11,All Students,2019-20,5804,714,5090,87.7,53,28,52.8
11,All Students,2020-21,7129,911,6218,87.2,42,16,38.1
11,All Students,2021-22,8454,1369,7085,83.8,50,26,52.0
11,All Students,2022-23,6184,s,s,s,s,s,s
12,All Students,2018-19,10476,1488,8988,85.8,64,34,53.1
12,All Students,2019-20,5174,703,4471,86.4,48,22,45.8
12,All Students,2020-21,7882,1212,6670,84.6,47,20,42.6
12,All Students,2021-22,6581,1293,5288,80.4,40,31,77.5
12,All Students,2022-23,7416,1011,6405,86.4,46,29,63.0
All Grades,All Students,2018-19,77714,13481,64233,82.7,483,265,54.9
All Grades,All Students,2019-20,50031,8515,41516,83.0,471,241,51.2
All Grades,All Students,2020-21,61674,10697,50977,82.7,377,177,46.9
All Grades,All Students,2021-22,50961,11029,39932,78.4,319,201,63.0
All Grades,All Students,2022-23,36945,6763,30182,81.7,249,142,57.0
9,All Students,2018-19,21146,2715,18431,87.2,132,56,42.4
9,All Students,2019-20,11375,1563,9812,86.3,113,50,44.2
9,All Students,2020-21,8549,1134,7415,86.7,55,21,38.2
9,All Students,2021-22,10027,1550,8477,84.5,65,37,56.9
9,All Students,2022-23,6631,828,5803,87.5,51,25,49.0
10,All Students,2018-19,19353,3291,16062,83.0,120,61,50.8
10,All Students,2019-20,13890,2312,11578,83.4,131,61,46.6
10,All Students,2020-21,13835,2163,11672,84.4,85,43,50.6
10,All Students,2021-22,8629,1366,7263,84.2,55,25,45.5
10,All Students,2022-23,8402,1146,7256,86.4,57,34,59.6
11,All Students,2018-19,18676,3085,15591,83.5,115,65,56.5
11,All Students,2019-20,12139,2021,10118,83.4,113,59,52.2
11,All Students,2020-21,21189,3982,17207,81.2,129,65,50.4
11,All Students,2021-22,13458,2656,10802,80.3,84,45,53.6
11,All Students,2022-23,8930,2006,6924,77.5,57,28,49.1
12,All Students,2018-19,18539,4390,14149,76.3,116,83,71.6
12,All Students,2019-20,12627,2619,10008,79.3,114,71,62.3
12,All Students,2020-21,18101,3418,14683,81.1,108,48,44.4
12,All Students,2021-22,18847,5457,13390,71.0,115,94,81.7
12,All Students,2022-23,12982,2783,10199,78.6,84,55,65.5
All Grades,All Students,2018-19,58857,6621,52236,88.8,385,136,35.3
All Grades,All Students,2019-20,39043,3923,35120,90.0,375,131,34.9
All Grades,All Students,2020-21,53548,11450,42098,78.6,336,179,53.3
All Grades,All Students,2021-22,52853,8174,44679,84.5,338,164,48.5
All Grades,All Students,2022-23,55305,8251,47054,85.1,367,190,51.8
9,All Students,2018-19,14695,1135,13560,92.3,107,30,28.0
9,All Students,2019-20,8535,725,7810,91.5,93,32,34.4
9,All Students,2020-21,5985,817,5168,86.3,53,24,45.3
9,All Students,2021-22,12998,1538,11460,88.2,87,36,41.4
9,All Students,2022-23,16299,2843,13456,82.6,121,74,61.2
10,All Students,2018-19,15265,1532,13733,90.0,95,27,28.4
10,All Students,2019-20,11713,971,10742,91.7,109,30,27.5
10,All Students,2020-21,15532,2201,13331,85.8,96,35,36.5
10,All Students,2021-22,10897,1122,9775,89.7,71,25,35.2
10,All Students,2022-23,16368,2437,13931,85.1,107,50,46.7
11,All Students,2018-19,15334,1341,13993,91.3,94,26,27.7
11,All Students,2019-20,9280,1004,8276,89.2,85,27,31.8
11,All Students,2020-21,17305,4117,13188,76.2,101,56,55.4
11,All Students,2021-22,13637,2268,11369,83.4,87,43,49.4
11,All Students,2022-23,10932,1144,9788,89.5,67,27,40.3
12,All Students,2018-19,13563,2613,10950,80.7,89,53,59.6
12,All Students,2019-20,9515,1223,8292,87.1,88,42,47.7
12,All Students,2020-21,14726,4315,10411,70.7,86,64,74.4
12,All Students,2021-22,15321,3246,12075,78.8,93,60,64.5
12,All Students,2022-23,11706,1827,9879,84.4,72,39,54.2
All Grades,All Students,2018-19,75682,1394,74288,98.2,462,11,2.4
All Grades,All Students,2019-20,50577,1187,49390,97.7,462,16,3.5
All Grades,All Students,2020-21,80625,2619,78006,96.8,464,21,4.5
All Grades,All Students,2021-22,72864,5462,67402,92.5,452,128,28.3
All Grades,All Students,2022-23,72123,4780,67343,93.4,446,89,20.0
9,All Students,2018-19,18989,280,18709,98.5,116,1,0.9
9,All Students,2019-20,12568,140,12428,98.9,115,1,0.9
9,All Students,2020-21,18116,533,17583,97.1,106,6,5.7
9,All Students,2021-22,13594,708,12886,94.8,87,13,14.9
9,All Students,2022-23,16368,1176,15192,92.8,106,21,19.8
10,All Students,2018-19,20313,371,19942,98.2,124,4,3.2
10,All Students,2019-20,13172,300,12872,97.7,122,6,4.9
10,All Students,2020-21,21034,536,20498,97.5,121,3,2.5
10,All Students,2021-22,19303,1062,18241,94.5,119,22,18.5
10,All Students,2022-23,16249,824,15425,94.9,103,17,16.5
11,All Students,2018-19,18726,362,18364,98.1,115,4,3.5
11,All Students,2019-20,13177,426,12751,96.8,119,5,4.2
11,All Students,2020-21,20650,721,19929,96.5,118,8,6.8
11,All Students,2021-22,20133,1316,18817,93.5,126,33,26.2
11,All Students,2022-23,19117,907,18210,95.3,115,17,14.8
12,All Students,2018-19,17654,381,17273,97.8,107,2,1.9
12,All Students,2019-20,11660,321,11339,97.2,106,4,3.8
12,All Students,2020-21,20825,829,19996,96.0,119,4,3.4
12,All Students,2021-22,19834,2376,17458,88.0,120,60,50.0
12,All Students,2022-23,20389,1873,18516,90.8,122,34,27.9
All Grades,All Students,2018-19,25611,859,24752,96.6,147,6,4.1
All Grades,All Students,2019-20,16186,683,15503,95.8,142,7,4.9
All Grades,All Students,2020-21,24741,518,24223,97.9,142,4,2.8
All Grades,All Students,2021-22,22420,1183,21237,94.7,130,17,13.1
All Grades,All Students,2022-23,20238,950,19288,95.3,116,7,6.0
4,All Students,2018-19,6771,259,6512,96.2,41,4,9.8
4,All Students,2019-20,3870,196,3674,94.9,34,3,8.8
4,All Students,2020-21,7000,91,6909,98.7,40,0,0.0
4,All Students,2021-22,4602,259,4343,94.4,26,4,15.4
4,All Students,2022-23,4425,227,4198,94.9,25,2,8.0
5,All Students,2018-19,6736,246,6490,96.3,38,0,0.0
5,All Students,2019-20,4496,207,4289,95.4,40,4,10.0
5,All Students,2020-21,5775,184,5591,96.8,33,2,6.1
5,All Students,2021-22,6884,415,6469,94.0,40,6,15.0
5,All Students,2022-23,4955,238,4717,95.2,28,3,10.7
6,All Students,2018-19,4628,137,4491,97.0,26,0,0.0
6,All Students,2019-20,2645,125,2520,95.3,23,0,0.0
6,All Students,2020-21,3500,51,3449,98.5,20,0,0.0
6,All Students,2021-22,3830,174,3656,95.5,23,2,8.7
6,All Students,2022-23,4279,217,4062,94.9,25,1,4.0
7,All Students,2018-19,3560,72,3488,98.0,20,0,0.0
7,All Students,2019-20,2990,83,2907,97.2,26,0,0.0
7,All Students,2020-21,4025,82,3943,98.0,23,1,4.3
7,All Students,2021-22,3210,108,3102,96.6,19,1,5.3
7,All Students,2022-23,3393,132,3261,96.1,20,0,0.0
8,All Students,2018-19,3916,145,3771,96.3,22,2,9.1
8,All Students,2019-20,2185,72,2113,96.7,19,0,0.0
8,All Students,2020-21,4441,110,4331,97.5,26,1,3.8
8,All Students,2021-22,3894,227,3667,94.2,22,4,18.2
8,All Students,2022-23,3186,136,3050,95.7,18,1,5.6
All Grades,All Students,2018-19,71086,8997,62089,87.3,449,192,42.8
All Grades,All Students,2019-20,46075,6458,39617,86.0,432,216,50.0
All Grades,All Students,2020-21,69376,3391,65985,95.1,437,67,15.3
All Grades,All Students,2021-22,70770,19069,51701,73.1,446,337,75.6
All Grades,All Students,2022-23,68766,15044,53722,78.1,441,299,67.8
9,All Students,2018-19,19020,2559,16461,86.5,123,50,40.7
9,All Students,2019-20,12385,1443,10942,88.3,118,49,41.5
9,All Students,2020-21,21392,1099,20293,94.9,134,23,17.2
9,All Students,2021-22,21271,5046,16225,76.3,135,93,68.9
9,All Students,2022-23,19739,4279,15460,78.3,126,82,65.1
10,All Students,2018-19,19731,2624,17107,86.7,125,60,48.0
10,All Students,2019-20,12595,2116,10479,83.2,120,70,58.3
10,All Students,2020-21,19342,854,18488,95.6,122,16,13.1
10,All Students,2021-22,17994,5680,12314,68.4,117,93,79.5
10,All Students,2022-23,17075,3750,13325,78.0,113,75,66.4
11,All Students,2018-19,17326,1897,15429,89.1,107,38,35.5
11,All Students,2019-20,9644,1244,8400,87.1,89,43,48.3
11,All Students,2020-21,14463,765,13698,94.7,89,15,16.9
11,All Students,2021-22,15597,3351,12246,78.5,93,62,66.7
11,All Students,2022-23,19359,3910,15449,79.8,122,79,64.8
12,All Students,2018-19,15009,1917,13092,87.2,94,44,46.8
12,All Students,2019-20,11451,1655,9796,85.5,106,55,51.9
12,All Students,2020-21,14164,669,13495,95.3,91,12,13.2
12,All Students,2021-22,15908,4992,10916,68.6,101,89,88.1
12,All Students,2022-23,12593,3105,9488,75.3,80,63,78.8
All Grades,All Students,2018-19,50988,6236,44752,87.8,329,134,40.7
All Grades,All Students,2019-20,33460,3758,29702,88.8,331,107,32.3
All Grades,All Students,2020-21,49547,10542,39005,78.7,298,162,54.4
All Grades,All Students,2021-22,54747,7475,47272,86.3,348,152,43.7
All Grades,All Students,2022-23,61974,8202,53772,86.8,382,161,42.1
8,All Students,2022-23,21,s,s,s,s,s,s
9,All Students,2018-19,14184,1359,12825,90.4,92,30,32.6
9,All Students,2019-20,9495,1010,8485,89.4,99,26,26.3
9,All Students,2020-21,12119,2646,9473,78.2,75,35,46.7
9,All Students,2021-22,15068,1805,13263,88.0,104,41,39.4
9,All Students,2022-23,16854,1704,15150,89.9,108,33,30.6
10,All Students,2018-19,14815,1510,13305,89.8,102,37,36.3
10,All Students,2019-20,10517,964,9553,90.8,104,33,31.7
10,All Students,2020-21,13841,3598,10243,74.0,86,56,65.1
10,All Students,2021-22,15376,1901,13475,87.6,98,31,31.6
10,All Students,2022-23,17073,2556,14517,85.0,105,46,43.8
11,All Students,2018-19,10455,1123,9332,89.3,64,21,32.8
11,All Students,2019-20,5801,524,5277,91.0,58,21,36.2
11,All Students,2020-21,12417,2425,9992,80.5,73,38,52.1
11,All Students,2021-22,12660,1580,11080,87.5,77,32,41.6
11,All Students,2022-23,15936,1768,14168,88.9,97,38,39.2
12,All Students,2018-19,11534,2244,9290,80.5,71,46,64.8
12,All Students,2019-20,7647,1260,6387,83.5,70,27,38.6
12,All Students,2020-21,11170,1873,9297,83.2,64,33,51.6
12,All Students,2021-22,11643,2189,9454,81.2,69,48,69.6
12,All Students,2022-23,12090,s,s,s,s,s,s
All Grades,All Students,2018-19,552510,16810,535700,97.0,3326,186,5.6
All Grades,All Students,2019-20,371791,9518,362273,97.4,3386,165,4.9
All Grades,All Students,2020-21,583781,16446,567335,97.2,3341,162,4.8
All Grades,All Students,2021-22,563476,23597,539879,95.8,3324,349,10.5
All Grades,All Students,2022-23,547954,19424,528530,96.5,3336,219,6.6
9,All Students,2018-19,137332,1811,135521,98.7,827,15,1.8
9,All Students,2019-20,100004,1230,98774,98.8,911,17,1.9
9,All Students,2020-21,142062,2280,139782,98.4,812,11,1.4
9,All Students,2021-22,136424,3001,133423,97.8,805,17,2.1
9,All Students,2022-23,134796,2767,132029,97.9,819,18,2.2
10,All Students,2018-19,137237,2755,134482,98.0,825,23,2.8
10,All Students,2019-20,90138,1679,88459,98.1,821,23,2.8
10,All Students,2020-21,157910,3315,154595,97.9,906,26,2.9
10,All Students,2021-22,137861,4218,133643,96.9,813,53,6.5
10,All Students,2022-23,133651,3434,130217,97.4,814,25,3.1
11,All Students,2018-19,140889,3643,137246,97.4,849,37,4.4
11,All Students,2019-20,89212,2275,86937,97.4,812,24,3.0
11,All Students,2020-21,141789,3513,138276,97.5,812,28,3.4
11,All Students,2021-22,151793,5504,146289,96.4,895,68,7.6
11,All Students,2022-23,132599,4220,128379,96.8,806,46,5.7
12,All Students,2018-19,137052,8601,128451,93.7,825,111,13.5
12,All Students,2019-20,92437,4334,88103,95.3,842,101,12.0
12,All Students,2020-21,142020,7338,134682,94.8,811,97,12.0
12,All Students,2021-22,137398,10874,126524,92.1,811,211,26.0
12,All Students,2022-23,146908,9003,137905,93.9,897,130,14.5
All Grades,All Students,2018-19,121466,12207,109259,90.0,761,177,23.3
All Grades,All Students,2019-20,80827,9134,71693,88.7,752,216,28.7
All Grades,All Students,2020-21,127963,18486,109477,85.6,741,304,41.0
All Grades,All Students,2021-22,120461,19024,101437,84.2,745,361,48.5
All Grades,All Students,2022-23,112529,12229,100300,89.1,718,211,29.4
9,All Students,2018-19,37238,4652,32586,87.5,233,64,27.5
9,All Students,2019-20,23182,1637,21545,92.9,219,38,17.4
9,All Students,2020-21,33449,3553,29896,89.4,196,64,32.7
9,All Students,2021-22,33054,3688,29366,88.8,207,72,34.8
9,All Students,2022-23,27356,2262,25094,91.7,182,44,24.2
10,All Students,2018-19,31653,3242,28411,89.8,201,48,23.9
10,All Students,2019-20,21143,3097,18046,85.4,195,69,35.4
10,All Students,2020-21,32860,4945,27915,85.0,191,82,42.9
10,All Students,2021-22,30547,4915,25632,83.9,187,95,50.8
10,All Students,2022-23,29163,2754,26409,90.6,181,42,23.2
11,All Students,2018-19,26756,2424,24332,90.9,169,38,22.5
11,All Students,2019-20,19273,2152,17121,88.8,179,51,28.5
11,All Students,2020-21,32215,5933,26282,81.6,185,86,46.5
11,All Students,2021-22,29585,4692,24893,84.1,183,93,50.8
11,All Students,2022-23,28187,2944,25243,89.6,179,52,29.1
12,All Students,2018-19,25819,1889,23930,92.7,158,27,17.1
12,All Students,2019-20,17229,2248,14981,87.0,158,57,36.1
12,All Students,2020-21,29439,4055,25384,86.2,169,72,42.6
12,All Students,2021-22,27275,5729,21546,79.0,168,101,60.1
12,All Students,2022-23,27823,4269,23554,84.7,176,73,41.5
All Grades,All Students,2018-19,45502,8664,36838,81.0,273,146,53.5
All Grades,All Students,2019-20,29675,4523,25152,84.8,278,129,46.4
All Grades,All Students,2020-21,52885,7537,45348,85.7,318,119,37.4
All Grades,All Students,2021-22,52238,12112,40126,76.8,314,191,60.8
All Grades,All Students,2022-23,39440,6441,32999,83.7,259,106,40.9
9,All Students,2018-19,16533,2620,13913,84.2,98,36,36.7
9,All Students,2019-20,7478,1411,6067,81.1,73,30,41.1
9,All Students,2020-21,17173,2619,14554,84.7,103,38,36.9
9,All Students,2021-22,11208,2281,8927,79.6,68,25,36.8
9,All Students,2022-23,7465,789,6676,89.4,54,14,25.9
10,All Students,2018-19,11721,2353,9368,79.9,72,41,56.9
10,All Students,2019-20,11138,1593,9545,85.7,103,46,44.7
10,All Students,2020-21,11334,1880,9454,83.4,70,28,40.0
10,All Students,2021-22,15083,3204,11879,78.8,91,58,63.7
10,All Students,2022-23,9032,1247,7785,86.2,60,21,35.0
11,All Students,2018-19,7480,1177,6303,84.3,45,23,51.1
11,All Students,2019-20,6028,688,5340,88.6,55,23,41.8
11,All Students,2020-21,14988,2032,12956,86.4,89,32,36.0
11,All Students,2021-22,10503,2483,8020,76.4,64,39,60.9
11,All Students,2022-23,13027,2016,11011,84.5,82,31,37.8
12,All Students,2018-19,9768,2514,7254,74.3,58,46,79.3
12,All Students,2019-20,5031,831,4200,83.5,47,30,63.8
12,All Students,2020-21,9390,1006,8384,89.3,56,21,37.5
12,All Students,2021-22,15444,4144,11300,73.2,91,69,75.8
12,All Students,2022-23,9916,2389,7527,75.9,63,40,63.5
All Grades,All Students,2018-19,75905,5754,70151,92.4,461,108,23.4
All Grades,All Students,2019-20,49879,3849,46030,92.3,463,102,22.0
All Grades,All Students,2020-21,60838,3430,57408,94.4,457,70,15.3
All Grades,All Students,2021-22,76109,10571,65538,86.1,463,220,47.5
All Grades,All Students,2022-23,69937,9094,60843,87.0,439,174,39.6
9,All Students,2018-19,20440,944,19496,95.4,125,18,14.4
9,All Students,2019-20,12635,559,12076,95.6,122,12,9.8
9,All Students,2020-21,16181,670,15511,95.9,122,14,11.5
9,All Students,2021-22,20306,2495,17811,87.7,126,58,46.0
9,All Students,2022-23,18529,2077,16452,88.8,123,49,39.8
10,All Students,2018-19,18981,1673,17308,91.2,117,27,23.1
10,All Students,2019-20,13336,790,12546,94.1,122,23,18.9
10,All Students,2020-21,14611,710,13901,95.1,110,16,14.5
10,All Students,2021-22,18946,2214,16732,88.3,114,47,41.2
10,All Students,2022-23,17761,1573,16188,91.1,111,32,28.8
11,All Students,2018-19,18844,1534,17310,91.9,113,24,21.2
11,All Students,2019-20,11749,846,10903,92.8,108,20,18.5
11,All Students,2020-21,15574,650,14924,95.8,117,17,14.5
11,All Students,2021-22,17168,2117,15051,87.7,105,43,41.0
11,All Students,2022-23,17337,2178,15159,87.4,109,46,42.2
12,All Students,2018-19,17640,1603,16037,90.9,106,39,36.8
12,All Students,2019-20,12159,1654,10505,86.4,111,47,42.3
12,All Students,2020-21,14472,1400,13072,90.3,108,23,21.3
12,All Students,2021-22,19689,3745,15944,81.0,118,72,61.0
12,All Students,2022-23,16310,3266,13044,80.0,96,47,49.0
All Grades,All Students,2018-19,85129,7559,77570,91.1,524,144,27.5
All Grades,All Students,2019-20,58196,5013,53183,91.4,537,147,27.4
All Grades,All Students,2020-21,89360,21282,68078,76.2,522,369,70.7
All Grades,All Students,2021-22,81434,12925,68509,84.1,489,287,58.7
All Grades,All Students,2022-23,72140,9603,62537,86.7,441,221,50.1
9,All Students,2018-19,26913,1469,25444,94.5,163,22,13.5
9,All Students,2019-20,15182,1216,13966,92.0,140,29,20.7
9,All Students,2020-21,22974,4907,18067,78.6,135,87,64.4
9,All Students,2021-22,20109,2644,17465,86.9,121,61,50.4
9,All Students,2022-23,18898,2326,16572,87.7,116,49,42.2
10,All Students,2018-19,20507,1591,18916,92.2,131,27,20.6
10,All Students,2019-20,16392,1114,15278,93.2,151,38,25.2
10,All Students,2020-21,22667,5548,17119,75.5,133,97,72.9
10,All Students,2021-22,19668,2284,17384,88.4,120,54,45.0
10,All Students,2022-23,17835,2153,15682,87.9,109,59,54.1
11,All Students,2018-19,21447,1997,19450,90.7,131,37,28.2
11,All Students,2019-20,12703,1132,11571,91.1,117,27,23.1
11,All Students,2020-21,24674,4993,19681,79.8,144,94,65.3
11,All Students,2021-22,18685,2918,15767,84.4,112,63,56.3
11,All Students,2022-23,17775,1894,15881,89.3,109,42,38.5
12,All Students,2018-19,16262,2502,13760,84.6,99,58,58.6
12,All Students,2019-20,13919,1551,12368,88.9,129,53,41.1
12,All Students,2020-21,19045,5834,13211,69.4,110,91,82.7
12,All Students,2021-22,22972,5079,17893,77.9,136,109,80.1
12,All Students,2022-23,17632,3230,14402,81.7,107,71,66.4
All Grades,All Students,2018-19,27921,6080,21841,78.2,191,110,57.6
All Grades,All Students,2019-20,12537,2192,10345,82.5,130,73,56.2
All Grades,All Students,2020-21,22278,1945,20333,91.3,141,45,31.9
All Grades,All Students,2021-22,20481,4436,16045,78.3,137,93,67.9
All Grades,All Students,2022-23,16913,3359,13554,80.1,114,68,59.6
8,All Students,2018-19,3,s,s,s,s,s,s
9,All Students,2018-19,8095,2546,5549,68.5,55,31,56.4
9,All Students,2019-20,4367,901,3466,79.4,46,29,63.0
9,All Students,2020-21,13076,1119,11957,91.4,78,19,24.4
9,All Students,2021-22,7877,1386,6491,82.4,50,27,54.0
9,All Students,2022-23,4472,1053,3419,76.5,30,22,73.3
10,All Students,2018-19,5949,s,s,s,s,s,s
10,All Students,2019-20,2503,429,2074,82.9,26,13,50.0
10,All Students,2020-21,3589,461,3128,87.2,23,14,60.9
10,All Students,2021-22,8437,1952,6485,76.9,58,44,75.9
10,All Students,2022-23,4695,1018,3677,78.3,33,20,60.6
11,All Students,2018-19,6328,739,5589,88.3,43,21,48.8
11,All Students,2019-20,2689,468,2221,82.6,26,15,57.7
11,All Students,2020-21,2012,158,1854,92.1,16,7,43.8
11,All Students,2021-22,2710,744,1966,72.5,18,14,77.8
11,All Students,2022-23,5943,924,5019,84.5,37,16,43.2
12,All Students,2018-19,7546,1679,5867,77.7,52,35,67.3
12,All Students,2019-20,2978,394,2584,86.8,32,16,50.0
12,All Students,2020-21,3601,207,3394,94.3,24,5,20.8
12,All Students,2021-22,1457,354,1103,75.7,11,8,72.7
12,All Students,2022-23,1803,364,1439,79.8,14,10,71.4
All Grades,All Students,2018-19,77003,3374,73629,95.6,440,37,8.4
All Grades,All Students,2019-20,55234,2680,52554,95.1,490,54,11.0
All Grades,All Students,2020-21,80258,1638,78620,98.0,473,12,2.5
All Grades,All Students,2021-22,77649,4229,73420,94.6,457,67,14.7
All Grades,All Students,2022-23,71688,4275,67413,94.0,419,52,12.4
0K,All Students,2018-19,14638,731,13907,95.0,84,10,11.9
0K,All Students,2019-20,11459,706,10753,93.8,100,17,17.0
0K,All Students,2020-21,14865,462,14403,96.9,88,4,4.5
0K,All Students,2021-22,11184,654,10530,94.2,65,8,12.3
0K,All Students,2022-23,10118,s,s,s,s,s,s
1,All Students,2018-19,16999,743,16256,95.6,96,9,9.4
1,All Students,2019-20,9394,446,8948,95.3,84,9,10.7
1,All Students,2020-21,14510,165,14345,98.9,85,0,0.0
1,All Students,2021-22,14647,782,13865,94.7,87,12,13.8
1,All Students,2022-23,10999,752,10247,93.2,64,6,9.4
2,All Students,2018-19,13189,492,12697,96.3,75,5,6.7
2,All Students,2019-20,10324,600,9724,94.2,92,13,14.1
2,All Students,2020-21,12950,348,12602,97.3,78,2,2.6
2,All Students,2021-22,13153,770,12383,94.1,77,8,10.4
2,All Students,2022-23,13611,822,12789,94.0,78,9,11.5
3,All Students,2018-19,12580,519,12061,95.9,72,3,4.2
3,All Students,2019-20,8799,284,8515,96.8,78,4,5.1
3,All Students,2020-21,13923,193,13730,98.6,83,0,0.0
3,All Students,2021-22,13721,612,13109,95.5,82,7,8.5
3,All Students,2022-23,12569,538,12031,95.7,75,5,6.7
4,All Students,2018-19,9963,404,9559,95.9,58,4,6.9
4,All Students,2019-20,8326,315,8011,96.2,74,6,8.1
4,All Students,2020-21,12286,237,12049,98.1,71,3,4.2
4,All Students,2021-22,12529,766,11763,93.9,73,16,21.9
4,All Students,2022-23,12736,627,12109,95.1,76,4,5.3
5,All Students,2018-19,9634,485,9149,95.0,55,6,10.9
5,All Students,2019-20,6932,329,6603,95.3,62,5,8.1
5,All Students,2020-21,11724,233,11491,98.0,68,3,4.4
5,All Students,2021-22,12415,645,11770,94.8,73,16,21.9
5,All Students,2022-23,11653,822,10831,92.9,66,15,22.7
6,All Students,2022-23,2,s,s,s,s,s,s
All Grades,All Students,2018-19,70533,15056,55477,78.7,476,313,65.8
All Grades,All Students,2019-20,32415,5895,26520,81.8,319,154,48.3
All Grades,All Students,2020-21,33833,7816,26017,76.9,212,116,54.7
All Grades,All Students,2021-22,33395,5786,27609,82.7,227,125,55.1
All Grades,All Students,2022-23,40130,7301,32829,81.8,282,160,56.7
9,All Students,2018-19,8822,1600,7222,81.9,64,36,56.3
9,All Students,2019-20,5131,562,4569,89.0,52,19,36.5
9,All Students,2020-21,7855,1644,6211,79.1,50,28,56.0
9,All Students,2021-22,11562,1271,10291,89.0,74,27,36.5
9,All Students,2022-23,14558,2353,12205,83.8,108,55,50.9
10,All Students,2018-19,15859,2996,12863,81.1,112,68,60.7
10,All Students,2019-20,5972,1543,4429,74.2,65,41,63.1
10,All Students,2020-21,9261,2617,6644,71.7,54,31,57.4
10,All Students,2021-22,6849,1086,5763,84.1,53,30,56.6
10,All Students,2022-23,10348,1457,8891,85.9,71,32,45.1
11,All Students,2018-19,21953,3839,18114,82.5,144,83,57.6
11,All Students,2019-20,7998,1117,6881,86.0,78,36,46.2
11,All Students,2020-21,6737,1714,5023,74.6,43,24,55.8
11,All Students,2021-22,8107,1892,6215,76.7,53,35,66.0
11,All Students,2022-23,7759,1580,6179,79.6,54,37,68.5
12,All Students,2018-19,23899,6621,17278,72.3,156,126,80.8
12,All Students,2019-20,13314,2673,10641,79.9,125,59,47.2
12,All Students,2020-21,9980,1841,8139,81.6,65,33,50.8
12,All Students,2021-22,6877,1537,5340,77.7,47,33,70.2
12,All Students,2022-23,7465,1911,5554,74.4,49,36,73.5
All Grades,All Students,2018-19,39362,3403,35959,91.4,240,72,30.0
All Grades,All Students,2019-20,26044,2031,24013,92.2,239,63,26.4
All Grades,All Students,2020-21,41927,3779,38148,91.0,240,73,30.4
All Grades,All Students,2021-22,39779,4499,35280,88.7,235,100,42.6
All Grades,All Students,2022-23,36426,4616,31810,87.3,231,111,48.1
9,All Students,2018-19,9971,586,9385,94.1,61,11,18.0
9,All Students,2019-20,6661,353,6308,94.7,61,8,13.1
9,All Students,2020-21,10777,984,9793,90.9,62,21,33.9
9,All Students,2021-22,9739,942,8797,90.3,58,20,34.5
9,All Students,2022-23,7804,867,6937,88.9,49,21,42.9
10,All Students,2018-19,10017,637,9380,93.6,61,10,16.4
10,All Students,2019-20,7297,623,6674,91.5,67,21,31.3
10,All Students,2020-21,10850,950,9900,91.2,62,18,29.0
10,All Students,2021-22,10200,1118,9082,89.0,60,27,45.0
10,All Students,2022-23,9708,1019,8689,89.5,65,22,33.8
11,All Students,2018-19,9537,1167,8370,87.8,58,27,46.6
11,All Students,2019-20,6390,420,5970,93.4,59,10,16.9
11,All Students,2020-21,10500,799,9701,92.4,60,16,26.7
11,All Students,2021-22,10370,1050,9320,89.9,61,25,41.0
11,All Students,2022-23,9287,971,8316,89.5,58,25,43.1
12,All Students,2018-19,9837,1013,8824,89.7,60,24,40.0
12,All Students,2019-20,5696,635,5061,88.9,52,24,46.2
12,All Students,2020-21,9800,1046,8754,89.3,56,18,32.1
12,All Students,2021-22,9470,1389,8081,85.3,56,28,50.0
12,All Students,2022-23,9627,1759,7868,81.7,59,43,72.9
All Grades,All Students,2018-19,68115,8103,60012,88.1,430,167,38.8
All Grades,All Students,2019-20,44601,5350,39251,88.0,423,145,34.3
All Grades,All Students,2020-21,72046,10932,61114,84.8,428,193,45.1
All Grades,All Students,2021-22,74077,14439,59638,80.5,456,277,60.7
All Grades,All Students,2022-23,75045,5235,69810,93.0,471,102,21.7
9,All Students,2018-19,22208,2359,19849,89.4,138,51,37.0
9,All Students,2019-20,15271,2122,13149,86.1,144,50,34.7
9,All Students,2020-21,24788,3472,21316,86.0,144,60,41.7
9,All Students,2021-22,24921,4055,20866,83.7,153,76,49.7
9,All Students,2022-23,25498,1613,23885,93.7,160,34,21.3
10,All Students,2018-19,17601,1895,15706,89.2,116,40,34.5
10,All Students,2019-20,12101,1119,10982,90.8,116,26,22.4
10,All Students,2020-21,17689,2026,15663,88.5,106,34,32.1
10,All Students,2021-22,17944,3291,14653,81.7,115,72,62.6
10,All Students,2022-23,19435,1375,18060,92.9,125,30,24.0
11,All Students,2018-19,14027,1601,12426,88.6,88,30,34.1
11,All Students,2019-20,8341,587,7754,93.0,81,18,22.2
11,All Students,2020-21,15552,2336,13216,85.0,95,40,42.1
11,All Students,2021-22,16671,3294,13377,80.2,101,60,59.4
11,All Students,2022-23,15274,940,14334,93.8,95,12,12.6
12,All Students,2018-19,14279,2248,12031,84.3,88,46,52.3
12,All Students,2019-20,8888,1522,7366,82.9,82,51,62.2
12,All Students,2020-21,14017,3098,10919,77.9,83,59,71.1
12,All Students,2021-22,14541,3799,10742,73.9,87,69,79.3
12,All Students,2022-23,14838,1307,13531,91.2,91,26,28.6
All Grades,All Students,2018-19,75526,10326,65200,86.3,473,178,37.6
All Grades,All Students,2019-20,48470,7317,41153,84.9,454,191,42.1
All Grades,All Students,2020-21,77089,25628,51461,66.8,459,387,84.3
All Grades,All Students,2021-22,70455,20336,50119,71.1,444,388,87.4
All Grades,All Students,2022-23,65025,12694,52331,80.5,416,232,55.8
9,All Students,2018-19,19112,2386,16726,87.5,125,38,30.4
9,All Students,2019-20,12611,2802,9809,77.8,123,68,55.3
9,All Students,2020-21,24331,9235,15096,62.0,145,123,84.8
9,All Students,2021-22,18098,4786,13312,73.6,121,94,77.7
9,All Students,2022-23,15810,2926,12884,81.5,104,64,61.5
10,All Students,2018-19,19811,2048,17763,89.7,122,34,27.9
10,All Students,2019-20,11660,1149,10511,90.1,113,36,31.9
10,All Students,2020-21,17509,5156,12353,70.6,104,76,73.1
10,All Students,2021-22,19814,5306,14508,73.2,123,110,89.4
10,All Students,2022-23,16563,3407,13156,79.4,109,57,52.3
11,All Students,2018-19,19421,2441,16980,87.4,119,43,36.1
11,All Students,2019-20,12058,1286,10772,89.3,111,32,28.8
11,All Students,2020-21,16824,4796,12028,71.5,102,90,88.2
11,All Students,2021-22,15798,4942,10856,68.7,100,91,91.0
11,All Students,2022-23,17978,3055,14923,83.0,111,54,48.6
12,All Students,2018-19,17182,3451,13731,79.9,107,63,58.9
12,All Students,2019-20,12141,2080,10061,82.9,107,55,51.4
12,All Students,2020-21,18425,6441,11984,65.0,108,98,90.7
12,All Students,2021-22,16745,5302,11443,68.3,100,93,93.0
12,All Students,2022-23,14674,3306,11368,77.5,92,57,62.0
All Grades,All Students,2018-19,87888,8226,79662,90.6,541,157,29.0
All Grades,All Students,2019-20,57248,6399,50849,88.8,531,192,36.2
All Grades,All Students,2020-21,89643,19554,70089,78.2,520,325,62.5
All Grades,All Students,2021-22,81209,10877,70332,86.6,491,218,44.4
All Grades,All Students,2022-23,77340,7390,69950,90.4,489,151,30.9
9,All Students,2018-19,32991,2911,30080,91.2,202,51,25.2
9,All Students,2019-20,16109,1421,14688,91.2,152,36,23.7
9,All Students,2020-21,24526,5675,18851,76.9,142,92,64.8
9,All Students,2021-22,25292,3424,21868,86.5,154,59,38.3
9,All Students,2022-23,19983,1915,18068,90.4,133,36,27.1
10,All Students,2018-19,21083,2203,18880,89.6,130,40,30.8
10,All Students,2019-20,15946,1744,14202,89.1,149,53,35.6
10,All Students,2020-21,23134,4335,18799,81.3,134,71,53.0
10,All Students,2021-22,18702,2347,16355,87.5,116,46,39.7
10,All Students,2022-23,22392,1936,20456,91.4,139,40,28.8
11,All Students,2018-19,18089,1297,16792,92.8,113,22,19.5
11,All Students,2019-20,12352,1377,10975,88.9,114,40,35.1
11,All Students,2020-21,21227,5005,16222,76.4,125,77,61.6
11,All Students,2021-22,18979,2312,16667,87.8,113,43,38.1
11,All Students,2022-23,17408,1942,15466,88.8,110,35,31.8
12,All Students,2018-19,15725,1815,13910,88.5,96,44,45.8
12,All Students,2019-20,12841,1857,10984,85.5,117,64,54.7
12,All Students,2020-21,20756,4539,16217,78.1,119,85,71.4
12,All Students,2021-22,18236,2794,15442,84.7,108,70,64.8
12,All Students,2022-23,17557,1597,15960,90.9,107,40,37.4
All Grades,All Students,2018-19,69805,11913,57892,82.9,450,243,54.0
All Grades,All Students,2019-20,49124,8276,40848,83.2,468,255,54.5
All Grades,All Students,2020-21,87150,14693,72457,83.1,513,226,44.1
All Grades,All Students,2021-22,82068,14956,67112,81.8,516,322,62.4
All Grades,All Students,2022-23,77552,11362,66190,85.3,480,257,53.5
9,All Students,2018-19,20532,3116,17416,84.8,137,58,42.3
9,All Students,2019-20,14265,2342,11923,83.6,139,68,48.9
9,All Students,2020-21,28407,3724,24683,86.9,164,56,34.1
9,All Students,2021-22,21730,3717,18013,82.9,134,75,56.0
9,All Students,2022-23,21269,3091,18178,85.5,138,68,49.3
10,All Students,2018-19,21328,4237,17091,80.1,136,82,60.3
10,All Students,2019-20,13991,2269,11722,83.8,131,66,50.4
10,All Students,2020-21,21018,4198,16820,80.0,127,59,46.5
10,All Students,2021-22,24934,3514,21420,85.9,155,75,48.4
10,All Students,2022-23,20592,2985,17607,85.5,126,68,54.0
11,All Students,2018-19,15318,2286,13032,85.1,99,52,52.5
11,All Students,2019-20,11060,2017,9043,81.8,106,66,62.3
11,All Students,2020-21,21002,3379,17623,83.9,122,56,45.9
11,All Students,2021-22,17431,3966,13465,77.2,115,86,74.8
11,All Students,2022-23,21376,2759,18617,87.1,130,65,50.0
12,All Students,2018-19,12627,2274,10353,82.0,78,51,65.4
12,All Students,2019-20,9808,1648,8160,83.2,92,55,59.8
12,All Students,2020-21,16723,3392,13331,79.7,100,55,55.0
12,All Students,2021-22,17973,3759,14214,79.1,112,86,76.8
12,All Students,2022-23,14315,2527,11788,82.3,86,56,65.1
All Grades,All Students,2018-19,66980,1034,65946,98.5,405,8,2.0
All Grades,All Students,2019-20,43435,952,42483,97.8,402,16,4.0
All Grades,All Students,2020-21,66939,2240,64699,96.7,403,33,8.2
All Grades,All Students,2021-22,63235,2968,60267,95.3,376,40,10.6
All Grades,All Students,2022-23,61343,1439,59904,97.7,376,18,4.8
9,All Students,2018-19,18516,125,18391,99.3,112,0,0.0
9,All Students,2019-20,10019,135,9884,98.7,95,3,3.2
9,All Students,2020-21,19094,961,18133,95.0,115,13,11.3
9,All Students,2021-22,14806,535,14271,96.4,89,5,5.6
9,All Students,2022-23,17697,354,17343,98.0,110,4,3.6
10,All Students,2018-19,17221,221,17000,98.7,105,2,1.9
10,All Students,2019-20,11436,220,11216,98.1,107,3,2.8
10,All Students,2020-21,14685,476,14209,96.8,88,9,10.2
10,All Students,2021-22,17235,803,16432,95.3,103,12,11.7
10,All Students,2022-23,14189,226,13963,98.4,86,3,3.5
11,All Students,2018-19,16547,292,16255,98.2,100,2,2.0
11,All Students,2019-20,10890,221,10669,98.0,99,2,2.0
11,All Students,2020-21,16867,335,16532,98.0,101,4,4.0
11,All Students,2021-22,14865,713,14152,95.2,88,8,9.1
11,All Students,2022-23,15781,320,15461,98.0,96,3,3.1
12,All Students,2018-19,14696,396,14300,97.3,88,4,4.5
12,All Students,2019-20,11090,376,10714,96.6,101,8,7.9
12,All Students,2020-21,16251,444,15807,97.3,98,6,6.1
12,All Students,2021-22,16329,917,15412,94.4,96,15,15.6
12,All Students,2022-23,13676,539,13137,96.1,84,8,9.5
All Grades,All Students,2018-19,75847,7924,67923,89.6,462,129,27.9
All Grades,All Students,2019-20,48939,4765,44174,90.3,455,138,30.3
All Grades,All Students,2020-21,77745,14088,63657,81.9,454,260,57.3
All Grades,All Students,2021-22,72965,13004,59961,82.2,453,246,54.3
All Grades,All Students,2022-23,66635,12290,54345,81.6,418,213,51.0
9,All Students,2018-19,19923,1794,18129,91.0,121,25,20.7
9,All Students,2019-20,12538,1537,11001,87.7,120,46,38.3
9,All Students,2020-21,19503,3635,15868,81.4,113,63,55.8
9,All Students,2021-22,19947,3427,16520,82.8,127,58,45.7
9,All Students,2022-23,17910,2886,15024,83.9,114,61,53.5
10,All Students,2018-19,20280,1616,18664,92.0,125,31,24.8
10,All Students,2019-20,13295,1231,12064,90.7,124,35,28.2
10,All Students,2020-21,20411,4114,16297,79.8,119,74,62.2
10,All Students,2021-22,16908,2596,14312,84.6,106,48,45.3
10,All Students,2022-23,16938,2602,14336,84.6,107,45,42.1
11,All Students,2018-19,17636,1497,16139,91.5,107,21,19.6
11,All Students,2019-20,11449,1043,10406,90.9,105,26,24.8
11,All Students,2020-21,20257,3030,17227,85.0,120,62,51.7
11,All Students,2021-22,17709,3341,14368,81.1,109,65,59.6
11,All Students,2022-23,15237,2741,12496,82.0,97,42,43.3
12,All Students,2018-19,18008,3017,14991,83.2,109,52,47.7
12,All Students,2019-20,11657,954,10703,91.8,106,31,29.2
12,All Students,2020-21,17574,3309,14265,81.2,102,61,59.8
12,All Students,2021-22,18401,3640,14761,80.2,111,75,67.6
12,All Students,2022-23,16550,4061,12489,75.5,100,65,65.0
All Grades,All Students,2018-19,87459,9250,78209,89.4,530,160,30.2
All Grades,All Students,2019-20,57078,5146,51932,91.0,529,159,30.1
All Grades,All Students,2020-21,88921,18448,70473,79.3,515,304,59.0
All Grades,All Students,2021-22,86466,12002,74464,86.1,522,255,48.9
All Grades,All Students,2022-23,78952,8686,70266,89.0,500,176,35.2
9,All Students,2018-19,24866,2668,22198,89.3,150,42,28.0
9,All Students,2019-20,14444,1309,13135,90.9,135,36,26.7
9,All Students,2020-21,23689,4877,18812,79.4,137,77,56.2
9,All Students,2021-22,25148,2675,22473,89.4,152,49,32.2
9,All Students,2022-23,19821,1762,18059,91.1,128,39,30.5
10,All Students,2018-19,24608,2140,22468,91.3,149,31,20.8
10,All Students,2019-20,15010,1431,13579,90.5,139,48,34.5
10,All Students,2020-21,21035,4348,16687,79.3,122,72,59.0
10,All Students,2021-22,21326,2654,18672,87.6,128,62,48.4
10,All Students,2022-23,21947,2277,19670,89.6,140,39,27.9
11,All Students,2018-19,22448,2148,20300,90.4,138,41,29.7
11,All Students,2019-20,14339,1262,13077,91.2,131,33,25.2
11,All Students,2020-21,22686,4055,18631,82.1,130,65,50.0
11,All Students,2021-22,19036,2570,16466,86.5,116,55,47.4
11,All Students,2022-23,19142,2043,17099,89.3,121,41,33.9
12,All Students,2018-19,15537,2294,13243,85.2,93,46,49.5
12,All Students,2019-20,13285,1144,12141,91.4,124,42,33.9
12,All Students,2020-21,21511,5168,16343,76.0,126,90,71.4
12,All Students,2021-22,20956,4103,16853,80.4,126,89,70.6
12,All Students,2022-23,18042,2604,15438,85.6,111,57,51.4
All Grades,All Students,2018-19,70188,6628,63560,90.6,442,105,23.8
All Grades,All Students,2019-20,38242,4627,33615,87.9,356,111,31.2
All Grades,All Students,2020-21,50032,11145,38887,77.7,289,126,43.6
All Grades,All Students,2021-22,46801,8388,38413,82.1,285,125,43.9
All Grades,All Students,2022-23,53160,7105,46055,86.6,343,121,35.3
9,All Students,2018-19,16292,2900,13392,82.2,107,40,37.4
9,All Students,2019-20,8807,1659,7148,81.2,83,29,34.9
9,All Students,2020-21,15044,4184,10860,72.2,87,46,52.9
9,All Students,2021-22,19868,2868,17000,85.6,119,30,25.2
9,All Students,2022-23,17720,2529,15191,85.7,119,37,31.1
10,All Students,2018-19,19148,1830,17318,90.4,123,35,28.5
10,All Students,2019-20,8157,1428,6729,82.5,75,31,41.3
10,All Students,2020-21,12093,3268,8825,73.0,70,30,42.9
10,All Students,2021-22,11925,2576,9349,78.4,71,33,46.5
10,All Students,2022-23,18020,1927,16093,89.3,116,36,31.0
11,All Students,2018-19,18175,780,17395,95.7,111,13,11.7
11,All Students,2019-20,8634,481,8153,94.4,80,16,20.0
11,All Students,2020-21,8429,1241,7188,85.3,49,15,30.6
11,All Students,2021-22,7427,1045,6382,85.9,46,26,56.5
11,All Students,2022-23,9542,1146,8396,88.0,60,22,36.7
12,All Students,2018-19,16573,1118,15455,93.3,101,17,16.8
12,All Students,2019-20,12644,1059,11585,91.6,118,35,29.7
12,All Students,2020-21,14466,2452,12014,83.0,83,35,42.2
12,All Students,2021-22,7581,1899,5682,75.0,49,36,73.5
12,All Students,2022-23,7878,1503,6375,80.9,48,26,54.2
All Grades,All Students,2018-19,259782,24749,235033,90.5,1598,498,31.2
All Grades,All Students,2019-20,173327,15980,157347,90.8,1613,495,30.7
All Grades,All Students,2020-21,281351,65027,216324,76.9,1676,1169,69.7
All Grades,All Students,2021-22,284441,46211,238230,83.8,1726,994,57.6
All Grades,All Students,2022-23,259703,28277,231426,89.1,1630,608,37.3
9,All Students,2018-19,87147,8993,78154,89.7,541,173,32.0
9,All Students,2019-20,56973,5524,51449,90.3,532,174,32.7
9,All Students,2020-21,91829,20427,71402,77.8,542,358,66.1
9,All Students,2021-22,78134,10547,67587,86.5,477,243,50.9
9,All Students,2022-23,65908,4991,60917,92.4,408,103,25.2
10,All Students,2018-19,65373,6031,59342,90.8,405,119,29.4
10,All Students,2019-20,47067,4664,42403,90.1,441,145,32.9
10,All Students,2020-21,76144,19103,57041,74.9,456,333,73.0
10,All Students,2021-22,84072,14393,69679,82.9,512,292,57.0
10,All Students,2022-23,70414,7880,62534,88.8,445,173,38.9
11,All Students,2018-19,51740,3662,48078,92.9,314,68,21.7
11,All Students,2019-20,32598,2562,30036,92.1,303,79,26.1
11,All Students,2020-21,58820,11265,47555,80.8,350,221,63.1
11,All Students,2021-22,61161,10036,51125,83.6,373,219,58.7
11,All Students,2022-23,68720,8044,60676,88.3,433,169,39.0
12,All Students,2018-19,55522,6063,49459,89.1,338,138,40.8
12,All Students,2019-20,36689,3230,33459,91.2,338,98,29.0
12,All Students,2020-21,54558,14232,40326,73.9,328,257,78.4
12,All Students,2021-22,61074,11235,49839,81.6,364,240,65.9
12,All Students,2022-23,54661,7362,47299,86.5,344,163,47.4
All Grades,All Students,2018-19,74224,10528,63696,85.8,451,194,43.0
All Grades,All Students,2019-20,48065,6105,41960,87.3,450,177,39.3
All Grades,All Students,2020-21,78745,20429,58316,74.1,471,278,59.0
All Grades,All Students,2021-22,73203,19475,53728,73.4,430,290,67.4
All Grades,All Students,2022-23,66526,9999,56527,85.0,417,191,45.8
8,All Students,2020-21,9,s,s,s,s,s,s
9,All Students,2018-19,23567,4226,19341,82.1,145,70,48.3
9,All Students,2019-20,14583,1704,12879,88.3,138,43,31.2
9,All Students,2020-21,23558,4486,19072,81.0,146,70,47.9
9,All Students,2021-22,17805,4194,13611,76.4,111,67,60.4
9,All Students,2022-23,16465,2443,14022,85.2,105,45,42.9
10,All Students,2018-19,20510,2556,17954,87.5,124,45,36.3
10,All Students,2019-20,12594,2136,10458,83.0,120,58,48.3
10,All Students,2020-21,25248,8475,16773,66.4,149,102,68.5
10,All Students,2021-22,23070,6105,16965,73.5,131,85,64.9
10,All Students,2022-23,15736,1959,13777,87.6,100,42,42.0
11,All Students,2018-19,15585,1916,13669,87.7,94,38,40.4
11,All Students,2019-20,11169,1148,10021,89.7,104,40,38.5
11,All Students,2020-21,13098,s,s,s,s,s,s
11,All Students,2021-22,16932,3882,13050,77.1,101,66,65.3
11,All Students,2022-23,17714,2270,15444,87.2,110,46,41.8
12,All Students,2018-19,14562,1830,12732,87.4,88,41,46.6
12,All Students,2019-20,9719,1117,8602,88.5,88,36,40.9
12,All Students,2020-21,16832,4626,12206,72.5,98,61,62.2
12,All Students,2021-22,15396,5294,10102,65.6,87,72,82.8
12,All Students,2022-23,16611,3327,13284,80.0,102,58,56.9
All Grades,All Students,2018-19,244879,25384,219495,89.6,1477,438,29.7
All Grades,All Students,2019-20,160426,14886,145540,90.7,1468,397,27.0
All Grades,All Students,2020-21,260103,19001,241102,92.7,1507,251,16.7
All Grades,All Students,2021-22,254975,38674,216301,84.8,1517,750,49.4
All Grades,All Students,2022-23,238323,26841,211482,88.7,1478,517,35.0
9,All Students,2018-19,71402,5765,65637,91.9,436,97,22.2
9,All Students,2019-20,41443,2475,38968,94.0,382,71,18.6
9,All Students,2020-21,75774,3984,71790,94.7,440,61,13.9
9,All Students,2021-22,62255,6977,55278,88.8,375,133,35.5
9,All Students,2022-23,60950,6362,54588,89.6,383,115,30.0
10,All Students,2018-19,60707,6293,54414,89.6,364,98,26.9
10,All Students,2019-20,45781,4455,41326,90.3,421,111,26.4
10,All Students,2020-21,63400,3642,59758,94.3,369,48,13.0
10,All Students,2021-22,71820,9096,62724,87.3,428,190,44.4
10,All Students,2022-23,57402,5425,51977,90.5,358,105,29.3
11,All Students,2018-19,64333,6661,57672,89.6,388,115,29.6
11,All Students,2019-20,35533,3409,32124,90.4,324,84,25.9
11,All Students,2020-21,69717,6414,63303,90.8,404,81,20.0
11,All Students,2021-22,56930,7106,49824,87.5,341,154,45.2
11,All Students,2022-23,66914,7267,59647,89.1,412,134,32.5
12,All Students,2018-19,48437,6665,41772,86.2,289,128,44.3
12,All Students,2019-20,37669,4547,33122,87.9,341,131,38.4
12,All Students,2020-21,51212,4961,46251,90.3,294,61,20.7
12,All Students,2021-22,63970,15495,48475,75.8,373,273,73.2
12,All Students,2022-23,53057,7787,45270,85.3,325,163,50.2
All Grades,All Students,2018-19,69860,15384,54476,78.0,455,284,62.4
All Grades,All Students,2019-20,42833,9316,33517,78.3,411,222,54.0
All Grades,All Students,2020-21,59558,17339,42219,70.9,353,249,70.5
All Grades,All Students,2021-22,55020,11462,43558,79.2,362,224,61.9
All Grades,All Students,2022-23,49143,11030,38113,77.6,332,219,66.0
9,All Students,2018-19,14193,4126,10067,70.9,98,61,62.2
9,All Students,2019-20,9004,2600,6404,71.1,85,38,44.7
9,All Students,2020-21,13708,4139,9569,69.8,81,60,74.1
9,All Students,2021-22,18245,3261,14984,82.1,119,68,57.1
9,All Students,2022-23,14118,3487,10631,75.3,96,58,60.4
10,All Students,2018-19,24519,5742,18777,76.6,159,101,63.5
10,All Students,2019-20,11167,2857,8310,74.4,112,68,60.7
10,All Students,2020-21,17907,6973,10934,61.1,107,89,83.2
10,All Students,2021-22,15338,4200,11138,72.6,100,70,70.0
10,All Students,2022-23,16171,3576,12595,77.9,109,74,67.9
11,All Students,2018-19,17272,2722,14550,84.2,108,65,60.2
11,All Students,2019-20,11108,1535,9573,86.2,104,45,43.3
11,All Students,2020-21,10381,2688,7693,74.1,60,36,60.0
11,All Students,2021-22,10566,1669,8897,84.2,69,39,56.5
11,All Students,2022-23,9560,1931,7629,79.8,67,47,70.1
12,All Students,2018-19,13876,2794,11082,79.9,90,57,63.3
12,All Students,2019-20,11554,2324,9230,79.9,110,71,64.5
12,All Students,2020-21,17562,3539,14023,79.8,105,64,61.0
12,All Students,2021-22,10871,2332,8539,78.5,74,47,63.5
12,All Students,2022-23,9294,2036,7258,78.1,60,40,66.7
All Grades,All Students,2018-19,68457,2270,66187,96.7,386,27,7.0
All Grades,All Students,2019-20,43492,1424,42068,96.7,381,21,5.5
All Grades,All Students,2020-21,66069,1491,64578,97.7,380,18,4.7
All Grades,All Students,2021-22,61389,3070,58319,95.0,360,49,13.6
All Grades,All Students,2022-23,58592,3768,54824,93.6,344,71,20.6
6,All Students,2018-19,23570,578,22992,97.5,133,4,3.0
6,All Students,2019-20,14595,511,14084,96.5,128,8,6.3
6,All Students,2020-21,21294,420,20874,98.0,124,7,5.6
6,All Students,2021-22,20107,1040,19067,94.8,120,16,13.3
6,All Students,2022-23,17345,969,16376,94.4,103,15,14.6
7,All Students,2018-19,22637,655,21982,97.1,128,10,7.8
7,All Students,2019-20,14802,325,14477,97.8,130,2,1.5
7,All Students,2020-21,22050,595,21455,97.3,126,7,5.6
7,All Students,2021-22,19935,886,19049,95.6,116,13,11.2
7,All Students,2022-23,20569,1209,19360,94.1,123,23,18.7
8,All Students,2018-19,22250,1037,21213,95.3,125,13,10.4
8,All Students,2019-20,14095,588,13507,95.8,123,11,8.9
8,All Students,2020-21,22725,476,22249,97.9,130,4,3.1
8,All Students,2021-22,21347,1144,20203,94.6,124,20,16.1
8,All Students,2022-23,20678,1590,19088,92.3,118,33,28.0
All Grades,All Students,2018-19,31227,2714,28513,91.3,205,70,34.1
All Grades,All Students,2019-20,17558,1687,15871,90.4,167,60,35.9
All Grades,All Students,2020-21,22599,4537,18062,79.9,134,73,54.5
All Grades,All Students,2021-22,21434,3774,17660,82.4,139,101,72.7
All Grades,All Students,2022-23,31776,4708,27068,85.2,217,138,63.6
6,All Students,2018-19,6231,719,5512,88.5,43,23,53.5
6,All Students,2019-20,6453,673,5780,89.6,61,21,34.4
6,All Students,2020-21,5348,939,4409,82.4,32,19,59.4
6,All Students,2021-22,5685,s,s,s,s,s,s
6,All Students,2022-23,10648,1700,8948,84.0,76,48,63.2
7,All Students,2018-19,10176,833,9343,91.8,67,22,32.8
7,All Students,2019-20,4108,416,3692,89.9,39,15,38.5
7,All Students,2020-21,10163,2026,8137,80.1,59,27,45.8
7,All Students,2021-22,6562,1179,5383,82.0,45,30,66.7
7,All Students,2022-23,10869,1378,9491,87.3,72,41,56.9
8,All Students,2018-19,14820,1162,13658,92.2,95,25,26.3
8,All Students,2019-20,6997,598,6399,91.5,67,24,35.8
8,All Students,2020-21,7088,1572,5516,77.8,43,27,62.8
8,All Students,2021-22,9176,1718,7458,81.3,56,41,73.2
8,All Students,2022-23,10259,1630,8629,84.1,69,49,71.0
9,All Students,2021-22,11,s,s,s,s,s,s
All Grades,All Students,2018-19,109577,4772,104805,95.6,638,67,10.5
All Grades,All Students,2019-20,72158,3142,69016,95.6,643,60,9.3
All Grades,All Students,2020-21,88788,3027,85761,96.6,535,39,7.3
All Grades,All Students,2021-22,83616,4660,78956,94.4,481,67,13.9
All Grades,All Students,2022-23,85306,5132,80174,94.0,498,74,14.9
PK in K-12 Schools,All Students,2018-19,3189,174,3015,94.5,20,2,10.0
PK in K-12 Schools,All Students,2019-20,2052,132,1920,93.6,18,1,5.6
PK in K-12 Schools,All Students,2020-21,2987,150,2837,95.0,21,3,14.3
PK in K-12 Schools,All Students,2021-22,3186,242,2944,92.4,18,6,33.3
PK in K-12 Schools,All Students,2022-23,3120,207,2913,93.4,19,6,31.6
0K,All Students,2018-19,17689,975,16714,94.5,104,16,15.4
0K,All Students,2019-20,11332,578,10754,94.9,100,13,13.0
0K,All Students,2020-21,13454,572,12882,95.7,83,6,7.2
0K,All Students,2021-22,15376,964,14412,93.7,90,14,15.6
0K,All Students,2022-23,15401,1027,14374,93.3,92,15,16.3
1,All Students,2018-19,18418,769,17649,95.8,110,8,7.3
1,All Students,2019-20,12440,637,11803,94.9,110,14,12.7
1,All Students,2020-21,13384,359,13025,97.3,80,4,5.0
1,All Students,2021-22,12153,721,11432,94.1,69,11,15.9
1,All Students,2022-23,14394,896,13498,93.8,84,10,11.9
2,All Students,2018-19,16442,590,15852,96.4,93,8,8.6
2,All Students,2019-20,12295,518,11777,95.8,112,9,8.0
2,All Students,2020-21,15546,572,14974,96.3,94,7,7.4
2,All Students,2021-22,12622,632,11990,95.0,72,6,8.3
2,All Students,2022-23,13098,699,12399,94.7,75,8,10.7
3,All Students,2018-19,20857,899,19958,95.7,121,14,11.6
3,All Students,2019-20,10541,340,10201,96.8,93,5,5.4
3,All Students,2020-21,14391,399,13992,97.2,84,4,4.8
3,All Students,2021-22,14617,783,13834,94.6,85,11,12.9
3,All Students,2022-23,12356,633,11723,94.9,72,5,6.9
4,All Students,2018-19,18303,709,17594,96.1,105,9,8.6
4,All Students,2019-20,13330,473,12857,96.5,121,9,7.4
4,All Students,2020-21,13558,318,13240,97.7,83,4,4.8
4,All Students,2021-22,13630,668,12962,95.1,78,9,11.5
4,All Students,2022-23,14662,882,13780,94.0,86,17,19.8
5,All Students,2018-19,14679,656,14023,95.5,85,10,11.8
5,All Students,2019-20,10168,464,9704,95.4,89,9,10.1
5,All Students,2020-21,15468,657,14811,95.8,90,11,12.2
5,All Students,2021-22,12032,650,11382,94.6,69,10,14.5
5,All Students,2022-23,12275,788,11487,93.6,70,13,18.6
All Grades,All Students,2018-19,153909,5436,148473,96.5,874,47,5.4
All Grades,All Students,2019-20,94520,3267,91253,96.5,829,56,6.8
All Grades,All Students,2020-21,143769,9466,134303,93.4,839,166,19.8
All Grades,All Students,2021-22,134565,8257,126308,93.9,779,142,18.2
All Grades,All Students,2022-23,127372,7470,119902,94.1,737,125,17.0
6,All Students,2018-19,55750,1785,53965,96.8,316,14,4.4
6,All Students,2019-20,33718,1247,32471,96.3,296,21,7.1
6,All Students,2020-21,50252,3888,46364,92.3,293,70,23.9
6,All Students,2021-22,44681,2510,42171,94.4,261,46,17.6
6,All Students,2022-23,42777,2072,40705,95.2,249,33,13.3
7,All Students,2018-19,45764,1264,44500,97.2,260,12,4.6
7,All Students,2019-20,32713,882,31831,97.3,287,16,5.6
7,All Students,2020-21,46356,2390,43966,94.8,273,41,15.0
7,All Students,2021-22,44356,2830,41526,93.6,257,48,18.7
7,All Students,2022-23,42461,2271,40190,94.7,247,39,15.8
8,All Students,2018-19,52395,2387,50008,95.4,298,21,7.0
8,All Students,2019-20,28089,1138,26951,95.9,246,19,7.7
8,All Students,2020-21,47161,3188,43973,93.2,273,55,20.1
8,All Students,2021-22,45528,2917,42611,93.6,261,48,18.4
8,All Students,2022-23,42134,3127,39007,92.6,241,53,22.0
All Grades,All Students,2018-19,98333,6430,91903,93.5,583,131,22.5
All Grades,All Students,2019-20,60642,4249,56393,93.0,555,136,24.5
All Grades,All Students,2020-21,84458,6850,77608,91.9,499,119,23.8
All Grades,All Students,2021-22,78224,8310,69914,89.4,478,176,36.8
All Grades,All Students,2022-23,84412,9754,74658,88.4,540,237,43.9
0K,All Students,2018-19,14195,1212,12983,91.5,88,28,31.8
0K,All Students,2019-20,9625,787,8838,91.8,89,26,29.2
0K,All Students,2020-21,13582,1380,12202,89.8,83,22,26.5
0K,All Students,2021-22,12284,1464,10820,88.1,78,35,44.9
0K,All Students,2022-23,12707,1612,11095,87.3,88,41,46.6
1,All Students,2018-19,13594,1003,12591,92.6,82,21,25.6
1,All Students,2019-20,9135,778,8357,91.5,87,28,32.2
1,All Students,2020-21,13416,1198,12218,91.1,80,24,30.0
1,All Students,2021-22,11919,1267,10652,89.4,73,24,32.9
1,All Students,2022-23,13762,1689,12073,87.7,88,44,50.0
2,All Students,2018-19,16103,1023,15080,93.6,95,19,20.0
2,All Students,2019-20,8561,647,7914,92.4,78,21,26.9
2,All Students,2020-21,13918,1121,12797,91.9,82,18,22.0
2,All Students,2021-22,13607,1587,12020,88.3,84,28,33.3
2,All Students,2022-23,14428,1505,12923,89.6,91,34,37.4
3,All Students,2018-19,16593,971,15622,94.1,99,18,18.2
3,All Students,2019-20,10313,630,9683,93.9,93,16,17.2
3,All Students,2020-21,13062,1094,11968,91.6,77,18,23.4
3,All Students,2021-22,13204,1317,11887,90.0,81,29,35.8
3,All Students,2022-23,16324,1958,14366,88.0,104,49,47.1
4,All Students,2018-19,19713,1129,18584,94.3,114,24,21.1
4,All Students,2019-20,10955,665,10290,93.9,98,20,20.4
4,All Students,2020-21,14777,1081,13696,92.7,86,16,18.6
4,All Students,2021-22,12449,1365,11084,89.0,76,33,43.4
4,All Students,2022-23,13709,1663,12046,87.9,83,37,44.6
5,All Students,2018-19,18135,1092,17043,94.0,105,21,20.0
5,All Students,2019-20,12053,742,11311,93.8,110,25,22.7
5,All Students,2020-21,15703,976,14727,93.8,91,21,23.1
5,All Students,2021-22,14761,1310,13451,91.1,86,27,31.4
5,All Students,2022-23,13482,1327,12155,90.2,86,32,37.2
All Grades,All Students,2018-19,78988,8795,70193,88.9,486,228,46.9
All Grades,All Students,2019-20,42692,4281,38411,90.0,396,162,40.9
All Grades,All Students,2020-21,53619,10013,43606,81.3,323,177,54.8
All Grades,All Students,2021-22,53414,8502,44912,84.1,336,203,60.4
All Grades,All Students,2022-23,55124,8090,47034,85.3,371,219,59.0
PK in K-12 Schools,All Students,2018-19,6394,1051,5343,83.6,41,27,65.9
PK in K-12 Schools,All Students,2019-20,2927,450,2477,84.6,27,18,66.7
PK in K-12 Schools,All Students,2020-21,2024,306,1718,84.9,13,7,53.8
PK in K-12 Schools,All Students,2021-22,7334,1486,5848,79.7,50,39,78.0
PK in K-12 Schools,All Students,2022-23,9723,1792,7931,81.6,69,55,79.7
0K,All Students,2018-19,6145,910,5235,85.2,41,25,61.0
0K,All Students,2019-20,3146,430,2716,86.3,30,15,50.0
0K,All Students,2020-21,3024,437,2587,85.5,20,10,50.0
0K,All Students,2021-22,3197,615,2582,80.8,20,12,60.0
0K,All Students,2022-23,3822,598,3224,84.4,28,19,67.9
1,All Students,2018-19,5686,454,5232,92.0,33,11,33.3
1,All Students,2019-20,3174,376,2798,88.2,31,17,54.8
1,All Students,2020-21,4318,1091,3227,74.7,26,18,69.2
1,All Students,2021-22,3990,826,3164,79.3,26,18,69.2
1,All Students,2022-23,3789,653,3136,82.8,28,16,57.1
2,All Students,2018-19,9073,962,8111,89.4,54,28,51.9
2,All Students,2019-20,2866,268,2598,90.6,27,11,40.7
2,All Students,2020-21,4512,980,3532,78.3,27,16,59.3
2,All Students,2021-22,4006,649,3357,83.8,24,15,62.5
2,All Students,2022-23,5176,1019,4157,80.3,32,22,68.8
3,All Students,2018-19,5872,632,5240,89.2,37,15,40.5
3,All Students,2019-20,5327,560,4767,89.5,49,16,32.7
3,All Students,2020-21,4196,567,3629,86.5,25,12,48.0
3,All Students,2021-22,3928,732,3196,81.4,24,15,62.5
3,All Students,2022-23,3795,427,3368,88.7,25,11,44.0
4,All Students,2018-19,7139,650,6489,90.9,46,19,41.3
4,All Students,2019-20,3084,233,2851,92.4,30,11,36.7
4,All Students,2020-21,7627,936,6691,87.7,45,19,42.2
4,All Students,2021-22,4197,531,3666,87.3,27,15,55.6
4,All Students,2022-23,4078,541,3537,86.7,24,12,50.0
5,All Students,2018-19,8584,603,7981,93.0,53,14,26.4
5,All Students,2019-20,4368,369,3999,91.6,38,12,31.6
5,All Students,2020-21,4830,752,4078,84.4,29,14,48.3
5,All Students,2021-22,7205,812,6393,88.7,44,22,50.0
5,All Students,2022-23,4790,549,4241,88.5,34,17,50.0
6,All Students,2018-19,8610,819,7791,90.5,53,26,49.1
6,All Students,2019-20,5457,441,5016,91.9,51,16,31.4
6,All Students,2020-21,6550,1296,5254,80.2,41,21,51.2
6,All Students,2021-22,5374,871,4503,83.8,35,20,57.1
6,All Students,2022-23,6585,564,6021,91.4,43,17,39.5
7,All Students,2018-19,10623,1328,9295,87.5,64,35,54.7
7,All Students,2019-20,5626,511,5115,90.9,52,23,44.2
7,All Students,2020-21,7830,1477,6353,81.1,46,29,63.0
7,All Students,2021-22,6878,1123,5755,83.7,43,26,60.5
7,All Students,2022-23,5463,821,4642,85.0,37,21,56.8
8,All Students,2018-19,10862,1386,9476,87.2,64,28,43.8
8,All Students,2019-20,6717,643,6074,90.4,61,23,37.7
8,All Students,2020-21,8708,2171,6537,75.1,51,31,60.8
8,All Students,2021-22,7305,857,6448,88.3,43,21,48.8
8,All Students,2022-23,7903,1126,6777,85.8,51,29,56.9
All Grades,All Students,2018-19,118678,7476,111202,93.7,708,144,20.3
All Grades,All Students,2019-20,78846,4583,74263,94.2,709,116,16.4
All Grades,All Students,2020-21,104976,5000,99976,95.2,634,81,12.8
All Grades,All Students,2021-22,102453,8335,94118,91.9,623,170,27.3
All Grades,All Students,2022-23,109723,9255,100468,91.6,650,204,31.4
PK in K-12 Schools,All Students,2018-19,18221,1820,16401,90.0,114,41,36.0
PK in K-12 Schools,All Students,2019-20,12367,988,11379,92.0,109,29,26.6
PK in K-12 Schools,All Students,2020-21,16349,1314,15035,92.0,105,32,30.5
PK in K-12 Schools,All Students,2021-22,21117,2453,18664,88.4,128,59,46.1
PK in K-12 Schools,All Students,2022-23,21380,2412,18968,88.7,126,59,46.8
0K,All Students,2018-19,18864,1544,17320,91.8,115,34,29.6
0K,All Students,2019-20,12437,770,11667,93.8,113,18,15.9
0K,All Students,2020-21,19369,1131,18238,94.2,119,16,13.4
0K,All Students,2021-22,15655,1329,14326,91.5,96,31,32.3
0K,All Students,2022-23,16868,1702,15166,89.9,104,45,43.3
1,All Students,2018-19,17258,941,16317,94.5,102,16,15.7
1,All Students,2019-20,12205,625,11580,94.9,109,16,14.7
1,All Students,2020-21,14835,754,14081,94.9,92,13,14.1
1,All Students,2021-22,18151,1287,16864,92.9,109,20,18.3
1,All Students,2022-23,16369,1375,14994,91.6,95,34,35.8
2,All Students,2018-19,15444,672,14772,95.6,90,9,10.0
2,All Students,2019-20,10700,613,10087,94.3,97,15,15.5
2,All Students,2020-21,14988,508,14480,96.6,88,4,4.5
2,All Students,2021-22,12927,990,11937,92.3,77,21,27.3
2,All Students,2022-23,17346,1237,16109,92.9,101,24,23.8
3,All Students,2018-19,16437,961,15476,94.2,97,19,19.6
3,All Students,2019-20,9691,406,9285,95.8,89,7,7.9
3,All Students,2020-21,13212,419,12793,96.8,80,6,7.5
3,All Students,2021-22,11597,647,10950,94.4,71,9,12.7
3,All Students,2022-23,12761,831,11930,93.5,74,13,17.6
4,All Students,2018-19,18098,933,17165,94.8,107,19,17.8
4,All Students,2019-20,10574,503,10071,95.2,96,14,14.6
4,All Students,2020-21,12212,222,11990,98.2,70,2,2.9
4,All Students,2021-22,12860,849,12011,93.4,78,14,17.9
4,All Students,2022-23,12258,909,11349,92.6,74,18,24.3
5,All Students,2018-19,14356,605,13751,95.8,83,6,7.2
5,All Students,2019-20,10872,678,10194,93.8,96,17,17.7
5,All Students,2020-21,14011,652,13359,95.3,80,8,10.0
5,All Students,2021-22,10146,780,9366,92.3,64,16,25.0
5,All Students,2022-23,12741,789,11952,93.8,76,11,14.5
All Grades,All Students,2018-19,158227,7027,151200,95.6,913,87,9.5
All Grades,All Students,2019-20,100126,4595,95531,95.4,884,85,9.6
All Grades,All Students,2020-21,116903,478,116425,99.6,690,3,0.4
All Grades,All Students,2021-22,112400,7529,104871,93.3,654,131,20.0
All Grades,All Students,2022-23,122897,9196,113701,92.5,724,172,23.8
PK in K-12 Schools,All Students,2018-19,3202,173,3029,94.6,18,3,16.7
PK in K-12 Schools,All Students,2019-20,2070,111,1959,94.6,18,3,16.7
PK in K-12 Schools,All Students,2020-21,2564,s,s,s,s,s,s
PK in K-12 Schools,All Students,2021-22,3180,313,2867,90.2,19,7,36.8
PK in K-12 Schools,All Students,2022-23,3123,285,2838,90.9,18,6,33.3
0K,All Students,2018-19,25946,1468,24478,94.3,150,21,14.0
0K,All Students,2019-20,16502,1114,15388,93.2,145,31,21.4
0K,All Students,2020-21,19904,52,19852,99.7,120,0,0.0
0K,All Students,2021-22,21675,1648,20027,92.4,125,35,28.0
0K,All Students,2022-23,23894,1899,21995,92.1,142,41,28.9
1,All Students,2018-19,23782,1036,22746,95.6,137,12,8.8
1,All Students,2019-20,15905,831,15074,94.8,143,15,10.5
1,All Students,2020-21,18363,118,18245,99.4,109,1,0.9
1,All Students,2021-22,19309,1248,18061,93.5,111,19,17.1
1,All Students,2022-23,24054,1955,22099,91.9,139,38,27.3
2,All Students,2018-19,25799,1237,24562,95.2,149,15,10.1
2,All Students,2019-20,15890,634,15256,96.0,141,8,5.7
2,All Students,2020-21,18934,62,18872,99.7,110,0,0.0
2,All Students,2021-22,17520,1217,16303,93.1,104,24,23.1
2,All Students,2022-23,20206,1418,18788,93.0,120,23,19.2
3,All Students,2018-19,29187,1375,27812,95.3,169,15,8.9
3,All Students,2019-20,16271,809,15462,95.0,143,15,10.5
3,All Students,2020-21,18960,93,18867,99.5,111,0,0.0
3,All Students,2021-22,17422,1073,16349,93.8,103,16,15.5
3,All Students,2022-23,18700,1486,17214,92.1,109,26,23.9
4,All Students,2018-19,26994,721,26273,97.3,156,6,3.8
4,All Students,2019-20,18303,501,17802,97.3,161,8,5.0
4,All Students,2020-21,19510,83,19427,99.6,113,1,0.9
4,All Students,2021-22,16780,827,15953,95.1,96,10,10.4
4,All Students,2022-23,16996,1094,15902,93.6,100,18,18.0
5,All Students,2018-19,23317,1017,22300,95.6,134,15,11.2
5,All Students,2019-20,15185,595,14590,96.1,133,5,3.8
5,All Students,2020-21,18610,60,18550,99.7,110,1,0.9
5,All Students,2021-22,16514,1203,15311,92.7,96,20,20.8
5,All Students,2022-23,15924,1059,14865,93.3,96,20,20.8
6,All Students,2020-21,6,s,s,s,s,s,s
All Grades,All Students,2018-19,70352,8440,61912,88.0,438,212,48.4
All Grades,All Students,2019-20,46369,5309,41060,88.6,437,185,42.3
All Grades,All Students,2020-21,69197,10806,58391,84.4,418,188,45.0
All Grades,All Students,2021-22,67341,12268,55073,81.8,422,291,69.0
All Grades,All Students,2022-23,87788,14437,73351,83.6,583,370,63.5
PK in K-12 Schools,All Students,2018-19,9363,1424,7939,84.8,59,37,62.7
PK in K-12 Schools,All Students,2019-20,5599,611,4988,89.1,57,22,38.6
PK in K-12 Schools,All Students,2020-21,7129,684,6445,90.4,45,15,33.3
PK in K-12 Schools,All Students,2021-22,8038,1806,6232,77.5,55,48,87.3
PK in K-12 Schools,All Students,2022-23,13264,2335,10929,82.4,93,66,71.0
0K,All Students,2018-19,10420,1378,9042,86.8,63,31,49.2
0K,All Students,2019-20,7427,1067,6360,85.6,68,36,52.9
0K,All Students,2020-21,11444,1819,9625,84.1,72,32,44.4
0K,All Students,2021-22,8723,1380,7343,84.2,54,34,63.0
0K,All Students,2022-23,13419,2484,10935,81.5,82,57,69.5
1,All Students,2018-19,11653,1337,10316,88.5,75,38,50.7
1,All Students,2019-20,6914,845,6069,87.8,67,31,46.3
1,All Students,2020-21,10730,1814,8916,83.1,64,29,45.3
1,All Students,2021-22,11294,2217,9077,80.4,70,48,68.6
1,All Students,2022-23,11065,s,s,s,s,s,s
2,All Students,2018-19,10082,1300,8782,87.1,62,34,54.8
2,All Students,2019-20,6927,730,6197,89.5,62,23,37.1
2,All Students,2020-21,10503,1767,8736,83.2,64,28,43.8
2,All Students,2021-22,10221,1614,8607,84.2,64,46,71.9
2,All Students,2022-23,13151,1857,11294,85.9,91,54,59.3
3,All Students,2018-19,11132,1256,9876,88.7,68,30,44.1
3,All Students,2019-20,6713,754,5959,88.8,66,26,39.4
3,All Students,2020-21,10155,1198,8957,88.2,60,17,28.3
3,All Students,2021-22,9144,1764,7380,80.7,60,40,66.7
3,All Students,2022-23,12476,1746,10730,86.0,83,48,57.8
4,All Students,2018-19,9511,973,8538,89.8,59,24,40.7
4,All Students,2019-20,6627,725,5902,89.1,61,26,42.6
4,All Students,2020-21,9535,1978,7557,79.3,56,36,64.3
4,All Students,2021-22,9904,1449,8455,85.4,59,32,54.2
4,All Students,2022-23,11360,1758,9602,84.5,73,46,63.0
5,All Students,2018-19,8191,772,7419,90.6,52,18,34.6
5,All Students,2019-20,6162,577,5585,90.6,56,21,37.5
5,All Students,2020-21,9701,1546,8155,84.1,57,31,54.4
5,All Students,2021-22,10017,2038,7979,79.7,60,43,71.7
5,All Students,2022-23,12884,1932,10952,85.0,83,45,54.2
6,All Students,2022-23,169,s,s,s,s,s,s
All Grades,All Students,2018-19,42221,2676,39545,93.7,262,57,21.8
All Grades,All Students,2019-20,25208,1828,23380,92.7,239,67,28.0
All Grades,All Students,2020-21,35231,4603,30628,86.9,220,99,45.0
All Grades,All Students,2021-22,48705,8455,40250,82.6,306,208,68.0
All Grades,All Students,2022-23,50026,7073,42953,85.9,321,168,52.3
PK in K-12 Schools,All Students,2018-19,5229,518,4711,90.1,33,15,45.5
PK in K-12 Schools,All Students,2019-20,1725,221,1504,87.2,20,11,55.0
PK in K-12 Schools,All Students,2020-21,875,s,s,s,s,s,s
PK in K-12 Schools,All Students,2021-22,7066,1777,5289,74.9,48,40,83.3
PK in K-12 Schools,All Students,2022-23,7041,1470,5571,79.1,51,39,76.5
0K,All Students,2018-19,2273,222,2051,90.2,17,5,29.4
0K,All Students,2019-20,2747,249,2498,90.9,27,10,37.0
0K,All Students,2020-21,2228,292,1936,86.9,16,7,43.8
0K,All Students,2021-22,4070,982,3088,75.9,26,21,80.8
0K,All Students,2022-23,3809,764,3045,79.9,27,19,70.4
1,All Students,2018-19,3338,193,3145,94.2,22,4,18.2
1,All Students,2019-20,1780,133,1647,92.5,18,5,27.8
1,All Students,2020-21,4133,843,3290,79.6,24,14,58.3
1,All Students,2021-22,3708,634,3074,82.9,22,14,63.6
1,All Students,2022-23,3766,474,3292,87.4,26,15,57.7
2,All Students,2018-19,3594,134,3460,96.3,21,1,4.8
2,All Students,2019-20,1741,150,1591,91.4,17,6,35.3
2,All Students,2020-21,2616,254,2362,90.3,15,5,33.3
2,All Students,2021-22,3719,657,3062,82.3,24,16,66.7
2,All Students,2022-23,3960,427,3533,89.2,24,8,33.3
3,All Students,2018-19,5006,363,4643,92.7,30,8,26.7
3,All Students,2019-20,2094,104,1990,95.0,19,4,21.1
3,All Students,2020-21,2192,s,s,s,s,s,s
3,All Students,2021-22,3516,419,3097,88.1,20,8,40.0
3,All Students,2022-23,4199,433,3766,89.7,27,8,29.6
4,All Students,2018-19,4035,268,3767,93.4,26,7,26.9
4,All Students,2019-20,3001,226,2775,92.5,27,9,33.3
4,All Students,2020-21,3567,282,3285,92.1,21,7,33.3
4,All Students,2021-22,4010,591,3419,85.3,26,15,57.7
4,All Students,2022-23,3827,400,3427,89.5,23,10,43.5
5,All Students,2018-19,3050,240,2810,92.1,18,5,27.8
5,All Students,2019-20,2529,123,2406,95.1,23,3,13.0
5,All Students,2020-21,4565,518,4047,88.7,30,13,43.3
5,All Students,2021-22,3947,462,3485,88.3,23,10,43.5
5,All Students,2022-23,3830,452,3378,88.2,25,6,24.0
6,All Students,2018-19,5791,308,5483,94.7,35,6,17.1
6,All Students,2019-20,2996,187,2809,93.8,28,5,17.9
6,All Students,2020-21,5345,938,4407,82.5,33,18,54.5
6,All Students,2021-22,7796,1069,6727,86.3,48,34,70.8
6,All Students,2022-23,6486,886,5600,86.3,38,22,57.9
7,All Students,2018-19,4919,220,4699,95.5,31,3,9.7
7,All Students,2019-20,3560,257,3303,92.8,33,10,30.3
7,All Students,2020-21,4512,583,3929,87.1,29,15,51.7
7,All Students,2021-22,5219,941,4278,82.0,31,23,74.2
7,All Students,2022-23,7756,978,6778,87.4,46,24,52.2
8,All Students,2018-19,4986,210,4776,95.8,29,3,10.3
8,All Students,2019-20,3035,178,2857,94.1,27,4,14.8
8,All Students,2020-21,5198,578,4620,88.9,32,13,40.6
8,All Students,2021-22,5654,923,4731,83.7,38,27,71.1
8,All Students,2022-23,5352,789,4563,85.3,34,17,50.0
All Grades,All Students,2018-19,98451,6296,92155,93.6,595,136,22.9
All Grades,All Students,2019-20,62612,4112,58500,93.4,567,117,20.6
All Grades,All Students,2020-21,84285,5078,79207,94.0,507,93,18.3
All Grades,All Students,2021-22,73271,7322,65949,90.0,432,169,39.1
All Grades,All Students,2022-23,78202,8468,69734,89.2,532,237,44.5
PK in K-12 Schools,All Students,2018-19,5983,438,5545,92.7,39,11,28.2
PK in K-12 Schools,All Students,2019-20,4059,337,3722,91.7,36,12,33.3
PK in K-12 Schools,All Students,2020-21,5279,363,4916,93.1,34,7,20.6
PK in K-12 Schools,All Students,2021-22,5692,750,4942,86.8,34,22,64.7
PK in K-12 Schools,All Students,2022-23,5678,719,4959,87.3,34,17,50.0
0K,All Students,2018-19,12690,899,11791,92.9,81,23,28.4
0K,All Students,2019-20,9704,976,8728,89.9,89,26,29.2
0K,All Students,2020-21,11361,899,10462,92.1,70,21,30.0
0K,All Students,2021-22,9759,1220,8539,87.5,58,29,50.0
0K,All Students,2022-23,12303,1654,10649,86.6,87,46,52.9
1,All Students,2018-19,15336,980,14356,93.6,90,21,23.3
1,All Students,2019-20,8326,458,7868,94.5,75,11,14.7
1,All Students,2020-21,13840,1275,12565,90.8,83,21,25.3
1,All Students,2021-22,9719,1088,8631,88.8,59,22,37.3
1,All Students,2022-23,10487,1057,9430,89.9,76,32,42.1
2,All Students,2018-19,14536,856,13680,94.1,87,16,18.4
2,All Students,2019-20,9828,672,9156,93.2,88,23,26.1
2,All Students,2020-21,12093,559,11534,95.4,72,8,11.1
2,All Students,2021-22,12740,1387,11353,89.1,75,28,37.3
2,All Students,2022-23,11330,1497,9833,86.8,79,42,53.2
3,All Students,2018-19,15440,1046,14394,93.2,95,24,25.3
3,All Students,2019-20,9421,461,8960,95.1,87,11,12.6
3,All Students,2020-21,13645,579,13066,95.8,79,11,13.9
3,All Students,2021-22,11120,787,10333,92.9,66,18,27.3
3,All Students,2022-23,13689,1450,12239,89.4,89,40,44.9
4,All Students,2018-19,16773,1010,15763,94.0,100,21,21.0
4,All Students,2019-20,10689,628,10061,94.1,99,21,21.2
4,All Students,2020-21,13811,456,13355,96.7,83,8,9.6
4,All Students,2021-22,11147,1023,10124,90.8,65,22,33.8
4,All Students,2022-23,12162,801,11361,93.4,84,26,31.0
5,All Students,2018-19,17693,1067,16626,94.0,103,20,19.4
5,All Students,2019-20,10585,580,10005,94.5,93,13,14.0
5,All Students,2020-21,14256,947,13309,93.4,86,17,19.8
5,All Students,2021-22,13094,1067,12027,91.9,75,28,37.3
5,All Students,2022-23,12553,1290,11263,89.7,83,34,41.0
All Grades,All Students,2018-19,75946,6775,69171,91.1,462,163,35.3
All Grades,All Students,2019-20,49651,4619,45032,90.7,444,138,31.1
All Grades,All Students,2020-21,64753,5909,58844,90.9,403,122,30.3
All Grades,All Students,2021-22,61603,7155,54448,88.4,366,143,39.1
All Grades,All Students,2022-23,67721,7519,60202,88.9,423,195,46.1
PK in K-12 Schools,All Students,2018-19,5844,775,5069,86.7,41,23,56.1
PK in K-12 Schools,All Students,2019-20,3926,s,s,s,s,s,s
PK in K-12 Schools,All Students,2020-21,4595,372,4223,91.9,30,7,23.3
PK in K-12 Schools,All Students,2021-22,6032,676,5356,88.8,36,12,33.3
PK in K-12 Schools,All Students,2022-23,5465,864,4601,84.2,41,25,61.0
0K,All Students,2018-19,10611,1133,9478,89.3,67,28,41.8
0K,All Students,2019-20,9611,970,8641,89.9,87,28,32.2
0K,All Students,2020-21,9038,796,8242,91.2,60,16,26.7
0K,All Students,2021-22,10710,1146,9564,89.3,65,23,35.4
0K,All Students,2022-23,11319,1295,10024,88.6,72,34,47.2
1,All Students,2018-19,10479,840,9639,92.0,62,20,32.3
1,All Students,2019-20,6830,698,6132,89.8,60,22,36.7
1,All Students,2020-21,14084,1459,12625,89.6,84,26,31.0
1,All Students,2021-22,8092,995,7097,87.7,48,16,33.3
1,All Students,2022-23,11768,1260,10508,89.3,70,29,41.4
2,All Students,2018-19,10295,1047,9248,89.8,64,30,46.9
2,All Students,2019-20,6600,551,6049,91.7,59,14,23.7
2,All Students,2020-21,8699,833,7866,90.4,56,20,35.7
2,All Students,2021-22,13319,1761,11558,86.8,78,33,42.3
2,All Students,2022-23,9215,841,8374,90.9,59,22,37.3
3,All Students,2018-19,12875,1086,11789,91.6,76,22,28.9
3,All Students,2019-20,7058,690,6368,90.2,63,20,31.7
3,All Students,2020-21,8684,595,8089,93.1,57,18,31.6
3,All Students,2021-22,7441,816,6625,89.0,44,17,38.6
3,All Students,2022-23,14336,1616,12720,88.7,85,42,49.4
4,All Students,2018-19,12378,880,11498,92.9,73,18,24.7
4,All Students,2019-20,7411,631,6780,91.5,67,21,31.3
4,All Students,2020-21,9362,877,8485,90.6,55,15,27.3
4,All Students,2021-22,7414,766,6648,89.7,42,16,38.1
4,All Students,2022-23,8573,997,7576,88.4,52,24,46.2
5,All Students,2018-19,13464,1014,12450,92.5,79,22,27.8
5,All Students,2019-20,8213,701,7512,91.5,72,21,29.2
5,All Students,2020-21,10291,977,9314,90.5,61,20,32.8
5,All Students,2021-22,8595,995,7600,88.4,53,26,49.1
5,All Students,2022-23,7045,646,6399,90.8,44,19,43.2
6,All Students,2019-20,2,s,s,s,s,s,s
All Grades,All Students,2018-19,113376,4283,109093,96.2,648,39,6.0
All Grades,All Students,2019-20,75916,3386,72530,95.5,673,63,9.4
All Grades,All Students,2020-21,103190,2822,100368,97.3,615,32,5.2
All Grades,All Students,2021-22,104212,6518,97694,93.7,606,109,18.0
All Grades,All Students,2022-23,105143,6866,98277,93.5,621,106,17.1
0K,All Students,2018-19,21857,925,20932,95.8,125,9,7.2
0K,All Students,2019-20,13362,775,12587,94.2,119,20,16.8
0K,All Students,2020-21,16458,507,15951,96.9,99,5,5.1
0K,All Students,2021-22,18489,1298,17191,93.0,109,27,24.8
0K,All Students,2022-23,16629,1448,15181,91.3,100,30,30.0
1,All Students,2018-19,21330,921,20409,95.7,122,8,6.6
1,All Students,2019-20,14124,672,13452,95.2,127,13,10.2
1,All Students,2020-21,17136,570,16566,96.7,103,7,6.8
1,All Students,2021-22,18227,1101,17126,94.0,105,17,16.2
1,All Students,2022-23,19222,1341,17881,93.0,114,20,17.5
2,All Students,2018-19,20961,790,20171,96.2,119,6,5.0
2,All Students,2019-20,13497,638,12859,95.3,119,11,9.2
2,All Students,2020-21,18499,552,17947,97.0,112,7,6.3
2,All Students,2021-22,16749,782,15967,95.3,97,5,5.2
2,All Students,2022-23,20346,1206,19140,94.1,119,16,13.4
3,All Students,2018-19,20218,737,19481,96.4,116,7,6.0
3,All Students,2019-20,13751,597,13154,95.7,122,9,7.4
3,All Students,2020-21,18464,395,18069,97.9,107,2,1.9
3,All Students,2021-22,18380,1347,17033,92.7,108,27,25.0
3,All Students,2022-23,17414,980,16434,94.4,103,10,9.7
4,All Students,2018-19,14817,411,14406,97.2,86,5,5.8
4,All Students,2019-20,12561,350,12211,97.2,111,5,4.5
4,All Students,2020-21,17591,503,17088,97.1,106,7,6.6
4,All Students,2021-22,17230,979,16251,94.3,99,17,17.2
4,All Students,2022-23,17352,978,16374,94.4,103,17,16.5
5,All Students,2018-19,14193,499,13694,96.5,80,4,5.0
5,All Students,2019-20,8621,354,8267,95.9,75,5,6.7
5,All Students,2020-21,15042,295,14747,98.0,88,4,4.5
5,All Students,2021-22,15137,1011,14126,93.3,88,16,18.2
5,All Students,2022-23,14180,913,13267,93.6,82,13,15.9
All Grades,All Students,2018-19,91333,8629,82704,90.6,559,179,32.0
All Grades,All Students,2019-20,58674,4805,53869,91.8,527,162,30.7
All Grades,All Students,2020-21,75167,12425,62742,83.5,444,203,45.7
All Grades,All Students,2021-22,69583,8571,61012,87.7,421,209,49.6
All Grades,All Students,2022-23,61713,8439,53274,86.3,386,196,50.8
PK in K-12 Schools,All Students,2018-19,14730,1326,13404,91.0,91,32,35.2
PK in K-12 Schools,All Students,2019-20,8938,790,8148,91.2,79,28,35.4
PK in K-12 Schools,All Students,2020-21,8661,1256,7405,85.5,53,20,37.7
PK in K-12 Schools,All Students,2021-22,11320,1620,9700,85.7,68,43,63.2
PK in K-12 Schools,All Students,2022-23,8651,1301,7350,85.0,54,29,53.7
0K,All Students,2018-19,8750,899,7851,89.7,50,14,28.0
0K,All Students,2019-20,7778,678,7100,91.3,71,22,31.0
0K,All Students,2020-21,9107,1168,7939,87.2,55,20,36.4
0K,All Students,2021-22,5773,730,5043,87.4,35,18,51.4
0K,All Students,2022-23,8642,1137,7505,86.8,52,25,48.1
1,All Students,2018-19,7702,756,6946,90.2,48,16,33.3
1,All Students,2019-20,5266,440,4826,91.6,48,16,33.3
1,All Students,2020-21,9035,1482,7553,83.6,54,23,42.6
1,All Students,2021-22,7266,968,6298,86.7,44,23,52.3
1,All Students,2022-23,5189,632,4557,87.8,33,17,51.5
2,All Students,2018-19,8595,753,7842,91.2,56,14,25.0
2,All Students,2019-20,4556,s,s,s,s,s,s
2,All Students,2020-21,6306,811,5495,87.1,37,11,29.7
2,All Students,2021-22,8020,837,7183,89.6,48,17,35.4
2,All Students,2022-23,6014,1044,4970,82.6,35,18,51.4
3,All Students,2018-19,8476,791,7685,90.7,52,20,38.5
3,All Students,2019-20,5424,340,5084,93.7,48,7,14.6
3,All Students,2020-21,6475,1123,5352,82.7,37,17,45.9
3,All Students,2021-22,6787,875,5912,87.1,43,24,55.8
3,All Students,2022-23,6871,604,6267,91.2,41,11,26.8
4,All Students,2018-19,8530,818,7712,90.4,50,13,26.0
4,All Students,2019-20,4858,361,4497,92.6,43,11,25.6
4,All Students,2020-21,7675,1221,6454,84.1,45,22,48.9
4,All Students,2021-22,5700,783,4917,86.3,35,19,54.3
4,All Students,2022-23,6328,876,5452,86.2,38,24,63.2
5,All Students,2018-19,8036,733,7303,90.9,47,10,21.3
5,All Students,2019-20,5278,403,4875,92.4,47,15,31.9
5,All Students,2020-21,7241,1335,5906,81.6,43,26,60.5
5,All Students,2021-22,6758,605,6153,91.0,41,14,34.1
5,All Students,2022-23,5627,800,4827,85.8,35,19,54.3
6,All Students,2018-19,8137,682,7455,91.6,51,13,25.5
6,All Students,2019-20,4945,391,4554,92.1,45,18,40.0
6,All Students,2020-21,4505,701,3804,84.4,26,13,50.0
6,All Students,2021-22,5628,722,4906,87.2,32,19,59.4
6,All Students,2022-23,4486,524,3962,88.3,31,19,61.3
7,All Students,2018-19,8281,704,7577,91.5,51,20,39.2
7,All Students,2019-20,6052,476,5576,92.1,54,14,25.9
7,All Students,2020-21,7134,1811,5323,74.6,42,27,64.3
7,All Students,2021-22,5285,611,4674,88.4,33,12,36.4
7,All Students,2022-23,4494,694,3800,84.6,32,14,43.8
8,All Students,2018-19,10096,1167,8929,88.4,63,27,42.9
8,All Students,2019-20,5480,414,5066,92.4,51,16,31.4
8,All Students,2020-21,9028,1517,7511,83.2,52,24,46.2
8,All Students,2021-22,7046,820,6226,88.4,42,20,47.6
8,All Students,2022-23,5411,827,4584,84.7,35,20,57.1
9,All Students,2019-20,99,s,s,s,s,s,s
All Grades,All Students,2018-19,64991,5651,59340,91.3,391,127,32.5
All Grades,All Students,2019-20,40261,3639,36622,91.0,372,134,36.0
All Grades,All Students,2020-21,55522,6268,49254,88.7,332,129,38.9
All Grades,All Students,2021-22,50712,7811,42901,84.6,311,190,61.1
All Grades,All Students,2022-23,48223,6326,41897,86.9,288,157,54.5
PK in K-12 Schools,All Students,2018-19,11332,1085,10247,90.4,71,25,35.2
PK in K-12 Schools,All Students,2019-20,5082,578,4504,88.6,49,26,53.1
PK in K-12 Schools,All Students,2020-21,5372,627,4745,88.3,35,16,45.7
PK in K-12 Schools,All Students,2021-22,9836,1602,8234,83.7,65,40,61.5
PK in K-12 Schools,All Students,2022-23,12805,1640,11165,87.2,76,43,56.6
0K,All Students,2018-19,10553,943,9610,91.1,62,23,37.1
0K,All Students,2019-20,7887,715,7172,90.9,72,30,41.7
0K,All Students,2020-21,7565,1089,6476,85.6,48,20,41.7
0K,All Students,2021-22,6527,1041,5486,84.1,40,27,67.5
0K,All Students,2022-23,4432,627,3805,85.9,27,16,59.3
1,All Students,2018-19,9395,833,8562,91.1,58,17,29.3
1,All Students,2019-20,5676,495,5181,91.3,53,19,35.8
1,All Students,2020-21,9891,1112,8779,88.8,58,19,32.8
1,All Students,2021-22,5648,829,4819,85.3,34,17,50.0
1,All Students,2022-23,5192,719,4473,86.2,30,17,56.7
2,All Students,2018-19,9631,841,8790,91.3,58,18,31.0
2,All Students,2019-20,5883,463,5420,92.1,52,13,25.0
2,All Students,2020-21,7194,504,6690,93.0,42,8,19.0
2,All Students,2021-22,8671,1324,7347,84.7,52,32,61.5
2,All Students,2022-23,5332,820,4512,84.6,33,17,51.5
3,All Students,2018-19,11126,936,10190,91.6,66,23,34.8
3,All Students,2019-20,6071,552,5519,90.9,55,15,27.3
3,All Students,2020-21,8593,740,7853,91.4,51,19,37.3
3,All Students,2021-22,5717,775,4942,86.4,34,23,67.6
3,All Students,2022-23,8432,996,7436,88.2,50,24,48.0
4,All Students,2018-19,6573,557,6016,91.5,39,10,25.6
4,All Students,2019-20,6203,565,5638,90.9,59,24,40.7
4,All Students,2020-21,8152,1240,6912,84.8,48,26,54.2
4,All Students,2021-22,6913,1051,5862,84.8,42,21,50.0
4,All Students,2022-23,5419,606,4813,88.8,33,17,51.5
5,All Students,2018-19,6381,456,5925,92.9,37,11,29.7
5,All Students,2019-20,3459,271,3188,92.2,32,7,21.9
5,All Students,2020-21,8755,956,7799,89.1,50,21,42.0
5,All Students,2021-22,7400,1189,6211,83.9,44,30,68.2
5,All Students,2022-23,6611,918,5693,86.1,39,23,59.0
All Grades,All Students,2018-19,100626,9337,91289,90.7,615,226,36.7
All Grades,All Students,2019-20,61764,5500,56264,91.1,568,187,32.9
All Grades,All Students,2020-21,92063,15987,76076,82.6,548,290,52.9
All Grades,All Students,2021-22,87660,15683,71977,82.1,533,340,63.8
All Grades,All Students,2022-23,88554,14573,73981,83.5,632,421,66.6
PK in K-12 Schools,All Students,2018-19,15787,1301,14486,91.8,96,28,29.2
PK in K-12 Schools,All Students,2019-20,10250,856,9394,91.6,95,28,29.5
PK in K-12 Schools,All Students,2020-21,13591,2130,11461,84.3,81,36,44.4
PK in K-12 Schools,All Students,2021-22,11351,1866,9485,83.6,67,41,61.2
PK in K-12 Schools,All Students,2022-23,8774,1596,7178,81.8,60,42,70.0
0K,All Students,2018-19,8473,1126,7347,86.7,56,29,51.8
0K,All Students,2019-20,4774,531,4243,88.9,46,19,41.3
0K,All Students,2020-21,7771,1478,6293,81.0,49,26,53.1
0K,All Students,2021-22,7848,1837,6011,76.6,53,39,73.6
0K,All Students,2022-23,8704,1630,7074,81.3,59,46,78.0
1,All Students,2018-19,8657,890,7767,89.7,52,22,42.3
1,All Students,2019-20,4515,409,4106,90.9,41,15,36.6
1,All Students,2020-21,7400,1551,5849,79.0,45,27,60.0
1,All Students,2021-22,7646,1640,6006,78.6,49,36,73.5
1,All Students,2022-23,8269,1646,6623,80.1,61,49,80.3
2,All Students,2018-19,7446,662,6784,91.1,47,19,40.4
2,All Students,2019-20,5658,522,5136,90.8,51,19,37.3
2,All Students,2020-21,6984,1293,5691,81.5,41,27,65.9
2,All Students,2021-22,7118,1212,5906,83.0,42,28,66.7
2,All Students,2022-23,7990,1347,6643,83.1,62,39,62.9
3,All Students,2018-19,8143,814,7329,90.0,50,21,42.0
3,All Students,2019-20,5901,498,5403,91.6,53,16,30.2
3,All Students,2020-21,9671,1110,8561,88.5,59,23,39.0
3,All Students,2021-22,8088,1391,6697,82.8,49,32,65.3
3,All Students,2022-23,7785,s,s,s,s,s,s
4,All Students,2018-19,9662,1011,8651,89.5,58,27,46.6
4,All Students,2019-20,4868,449,4419,90.8,44,19,43.2
4,All Students,2020-21,8386,1344,7042,84.0,49,25,51.0
4,All Students,2021-22,10943,1469,9474,86.6,65,38,58.5
4,All Students,2022-23,7834,1056,6778,86.5,57,29,50.9
5,All Students,2018-19,9145,689,8456,92.5,54,16,29.6
5,All Students,2019-20,5382,620,4762,88.5,48,20,41.7
5,All Students,2020-21,7356,1308,6048,82.2,44,22,50.0
5,All Students,2021-22,9308,1552,7756,83.3,55,33,60.0
5,All Students,2022-23,11409,1221,10188,89.3,73,33,45.2
6,All Students,2018-19,11200,944,10256,91.6,68,19,27.9
6,All Students,2019-20,6256,531,5725,91.5,60,14,23.3
6,All Students,2020-21,7931,1563,6368,80.3,46,33,71.7
6,All Students,2021-22,7219,1373,5846,81.0,46,34,73.9
6,All Students,2022-23,8741,1538,7203,82.4,63,44,69.8
7,All Students,2018-19,11513,951,10562,91.7,69,21,30.4
7,All Students,2019-20,7800,587,7213,92.5,72,23,31.9
7,All Students,2020-21,10374,2359,8015,77.3,62,43,69.4
7,All Students,2021-22,8244,1510,6734,81.7,51,32,62.7
7,All Students,2022-23,9697,1789,7908,81.6,71,49,69.0
8,All Students,2018-19,10600,949,9651,91.0,65,24,36.9
8,All Students,2019-20,6360,497,5863,92.2,58,14,24.1
8,All Students,2020-21,12599,1851,10748,85.3,72,28,38.9
8,All Students,2021-22,9895,1833,8062,81.5,56,27,48.2
8,All Students,2022-23,9346,1521,7825,83.7,66,50,75.8
9,All Students,2022-23,5,s,s,s,s,s,s
All Grades,All Students,2018-19,145526,5791,139735,96.0,832,57,6.9
All Grades,All Students,2019-20,88063,3669,84394,95.8,780,56,7.2
All Grades,All Students,2020-21,107646,2963,104683,97.2,636,33,5.2
All Grades,All Students,2021-22,96951,5954,90997,93.9,570,94,16.5
All Grades,All Students,2022-23,97070,6736,90334,93.1,583,124,21.3
0K,All Students,2018-19,22232,1189,21043,94.7,126,16,12.7
0K,All Students,2019-20,13305,751,12554,94.4,116,15,12.9
0K,All Students,2020-21,16051,457,15594,97.2,97,6,6.2
0K,All Students,2021-22,14350,1335,13015,90.7,89,27,30.3
0K,All Students,2022-23,16659,1316,15343,92.1,103,31,30.1
1,All Students,2018-19,18362,699,17663,96.2,106,5,4.7
1,All Students,2019-20,14059,669,13390,95.2,126,16,12.7
1,All Students,2020-21,15914,341,15573,97.9,95,4,4.2
1,All Students,2021-22,15930,971,14959,93.9,92,11,12.0
1,All Students,2022-23,14292,1205,13087,91.6,87,28,32.2
2,All Students,2018-19,23890,946,22944,96.0,138,4,2.9
2,All Students,2019-20,11984,417,11567,96.5,108,3,2.8
2,All Students,2020-21,18198,549,17649,97.0,108,6,5.6
2,All Students,2021-22,16045,831,15214,94.8,93,10,10.8
2,All Students,2022-23,16370,1063,15307,93.5,102,18,17.6
3,All Students,2018-19,27501,964,26537,96.5,156,7,4.5
3,All Students,2019-20,14523,653,13870,95.5,130,9,6.9
3,All Students,2020-21,17032,337,16695,98.0,101,4,4.0
3,All Students,2021-22,17754,1012,16742,94.3,102,14,13.7
3,All Students,2022-23,15360,970,14390,93.7,89,11,12.4
4,All Students,2018-19,27813,716,27097,97.4,159,6,3.8
4,All Students,2019-20,17039,512,16527,97.0,150,5,3.3
4,All Students,2020-21,17491,318,17173,98.2,102,2,2.0
4,All Students,2021-22,16436,786,15650,95.2,97,13,13.4
4,All Students,2022-23,18553,1326,17227,92.9,108,26,24.1
5,All Students,2018-19,25728,1277,24451,95.0,147,19,12.9
5,All Students,2019-20,17153,667,16486,96.1,150,8,5.3
5,All Students,2020-21,22960,961,21999,95.8,133,11,8.3
5,All Students,2021-22,16436,1019,15417,93.8,97,19,19.6
5,All Students,2022-23,15836,856,14980,94.6,94,10,10.6
All Grades,All Students,2018-19,23283,1860,21423,92.0,148,46,31.1
All Grades,All Students,2019-20,11220,1022,10198,90.9,101,33,32.7
All Grades,All Students,2020-21,18286,2673,15613,85.4,110,61,55.5
All Grades,All Students,2021-22,20291,2618,17673,87.1,130,70,53.8
All Grades,All Students,2022-23,19594,2538,17056,87.0,129,67,51.9
PK in K-12 Schools,All Students,2020-21,1945,292,1653,85.0,13,7,53.8
PK in K-12 Schools,All Students,2021-22,4283,791,3492,81.5,31,24,77.4
PK in K-12 Schools,All Students,2022-23,4481,741,3740,83.5,31,20,64.5
0K,All Students,2018-19,1642,152,1490,90.7,12,5,41.7
0K,All Students,2019-20,614,s,s,s,s,s,s
0K,All Students,2020-21,2860,421,2439,85.3,18,9,50.0
0K,All Students,2021-22,2850,549,2301,80.7,17,12,70.6
0K,All Students,2022-23,2462,360,2102,85.4,15,10,66.7
1,All Students,2018-19,3521,275,3246,92.2,23,9,39.1
1,All Students,2019-20,1271,168,1103,86.8,12,4,33.3
1,All Students,2020-21,1047,88,959,91.6,6,3,50.0
1,All Students,2021-22,3044,301,2743,90.1,19,8,42.1
1,All Students,2022-23,2766,434,2332,84.3,18,12,66.7
2,All Students,2018-19,3551,294,3257,91.7,24,8,33.3
2,All Students,2019-20,1260,s,s,s,s,s,s
2,All Students,2020-21,2261,314,1947,86.1,13,5,38.5
2,All Students,2021-22,744,s,s,s,s,s,s
2,All Students,2022-23,3321,383,2938,88.5,23,11,47.8
3,All Students,2018-19,4316,380,3936,91.2,25,9,36.0
3,All Students,2019-20,3044,221,2823,92.7,27,8,29.6
3,All Students,2020-21,2128,231,1897,89.1,13,6,46.2
3,All Students,2021-22,2725,286,2439,89.5,18,9,50.0
3,All Students,2022-23,1514,133,1381,91.2,10,4,40.0
4,All Students,2018-19,4570,374,4196,91.8,30,11,36.7
4,All Students,2019-20,2464,210,2254,91.5,22,5,22.7
4,All Students,2020-21,4370,634,3736,85.5,26,17,65.4
4,All Students,2021-22,2283,s,s,s,s,s,s
4,All Students,2022-23,2656,260,2396,90.2,17,4,23.5
5,All Students,2018-19,5683,385,5298,93.2,34,4,11.8
5,All Students,2019-20,2567,253,2314,90.1,23,8,34.8
5,All Students,2020-21,3675,693,2982,81.1,21,14,66.7
5,All Students,2021-22,4362,441,3921,89.9,27,12,44.4
5,All Students,2022-23,2394,227,2167,90.5,15,6,40.0
All Grades,All Students,2018-19,25022,2375,22647,90.5,162,65,40.1
All Grades,All Students,2019-20,16319,1649,14670,89.9,156,64,41.0
All Grades,All Students,2020-21,24232,5886,18346,75.7,150,90,60.0
All Grades,All Students,2021-22,22553,4589,17964,79.7,145,103,71.0
All Grades,All Students,2022-23,18525,3015,15510,83.7,124,82,66.1
PK in K-12 Schools,All Students,2018-19,3052,274,2778,91.0,20,7,35.0
PK in K-12 Schools,All Students,2019-20,2645,351,2294,86.7,25,15,60.0
PK in K-12 Schools,All Students,2020-21,2902,874,2028,69.9,20,12,60.0
PK in K-12 Schools,All Students,2021-22,2887,813,2074,71.8,20,17,85.0
PK in K-12 Schools,All Students,2022-23,2260,516,1744,77.2,25,23,92.0
0K,All Students,2018-19,2859,340,2519,88.1,21,14,66.7
0K,All Students,2019-20,2646,250,2396,90.6,24,8,33.3
0K,All Students,2020-21,4072,1471,2601,63.9,26,22,84.6
0K,All Students,2021-22,2021,404,1617,80.0,14,11,78.6
0K,All Students,2022-23,2609,530,2079,79.7,16,12,75.0
1,All Students,2018-19,2734,331,2403,87.9,19,9,47.4
1,All Students,2019-20,2252,291,1961,87.1,22,13,59.1
1,All Students,2020-21,3536,755,2781,78.6,21,11,52.4
1,All Students,2021-22,4284,927,3357,78.4,28,19,67.9
1,All Students,2022-23,2525,429,2096,83.0,17,13,76.5
2,All Students,2018-19,4683,448,4235,90.4,28,10,35.7
2,All Students,2019-20,1766,161,1605,90.9,18,5,27.8
2,All Students,2020-21,3315,656,2659,80.2,20,9,45.0
2,All Students,2021-22,3398,562,2836,83.5,20,13,65.0
2,All Students,2022-23,4027,564,3463,86.0,24,16,66.7
3,All Students,2018-19,2691,244,2447,90.9,18,6,33.3
3,All Students,2019-20,3381,301,3080,91.1,33,12,36.4
3,All Students,2020-21,2795,601,2194,78.5,17,12,70.6
3,All Students,2021-22,3001,709,2292,76.4,20,15,75.0
3,All Students,2022-23,3265,412,2853,87.4,19,7,36.8
4,All Students,2018-19,3872,329,3543,91.5,25,9,36.0
4,All Students,2019-20,1662,94,1568,94.3,16,4,25.0
4,All Students,2020-21,4683,1093,3590,76.7,28,17,60.7
4,All Students,2021-22,2459,482,1977,80.4,17,12,70.6
4,All Students,2022-23,2304,379,1925,83.6,13,8,61.5
5,All Students,2018-19,5131,409,4722,92.0,31,10,32.3
5,All Students,2019-20,1967,201,1766,89.8,18,7,38.9
5,All Students,2020-21,2929,436,2493,85.1,18,7,38.9
5,All Students,2021-22,4503,692,3811,84.6,26,16,61.5
5,All Students,2022-23,1535,185,1350,87.9,10,3,30.0
All Grades,All Students,2018-19,42549,1151,41398,97.3,241,2,0.8
All Grades,All Students,2019-20,28517,818,27699,97.1,250,7,2.8
All Grades,All Students,2020-21,44549,408,44141,99.1,255,2,0.8
All Grades,All Students,2021-22,45014,2094,42920,95.3,266,28,10.5
All Grades,All Students,2022-23,44680,2067,42613,95.4,261,24,9.2
5,All Students,2018-19,11105,293,10812,97.4,63,1,1.6
5,All Students,2019-20,7366,227,7139,96.9,64,1,1.6
5,All Students,2020-21,11550,57,11493,99.5,66,0,0.0
5,All Students,2021-22,10273,465,9808,95.5,68,9,13.2
5,All Students,2022-23,9945,541,9404,94.6,61,7,11.5
6,All Students,2018-19,11248,385,10863,96.6,64,1,1.6
6,All Students,2019-20,7395,249,7146,96.6,66,4,6.1
6,All Students,2020-21,11025,87,10938,99.2,63,0,0.0
6,All Students,2021-22,11682,471,11211,96.0,66,4,6.1
6,All Students,2022-23,11633,476,11157,95.9,66,4,6.1
7,All Students,2018-19,10406,179,10227,98.3,59,0,0.0
7,All Students,2019-20,7015,132,6883,98.1,61,0,0.0
7,All Students,2020-21,11550,165,11385,98.6,66,2,3.0
7,All Students,2021-22,11547,532,11015,95.4,67,5,7.5
7,All Students,2022-23,11728,478,11250,95.9,68,6,8.8
8,All Students,2018-19,9790,294,9496,97.0,55,0,0.0
8,All Students,2019-20,6741,210,6531,96.9,59,2,3.4
8,All Students,2020-21,10424,99,10325,99.1,60,0,0.0
8,All Students,2021-22,11512,626,10886,94.6,65,10,15.4
8,All Students,2022-23,11374,572,10802,95.0,66,7,10.6
All Grades,All Students,2018-19,71311,2698,68613,96.2,404,22,5.4
All Grades,All Students,2019-20,46398,1566,44832,96.6,409,20,4.9
All Grades,All Students,2020-21,67289,4473,62816,93.4,391,59,15.1
All Grades,All Students,2021-22,64806,3969,60837,93.9,372,56,15.1
All Grades,All Students,2022-23,62954,3960,58994,93.7,366,69,18.9
6,All Students,2018-19,23649,923,22726,96.1,134,8,6.0
6,All Students,2019-20,16261,534,15727,96.7,144,10,6.9
6,All Students,2020-21,21501,1190,20311,94.5,124,14,11.3
6,All Students,2021-22,21819,1364,20455,93.7,125,25,20.0
6,All Students,2022-23,21843,1251,20592,94.3,127,23,18.1
7,All Students,2018-19,24075,755,23320,96.9,136,7,5.1
7,All Students,2019-20,14961,419,14542,97.2,133,3,2.3
7,All Students,2020-21,23888,1803,22085,92.5,141,25,17.7
7,All Students,2021-22,20148,1175,18973,94.2,117,12,10.3
7,All Students,2022-23,20277,1395,18882,93.1,117,26,22.2
8,All Students,2018-19,23587,1020,22567,95.7,134,7,5.2
8,All Students,2019-20,15176,613,14563,96.0,132,7,5.3
8,All Students,2020-21,21900,1480,20420,93.2,126,20,15.9
8,All Students,2021-22,22839,1430,21409,93.7,130,19,14.6
8,All Students,2022-23,20834,1314,19520,93.7,122,20,16.4
All Grades,All Students,2018-19,39684,1850,37834,95.3,234,34,14.5
All Grades,All Students,2019-20,26767,1267,25500,95.3,239,31,13.0
All Grades,All Students,2020-21,40317,2009,38308,95.0,234,30,12.8
All Grades,All Students,2021-22,36645,3072,33573,91.6,218,62,28.4
All Grades,All Students,2022-23,38899,4319,34580,88.9,248,102,41.1
6,All Students,2018-19,13044,645,12399,95.1,77,9,11.7
6,All Students,2019-20,9860,354,9506,96.4,87,7,8.0
6,All Students,2020-21,11721,644,11077,94.5,68,10,14.7
6,All Students,2021-22,10155,892,9263,91.2,63,21,33.3
6,All Students,2022-23,11107,1208,9899,89.1,71,30,42.3
7,All Students,2018-19,12083,531,11552,95.6,72,12,16.7
7,All Students,2019-20,8833,444,8389,95.0,79,11,13.9
7,All Students,2020-21,15057,884,14173,94.1,87,15,17.2
7,All Students,2021-22,11318,1085,10233,90.4,68,21,30.9
7,All Students,2022-23,14318,1497,12821,89.5,88,38,43.2
8,All Students,2018-19,14557,674,13883,95.4,85,13,15.3
8,All Students,2019-20,8074,469,7605,94.2,73,13,17.8
8,All Students,2020-21,13539,481,13058,96.4,79,5,6.3
8,All Students,2021-22,15172,1095,14077,92.8,87,20,23.0
8,All Students,2022-23,13474,1614,11860,88.0,89,34,38.2
All Grades,All Students,2018-19,29228,2524,26704,91.4,174,45,25.9
All Grades,All Students,2019-20,17113,1695,15418,90.1,162,62,38.3
All Grades,All Students,2020-21,19362,2527,16835,86.9,114,37,32.5
All Grades,All Students,2021-22,16718,2956,13762,82.3,101,68,67.3
All Grades,All Students,2022-23,15733,2943,12790,81.3,107,73,68.2
6,All Students,2018-19,9016,719,8297,92.0,56,15,26.8
6,All Students,2019-20,4863,508,4355,89.6,46,19,41.3
6,All Students,2020-21,4747,s,s,s,s,s,s
6,All Students,2021-22,5292,1283,4009,75.8,32,26,81.3
6,All Students,2022-23,3957,886,3071,77.6,29,23,79.3
7,All Students,2018-19,9592,815,8777,91.5,56,15,26.8
7,All Students,2019-20,5914,445,5469,92.5,59,18,30.5
7,All Students,2020-21,6102,934,5168,84.7,36,12,33.3
7,All Students,2021-22,5225,686,4539,86.9,32,17,53.1
7,All Students,2022-23,5464,1109,4355,79.7,38,27,71.1
8,All Students,2018-19,10620,990,9630,90.7,62,15,24.2
8,All Students,2019-20,6336,742,5594,88.3,57,25,43.9
8,All Students,2020-21,8499,1117,7382,86.9,49,16,32.7
8,All Students,2021-22,6201,987,5214,84.1,37,25,67.6
8,All Students,2022-23,6312,948,5364,85.0,40,23,57.5
9,All Students,2020-21,14,s,s,s,s,s,s
All Grades,All Students,2018-19,26870,2036,24834,92.4,161,42,26.1
All Grades,All Students,2019-20,16126,958,15168,94.1,147,27,18.4
All Grades,All Students,2020-21,31221,6323,24898,79.7,181,104,57.5
All Grades,All Students,2021-22,27416,2709,24707,90.1,166,67,40.4
All Grades,All Students,2022-23,30009,2681,27328,91.1,194,67,34.5
6,All Students,2018-19,9330,565,8765,93.9,54,9,16.7
6,All Students,2019-20,5462,307,5155,94.4,52,14,26.9
6,All Students,2020-21,14688,2371,12317,83.9,85,44,51.8
6,All Students,2021-22,7649,765,6884,90.0,46,19,41.3
6,All Students,2022-23,8789,767,8022,91.3,63,23,36.5
7,All Students,2018-19,8237,s,s,s,s,s,s
7,All Students,2019-20,5988,334,5654,94.4,54,7,13.0
7,All Students,2020-21,8041,s,s,s,s,s,s
7,All Students,2021-22,12705,1274,11431,90.0,76,29,38.2
7,All Students,2022-23,7848,625,7223,92.0,48,13,27.1
8,All Students,2018-19,9246,844,8402,90.9,56,18,32.1
8,All Students,2019-20,4676,317,4359,93.2,41,6,14.6
8,All Students,2020-21,8491,2003,6488,76.4,49,29,59.2
8,All Students,2021-22,7062,670,6392,90.5,44,19,43.2
8,All Students,2022-23,13372,1289,12083,90.4,83,31,37.3
9,All Students,2018-19,57,s,s,s,s,s,s
9,All Students,2020-21,1,s,s,s,s,s,s
All Grades,All Students,2018-19,42848,3056,39792,92.9,255,62,24.3
All Grades,All Students,2019-20,27900,1903,25997,93.2,249,51,20.5
All Grades,All Students,2020-21,39969,3085,36884,92.3,232,51,22.0
All Grades,All Students,2021-22,30790,4607,26183,85.0,185,107,57.8
All Grades,All Students,2022-23,23107,2626,20481,88.6,147,67,45.6
6,All Students,2018-19,14737,1096,13641,92.6,88,25,28.4
6,All Students,2019-20,9765,758,9007,92.2,88,22,25.0
6,All Students,2020-21,10445,791,9654,92.4,61,15,24.6
6,All Students,2021-22,7557,1262,6295,83.3,49,31,63.3
6,All Students,2022-23,5230,518,4712,90.1,34,12,35.3
7,All Students,2018-19,13408,888,12520,93.4,82,17,20.7
7,All Students,2019-20,9708,707,9001,92.7,87,20,23.0
7,All Students,2020-21,14761,1398,13363,90.5,86,21,24.4
7,All Students,2021-22,10102,1357,8745,86.6,59,30,50.8
7,All Students,2022-23,7092,856,6236,87.9,47,23,48.9
8,All Students,2018-19,14703,1072,13631,92.7,85,20,23.5
8,All Students,2019-20,8427,438,7989,94.8,74,9,12.2
8,All Students,2020-21,14763,896,13867,93.9,85,15,17.6
8,All Students,2021-22,13131,1988,11143,84.9,77,46,59.7
8,All Students,2022-23,10785,1252,9533,88.4,66,32,48.5
All Grades,All Students,2018-19,76178,3007,73171,96.1,433,28,6.5
All Grades,All Students,2019-20,59667,2300,57367,96.1,535,40,7.5
All Grades,All Students,2020-21,106039,5169,100870,95.1,627,84,13.4
All Grades,All Students,2021-22,125314,11429,113885,90.9,742,195,26.3
All Grades,All Students,2022-23,120000,9869,110131,91.8,716,175,24.4
6,All Students,2018-19,20176,747,19429,96.3,114,6,5.3
6,All Students,2019-20,10926,419,10507,96.2,97,5,5.2
6,All Students,2020-21,18110,733,17377,96.0,105,12,11.4
6,All Students,2021-22,18878,1542,17336,91.8,108,24,22.2
6,All Students,2022-23,18237,1357,16880,92.6,105,25,23.8
7,All Students,2018-19,17992,644,17348,96.4,101,5,5.0
7,All Students,2019-20,13021,500,12521,96.2,115,11,9.6
7,All Students,2020-21,16588,818,15770,95.1,99,16,16.2
7,All Students,2021-22,18494,1553,16941,91.6,110,23,20.9
7,All Students,2022-23,18130,1322,16808,92.7,103,20,19.4
8,All Students,2018-19,17805,766,17039,95.7,100,9,9.0
8,All Students,2019-20,12015,441,11574,96.3,106,4,3.8
8,All Students,2020-21,18502,899,17603,95.1,108,14,13.0
8,All Students,2021-22,17719,1324,16395,92.5,103,21,20.4
8,All Students,2022-23,18376,1428,16948,92.2,107,26,24.3
9,All Students,2018-19,20205,850,19355,95.8,118,8,6.8
9,All Students,2019-20,10783,440,10343,95.9,99,11,11.1
9,All Students,2020-21,18107,697,17410,96.2,111,14,12.6
9,All Students,2021-22,18392,1820,16572,90.1,108,25,23.1
9,All Students,2022-23,16599,1386,15213,91.7,102,19,18.6
10,All Students,2019-20,12922,500,12422,96.1,118,9,7.6
10,All Students,2020-21,14577,750,13827,94.9,87,11,12.6
10,All Students,2021-22,17145,1183,15962,93.1,106,19,17.9
10,All Students,2022-23,17304,1324,15980,92.3,107,23,21.5
11,All Students,2020-21,20155,1272,18883,93.7,117,17,14.5
11,All Students,2021-22,15443,1323,14120,91.4,93,22,23.7
11,All Students,2022-23,16671,1405,15266,91.6,103,25,24.3
12,All Students,2021-22,19243,2684,16559,86.1,114,61,53.5
12,All Students,2022-23,14683,1647,13036,88.8,89,37,41.6
All Grades,All Students,2018-19,56439,10430,46009,81.5,377,216,57.3
All Grades,All Students,2019-20,31140,6073,25067,80.5,298,151,50.7
All Grades,All Students,2020-21,32399,7163,25236,77.9,186,87,46.8
All Grades,All Students,2021-22,20065,4717,15348,76.5,130,97,74.6
All Grades,All Students,2022-23,17735,4687,13048,73.6,120,89,74.2
9,All Students,2018-19,12356,4157,8199,66.4,87,65,74.7
9,All Students,2019-20,8695,2553,6142,70.6,81,48,59.3
9,All Students,2020-21,5151,2110,3041,59.0,26,17,65.4
9,All Students,2021-22,3083,869,2214,71.8,21,19,90.5
9,All Students,2022-23,5347,1564,3783,70.7,33,21,63.6
10,All Students,2018-19,16158,2364,13794,85.4,109,55,50.5
10,All Students,2019-20,5734,1251,4483,78.2,57,33,57.9
10,All Students,2020-21,10023,2871,7152,71.4,59,40,67.8
10,All Students,2021-22,3671,1100,2571,70.0,25,22,88.0
10,All Students,2022-23,2944,744,2200,74.7,23,19,82.6
11,All Students,2018-19,12052,1598,10454,86.7,80,42,52.5
11,All Students,2019-20,8499,1118,7381,86.8,82,34,41.5
11,All Students,2020-21,6045,749,5296,87.6,35,10,28.6
11,All Students,2021-22,5803,993,4810,82.9,37,20,54.1
11,All Students,2022-23,4117,1296,2821,68.5,28,23,82.1
12,All Students,2018-19,15873,2311,13562,85.4,101,54,53.5
12,All Students,2019-20,8212,1151,7061,86.0,78,36,46.2
12,All Students,2020-21,11120,1420,9700,87.2,65,19,29.2
12,All Students,2021-22,7508,1755,5753,76.6,47,36,76.6
12,All Students,2022-23,5327,1083,4244,79.7,36,26,72.2
All Grades,All Students,2018-19,68190,10107,58083,85.2,421,223,53.0
All Grades,All Students,2019-20,44703,6511,38192,85.4,425,238,56.0
All Grades,All Students,2020-21,65100,12163,52937,81.3,380,235,61.8
All Grades,All Students,2021-22,61011,14739,46272,75.8,380,290,76.3
All Grades,All Students,2022-23,52496,11537,40959,78.0,347,240,69.2
9,All Students,2018-19,18601,2539,16062,86.4,118,48,40.7
9,All Students,2019-20,11692,1787,9905,84.7,117,66,56.4
9,All Students,2020-21,12812,1811,11001,85.9,76,31,40.8
9,All Students,2021-22,13952,2405,11547,82.8,89,52,58.4
9,All Students,2022-23,12039,2003,10036,83.4,82,46,56.1
10,All Students,2018-19,16652,1860,14792,88.8,102,49,48.0
10,All Students,2019-20,12137,1592,10545,86.9,115,62,53.9
10,All Students,2020-21,17922,3437,14485,80.8,104,73,70.2
10,All Students,2021-22,12651,2397,10254,81.1,78,46,59.0
10,All Students,2022-23,13046,2222,10824,83.0,84,48,57.1
11,All Students,2018-19,16638,2388,14250,85.6,101,48,47.5
11,All Students,2019-20,10657,1419,9238,86.7,98,52,53.1
11,All Students,2020-21,18331,3238,15093,82.3,105,61,58.1
11,All Students,2021-22,17898,4343,13555,75.7,109,91,83.5
11,All Students,2022-23,11947,2365,9582,80.2,79,55,69.6
12,All Students,2018-19,16299,3320,12979,79.6,100,78,78.0
12,All Students,2019-20,10217,1713,8504,83.2,95,58,61.1
12,All Students,2020-21,16035,3677,12358,77.1,95,70,73.7
12,All Students,2021-22,16510,5594,10916,66.1,104,101,97.1
12,All Students,2022-23,15464,4947,10517,68.0,102,91,89.2
All Grades,All Students,2018-19,134212,7808,126404,94.2,775,111,14.3
All Grades,All Students,2019-20,79143,4738,74405,94.0,701,108,15.4
All Grades,All Students,2020-21,100385,4514,95871,95.5,582,70,12.0
All Grades,All Students,2021-22,88324,8228,80096,90.7,522,168,32.2
All Grades,All Students,2022-23,79368,7706,71662,90.3,503,192,38.2
0K,All Students,2018-19,16583,1090,15493,93.4,96,18,18.8
0K,All Students,2019-20,9401,716,8685,92.4,87,24,27.6
0K,All Students,2020-21,10149,238,9911,97.7,61,5,8.2
0K,All Students,2021-22,8282,871,7411,89.5,48,16,33.3
0K,All Students,2022-23,7390,680,6710,90.8,48,18,37.5
1,All Students,2018-19,15412,1025,14387,93.3,92,21,22.8
1,All Students,2019-20,9136,695,8441,92.4,79,13,16.5
1,All Students,2020-21,12543,670,11873,94.7,72,11,15.3
1,All Students,2021-22,9974,837,9137,91.6,60,19,31.7
1,All Students,2022-23,7691,839,6852,89.1,47,21,44.7
2,All Students,2018-19,17249,958,16291,94.4,100,11,11.0
2,All Students,2019-20,9334,547,8787,94.1,84,14,16.7
2,All Students,2020-21,12085,163,11922,98.7,71,0,0.0
2,All Students,2021-22,10672,1041,9631,90.2,64,20,31.3
2,All Students,2022-23,10015,832,9183,91.7,65,18,27.7
3,All Students,2018-19,17144,1200,15944,93.0,99,16,16.2
3,All Students,2019-20,10324,549,9775,94.7,90,12,13.3
3,All Students,2020-21,12422,466,11956,96.2,71,5,7.0
3,All Students,2021-22,10559,868,9691,91.8,61,17,27.9
3,All Students,2022-23,9156,791,8365,91.4,56,20,35.7
4,All Students,2018-19,16647,688,15959,95.9,94,7,7.4
4,All Students,2019-20,9602,511,9091,94.7,86,12,14.0
4,All Students,2020-21,13825,691,13134,95.0,79,8,10.1
4,All Students,2021-22,10345,900,9445,91.3,60,17,28.3
4,All Students,2022-23,11660,858,10802,92.6,70,18,25.7
5,All Students,2018-19,17205,789,16416,95.4,98,9,9.2
5,All Students,2019-20,9603,516,9087,94.6,85,6,7.1
5,All Students,2020-21,11653,314,11339,97.3,68,4,5.9
5,All Students,2021-22,12440,932,11508,92.5,73,20,27.4
5,All Students,2022-23,9860,996,8864,89.9,57,21,36.8
6,All Students,2018-19,12160,711,11449,94.2,69,10,14.5
6,All Students,2019-20,7251,364,6887,95.0,63,8,12.7
6,All Students,2020-21,8115,542,7573,93.3,47,8,17.0
6,All Students,2021-22,8810,1042,7768,88.2,52,22,42.3
6,All Students,2022-23,5925,627,5298,89.4,41,20,48.8
7,All Students,2018-19,11350,660,10690,94.2,66,10,15.2
7,All Students,2019-20,7404,356,7048,95.2,65,6,9.2
7,All Students,2020-21,9274,464,8810,95.0,53,8,15.1
7,All Students,2021-22,8479,818,7661,90.4,52,18,34.6
7,All Students,2022-23,8964,995,7969,88.9,60,31,51.7
8,All Students,2018-19,10462,687,9775,93.4,61,9,14.8
8,All Students,2019-20,7088,484,6604,93.2,62,13,21.0
8,All Students,2020-21,10319,966,9353,90.6,60,21,35.0
8,All Students,2021-22,8763,919,7844,89.5,52,19,36.5
8,All Students,2022-23,8707,1088,7619,87.5,59,25,42.4
All Grades,All Students,2018-19,92517,2423,90094,97.4,523,7,1.3
All Grades,All Students,2019-20,59998,1780,58218,97.0,522,14,2.7
All Grades,All Students,2020-21,89951,1285,88666,98.6,519,10,1.9
All Grades,All Students,2021-22,90024,4702,85322,94.8,512,51,10.0
All Grades,All Students,2022-23,88977,4259,84718,95.2,508,39,7.7
0K,All Students,2018-19,8891,233,8658,97.4,51,0,0.0
0K,All Students,2019-20,5750,244,5506,95.8,50,2,4.0
0K,All Students,2020-21,8731,68,8663,99.2,50,0,0.0
0K,All Students,2021-22,8762,574,8188,93.4,50,7,14.0
0K,All Students,2022-23,8584,552,8032,93.6,50,8,16.0
1,All Students,2018-19,10234,262,9972,97.4,58,1,1.7
1,All Students,2019-20,6670,214,6456,96.8,58,0,0.0
1,All Students,2020-21,10041,111,9930,98.9,58,1,1.7
1,All Students,2021-22,10276,592,9684,94.2,59,9,15.3
1,All Students,2022-23,10265,523,9742,94.9,58,3,5.2
2,All Students,2018-19,10322,309,10013,97.0,58,2,3.4
2,All Students,2019-20,6654,247,6407,96.3,58,3,5.2
2,All Students,2020-21,10150,74,10076,99.3,58,0,0.0
2,All Students,2021-22,10159,558,9601,94.5,58,6,10.3
2,All Students,2022-23,10265,446,9819,95.7,58,2,3.4
3,All Students,2018-19,10324,254,10070,97.5,58,0,0.0
3,All Students,2019-20,6663,175,6488,97.4,58,2,3.4
3,All Students,2020-21,10198,106,10092,99.0,59,0,0.0
3,All Students,2021-22,10266,446,9820,95.7,58,3,5.2
3,All Students,2022-23,10079,559,9520,94.5,58,5,8.6
4,All Students,2018-19,9789,235,9554,97.6,55,0,0.0
4,All Students,2019-20,6670,208,6462,96.9,58,3,5.2
4,All Students,2020-21,9800,83,9717,99.2,56,1,1.8
4,All Students,2021-22,10265,567,9698,94.5,58,7,12.1
4,All Students,2022-23,10154,504,9650,95.0,58,5,8.6
5,All Students,2018-19,9612,177,9435,98.2,54,0,0.0
5,All Students,2019-20,6194,150,6044,97.6,54,1,1.9
5,All Students,2020-21,9796,189,9607,98.1,56,1,1.8
5,All Students,2021-22,9491,506,8985,94.7,54,5,9.3
5,All Students,2022-23,9065,429,8636,95.3,52,2,3.8
6,All Students,2018-19,11242,381,10861,96.6,64,3,4.7
6,All Students,2019-20,7360,186,7174,97.5,64,1,1.6
6,All Students,2020-21,11037,179,10858,98.4,65,2,3.1
6,All Students,2021-22,11204,559,10645,95.0,64,6,9.4
6,All Students,2022-23,11326,490,10836,95.7,64,7,10.9
7,All Students,2018-19,10851,143,10708,98.7,61,0,0.0
7,All Students,2019-20,7252,144,7108,98.0,63,2,3.2
7,All Students,2020-21,9664,155,9509,98.4,56,1,1.8
7,All Students,2021-22,10224,423,9801,95.9,58,4,6.9
7,All Students,2022-23,9930,321,9609,96.8,57,3,5.3
8,All Students,2018-19,11252,429,10823,96.2,64,1,1.6
8,All Students,2019-20,6785,212,6573,96.9,59,0,0.0
8,All Students,2020-21,10534,320,10214,97.0,61,4,6.6
8,All Students,2021-22,9377,477,8900,94.9,53,4,7.5
8,All Students,2022-23,9309,435,8874,95.3,53,4,7.5
All Grades,All Students,2018-19,49725,8913,40812,82.1,327,181,55.4
All Grades,All Students,2019-20,33461,5586,27875,83.3,321,172,53.6
All Grades,All Students,2020-21,51590,13280,38310,74.3,306,198,64.7
All Grades,All Students,2021-22,43379,11374,32005,73.8,276,210,76.1
All Grades,All Students,2022-23,51772,10879,40893,79.0,335,221,66.0
9,All Students,2018-19,13227,2657,10570,79.9,91,49,53.8
9,All Students,2019-20,10305,1068,9237,89.6,101,42,41.6
9,All Students,2020-21,11666,2674,8992,77.1,71,44,62.0
9,All Students,2021-22,7475,1773,5702,76.3,50,38,76.0
9,All Students,2022-23,21717,3359,18358,84.5,140,80,57.1
10,All Students,2018-19,13876,2263,11613,83.7,93,44,47.3
10,All Students,2019-20,8690,2029,6661,76.7,85,57,67.1
10,All Students,2020-21,16165,4091,12074,74.7,95,62,65.3
10,All Students,2021-22,10734,2970,7764,72.3,69,50,72.5
10,All Students,2022-23,7749,1827,5922,76.4,54,40,74.1
11,All Students,2018-19,10367,1374,8993,86.7,64,31,48.4
11,All Students,2019-20,7618,1256,6362,83.5,72,39,54.2
11,All Students,2020-21,11064,2853,8211,74.2,65,42,64.6
11,All Students,2021-22,15374,4027,11347,73.8,95,72,75.8
11,All Students,2022-23,9032,2226,6806,75.4,57,42,73.7
12,All Students,2018-19,12255,2619,9636,78.6,79,57,72.2
12,All Students,2019-20,6848,1233,5615,82.0,63,34,54.0
12,All Students,2020-21,12695,3662,9033,71.2,75,50,66.7
12,All Students,2021-22,9796,2604,7192,73.4,62,50,80.6
12,All Students,2022-23,13274,3467,9807,73.9,84,59,70.2
All Grades,All Students,2018-19,67619,9555,58064,85.9,439,178,40.5
All Grades,All Students,2019-20,46733,8415,38318,82.0,441,212,48.1
All Grades,All Students,2020-21,77750,17639,60111,77.3,456,394,86.4
All Grades,All Students,2021-22,70625,16421,54204,76.7,444,322,72.5
All Grades,All Students,2022-23,65940,13734,52206,79.2,449,282,62.8
9,All Students,2018-19,19692,2448,17244,87.6,127,38,29.9
9,All Students,2019-20,11851,1991,9860,83.2,117,50,42.7
9,All Students,2020-21,22185,4106,18079,81.5,128,106,82.8
9,All Students,2021-22,16644,3349,13295,79.9,107,67,62.6
9,All Students,2022-23,15999,2734,13265,82.9,112,63,56.3
10,All Students,2018-19,18305,2032,16273,88.9,118,40,33.9
10,All Students,2019-20,11555,1579,9976,86.3,110,48,43.6
10,All Students,2020-21,18659,5071,13588,72.8,107,95,88.8
10,All Students,2021-22,21144,4521,16623,78.6,129,91,70.5
10,All Students,2022-23,16940,3607,13333,78.7,116,67,57.8
11,All Students,2018-19,15399,2544,12855,83.5,100,45,45.0
11,All Students,2019-20,12595,2048,10547,83.7,119,61,51.3
11,All Students,2020-21,16348,3565,12783,78.2,94,80,85.1
11,All Students,2021-22,17178,4437,12741,74.2,108,77,71.3
11,All Students,2022-23,17960,3952,14008,78.0,120,79,65.8
12,All Students,2018-19,14223,2531,11692,82.2,94,55,58.5
12,All Students,2019-20,10732,2797,7935,73.9,95,53,55.8
12,All Students,2020-21,20558,4897,15661,76.2,127,113,89.0
12,All Students,2021-22,15659,4114,11545,73.7,100,87,87.0
12,All Students,2022-23,15041,3441,11600,77.1,101,73,72.3
All Grades,All Students,2018-19,52539,6446,46093,87.7,329,142,43.2
All Grades,All Students,2019-20,34867,4584,30283,86.9,329,141,42.9
All Grades,All Students,2020-21,62767,2969,59798,95.3,365,43,11.8
All Grades,All Students,2021-22,65483,8453,57030,87.1,403,175,43.4
All Grades,All Students,2022-23,56429,7464,48965,86.8,364,161,44.2
6,All Students,2018-19,4181,433,3748,89.6,25,11,44.0
6,All Students,2019-20,3614,351,3263,90.3,32,12,37.5
6,All Students,2020-21,4211,256,3955,93.9,25,4,16.0
6,All Students,2021-22,4322,401,3921,90.7,25,11,44.0
6,All Students,2022-23,2095,205,1890,90.2,14,5,35.7
7,All Students,2018-19,7133,669,6464,90.6,44,17,38.6
7,All Students,2019-20,2536,304,2232,88.0,24,12,50.0
7,All Students,2020-21,5250,306,4944,94.2,30,5,16.7
7,All Students,2021-22,4048,447,3601,89.0,27,13,48.1
7,All Students,2022-23,3321,237,3084,92.9,20,4,20.0
8,All Students,2018-19,3847,471,3376,87.8,23,7,30.4
8,All Students,2019-20,3972,464,3508,88.3,37,14,37.8
8,All Students,2020-21,4369,317,4052,92.7,25,6,24.0
8,All Students,2021-22,4856,458,4398,90.6,29,5,17.2
8,All Students,2022-23,3440,400,3040,88.4,23,11,47.8
9,All Students,2018-19,12339,1387,10952,88.8,78,25,32.1
9,All Students,2019-20,8826,1485,7341,83.2,79,31,39.2
9,All Students,2020-21,18825,1027,17798,94.5,110,15,13.6
9,All Students,2021-22,16494,1776,14718,89.2,103,36,35.0
9,All Students,2022-23,9760,1070,8690,89.0,63,26,41.3
10,All Students,2018-19,10069,1269,8800,87.4,64,29,45.3
10,All Students,2019-20,6000,625,5375,89.6,59,21,35.6
10,All Students,2020-21,13365,571,12794,95.7,78,7,9.0
10,All Students,2021-22,15802,2356,13446,85.1,98,51,52.0
10,All Students,2022-23,13503,1549,11954,88.5,87,29,33.3
11,All Students,2018-19,7417,919,6498,87.6,46,21,45.7
11,All Students,2019-20,5336,659,4677,87.6,55,25,45.5
11,All Students,2020-21,8872,332,8540,96.3,52,4,7.7
11,All Students,2021-22,12434,1969,10465,84.2,74,36,48.6
11,All Students,2022-23,12617,1927,10690,84.7,80,39,48.8
12,All Students,2018-19,7553,1298,6255,82.8,49,32,65.3
12,All Students,2019-20,4583,696,3887,84.8,43,26,60.5
12,All Students,2020-21,7875,160,7715,98.0,45,2,4.4
12,All Students,2021-22,7527,1046,6481,86.1,47,23,48.9
12,All Students,2022-23,11693,2076,9617,82.2,77,47,61.0
All Grades,All Students,2018-19,68452,5704,62748,91.7,420,98,23.3
All Grades,All Students,2019-20,43902,3758,40144,91.4,404,100,24.8
All Grades,All Students,2020-21,69997,6021,63976,91.4,411,103,25.1
All Grades,All Students,2021-22,68549,8831,59718,87.1,411,189,46.0
All Grades,All Students,2022-23,69201,7077,62124,89.8,431,146,33.9
9,All Students,2018-19,17954,1347,16607,92.5,112,23,20.5
9,All Students,2019-20,11339,733,10606,93.5,106,18,17.0
9,All Students,2020-21,19971,800,19171,96.0,118,9,7.6
9,All Students,2021-22,18843,1979,16864,89.5,114,39,34.2
9,All Students,2022-23,19049,1665,17384,91.3,118,32,27.1
10,All Students,2018-19,17846,928,16918,94.8,110,9,8.2
10,All Students,2019-20,10319,789,9530,92.4,95,22,23.2
10,All Students,2020-21,16644,1460,15184,91.2,99,28,28.3
10,All Students,2021-22,19600,1852,17748,90.6,116,38,32.8
10,All Students,2022-23,17528,1671,15857,90.5,111,33,29.7
11,All Students,2018-19,16946,1629,15317,90.4,103,29,28.2
11,All Students,2019-20,11603,806,10797,93.1,106,19,17.9
11,All Students,2020-21,15133,1519,13614,90.0,88,24,27.3
11,All Students,2021-22,16082,2305,13777,85.7,96,50,52.1
11,All Students,2022-23,17468,1799,15669,89.7,110,28,25.5
12,All Students,2018-19,15706,1800,13906,88.5,95,37,38.9
12,All Students,2019-20,10641,1430,9211,86.6,97,41,42.3
12,All Students,2020-21,18249,2242,16007,87.7,106,42,39.6
12,All Students,2021-22,14024,2695,11329,80.8,85,62,72.9
12,All Students,2022-23,15156,1942,13214,87.2,92,53,57.6
All Grades,All Students,2018-19,35504,3123,32381,91.2,227,68,30.0
All Grades,All Students,2019-20,21280,1668,19612,92.2,204,60,29.4
All Grades,All Students,2020-21,32164,4528,27636,85.9,186,74,39.8
All Grades,All Students,2021-22,27253,3466,23787,87.3,168,73,43.5
All Grades,All Students,2022-23,30463,3957,26506,87.0,192,90,46.9
6,All Students,2018-19,10899,1016,9883,90.7,68,23,33.8
6,All Students,2019-20,5685,423,5262,92.6,57,19,33.3
6,All Students,2020-21,11587,1354,10233,88.3,67,22,32.8
6,All Students,2021-22,8041,1194,6847,85.2,51,28,54.9
6,All Students,2022-23,11199,1422,9777,87.3,71,38,53.5
7,All Students,2018-19,11391,1055,10336,90.7,74,26,35.1
7,All Students,2019-20,7596,558,7038,92.7,73,20,27.4
7,All Students,2020-21,8770,1272,7498,85.5,51,21,41.2
7,All Students,2021-22,10618,1406,9212,86.8,64,25,39.1
7,All Students,2022-23,8611,1102,7509,87.2,53,28,52.8
8,All Students,2018-19,13214,1052,12162,92.0,85,19,22.4
8,All Students,2019-20,7999,687,7312,91.4,74,21,28.4
8,All Students,2020-21,11807,1902,9905,83.9,68,31,45.6
8,All Students,2021-22,8594,866,7728,89.9,53,20,37.7
8,All Students,2022-23,10653,1433,9220,86.5,68,24,35.3
All Grades,All Students,2018-19,67420,3759,63661,94.4,406,50,12.3
All Grades,All Students,2019-20,46350,2570,43780,94.5,426,64,15.0
All Grades,All Students,2020-21,65438,3718,61720,94.3,403,58,14.4
All Grades,All Students,2021-22,64785,5581,59204,91.4,387,116,30.0
All Grades,All Students,2022-23,65150,5769,59381,91.1,384,118,30.7
PK in K-12 Schools,All Students,2018-19,9399,599,8800,93.6,56,9,16.1
PK in K-12 Schools,All Students,2019-20,6087,455,5632,92.5,55,13,23.6
PK in K-12 Schools,All Students,2020-21,9260,599,8661,93.5,57,12,21.1
PK in K-12 Schools,All Students,2021-22,11836,1289,10547,89.1,70,29,41.4
PK in K-12 Schools,All Students,2022-23,12133,1248,10885,89.7,69,27,39.1
0K,All Students,2018-19,16306,1066,15240,93.5,101,15,14.9
0K,All Students,2019-20,9438,607,8831,93.6,87,19,21.8
0K,All Students,2020-21,12719,754,11965,94.1,77,11,14.3
0K,All Students,2021-22,10496,993,9503,90.5,68,24,35.3
0K,All Students,2022-23,10486,1140,9346,89.1,65,24,36.9
1,All Students,2018-19,9426,534,8892,94.3,55,6,10.9
1,All Students,2019-20,8910,439,8471,95.1,80,10,12.5
1,All Students,2020-21,11319,820,10499,92.8,70,12,17.1
1,All Students,2021-22,9817,714,9103,92.7,58,12,20.7
1,All Students,2022-23,9535,850,8685,91.1,58,20,34.5
2,All Students,2018-19,7539,440,7099,94.2,47,6,12.8
2,All Students,2019-20,5798,295,5503,94.9,56,7,12.5
2,All Students,2020-21,10086,311,9775,96.9,60,5,8.3
2,All Students,2021-22,9338,775,8563,91.7,54,15,27.8
2,All Students,2022-23,9606,809,8797,91.6,56,14,25.0
3,All Students,2018-19,8320,391,7929,95.3,50,3,6.0
3,All Students,2019-20,5639,321,5318,94.3,53,7,13.2
3,All Students,2020-21,7393,593,6800,92.0,49,12,24.5
3,All Students,2021-22,8805,512,8293,94.2,52,9,17.3
3,All Students,2022-23,8534,652,7882,92.4,50,12,24.0
4,All Students,2018-19,7268,279,6989,96.2,44,3,6.8
4,All Students,2019-20,5638,247,5391,95.6,51,4,7.8
4,All Students,2020-21,7665,356,7309,95.4,48,3,6.3
4,All Students,2021-22,7479,650,6829,91.3,44,16,36.4
4,All Students,2022-23,8611,584,8027,93.2,50,12,24.0
5,All Students,2018-19,9162,450,8712,95.1,53,8,15.1
5,All Students,2019-20,4840,206,4634,95.7,44,4,9.1
5,All Students,2020-21,6996,285,6711,95.9,42,3,7.1
5,All Students,2021-22,7014,648,6366,90.8,41,11,26.8
5,All Students,2022-23,6245,486,5759,92.2,36,9,25.0
All Grades,All Students,2018-19,238173,7439,230734,96.9,1430,74,5.2
All Grades,All Students,2019-20,161412,6821,154591,95.8,1477,104,7.0
All Grades,All Students,2020-21,253399,15684,237715,93.8,1521,268,17.6
All Grades,All Students,2021-22,254907,13464,241443,94.7,1517,169,11.1
All Grades,All Students,2022-23,237980,16460,221520,93.1,1470,283,19.3
9,All Students,2018-19,62988,1467,61521,97.7,378,13,3.4
9,All Students,2019-20,40323,1192,39131,97.0,369,7,1.9
9,All Students,2020-21,66251,2312,63939,96.5,401,33,8.2
9,All Students,2021-22,67247,2269,64978,96.6,403,22,5.5
9,All Students,2022-23,57329,3460,53869,94.0,359,49,13.6
10,All Students,2018-19,65504,1875,63629,97.1,393,17,4.3
10,All Students,2019-20,40630,1374,39256,96.6,373,18,4.8
10,All Students,2020-21,61325,3584,57741,94.2,369,58,15.7
10,All Students,2021-22,65296,3286,62010,95.0,389,47,12.1
10,All Students,2022-23,61942,4405,57537,92.9,384,80,20.8
11,All Students,2018-19,58449,1688,56761,97.1,353,17,4.8
11,All Students,2019-20,42462,1874,40588,95.6,389,30,7.7
11,All Students,2020-21,61719,3229,58490,94.8,368,46,12.5
11,All Students,2021-22,60415,3151,57264,94.8,359,30,8.4
11,All Students,2022-23,62128,3829,58299,93.8,379,61,16.1
12,All Students,2018-19,51232,2409,48823,95.3,306,27,8.8
12,All Students,2019-20,37997,2381,35616,93.7,346,49,14.2
12,All Students,2020-21,64104,6559,57545,89.8,383,131,34.2
12,All Students,2021-22,61949,4758,57191,92.3,366,70,19.1
12,All Students,2022-23,56581,4766,51815,91.6,348,93,26.7
All Grades,All Students,2018-19,459092,22176,436916,95.2,2765,284,10.3
All Grades,All Students,2019-20,323801,14401,309400,95.6,2958,295,10.0
All Grades,All Students,2020-21,475028,43386,431642,90.9,2721,793,29.1
All Grades,All Students,2021-22,400943,23167,377776,94.2,2384,348,14.6
All Grades,All Students,2022-23,391990,30366,361624,92.3,2380,551,23.2
9,All Students,2018-19,99107,2423,96684,97.6,597,14,2.3
9,All Students,2019-20,99250,3198,96052,96.8,908,63,6.9
9,All Students,2020-21,77232,4801,72431,93.8,442,61,13.8
9,All Students,2021-22,74090,3613,70477,95.1,440,42,9.5
9,All Students,2022-23,98983,4789,94194,95.2,602,67,11.1
10,All Students,2018-19,132747,4993,127754,96.2,799,48,6.0
10,All Students,2019-20,69476,2289,67187,96.7,635,42,6.6
10,All Students,2020-21,155270,11199,144071,92.8,891,156,17.5
10,All Students,2021-22,77263,3520,73743,95.4,460,42,9.1
10,All Students,2022-23,79535,4680,74855,94.1,483,85,17.6
11,All Students,2018-19,107555,4705,102850,95.6,651,49,7.5
11,All Students,2019-20,85276,4053,81223,95.2,779,86,11.0
11,All Students,2020-21,108265,9015,99250,91.7,621,165,26.6
11,All Students,2021-22,145140,8527,136613,94.1,865,127,14.7
11,All Students,2022-23,73754,4621,69133,93.7,449,74,16.5
12,All Students,2018-19,119683,10055,109628,91.6,718,173,24.1
12,All Students,2019-20,69799,4861,64938,93.0,636,104,16.4
12,All Students,2020-21,134261,18371,115890,86.3,767,411,53.6
12,All Students,2021-22,104450,7507,96943,92.8,619,137,22.1
12,All Students,2022-23,139718,16276,123442,88.4,846,325,38.4
All Grades,All Students,2018-19,70003,9934,60069,85.8,442,192,43.4
All Grades,All Students,2019-20,44264,6812,37452,84.6,428,203,47.4
All Grades,All Students,2020-21,67451,12284,55167,81.8,397,186,46.9
All Grades,All Students,2021-22,65820,12657,53163,80.8,409,237,57.9
All Grades,All Students,2022-23,72146,14947,57199,79.3,460,300,65.2
9,All Students,2018-19,22406,3510,18896,84.3,143,60,42.0
9,All Students,2019-20,14736,2517,12219,82.9,148,75,50.7
9,All Students,2020-21,25023,4965,20058,80.2,145,70,48.3
9,All Students,2021-22,17350,3326,14024,80.8,107,57,53.3
9,All Students,2022-23,27001,5204,21797,80.7,175,102,58.3
10,All Students,2018-19,15702,2613,13089,83.4,102,52,51.0
10,All Students,2019-20,11890,1852,10038,84.4,112,51,45.5
10,All Students,2020-21,16756,2962,13794,82.3,97,44,45.4
10,All Students,2021-22,19090,3694,15396,80.6,119,65,54.6
10,All Students,2022-23,17359,3654,13705,79.0,112,71,63.4
11,All Students,2018-19,16748,1869,14879,88.8,105,39,37.1
11,All Students,2019-20,6963,1085,5878,84.4,70,31,44.3
11,All Students,2020-21,15737,2526,13211,83.9,92,36,39.1
11,All Students,2021-22,15101,2733,12368,81.9,96,64,66.7
11,All Students,2022-23,15381,2485,12896,83.8,96,56,58.3
12,All Students,2018-19,15147,1942,13205,87.2,92,41,44.6
12,All Students,2019-20,10675,1358,9317,87.3,98,46,46.9
12,All Students,2020-21,9935,1831,8104,81.6,63,36,57.1
12,All Students,2021-22,14279,2904,11375,79.7,87,51,58.6
12,All Students,2022-23,12405,3604,8801,70.9,77,71,92.2
All Grades,All Students,2018-19,77868,14700,63168,81.1,514,276,53.7
All Grades,All Students,2019-20,49939,8747,41192,82.5,471,235,49.9
All Grades,All Students,2020-21,77297,11691,65606,84.9,459,212,46.2
All Grades,All Students,2021-22,74226,14696,59530,80.2,451,256,56.8
All Grades,All Students,2022-23,71820,13897,57923,80.7,460,264,57.4
9,All Students,2018-19,25308,4974,20334,80.3,161,73,45.3
9,All Students,2019-20,16680,2872,13808,82.8,160,75,46.9
9,All Students,2020-21,22813,3915,18898,82.8,133,71,53.4
9,All Students,2021-22,19904,3255,16649,83.6,122,60,49.2
9,All Students,2022-23,22333,3966,18367,82.2,142,72,50.7
10,All Students,2018-19,19254,4370,14884,77.3,133,86,64.7
10,All Students,2019-20,12720,1898,10822,85.1,119,45,37.8
10,All Students,2020-21,23678,3467,20211,85.4,137,54,39.4
10,All Students,2021-22,18700,4086,14614,78.1,113,69,61.1
10,All Students,2022-23,18537,3389,15148,81.7,119,69,58.0
11,All Students,2018-19,16851,2786,14065,83.5,108,57,52.8
11,All Students,2019-20,9522,1635,7887,82.8,90,56,62.2
11,All Students,2020-21,18001,2025,15976,88.8,103,37,35.9
11,All Students,2021-22,18046,3595,14451,80.1,109,68,62.4
11,All Students,2022-23,15227,3207,12020,78.9,98,64,65.3
12,All Students,2018-19,16455,2570,13885,84.4,112,60,53.6
12,All Students,2019-20,11017,2342,8675,78.7,102,59,57.8
12,All Students,2020-21,12805,2284,10521,82.2,86,50,58.1
12,All Students,2021-22,17576,3760,13816,78.6,107,59,55.1
12,All Students,2022-23,15723,3335,12388,78.8,101,59,58.4
All Grades,All Students,2018-19,73667,1871,71796,97.5,445,24,5.4
All Grades,All Students,2019-20,50203,1229,48974,97.6,458,13,2.8
All Grades,All Students,2020-21,78945,1374,77571,98.3,454,11,2.4
All Grades,All Students,2021-22,73453,3816,69637,94.8,438,68,15.5
All Grades,All Students,2022-23,78374,3705,74669,95.3,478,66,13.8
9,All Students,2018-19,18635,647,17988,96.5,113,7,6.2
9,All Students,2019-20,13203,341,12862,97.4,120,3,2.5
9,All Students,2020-21,20218,231,19987,98.9,117,1,0.9
9,All Students,2021-22,16771,1002,15769,94.0,103,20,19.4
9,All Students,2022-23,23616,1409,22207,94.0,144,24,16.7
10,All Students,2018-19,18656,468,18188,97.5,113,2,1.8
10,All Students,2019-20,12439,380,12059,96.9,114,2,1.8
10,All Students,2020-21,20202,370,19832,98.2,116,3,2.6
10,All Students,2021-22,18842,1022,17820,94.6,112,17,15.2
10,All Students,2022-23,17963,1068,16895,94.1,111,19,17.1
11,All Students,2018-19,19157,720,18437,96.2,116,14,12.1
11,All Students,2019-20,12243,377,11866,96.9,113,7,6.2
11,All Students,2020-21,19275,402,18873,97.9,111,4,3.6
11,All Students,2021-22,19487,1576,17911,91.9,115,31,27.0
11,All Students,2022-23,18150,1078,17072,94.1,110,21,19.1
12,All Students,2018-19,17219,36,17183,99.8,103,1,1.0
12,All Students,2019-20,12318,131,12187,98.9,111,1,0.9
12,All Students,2020-21,19250,371,18879,98.1,110,3,2.7
12,All Students,2021-22,18353,216,18137,98.8,108,0,0.0
12,All Students,2022-23,18645,150,18495,99.2,113,2,1.8
All Grades,All Students,2018-19,55602,2991,52611,94.6,319,46,14.4
All Grades,All Students,2019-20,34102,2135,31967,93.7,311,71,22.8
All Grades,All Students,2020-21,51795,761,51034,98.5,299,6,2.0
All Grades,All Students,2021-22,52247,3097,49150,94.1,302,49,16.2
All Grades,All Students,2022-23,51701,3159,48542,93.9,301,47,15.6
0K,All Students,2018-19,2314,72,2242,96.9,13,1,7.7
0K,All Students,2019-20,1495,97,1398,93.5,13,2,15.4
0K,All Students,2020-21,1739,8,1731,99.5,10,0,0.0
0K,All Students,2021-22,2478,176,2302,92.9,14,2,14.3
0K,All Students,2022-23,2301,98,2203,95.7,13,0,0.0
1,All Students,2018-19,2492,64,2428,97.4,14,0,0.0
1,All Students,2019-20,1610,68,1542,95.8,14,1,7.1
1,All Students,2020-21,2088,21,2067,99.0,12,0,0.0
1,All Students,2021-22,2259,54,2205,97.6,13,0,0.0
1,All Students,2022-23,2511,165,2346,93.4,15,2,13.3
2,All Students,2018-19,2670,123,2547,95.4,15,2,13.3
2,All Students,2019-20,1675,41,1634,97.6,15,0,0.0
2,All Students,2020-21,2243,12,2231,99.5,14,0,0.0
2,All Students,2021-22,2138,107,2031,95.0,12,2,16.7
2,All Students,2022-23,2301,72,2229,96.9,13,0,0.0
3,All Students,2018-19,2848,95,2753,96.7,16,0,0.0
3,All Students,2019-20,1710,61,1649,96.4,15,0,0.0
3,All Students,2020-21,2436,17,2419,99.3,14,0,0.0
3,All Students,2021-22,2315,87,2228,96.2,13,0,0.0
3,All Students,2022-23,2301,114,2187,95.0,13,2,15.4
4,All Students,2018-19,2492,153,2339,93.9,14,3,21.4
4,All Students,2019-20,1725,33,1692,98.1,15,0,0.0
4,All Students,2020-21,2610,17,2593,99.3,15,0,0.0
4,All Students,2021-22,2655,67,2588,97.5,15,0,0.0
4,All Students,2022-23,2334,93,2241,96.0,14,0,0.0
5,All Students,2018-19,2848,111,2737,96.1,16,0,0.0
5,All Students,2019-20,1725,126,1599,92.7,15,4,26.7
5,All Students,2020-21,2438,3,2435,99.9,14,0,0.0
5,All Students,2021-22,2580,127,2453,95.1,15,0,0.0
5,All Students,2022-23,2655,96,2559,96.4,15,0,0.0
6,All Students,2018-19,2492,84,2408,96.6,14,1,7.1
6,All Students,2019-20,1610,57,1553,96.5,14,1,7.1
6,All Students,2020-21,2599,21,2578,99.2,15,0,0.0
6,All Students,2021-22,2296,104,2192,95.5,13,0,0.0
6,All Students,2022-23,2765,103,2662,96.3,16,1,6.3
7,All Students,2018-19,3026,55,2971,98.2,17,0,0.0
7,All Students,2019-20,1380,53,1327,96.2,12,1,8.3
7,All Students,2020-21,2262,16,2246,99.3,13,0,0.0
7,All Students,2021-22,2321,190,2131,91.8,14,5,35.7
7,All Students,2022-23,2145,86,2059,96.0,13,0,0.0
8,All Students,2018-19,2492,99,2393,96.0,14,0,0.0
8,All Students,2019-20,2070,55,2015,97.3,18,0,0.0
8,All Students,2020-21,2088,11,2077,99.5,12,0,0.0
8,All Students,2021-22,2134,80,2054,96.3,13,1,7.7
8,All Students,2022-23,2301,163,2138,92.9,13,3,23.1
9,All Students,2018-19,7538,412,7126,94.5,46,6,13.0
9,All Students,2019-20,4236,263,3973,93.8,40,11,27.5
9,All Students,2020-21,8393,89,8304,98.9,48,1,2.1
9,All Students,2021-22,7740,451,7289,94.2,45,6,13.3
9,All Students,2022-23,7323,418,6905,94.3,42,7,16.7
10,All Students,2018-19,8034,399,7635,95.0,47,6,12.8
10,All Students,2019-20,4442,215,4227,95.2,42,6,14.3
10,All Students,2020-21,7587,130,7457,98.3,44,1,2.3
10,All Students,2021-22,8779,416,8363,95.3,51,6,11.8
10,All Students,2022-23,7948,565,7383,92.9,47,8,17.0
11,All Students,2018-19,9036,452,8584,95.0,51,5,9.8
11,All Students,2019-20,5237,456,4781,91.3,50,17,34.0
11,All Students,2020-21,7525,87,7438,98.8,43,0,0.0
11,All Students,2021-22,7369,495,6874,93.3,43,11,25.6
11,All Students,2022-23,8411,532,7879,93.7,50,7,14.0
12,All Students,2018-19,7320,872,6448,88.1,42,22,52.4
12,All Students,2019-20,5187,610,4577,88.2,48,28,58.3
12,All Students,2020-21,7787,329,7458,95.8,45,4,8.9
12,All Students,2021-22,7183,743,6440,89.7,41,16,39.0
12,All Students,2022-23,6405,654,5751,89.8,37,17,45.9
All Grades,All Students,2018-19,60017,9983,50034,83.4,395,193,48.9
All Grades,All Students,2019-20,36069,5187,30882,85.6,350,139,39.7
All Grades,All Students,2020-21,58148,6718,51430,88.4,348,99,28.4
All Grades,All Students,2021-22,59239,7781,51458,86.9,379,153,40.4
All Grades,All Students,2022-23,54824,6004,48820,89.0,352,92,26.1
6,All Students,2018-19,4333,338,3995,92.2,26,5,19.2
6,All Students,2019-20,3158,221,2937,93.0,28,3,10.7
6,All Students,2020-21,5999,330,5669,94.5,35,4,11.4
6,All Students,2021-22,4119,378,3741,90.8,24,6,25.0
6,All Students,2022-23,2865,359,2506,87.5,18,5,27.8
7,All Students,2018-19,4000,712,3288,82.2,26,15,57.7
7,All Students,2019-20,2709,175,2534,93.5,26,5,19.2
7,All Students,2020-21,5050,226,4824,95.5,31,4,12.9
7,All Students,2021-22,6733,515,6218,92.4,40,14,35.0
7,All Students,2022-23,3827,142,3685,96.3,26,3,11.5
8,All Students,2018-19,4258,456,3802,89.3,25,11,44.0
8,All Students,2019-20,2665,304,2361,88.6,25,11,44.0
8,All Students,2020-21,4616,432,4184,90.6,27,5,18.5
8,All Students,2021-22,5538,511,5027,90.8,33,10,30.3
8,All Students,2022-23,6674,234,6440,96.5,43,3,7.0
9,All Students,2018-19,13453,3172,10281,76.4,102,59,57.8
9,All Students,2019-20,8484,1691,6793,80.1,85,36,42.4
9,All Students,2020-21,12894,2296,10598,82.2,76,27,35.5
9,All Students,2021-22,13398,1953,11445,85.4,90,34,37.8
9,All Students,2022-23,11290,1569,9721,86.1,76,21,27.6
10,All Students,2018-19,12567,2443,10124,80.6,82,52,63.4
10,All Students,2019-20,7045,1314,5731,81.3,70,41,58.6
10,All Students,2020-21,12169,1788,10381,85.3,76,25,32.9
10,All Students,2021-22,11349,2083,9266,81.6,76,32,42.1
10,All Students,2022-23,12209,1320,10889,89.2,75,15,20.0
11,All Students,2018-19,12559,1754,10805,86.0,77,29,37.7
11,All Students,2019-20,6581,917,5664,86.1,65,26,40.0
11,All Students,2020-21,8420,710,7710,91.6,51,17,33.3
11,All Students,2021-22,10190,1304,8886,87.2,65,31,47.7
11,All Students,2022-23,9798,1197,8601,87.8,61,20,32.8
12,All Students,2018-19,8847,1108,7739,87.5,57,22,38.6
12,All Students,2019-20,5427,565,4862,89.6,51,17,33.3
12,All Students,2020-21,9000,936,8064,89.6,52,17,32.7
12,All Students,2021-22,7912,1037,6875,86.9,51,26,51.0
12,All Students,2022-23,8161,1183,6978,85.5,53,25,47.2
All Grades,All Students,2018-19,76836,3492,73344,95.5,438,49,11.2
All Grades,All Students,2019-20,47998,2121,45877,95.6,428,47,11.0
All Grades,All Students,2020-21,68168,4590,63578,93.3,398,84,21.1
All Grades,All Students,2021-22,63497,5615,57882,91.2,368,122,33.2
All Grades,All Students,2022-23,63619,5924,57695,90.7,377,113,30.0
6,All Students,2018-19,26700,1282,25418,95.2,151,18,11.9
6,All Students,2019-20,15248,699,14549,95.4,136,16,11.8
6,All Students,2020-21,20341,1322,19019,93.5,121,30,24.8
6,All Students,2021-22,21928,2014,19914,90.8,128,45,35.2
6,All Students,2022-23,22363,2053,20310,90.8,132,39,29.5
7,All Students,2018-19,24685,920,23765,96.3,142,11,7.7
7,All Students,2019-20,17151,655,16496,96.2,152,14,9.2
7,All Students,2020-21,22044,1278,20766,94.2,128,24,18.8
7,All Students,2021-22,19779,1650,18129,91.7,114,34,29.8
7,All Students,2022-23,21441,1919,19522,91.0,128,37,28.9
8,All Students,2018-19,25451,1290,24161,94.9,145,20,13.8
8,All Students,2019-20,15599,767,14832,95.1,140,17,12.1
8,All Students,2020-21,25783,1990,23793,92.3,149,30,20.1
8,All Students,2021-22,21790,1951,19839,91.0,126,43,34.1
8,All Students,2022-23,19815,1952,17863,90.1,117,37,31.6
All Grades,All Students,2018-19,71263,8836,62427,87.6,451,220,48.8
All Grades,All Students,2019-20,42972,5262,37710,87.8,407,177,43.5
All Grades,All Students,2020-21,61798,12924,48874,79.1,386,243,63.0
All Grades,All Students,2021-22,56082,10195,45887,81.8,351,246,70.1
All Grades,All Students,2022-23,59448,10874,48574,81.7,386,264,68.4
PK in K-12 Schools,All Students,2018-19,5270,736,4534,86.0,32,21,65.6
PK in K-12 Schools,All Students,2019-20,4466,807,3659,81.9,46,33,71.7
PK in K-12 Schools,All Students,2020-21,6833,1614,5219,76.4,50,37,74.0
PK in K-12 Schools,All Students,2021-22,5918,1393,4525,76.5,40,36,90.0
PK in K-12 Schools,All Students,2022-23,6790,1797,4993,73.5,42,37,88.1
0K,All Students,2018-19,5149,826,4323,84.0,36,25,69.4
0K,All Students,2019-20,3351,347,3004,89.6,32,15,46.9
0K,All Students,2020-21,4612,988,3624,78.6,29,19,65.5
0K,All Students,2021-22,4229,990,3239,76.6,26,23,88.5
0K,All Students,2022-23,4660,917,3743,80.3,32,23,71.9
1,All Students,2018-19,4309,619,3690,85.6,25,13,52.0
1,All Students,2019-20,3488,530,2958,84.8,34,21,61.8
1,All Students,2020-21,5469,1477,3992,73.0,36,26,72.2
1,All Students,2021-22,4435,833,3602,81.2,30,24,80.0
1,All Students,2022-23,4601,749,3852,83.7,31,23,74.2
2,All Students,2018-19,4115,506,3609,87.7,26,15,57.7
2,All Students,2019-20,2518,379,2139,84.9,23,10,43.5
2,All Students,2020-21,5621,1745,3876,69.0,35,30,85.7
2,All Students,2021-22,4974,668,4306,86.6,29,17,58.6
2,All Students,2022-23,4939,812,4127,83.6,36,23,63.9
3,All Students,2018-19,4815,509,4306,89.4,29,14,48.3
3,All Students,2019-20,2686,310,2376,88.5,28,9,32.1
3,All Students,2020-21,4697,1004,3693,78.6,28,18,64.3
3,All Students,2021-22,5457,980,4477,82.0,34,24,70.6
3,All Students,2022-23,6117,870,5247,85.8,37,23,62.2
4,All Students,2018-19,6519,547,5972,91.6,41,14,34.1
4,All Students,2019-20,3130,357,2773,88.6,29,12,41.4
4,All Students,2020-21,3828,935,2893,75.6,27,18,66.7
4,All Students,2021-22,3790,911,2879,76.0,24,19,79.2
4,All Students,2022-23,6053,994,5059,83.6,40,26,65.0
5,All Students,2018-19,6149,625,5524,89.8,41,19,46.3
5,All Students,2019-20,3907,363,3544,90.7,34,11,32.4
5,All Students,2020-21,5054,763,4291,84.9,32,19,59.4
5,All Students,2021-22,4686,804,3882,82.8,29,20,69.0
5,All Students,2022-23,4185,767,3418,81.7,27,17,63.0
6,All Students,2018-19,9387,877,8510,90.7,60,22,36.7
6,All Students,2019-20,5377,560,4817,89.6,51,19,37.3
6,All Students,2020-21,8230,1235,6995,85.0,47,24,51.1
6,All Students,2021-22,6709,901,5808,86.6,43,21,48.8
6,All Students,2022-23,6837,1382,5455,79.8,47,31,66.0
7,All Students,2018-19,13439,1633,11806,87.8,84,33,39.3
7,All Students,2019-20,6122,697,5425,88.6,58,21,36.2
7,All Students,2020-21,7951,1817,6134,77.1,46,27,58.7
7,All Students,2021-22,7004,1061,5943,84.9,42,26,61.9
7,All Students,2022-23,7242,1146,6096,84.2,45,24,53.3
8,All Students,2018-19,12111,1958,10153,83.8,77,44,57.1
8,All Students,2019-20,7927,912,7015,88.5,72,26,36.1
8,All Students,2020-21,9503,1346,8157,85.8,56,25,44.6
8,All Students,2021-22,8880,1654,7226,81.4,54,36,66.7
8,All Students,2022-23,8024,1440,6584,82.1,49,37,75.5
All Grades,All Students,2018-19,106196,3322,102874,96.9,606,33,5.4
All Grades,All Students,2019-20,68495,2277,66218,96.7,601,38,6.3
All Grades,All Students,2020-21,99602,1147,98455,98.8,579,12,2.1
All Grades,All Students,2021-22,94027,5112,88915,94.6,539,73,13.5
All Grades,All Students,2022-23,97893,4811,93082,95.1,564,68,12.1
0K,All Students,2018-19,8835,324,8511,96.3,51,2,3.9
0K,All Students,2019-20,5754,244,5510,95.8,50,4,8.0
0K,All Students,2020-21,7892,69,7823,99.1,46,1,2.2
0K,All Students,2021-22,7911,594,7317,92.5,46,13,28.3
0K,All Students,2022-23,8290,494,7796,94.0,49,10,20.4
1,All Students,2018-19,10972,460,10512,95.8,65,8,12.3
1,All Students,2019-20,6855,304,6551,95.6,60,1,1.7
1,All Students,2020-21,10457,42,10415,99.6,62,0,0.0
1,All Students,2021-22,8376,697,7679,91.7,50,10,20.0
1,All Students,2022-23,9705,729,8976,92.5,57,17,29.8
2,All Students,2018-19,11392,468,10924,95.9,64,7,10.9
2,All Students,2019-20,7323,331,6992,95.5,65,8,12.3
2,All Students,2020-21,14649,136,14513,99.1,85,0,0.0
2,All Students,2021-22,9294,353,8941,96.2,53,2,3.8
2,All Students,2022-23,10303,455,9848,95.6,60,5,8.3
3,All Students,2018-19,11359,372,10987,96.7,65,3,4.6
3,All Students,2019-20,7301,225,7076,96.9,64,3,4.7
3,All Students,2020-21,10092,94,9998,99.1,59,2,3.4
3,All Students,2021-22,14222,697,13525,95.1,81,7,8.6
3,All Students,2022-23,10495,384,10111,96.3,60,2,3.3
4,All Students,2018-19,11528,338,11190,97.1,66,3,4.5
4,All Students,2019-20,7342,202,7140,97.2,64,2,3.1
4,All Students,2020-21,11348,83,11265,99.3,66,0,0.0
4,All Students,2021-22,8974,489,8485,94.6,52,6,11.5
4,All Students,2022-23,15379,762,14617,95.0,88,9,10.2
5,All Students,2018-19,11690,290,11400,97.5,66,1,1.5
5,All Students,2019-20,10785,302,10483,97.2,96,7,7.3
5,All Students,2020-21,10522,85,10437,99.2,61,0,0.0
5,All Students,2021-22,14572,751,13821,94.8,83,12,14.5
5,All Students,2022-23,10072,490,9582,95.1,57,6,10.5
6,All Students,2018-19,11885,414,11471,96.5,68,5,7.4
6,All Students,2019-20,7495,216,7279,97.1,66,2,3.0
6,All Students,2020-21,14989,236,14753,98.4,86,2,2.3
6,All Students,2021-22,9734,585,9149,94.0,55,12,21.8
6,All Students,2022-23,14183,624,13559,95.6,82,9,11.0
7,All Students,2018-19,13583,271,13312,98.0,77,1,1.3
7,All Students,2019-20,7130,213,6917,97.0,62,5,8.1
7,All Students,2020-21,9149,146,9003,98.4,54,2,3.7
7,All Students,2021-22,12245,526,11719,95.7,70,5,7.1
7,All Students,2022-23,7457,325,7132,95.6,43,5,11.6
8,All Students,2018-19,14952,385,14567,97.4,84,3,3.6
8,All Students,2019-20,8510,240,8270,97.2,74,6,8.1
8,All Students,2020-21,10504,256,10248,97.6,60,5,8.3
8,All Students,2021-22,8699,420,8279,95.2,49,6,12.2
8,All Students,2022-23,12009,548,11461,95.4,68,5,7.4
All Grades,All Students,2018-19,45198,4418,40780,90.2,275,109,39.6
All Grades,All Students,2019-20,30753,2945,27808,90.4,284,110,38.7
All Grades,All Students,2020-21,47283,7594,39689,83.9,279,140,50.2
All Grades,All Students,2021-22,41590,6283,35307,84.9,261,154,59.0
All Grades,All Students,2022-23,40658,5468,35190,86.6,247,137,55.5
PK in K-12 Schools,All Students,2018-19,5505,680,4825,87.6,34,19,55.9
PK in K-12 Schools,All Students,2019-20,5191,731,4460,85.9,48,28,58.3
PK in K-12 Schools,All Students,2020-21,9344,2339,7005,75.0,60,39,65.0
PK in K-12 Schools,All Students,2021-22,8954,1768,7186,80.3,58,41,70.7
PK in K-12 Schools,All Students,2022-23,9349,1747,7602,81.3,59,44,74.6
0K,All Students,2018-19,7026,883,6143,87.4,44,23,52.3
0K,All Students,2019-20,4193,343,3850,91.8,38,12,31.6
0K,All Students,2020-21,7082,1208,5874,82.9,41,22,53.7
0K,All Students,2021-22,5844,914,4930,84.4,40,26,65.0
0K,All Students,2022-23,5868,790,5078,86.5,35,21,60.0
1,All Students,2018-19,6425,726,5699,88.7,39,21,53.8
1,All Students,2019-20,4234,465,3769,89.0,37,13,35.1
1,All Students,2020-21,5240,571,4669,89.1,30,14,46.7
1,All Students,2021-22,6250,853,5397,86.4,37,19,51.4
1,All Students,2022-23,4634,568,4066,87.7,29,15,51.7
2,All Students,2018-19,4497,450,4047,90.0,28,13,46.4
2,All Students,2019-20,3578,397,3181,88.9,35,19,54.3
2,All Students,2020-21,6363,842,5521,86.8,37,17,45.9
2,All Students,2021-22,4760,550,4210,88.4,30,14,46.7
2,All Students,2022-23,6295,719,5576,88.6,37,16,43.2
3,All Students,2018-19,7391,652,6739,91.2,47,15,31.9
3,All Students,2019-20,3729,321,3408,91.4,34,11,32.4
3,All Students,2020-21,5870,1009,4861,82.8,34,16,47.1
3,All Students,2021-22,5388,684,4704,87.3,33,16,48.5
3,All Students,2022-23,5271,660,4611,87.5,33,19,57.6
4,All Students,2018-19,8779,660,8119,92.5,51,10,19.6
4,All Students,2019-20,4909,353,4556,92.8,45,14,31.1
4,All Students,2020-21,5722,706,5016,87.7,33,12,36.4
4,All Students,2021-22,4983,842,4141,83.1,30,21,70.0
4,All Students,2022-23,4475,420,4055,90.6,26,8,30.8
5,All Students,2018-19,5575,367,5208,93.4,32,8,25.0
5,All Students,2019-20,4919,335,4584,93.2,47,13,27.7
5,All Students,2020-21,7662,919,6743,88.0,44,20,45.5
5,All Students,2021-22,5411,672,4739,87.6,33,17,51.5
5,All Students,2022-23,4766,564,4202,88.2,28,14,50.0
All Grades,All Students,2018-19,43909,5034,38875,88.5,290,154,53.1
All Grades,All Students,2019-20,28447,3235,25212,88.6,283,135,47.7
All Grades,All Students,2020-21,35294,6992,28302,80.2,232,136,58.6
All Grades,All Students,2021-22,31319,6658,24661,78.7,209,167,79.9
All Grades,All Students,2022-23,30647,5187,25460,83.1,259,187,72.2
PK in K-12 Schools,All Students,2018-19,6961,1037,5924,85.1,51,34,66.7
PK in K-12 Schools,All Students,2019-20,5847,878,4969,85.0,56,38,67.9
PK in K-12 Schools,All Students,2020-21,5593,986,4607,82.4,44,29,65.9
PK in K-12 Schools,All Students,2021-22,5715,1262,4453,77.9,39,38,97.4
PK in K-12 Schools,All Students,2022-23,8583,1560,7023,81.8,65,49,75.4
0K,All Students,2018-19,5040,782,4258,84.5,35,24,68.6
0K,All Students,2019-20,2582,394,2188,84.7,31,20,64.5
0K,All Students,2020-21,4552,1139,3413,75.0,31,20,64.5
0K,All Students,2021-22,4632,1276,3356,72.5,30,26,86.7
0K,All Students,2022-23,3577,746,2831,79.1,29,21,72.4
1,All Students,2018-19,4462,458,4004,89.7,30,13,43.3
1,All Students,2019-20,4087,527,3560,87.1,41,24,58.5
1,All Students,2020-21,2875,877,1998,69.5,18,11,61.1
1,All Students,2021-22,4225,1020,3205,75.9,31,29,93.5
1,All Students,2022-23,3965,751,3214,81.1,39,29,74.4
2,All Students,2018-19,5454,550,4904,89.9,36,19,52.8
2,All Students,2019-20,2936,325,2611,88.9,30,13,43.3
2,All Students,2020-21,5393,1307,4086,75.8,33,23,69.7
2,All Students,2021-22,3163,577,2586,81.8,23,17,73.9
2,All Students,2022-23,3705,588,3117,84.1,35,29,82.9
3,All Students,2018-19,8282,793,7489,90.4,51,22,43.1
3,All Students,2019-20,4323,516,3807,88.1,42,21,50.0
3,All Students,2020-21,4946,941,4005,81.0,31,17,54.8
3,All Students,2021-22,3808,700,3108,81.6,23,18,78.3
3,All Students,2022-23,3159,s,s,s,s,s,s
4,All Students,2018-19,7399,692,6707,90.6,47,19,40.4
4,All Students,2019-20,4178,317,3861,92.4,39,11,28.2
4,All Students,2020-21,5884,1161,4723,80.3,38,22,57.9
4,All Students,2021-22,4080,748,3332,81.7,26,17,65.4
4,All Students,2022-23,3711,447,3264,88.0,36,22,61.1
5,All Students,2018-19,6311,722,5589,88.6,40,23,57.5
5,All Students,2019-20,4494,278,4216,93.8,44,8,18.2
5,All Students,2020-21,6051,581,5470,90.4,37,14,37.8
5,All Students,2021-22,5696,1075,4621,81.1,37,22,59.5
5,All Students,2022-23,3942,566,3376,85.6,26,14,53.8
6,All Students,2022-23,5,s,s,s,s,s,s
All Grades,All Students,2018-19,140819,13310,127509,90.5,847,322,38.0
All Grades,All Students,2019-20,80661,6401,74260,92.1,739,237,32.1
All Grades,All Students,2020-21,106936,8767,98169,91.8,632,193,30.5
All Grades,All Students,2021-22,99128,13019,86109,86.9,594,320,53.9
All Grades,All Students,2022-23,106570,14543,92027,86.4,692,391,56.5
PK in K-12 Schools,All Students,2018-19,7502,1238,6264,83.5,50,33,66.0
PK in K-12 Schools,All Students,2019-20,6073,891,5182,85.3,62,35,56.5
PK in K-12 Schools,All Students,2020-21,5743,630,5113,89.0,38,19,50.0
PK in K-12 Schools,All Students,2021-22,5082,885,4197,82.6,30,22,73.3
PK in K-12 Schools,All Students,2022-23,9512,1633,7879,82.8,66,47,71.2
0K,All Students,2018-19,12069,1632,10437,86.5,79,46,58.2
0K,All Students,2019-20,5914,632,5282,89.3,55,29,52.7
0K,All Students,2020-21,7053,712,6341,89.9,43,17,39.5
0K,All Students,2021-22,7314,1171,6143,84.0,44,32,72.7
0K,All Students,2022-23,6888,1117,5771,83.8,49,38,77.6
1,All Students,2018-19,12675,1236,11439,90.2,75,29,38.7
1,All Students,2019-20,7184,653,6531,90.9,69,25,36.2
1,All Students,2020-21,8432,566,7866,93.3,52,16,30.8
1,All Students,2021-22,7624,1114,6510,85.4,46,32,69.6
1,All Students,2022-23,8193,1242,6951,84.8,55,35,63.6
2,All Students,2018-19,12459,1225,11234,90.2,78,35,44.9
2,All Students,2019-20,7783,591,7192,92.4,69,23,33.3
2,All Students,2020-21,10572,1052,9520,90.0,61,21,34.4
2,All Students,2021-22,8261,1179,7082,85.7,51,29,56.9
2,All Students,2022-23,9217,1139,8078,87.6,59,29,49.2
3,All Students,2018-19,13675,1259,12416,90.8,82,29,35.4
3,All Students,2019-20,6347,509,5838,92.0,58,21,36.2
3,All Students,2020-21,11525,418,11107,96.4,67,11,16.4
3,All Students,2021-22,10375,1301,9074,87.5,64,32,50.0
3,All Students,2022-23,9193,1077,8116,88.3,61,29,47.5
4,All Students,2018-19,16585,1554,15031,90.6,96,35,36.5
4,All Students,2019-20,8013,597,7416,92.5,71,22,31.0
4,All Students,2020-21,9851,420,9431,95.7,57,8,14.0
4,All Students,2021-22,10531,1264,9267,88.0,63,30,47.6
4,All Students,2022-23,11912,1444,10468,87.9,74,37,50.0
5,All Students,2018-19,15673,1388,14285,91.1,93,33,35.5
5,All Students,2019-20,9668,647,9021,93.3,88,23,26.1
5,All Students,2020-21,11297,727,10570,93.6,65,12,18.5
5,All Students,2021-22,9634,1170,8464,87.9,57,28,49.1
5,All Students,2022-23,11816,1543,10273,86.9,75,38,50.7
6,All Students,2018-19,15405,1346,14059,91.3,93,31,33.3
6,All Students,2019-20,10387,789,9598,92.4,93,28,30.1
6,All Students,2020-21,12620,763,11857,94.0,76,17,22.4
6,All Students,2021-22,12974,1491,11483,88.5,77,37,48.1
6,All Students,2022-23,12382,1694,10688,86.3,81,49,60.5
7,All Students,2018-19,17203,999,16204,94.2,100,22,22.0
7,All Students,2019-20,9469,579,8890,93.9,85,15,17.6
7,All Students,2020-21,15535,1981,13554,87.2,90,39,43.3
7,All Students,2021-22,12305,1378,10927,88.8,75,26,34.7
7,All Students,2022-23,14778,1961,12817,86.7,90,46,51.1
8,All Students,2018-19,17573,1433,16140,91.8,101,29,28.7
8,All Students,2019-20,9823,513,9310,94.8,89,16,18.0
8,All Students,2020-21,14308,1498,12810,89.5,83,33,39.8
8,All Students,2021-22,15028,2066,12962,86.3,87,52,59.8
8,All Students,2022-23,12679,1693,10986,86.6,82,43,52.4
All Grades,All Students,2018-19,115250,12416,102834,89.2,677,283,41.8
All Grades,All Students,2019-20,68304,7417,60887,89.1,620,245,39.5
All Grades,All Students,2020-21,98040,18116,79924,81.5,581,286,49.2
All Grades,All Students,2021-22,97453,17403,80050,82.1,587,394,67.1
All Grades,All Students,2022-23,89419,13136,76283,85.3,558,335,60.0
PK in K-12 Schools,All Students,2018-19,7950,1261,6689,84.1,49,31,63.3
PK in K-12 Schools,All Students,2019-20,5017,800,4217,84.1,45,24,53.3
PK in K-12 Schools,All Students,2020-21,6331,841,5490,86.7,38,15,39.5
PK in K-12 Schools,All Students,2021-22,6989,1143,5846,83.6,42,29,69.0
PK in K-12 Schools,All Students,2022-23,6253,1182,5071,81.1,47,37,78.7
0K,All Students,2018-19,9537,1359,8178,85.8,56,30,53.6
0K,All Students,2019-20,6332,798,5534,87.4,56,25,44.6
0K,All Students,2020-21,8321,1864,6457,77.6,50,31,62.0
0K,All Students,2021-22,6799,1042,5757,84.7,42,26,61.9
0K,All Students,2022-23,6383,1009,5374,84.2,42,27,64.3
1,All Students,2018-19,11324,1279,10045,88.7,65,31,47.7
1,All Students,2019-20,6161,702,5459,88.6,55,23,41.8
1,All Students,2020-21,8228,996,7232,87.9,49,18,36.7
1,All Students,2021-22,8589,1465,7124,82.9,53,36,67.9
1,All Students,2022-23,7486,1068,6418,85.7,47,28,59.6
2,All Students,2018-19,9316,925,8391,90.1,54,22,40.7
2,All Students,2019-20,6137,801,5336,86.9,55,30,54.5
2,All Students,2020-21,8911,1331,7580,85.1,54,27,50.0
2,All Students,2021-22,9227,1669,7558,81.9,56,33,58.9
2,All Students,2022-23,8384,1066,7318,87.3,50,28,56.0
3,All Students,2018-19,11792,1266,10526,89.3,69,32,46.4
3,All Students,2019-20,5905,562,5343,90.5,55,20,36.4
3,All Students,2020-21,9353,940,8413,89.9,55,21,38.2
3,All Students,2021-22,9429,1337,8092,85.8,59,37,62.7
3,All Students,2022-23,8996,1225,7771,86.4,57,31,54.4
4,All Students,2018-19,11525,811,10714,93.0,66,13,19.7
4,All Students,2019-20,6294,503,5791,92.0,55,16,29.1
4,All Students,2020-21,8501,1300,7201,84.7,50,25,50.0
4,All Students,2021-22,10262,1871,8391,81.8,60,39,65.0
4,All Students,2022-23,8763,928,7835,89.4,53,27,50.9
5,All Students,2018-19,11947,1109,10838,90.7,70,25,35.7
5,All Students,2019-20,7270,570,6700,92.2,64,20,31.3
5,All Students,2020-21,9779,579,9200,94.1,56,9,16.1
5,All Students,2021-22,8863,1587,7276,82.1,54,38,70.4
5,All Students,2022-23,10416,1442,8974,86.2,61,35,57.4
6,All Students,2018-19,14732,1483,13249,89.9,87,34,39.1
6,All Students,2019-20,8631,918,7713,89.4,82,33,40.2
6,All Students,2020-21,11942,2377,9565,80.1,72,40,55.6
6,All Students,2021-22,12779,2478,10301,80.6,77,53,68.8
6,All Students,2022-23,9123,1499,7624,83.6,61,39,63.9
7,All Students,2018-19,11936,1090,10846,90.9,71,22,31.0
7,All Students,2019-20,9169,955,8214,89.6,84,32,38.1
7,All Students,2020-21,13184,3723,9461,71.8,77,49,63.6
7,All Students,2021-22,10838,2069,8769,80.9,62,46,74.2
7,All Students,2022-23,11907,1880,10027,84.2,71,42,59.2
8,All Students,2018-19,15191,1833,13358,87.9,90,43,47.8
8,All Students,2019-20,7388,808,6580,89.1,69,22,31.9
8,All Students,2020-21,13490,4165,9325,69.1,80,51,63.8
8,All Students,2021-22,13678,2742,10936,80.0,82,57,69.5
8,All Students,2022-23,11708,1837,9871,84.3,69,41,59.4
All Grades,All Students,2018-19,74342,5701,68641,92.3,448,151,33.7
All Grades,All Students,2019-20,42604,3143,39461,92.6,386,102,26.4
All Grades,All Students,2020-21,60427,4647,55780,92.3,366,89,24.3
All Grades,All Students,2021-22,58364,6447,51917,89.0,356,160,44.9
All Grades,All Students,2022-23,56210,5888,50322,89.5,377,171,45.4
PK in K-12 Schools,All Students,2018-19,5639,588,5051,89.6,35,14,40.0
PK in K-12 Schools,All Students,2019-20,3634,476,3158,86.9,33,16,48.5
PK in K-12 Schools,All Students,2020-21,5355,591,4764,89.0,34,13,38.2
PK in K-12 Schools,All Students,2021-22,4762,707,4055,85.2,31,20,64.5
PK in K-12 Schools,All Students,2022-23,5730,923,4807,83.9,35,30,85.7
0K,All Students,2018-19,7585,488,7097,93.6,45,14,31.1
0K,All Students,2019-20,4956,386,4570,92.2,48,15,31.3
0K,All Students,2020-21,8650,907,7743,89.5,54,18,33.3
0K,All Students,2021-22,8194,1056,7138,87.1,55,26,47.3
0K,All Students,2022-23,6692,997,5695,85.1,57,34,59.6
1,All Students,2018-19,10531,851,9680,91.9,63,26,41.3
1,All Students,2019-20,5518,384,5134,93.0,49,9,18.4
1,All Students,2020-21,7298,689,6609,90.6,44,15,34.1
1,All Students,2021-22,9224,910,8314,90.1,55,21,38.2
1,All Students,2022-23,8292,918,7374,88.9,54,24,44.4
2,All Students,2018-19,11590,919,10671,92.1,71,27,38.0
2,All Students,2019-20,6422,423,5999,93.4,57,14,24.6
2,All Students,2020-21,7637,389,7248,94.9,46,7,15.2
2,All Students,2021-22,7568,919,6649,87.9,45,21,46.7
2,All Students,2022-23,9494,864,8630,90.9,62,24,38.7
3,All Students,2018-19,11997,908,11089,92.4,71,21,29.6
3,All Students,2019-20,7098,469,6629,93.4,64,14,21.9
3,All Students,2020-21,9209,719,8490,92.2,56,14,25.0
3,All Students,2021-22,7789,721,7068,90.7,47,17,36.2
3,All Students,2022-23,7756,669,7087,91.4,55,22,40.0
4,All Students,2018-19,12893,861,12032,93.3,79,25,31.6
4,All Students,2019-20,7014,504,6510,92.8,62,20,32.3
4,All Students,2020-21,10834,633,10201,94.2,65,11,16.9
4,All Students,2021-22,9690,1057,8633,89.1,57,28,49.1
4,All Students,2022-23,7277,641,6636,91.2,51,20,39.2
5,All Students,2018-19,14107,1086,13021,92.3,84,24,28.6
5,All Students,2019-20,7962,501,7461,93.7,73,14,19.2
5,All Students,2020-21,11429,709,10720,93.8,66,10,15.2
5,All Students,2021-22,11137,1077,10060,90.3,66,27,40.9
5,All Students,2022-23,10969,876,10093,92.0,63,17,27.0
All Grades,All Students,2018-19,72157,7179,64978,90.1,431,196,45.5
All Grades,All Students,2019-20,46170,4988,41182,89.2,424,173,40.8
All Grades,All Students,2020-21,66149,10642,55507,83.9,395,213,53.9
All Grades,All Students,2021-22,64595,10038,54557,84.5,403,251,62.3
All Grades,All Students,2022-23,70182,11760,58422,83.2,470,317,67.4
PK in K-12 Schools,All Students,2018-19,4869,999,3870,79.5,30,27,90.0
PK in K-12 Schools,All Students,2019-20,4158,1042,3116,74.9,39,33,84.6
PK in K-12 Schools,All Students,2020-21,5394,1198,4196,77.8,35,21,60.0
PK in K-12 Schools,All Students,2021-22,6676,1748,4928,73.8,48,42,87.5
PK in K-12 Schools,All Students,2022-23,7041,1722,5319,75.5,52,48,92.3
0K,All Students,2018-19,5104,674,4430,86.8,34,21,61.8
0K,All Students,2019-20,3140,479,2661,84.7,29,21,72.4
0K,All Students,2020-21,5174,1037,4137,80.0,33,21,63.6
0K,All Students,2021-22,5865,1078,4787,81.6,39,27,69.2
0K,All Students,2022-23,6055,897,5158,85.2,39,30,76.9
1,All Students,2018-19,5279,473,4806,91.0,33,13,39.4
1,All Students,2019-20,3039,309,2730,89.8,29,13,44.8
1,All Students,2020-21,4844,s,s,s,s,s,s
1,All Students,2021-22,5054,809,4245,84.0,32,23,71.9
1,All Students,2022-23,6785,1351,5434,80.1,44,28,63.6
2,All Students,2018-19,6545,604,5941,90.8,39,17,43.6
2,All Students,2019-20,3673,370,3303,89.9,34,11,32.4
2,All Students,2020-21,4898,744,4154,84.8,30,17,56.7
2,All Students,2021-22,4386,733,3653,83.3,26,19,73.1
2,All Students,2022-23,5689,798,4891,86.0,36,22,61.1
3,All Students,2018-19,6277,605,5672,90.4,36,12,33.3
3,All Students,2019-20,4057,344,3713,91.5,36,9,25.0
3,All Students,2020-21,4884,681,4203,86.1,29,14,48.3
3,All Students,2021-22,5239,731,4508,86.0,32,19,59.4
3,All Students,2022-23,4408,628,3780,85.8,30,18,60.0
4,All Students,2018-19,6965,586,6379,91.6,42,20,47.6
4,All Students,2019-20,3868,350,3518,91.0,35,11,31.4
4,All Students,2020-21,6014,497,5517,91.7,36,14,38.9
4,All Students,2021-22,5264,702,4562,86.7,30,20,66.7
4,All Students,2022-23,5781,1014,4767,82.5,38,25,65.8
5,All Students,2018-19,8959,703,8256,92.2,53,17,32.1
5,All Students,2019-20,5055,417,4638,91.8,47,17,36.2
5,All Students,2020-21,5447,891,4556,83.6,32,18,56.3
5,All Students,2021-22,5939,661,5278,88.9,37,19,51.4
5,All Students,2022-23,6908,1005,5903,85.5,43,31,72.1
6,All Students,2018-19,9220,652,8568,92.9,53,18,34.0
6,All Students,2019-20,6952,508,6444,92.7,63,15,23.8
6,All Students,2020-21,9706,2187,7519,77.5,57,39,68.4
6,All Students,2021-22,7100,964,6136,86.4,44,23,52.3
6,All Students,2022-23,8969,1184,7785,86.8,62,33,53.2
7,All Students,2018-19,9191,980,8211,89.3,54,27,50.0
7,All Students,2019-20,6270,523,5747,91.7,58,19,32.8
7,All Students,2020-21,10290,1230,9060,88.0,59,24,40.7
7,All Students,2021-22,8636,1446,7190,83.3,51,36,70.6
7,All Students,2022-23,9295,1470,7825,84.2,62,38,61.3
8,All Students,2018-19,9748,903,8845,90.7,57,24,42.1
8,All Students,2019-20,5958,646,5312,89.2,54,24,44.4
8,All Students,2020-21,9164,1475,7689,83.9,53,27,50.9
8,All Students,2021-22,10436,1166,9270,88.8,64,23,35.9
8,All Students,2022-23,9251,1691,7560,81.7,64,44,68.8
9,All Students,2020-21,334,s,s,s,s,s,s
All Grades,All Students,2018-19,47742,4915,42827,89.7,320,157,49.1
All Grades,All Students,2019-20,28297,2561,25736,90.9,266,90,33.8
All Grades,All Students,2020-21,31940,4940,27000,84.5,198,89,44.9
All Grades,All Students,2021-22,28911,5202,23709,82.0,184,126,68.5
All Grades,All Students,2022-23,29164,4685,24479,83.9,237,169,71.3
PK in K-12 Schools,All Students,2018-19,5680,1131,4549,80.1,54,46,85.2
PK in K-12 Schools,All Students,2019-20,3859,641,3218,83.4,42,25,59.5
PK in K-12 Schools,All Students,2020-21,3974,1086,2888,72.7,25,17,68.0
PK in K-12 Schools,All Students,2021-22,4949,1206,3743,75.6,36,33,91.7
PK in K-12 Schools,All Students,2022-23,4798,986,3812,79.4,40,37,92.5
0K,All Students,2018-19,5032,581,4451,88.5,35,19,54.3
0K,All Students,2019-20,2082,279,1803,86.6,19,11,57.9
0K,All Students,2020-21,3471,505,2966,85.5,24,11,45.8
0K,All Students,2021-22,3838,603,3235,84.3,25,14,56.0
0K,All Students,2022-23,3866,788,3078,79.6,29,27,93.1
1,All Students,2018-19,8192,823,7369,90.0,53,24,45.3
1,All Students,2019-20,3686,260,3426,92.9,35,7,20.0
1,All Students,2020-21,3309,448,2861,86.5,21,9,42.9
1,All Students,2021-22,3489,545,2944,84.4,23,14,60.9
1,All Students,2022-23,4183,529,3654,87.4,33,19,57.6
2,All Students,2018-19,6586,610,5976,90.7,41,19,46.3
2,All Students,2019-20,5331,473,4858,91.1,48,16,33.3
2,All Students,2020-21,3954,586,3368,85.2,26,11,42.3
2,All Students,2021-22,3579,619,2960,82.7,23,17,73.9
2,All Students,2022-23,3665,499,3166,86.4,39,25,64.1
3,All Students,2018-19,6882,553,6329,92.0,43,16,37.2
3,All Students,2019-20,4628,367,4261,92.1,42,13,31.0
3,All Students,2020-21,7054,964,6090,86.3,41,19,46.3
3,All Students,2021-22,3331,s,s,s,s,s,s
3,All Students,2022-23,3660,523,3137,85.7,32,19,59.4
4,All Students,2018-19,8126,730,7396,91.0,49,19,38.8
4,All Students,2019-20,3553,214,3339,94.0,33,7,21.2
4,All Students,2020-21,5297,844,4453,84.1,32,15,46.9
4,All Students,2021-22,6291,1057,5234,83.2,36,22,61.1
4,All Students,2022-23,4076,565,3511,86.1,31,19,61.3
5,All Students,2018-19,7244,487,6757,93.3,45,14,31.1
5,All Students,2019-20,5158,327,4831,93.7,47,11,23.4
5,All Students,2020-21,4881,507,4374,89.6,29,7,24.1
5,All Students,2021-22,3428,719,2709,79.0,20,14,70.0
5,All Students,2022-23,4916,795,4121,83.8,33,23,69.7
6,All Students,2021-22,6,s,s,s,s,s,s
All Grades,All Students,2018-19,84142,9703,74439,88.5,514,230,44.7
All Grades,All Students,2019-20,52913,6416,46497,87.9,489,236,48.3
All Grades,All Students,2020-21,74578,13595,60983,81.8,439,238,54.2
All Grades,All Students,2021-22,66337,11614,54723,82.5,410,263,64.1
All Grades,All Students,2022-23,66087,10274,55813,84.5,447,270,60.4
PK in K-12 Schools,All Students,2018-19,9313,1601,7712,82.8,59,38,64.4
PK in K-12 Schools,All Students,2019-20,7186,1440,5746,80.0,69,48,69.6
PK in K-12 Schools,All Students,2020-21,7247,2319,4928,68.0,42,37,88.1
PK in K-12 Schools,All Students,2021-22,6176,1471,4705,76.2,37,27,73.0
PK in K-12 Schools,All Students,2022-23,7479,1671,5808,77.7,47,41,87.2
0K,All Students,2018-19,5822,770,5052,86.8,37,20,54.1
0K,All Students,2019-20,4305,585,3720,86.4,40,27,67.5
0K,All Students,2020-21,5148,1356,3792,73.7,32,20,62.5
0K,All Students,2021-22,5871,1129,4742,80.8,36,28,77.8
0K,All Students,2022-23,6544,1292,5252,80.3,46,34,73.9
1,All Students,2018-19,6323,681,5642,89.2,38,15,39.5
1,All Students,2019-20,3358,468,2890,86.1,30,19,63.3
1,All Students,2020-21,5829,1455,4374,75.0,34,25,73.5
1,All Students,2021-22,4879,784,4095,83.9,28,20,71.4
1,All Students,2022-23,4566,699,3867,84.7,33,20,60.6
2,All Students,2018-19,6633,724,5909,89.1,41,16,39.0
2,All Students,2019-20,3663,402,3261,89.0,35,19,54.3
2,All Students,2020-21,5420,1010,4410,81.4,31,20,64.5
2,All Students,2021-22,5442,863,4579,84.1,32,25,78.1
2,All Students,2022-23,5258,716,4542,86.4,33,17,51.5
3,All Students,2018-19,6310,642,5668,89.8,39,14,35.9
3,All Students,2019-20,4103,512,3591,87.5,40,22,55.0
3,All Students,2020-21,5207,912,4295,82.5,32,15,46.9
3,All Students,2021-22,5518,1081,4437,80.4,35,22,62.9
3,All Students,2022-23,5514,635,4879,88.5,40,23,57.5
4,All Students,2018-19,6033,585,5448,90.3,35,15,42.9
4,All Students,2019-20,4073,433,3640,89.4,39,19,48.7
4,All Students,2020-21,6219,1120,5099,82.0,36,22,61.1
4,All Students,2021-22,4014,781,3233,80.5,25,17,68.0
4,All Students,2022-23,4605,765,3840,83.4,30,19,63.3
5,All Students,2018-19,8331,648,7683,92.2,50,18,36.0
5,All Students,2019-20,4118,362,3756,91.2,36,12,33.3
5,All Students,2020-21,6955,1152,5803,83.4,42,23,54.8
5,All Students,2021-22,5170,820,4350,84.1,33,17,51.5
5,All Students,2022-23,5293,647,4646,87.8,36,17,47.2
6,All Students,2018-19,11681,1231,10450,89.5,67,25,37.3
6,All Students,2019-20,6812,549,6263,91.9,61,22,36.1
6,All Students,2020-21,11160,1212,9948,89.1,65,21,32.3
6,All Students,2021-22,7969,1333,6636,83.3,52,34,65.4
6,All Students,2022-23,6863,1061,5802,84.5,45,23,51.1
7,All Students,2018-19,12366,1368,10998,88.9,77,30,39.0
7,All Students,2019-20,7748,815,6933,89.5,68,23,33.8
7,All Students,2020-21,9874,1355,8519,86.3,59,27,45.8
7,All Students,2021-22,10530,1476,9054,86.0,67,36,53.7
7,All Students,2022-23,8301,1323,6978,84.1,57,38,66.7
8,All Students,2018-19,11330,1453,9877,87.2,71,39,54.9
8,All Students,2019-20,7547,850,6697,88.7,71,25,35.2
8,All Students,2020-21,11519,1704,9815,85.2,66,28,42.4
8,All Students,2021-22,10768,1876,8892,82.6,65,37,56.9
8,All Students,2022-23,11664,1465,10199,87.4,80,38,47.5
All Grades,All Students,2018-19,57419,6225,51194,89.2,353,165,46.7
All Grades,All Students,2019-20,36734,4155,32579,88.7,332,138,41.6
All Grades,All Students,2020-21,47753,7525,40228,84.2,284,149,52.5
All Grades,All Students,2021-22,39844,6822,33022,82.9,245,165,67.3
All Grades,All Students,2022-23,43737,7436,36301,83.0,289,187,64.7
PK in K-12 Schools,All Students,2018-19,8117,1220,6897,85.0,52,33,63.5
PK in K-12 Schools,All Students,2019-20,5809,866,4943,85.1,52,27,51.9
PK in K-12 Schools,All Students,2020-21,7245,1409,5836,80.6,45,27,60.0
PK in K-12 Schools,All Students,2021-22,7683,1619,6064,78.9,52,41,78.8
PK in K-12 Schools,All Students,2022-23,7676,1679,5997,78.1,53,39,73.6
0K,All Students,2018-19,17627,1912,15715,89.2,106,49,46.2
0K,All Students,2019-20,9715,1168,8547,88.0,91,42,46.2
0K,All Students,2020-21,12350,2181,10169,82.3,76,46,60.5
0K,All Students,2021-22,10540,1772,8768,83.2,65,43,66.2
0K,All Students,2022-23,12787,2085,10702,83.7,83,57,68.7
1,All Students,2018-19,16886,1691,15195,90.0,104,44,42.3
1,All Students,2019-20,10657,1108,9549,89.6,95,36,37.9
1,All Students,2020-21,12568,1990,10578,84.2,73,41,56.2
1,All Students,2021-22,10586,1734,8852,83.6,63,41,65.1
1,All Students,2022-23,12118,1982,10136,83.6,80,47,58.8
2,All Students,2018-19,14789,1402,13387,90.5,91,39,42.9
2,All Students,2019-20,10553,1013,9540,90.4,94,33,35.1
2,All Students,2020-21,15590,1945,13645,87.5,90,35,38.9
2,All Students,2021-22,11035,1697,9338,84.6,65,40,61.5
2,All Students,2022-23,11156,1690,9466,84.9,73,44,60.3
All Grades,All Students,2018-19,68318,6638,61680,90.3,428,184,43.0
All Grades,All Students,2019-20,44831,4054,40777,91.0,441,160,36.3
All Grades,All Students,2020-21,59250,4777,54473,91.9,367,106,28.9
All Grades,All Students,2021-22,58399,7496,50903,87.2,361,205,56.8
All Grades,All Students,2022-23,54564,6064,48500,88.9,344,170,49.4
PK in K-12 Schools,All Students,2018-19,8402,1127,7275,86.6,56,35,62.5
PK in K-12 Schools,All Students,2019-20,8641,1240,7401,85.6,87,54,62.1
PK in K-12 Schools,All Students,2020-21,8039,418,7621,94.8,57,10,17.5
PK in K-12 Schools,All Students,2021-22,9285,1343,7942,85.5,59,34,57.6
PK in K-12 Schools,All Students,2022-23,9125,1155,7970,87.3,64,30,46.9
0K,All Students,2018-19,9111,1206,7905,86.8,60,36,60.0
0K,All Students,2019-20,5069,571,4498,88.7,50,28,56.0
0K,All Students,2020-21,8056,955,7101,88.1,50,19,38.0
0K,All Students,2021-22,12011,1764,10247,85.3,77,52,67.5
0K,All Students,2022-23,8610,935,7675,89.1,55,28,50.9
1,All Students,2018-19,7760,759,7001,90.2,48,20,41.7
1,All Students,2019-20,5420,522,4898,90.4,54,22,40.7
1,All Students,2020-21,7207,909,6298,87.4,44,20,45.5
1,All Students,2021-22,6858,774,6084,88.7,42,23,54.8
1,All Students,2022-23,9311,1211,8100,87.0,58,35,60.3
2,All Students,2018-19,9444,698,8746,92.6,60,18,30.0
2,All Students,2019-20,4467,s,s,s,s,s,s
2,All Students,2020-21,8275,763,7512,90.8,52,22,42.3
2,All Students,2021-22,7639,965,6674,87.4,46,24,52.2
2,All Students,2022-23,6522,590,5932,91.0,41,17,41.5
3,All Students,2018-19,12948,1038,11910,92.0,81,27,33.3
3,All Students,2019-20,7348,526,6822,92.8,72,17,23.6
3,All Students,2020-21,6251,440,5811,93.0,38,11,28.9
3,All Students,2021-22,7752,862,6890,88.9,47,24,51.1
3,All Students,2022-23,6881,746,6135,89.2,42,20,47.6
4,All Students,2018-19,10017,888,9129,91.1,62,25,40.3
4,All Students,2019-20,7688,481,7207,93.7,71,15,21.1
4,All Students,2020-21,9382,659,8723,93.0,55,14,25.5
4,All Students,2021-22,6637,846,5791,87.3,40,22,55.0
4,All Students,2022-23,7316,706,6610,90.3,42,18,42.9
5,All Students,2018-19,10636,922,9714,91.3,61,23,37.7
5,All Students,2019-20,6174,342,5832,94.5,59,10,16.9
5,All Students,2020-21,11924,627,11297,94.7,69,10,14.5
5,All Students,2021-22,8217,942,7275,88.5,50,26,52.0
5,All Students,2022-23,6799,721,6078,89.4,42,22,52.4
6,All Students,2019-20,24,s,s,s,s,s,s
All Grades,All Students,2018-19,43689,3867,39822,91.1,263,92,35.0
All Grades,All Students,2019-20,28031,2667,25364,90.5,262,99,37.8
All Grades,All Students,2020-21,38023,5478,32545,85.6,229,101,44.1
All Grades,All Students,2021-22,35979,5676,30303,84.2,220,132,60.0
All Grades,All Students,2022-23,44724,7051,37673,84.2,311,185,59.5
PK in K-12 Schools,All Students,2018-19,5306,770,4536,85.5,33,17,51.5
PK in K-12 Schools,All Students,2019-20,4232,742,3490,82.5,42,27,64.3
PK in K-12 Schools,All Students,2020-21,5202,1446,3756,72.2,36,27,75.0
PK in K-12 Schools,All Students,2021-22,4312,1018,3294,76.4,29,26,89.7
PK in K-12 Schools,All Students,2022-23,6753,1216,5537,82.0,51,36,70.6
0K,All Students,2018-19,5191,558,4633,89.3,35,14,40.0
0K,All Students,2019-20,2772,320,2452,88.5,27,12,44.4
0K,All Students,2020-21,4975,1020,3955,79.5,29,18,62.1
0K,All Students,2021-22,4958,1104,3854,77.7,32,26,81.3
0K,All Students,2022-23,5319,1123,4196,78.9,36,26,72.2
1,All Students,2018-19,5124,567,4557,88.9,31,14,45.2
1,All Students,2019-20,3582,343,3239,90.4,36,12,33.3
1,All Students,2020-21,4410,567,3843,87.1,27,11,40.7
1,All Students,2021-22,5054,819,4235,83.8,31,22,71.0
1,All Students,2022-23,6530,1251,5279,80.8,50,36,72.0
2,All Students,2018-19,5113,347,4766,93.2,30,9,30.0
2,All Students,2019-20,3391,323,3068,90.5,32,15,46.9
2,All Students,2020-21,5065,676,4389,86.7,30,12,40.0
2,All Students,2021-22,5443,721,4722,86.8,32,14,43.8
2,All Students,2022-23,5647,1092,4555,80.7,39,23,59.0
3,All Students,2018-19,7857,545,7312,93.1,46,11,23.9
3,All Students,2019-20,3376,198,3178,94.1,30,6,20.0
3,All Students,2020-21,5432,558,4874,89.7,33,12,36.4
3,All Students,2021-22,5727,658,5069,88.5,35,14,40.0
3,All Students,2022-23,6864,771,6093,88.8,44,20,45.5
4,All Students,2018-19,8706,714,7992,91.8,52,20,38.5
4,All Students,2019-20,5210,346,4864,93.4,47,11,23.4
4,All Students,2020-21,4906,596,4310,87.9,28,9,32.1
4,All Students,2021-22,5434,741,4693,86.4,32,17,53.1
4,All Students,2022-23,6622,716,5906,89.2,44,20,45.5
5,All Students,2018-19,6392,366,6026,94.3,36,7,19.4
5,All Students,2019-20,5468,395,5073,92.8,48,16,33.3
5,All Students,2020-21,8033,615,7418,92.3,46,12,26.1
5,All Students,2021-22,5051,615,4436,87.8,29,13,44.8
5,All Students,2022-23,6989,882,6107,87.4,47,24,51.1
All Grades,All Students,2018-19,136914,10331,126583,92.5,790,220,27.8
All Grades,All Students,2019-20,87770,6309,81461,92.8,786,204,26.0
All Grades,All Students,2020-21,133931,9110,124821,93.2,775,176,22.7
All Grades,All Students,2021-22,133184,12684,120500,90.5,782,293,37.5
All Grades,All Students,2022-23,134825,9405,125420,93.0,786,175,22.3
PK in K-12 Schools,All Students,2018-19,11934,1255,10679,89.5,71,29,40.8
PK in K-12 Schools,All Students,2019-20,9141,893,8248,90.2,86,36,41.9
PK in K-12 Schools,All Students,2020-21,14062,1400,12662,90.0,85,30,35.3
PK in K-12 Schools,All Students,2021-22,14223,1963,12260,86.2,85,52,61.2
PK in K-12 Schools,All Students,2022-23,14155,1544,12611,89.1,83,40,48.2
0K,All Students,2018-19,13089,1437,11652,89.0,76,36,47.4
0K,All Students,2019-20,8542,821,7721,90.4,78,28,35.9
0K,All Students,2020-21,13158,1414,11744,89.3,77,27,35.1
0K,All Students,2021-22,11714,1409,10305,88.0,74,38,51.4
0K,All Students,2022-23,11444,1101,10343,90.4,67,19,28.4
1,All Students,2018-19,11275,921,10354,91.8,67,23,34.3
1,All Students,2019-20,8575,642,7933,92.5,77,20,26.0
1,All Students,2020-21,13844,1330,12514,90.4,80,26,32.5
1,All Students,2021-22,11083,1068,10015,90.4,65,29,44.6
1,All Students,2022-23,12353,837,11516,93.2,73,17,23.3
2,All Students,2018-19,13623,853,12770,93.7,79,19,24.1
2,All Students,2019-20,6572,420,6152,93.6,61,12,19.7
2,All Students,2020-21,12194,856,11338,93.0,70,18,25.7
2,All Students,2021-22,11811,1120,10691,90.5,70,26,37.1
2,All Students,2022-23,10970,855,10115,92.2,65,15,23.1
3,All Students,2018-19,13989,1211,12778,91.3,81,28,34.6
3,All Students,2019-20,7687,522,7165,93.2,67,17,25.4
3,All Students,2020-21,9978,656,9322,93.4,57,9,15.8
3,All Students,2021-22,12379,1223,11156,90.1,73,29,39.7
3,All Students,2022-23,12341,833,11508,93.3,72,11,15.3
4,All Students,2018-19,11924,894,11030,92.5,69,13,18.8
4,All Students,2019-20,8754,677,8077,92.3,79,28,35.4
4,All Students,2020-21,11158,607,10551,94.6,64,9,14.1
4,All Students,2021-22,10514,1098,9416,89.6,61,25,41.0
4,All Students,2022-23,11588,758,10830,93.5,69,15,21.7
5,All Students,2018-19,10933,824,10109,92.5,62,18,29.0
5,All Students,2019-20,7541,435,7106,94.2,67,9,13.4
5,All Students,2020-21,12626,859,11767,93.2,72,20,27.8
5,All Students,2021-22,10966,824,10142,92.5,64,17,26.6
5,All Students,2022-23,11444,762,10682,93.3,66,11,16.7
6,All Students,2018-19,16694,993,15701,94.1,94,16,17.0
6,All Students,2019-20,10586,678,9908,93.6,93,23,24.7
6,All Students,2020-21,17371,774,16597,95.5,100,12,12.0
6,All Students,2021-22,19812,1785,18027,91.0,115,38,33.0
6,All Students,2022-23,16766,917,15849,94.5,96,15,15.6
7,All Students,2018-19,16664,937,15727,94.4,96,17,17.7
7,All Students,2019-20,9715,573,9142,94.1,85,12,14.1
7,All Students,2020-21,15018,449,14569,97.0,86,11,12.8
7,All Students,2021-22,16572,1078,15494,93.5,95,20,21.1
7,All Students,2022-23,18428,1015,17413,94.5,108,22,20.4
8,All Students,2018-19,16789,1006,15783,94.0,95,21,22.1
8,All Students,2019-20,10657,648,10009,93.9,93,19,20.4
8,All Students,2020-21,14522,765,13757,94.7,84,14,16.7
8,All Students,2021-22,14110,1116,12994,92.1,80,19,23.8
8,All Students,2022-23,15336,783,14553,94.9,87,10,11.5
All Grades,All Students,2018-19,56743,4885,51858,91.4,339,109,32.2
All Grades,All Students,2019-20,34078,2861,31217,91.6,308,90,29.2
All Grades,All Students,2020-21,46975,3224,43751,93.1,277,60,21.7
All Grades,All Students,2021-22,43048,5709,37339,86.7,261,129,49.4
All Grades,All Students,2022-23,46555,6125,40430,86.8,326,194,59.5
PK in K-12 Schools,All Students,2018-19,5042,763,4279,84.9,31,13,41.9
PK in K-12 Schools,All Students,2019-20,3016,431,2585,85.7,27,14,51.9
PK in K-12 Schools,All Students,2020-21,3928,301,3627,92.3,24,6,25.0
PK in K-12 Schools,All Students,2021-22,4641,1071,3570,76.9,29,22,75.9
PK in K-12 Schools,All Students,2022-23,5679,921,4758,83.8,34,25,73.5
0K,All Students,2018-19,5684,531,5153,90.7,37,11,29.7
0K,All Students,2019-20,6437,634,5803,90.2,56,21,37.5
0K,All Students,2020-21,7644,619,7025,91.9,46,15,32.6
0K,All Students,2021-22,4243,699,3544,83.5,27,15,55.6
0K,All Students,2022-23,6637,997,5640,85.0,50,33,66.0
1,All Students,2018-19,6395,580,5815,90.9,37,13,35.1
1,All Students,2019-20,3524,370,3154,89.5,35,11,31.4
1,All Students,2020-21,8179,571,7608,93.0,48,10,20.8
1,All Students,2021-22,8077,922,7155,88.6,48,24,50.0
1,All Students,2022-23,5225,720,4505,86.2,43,26,60.5
2,All Students,2018-19,9321,814,8507,91.3,57,20,35.1
2,All Students,2019-20,3464,291,3173,91.6,34,8,23.5
2,All Students,2020-21,5160,462,4698,91.0,30,9,30.0
2,All Students,2021-22,8108,946,7162,88.3,49,23,46.9
2,All Students,2022-23,8474,1009,7465,88.1,56,31,55.4
3,All Students,2018-19,10074,710,9364,93.0,59,17,28.8
3,All Students,2019-20,5346,347,4999,93.5,47,14,29.8
3,All Students,2020-21,5633,333,5300,94.1,33,6,18.2
3,All Students,2021-22,4595,507,4088,89.0,31,12,38.7
3,All Students,2022-23,8919,1051,7868,88.2,62,33,53.2
4,All Students,2018-19,9619,865,8754,91.0,58,22,37.9
4,All Students,2019-20,6190,380,5810,93.9,56,10,17.9
4,All Students,2020-21,7331,366,6965,95.0,44,7,15.9
4,All Students,2021-22,5351,675,4676,87.4,31,16,51.6
4,All Students,2022-23,5396,607,4789,88.8,38,18,47.4
5,All Students,2018-19,10608,622,9986,94.1,60,13,21.7
5,All Students,2019-20,6101,408,5693,93.3,53,12,22.6
5,All Students,2020-21,9100,572,8528,93.7,52,7,13.5
5,All Students,2021-22,8033,889,7144,88.9,46,17,37.0
5,All Students,2022-23,6225,820,5405,86.8,43,28,65.1
All Grades,All Students,2018-19,86361,6873,79488,92.0,514,159,30.9
All Grades,All Students,2019-20,52138,4225,47913,91.9,469,135,28.8
All Grades,All Students,2020-21,78570,9404,69166,88.0,454,169,37.2
All Grades,All Students,2021-22,79692,11666,68026,85.4,470,261,55.5
All Grades,All Students,2022-23,83579,12013,71566,85.6,534,300,56.2
3,All Students,2018-19,13825,1084,12741,92.2,83,25,30.1
3,All Students,2019-20,7531,595,6936,92.1,70,19,27.1
3,All Students,2020-21,13384,1583,11801,88.2,79,30,38.0
3,All Students,2021-22,13553,1983,11570,85.4,81,43,53.1
3,All Students,2022-23,11142,1748,9394,84.3,74,50,67.6
4,All Students,2018-19,15165,1197,13968,92.1,92,33,35.9
4,All Students,2019-20,9104,774,8330,91.5,81,26,32.1
4,All Students,2020-21,11205,865,10340,92.3,66,14,21.2
4,All Students,2021-22,11811,1611,10200,86.4,69,38,55.1
4,All Students,2022-23,13933,1704,12229,87.8,87,41,47.1
5,All Students,2018-19,16664,1284,15380,92.3,96,28,29.2
5,All Students,2019-20,10238,792,9446,92.3,92,23,25.0
5,All Students,2020-21,13829,1235,12594,91.1,79,23,29.1
5,All Students,2021-22,12060,1597,10463,86.8,71,39,54.9
5,All Students,2022-23,13457,1772,11685,86.8,84,47,56.0
6,All Students,2018-19,14570,1114,13456,92.4,87,23,26.4
6,All Students,2019-20,8247,675,7572,91.8,73,20,27.4
6,All Students,2020-21,15050,1788,13262,88.1,86,31,36.0
6,All Students,2021-22,14014,2197,11817,84.3,83,45,54.2
6,All Students,2022-23,12563,1984,10579,84.2,84,50,59.5
7,All Students,2018-19,12917,975,11942,92.5,80,21,26.3
7,All Students,2019-20,8366,620,7746,92.6,75,20,26.7
7,All Students,2020-21,12764,1895,10869,85.2,73,39,53.4
7,All Students,2021-22,15040,2040,13000,86.4,90,49,54.4
7,All Students,2022-23,15328,2173,13155,85.8,97,54,55.7
8,All Students,2018-19,13220,1219,12001,90.8,76,29,38.2
8,All Students,2019-20,8652,769,7883,91.1,78,27,34.6
8,All Students,2020-21,12338,2038,10300,83.5,71,32,45.1
8,All Students,2021-22,13214,2238,10976,83.1,76,47,61.8
8,All Students,2022-23,17156,2632,14524,84.7,108,58,53.7
All Grades,All Students,2018-19,33315,1890,31425,94.3,193,33,17.1
All Grades,All Students,2019-20,23978,1407,22571,94.1,211,42,19.9
All Grades,All Students,2020-21,35742,1374,34368,96.2,206,24,11.7
All Grades,All Students,2021-22,31989,3306,28683,89.7,191,74,38.7
All Grades,All Students,2022-23,31864,3135,28729,90.2,193,72,37.3
6,All Students,2018-19,11199,528,10671,95.3,67,7,10.4
6,All Students,2019-20,9792,615,9177,93.7,86,19,22.1
6,All Students,2020-21,11756,419,11337,96.4,69,8,11.6
6,All Students,2021-22,11031,1327,9704,88.0,66,29,43.9
6,All Students,2022-23,12405,1351,11054,89.1,73,29,39.7
7,All Students,2018-19,10760,651,10109,93.9,62,14,22.6
7,All Students,2019-20,6940,306,6634,95.6,62,6,9.7
7,All Students,2020-21,12614,493,12121,96.1,72,10,13.9
7,All Students,2021-22,9512,922,8590,90.3,58,20,34.5
7,All Students,2022-23,9923,961,8962,90.3,61,26,42.6
8,All Students,2018-19,11356,711,10645,93.7,64,12,18.8
8,All Students,2019-20,7246,486,6760,93.3,63,17,27.0
8,All Students,2020-21,11370,460,10910,96.0,65,6,9.2
8,All Students,2021-22,11446,1057,10389,90.8,67,25,37.3
8,All Students,2022-23,9536,823,8713,91.4,59,17,28.8
All Grades,All Students,2018-19,96977,10178,86799,89.5,600,218,36.3
All Grades,All Students,2019-20,59128,6561,52567,88.9,561,207,36.9
All Grades,All Students,2020-21,82291,14740,67551,82.1,487,255,52.4
All Grades,All Students,2021-22,81546,12324,69222,84.9,487,255,52.4
All Grades,All Students,2022-23,89158,8444,80714,90.5,571,192,33.6
6,All Students,2018-19,11455,788,10667,93.1,69,18,26.1
6,All Students,2019-20,7339,525,6814,92.8,70,21,30.0
6,All Students,2020-21,8008,882,7126,89.0,47,16,34.0
6,All Students,2021-22,10496,1018,9478,90.3,62,21,33.9
6,All Students,2022-23,7798,622,7176,92.0,53,18,34.0
7,All Students,2018-19,13067,1148,11919,91.2,81,27,33.3
7,All Students,2019-20,8138,674,7464,91.7,81,22,27.2
7,All Students,2020-21,11120,1762,9358,84.2,65,34,52.3
7,All Students,2021-22,8593,1156,7437,86.5,54,22,40.7
7,All Students,2022-23,11966,1070,10896,91.1,76,19,25.0
8,All Students,2018-19,13843,1004,12839,92.7,80,18,22.5
8,All Students,2019-20,8916,770,8146,91.4,82,26,31.7
8,All Students,2020-21,12187,1844,10343,84.9,72,36,50.0
8,All Students,2021-22,11405,1684,9721,85.2,72,43,59.7
8,All Students,2022-23,11939,1066,10873,91.1,76,27,35.5
9,All Students,2018-19,13537,1436,12101,89.4,89,29,32.6
9,All Students,2019-20,7954,866,7088,89.1,79,24,30.4
9,All Students,2020-21,11408,1980,9428,82.6,69,36,52.2
9,All Students,2021-22,16885,2203,14682,87.0,98,46,46.9
9,All Students,2022-23,19321,1845,17476,90.5,126,43,34.1
10,All Students,2018-19,15227,2252,12975,85.2,98,45,45.9
10,All Students,2019-20,10122,1465,8657,85.5,95,40,42.1
10,All Students,2020-21,15327,3313,12014,78.4,93,50,53.8
10,All Students,2021-22,12553,2224,10329,82.3,73,40,54.8
10,All Students,2022-23,16167,1442,14725,91.1,100,27,27.0
11,All Students,2018-19,13963,1403,12560,90.0,87,38,43.7
11,All Students,2019-20,7908,873,7035,89.0,74,33,44.6
11,All Students,2020-21,11160,1797,9363,83.9,65,34,52.3
11,All Students,2021-22,11843,1865,9978,84.3,70,38,54.3
11,All Students,2022-23,11242,1255,9987,88.8,72,25,34.7
12,All Students,2018-19,15885,2147,13738,86.5,96,43,44.8
12,All Students,2019-20,8751,1388,7363,84.1,80,41,51.3
12,All Students,2020-21,13081,3162,9919,75.8,76,49,64.5
12,All Students,2021-22,9771,2174,7597,77.8,58,45,77.6
12,All Students,2022-23,10725,1144,9581,89.3,68,33,48.5
All Grades,All Students,2018-19,54768,7457,47311,86.4,356,219,61.5
All Grades,All Students,2019-20,29426,3763,25663,87.2,284,146,51.4
All Grades,All Students,2020-21,38004,6455,31549,83.0,231,138,59.7
All Grades,All Students,2021-22,35808,6680,29128,81.3,227,172,75.8
All Grades,All Students,2022-23,34067,5415,28652,84.1,261,174,66.7
PK in K-12 Schools,All Students,2018-19,6925,1154,5771,83.3,47,35,74.5
PK in K-12 Schools,All Students,2019-20,4769,872,3897,81.7,46,27,58.7
PK in K-12 Schools,All Students,2020-21,6055,1123,4932,81.5,39,28,71.8
PK in K-12 Schools,All Students,2021-22,6313,1327,4986,79.0,41,33,80.5
PK in K-12 Schools,All Students,2022-23,6083,1067,5016,82.5,42,29,69.0
0K,All Students,2018-19,7718,1497,6221,80.6,54,42,77.8
0K,All Students,2019-20,3700,491,3209,86.7,36,22,61.1
0K,All Students,2020-21,5741,1207,4534,79.0,37,27,73.0
0K,All Students,2021-22,5323,1107,4216,79.2,36,29,80.6
0K,All Students,2022-23,5095,902,4193,82.3,46,37,80.4
1,All Students,2018-19,4590,497,4093,89.2,28,13,46.4
1,All Students,2019-20,3276,414,2862,87.4,34,20,58.8
1,All Students,2020-21,5217,1115,4102,78.6,32,19,59.4
1,All Students,2021-22,4357,855,3502,80.4,28,21,75.0
1,All Students,2022-23,4952,1050,3902,78.8,40,31,77.5
2,All Students,2018-19,9494,1188,8306,87.5,65,41,63.1
2,All Students,2019-20,2969,338,2631,88.6,28,13,46.4
2,All Students,2020-21,4263,917,3346,78.5,25,19,76.0
2,All Students,2021-22,4919,880,4039,82.1,31,22,71.0
2,All Students,2022-23,4535,758,3777,83.3,34,23,67.6
3,All Students,2018-19,8070,941,7129,88.3,49,26,53.1
3,All Students,2019-20,5556,708,4848,87.3,53,27,50.9
3,All Students,2020-21,4725,382,4343,91.9,27,8,29.6
3,All Students,2021-22,3965,681,3284,82.8,26,18,69.2
3,All Students,2022-23,4093,560,3533,86.3,32,19,59.4
4,All Students,2018-19,9380,1179,8201,87.4,60,35,58.3
4,All Students,2019-20,3780,376,3404,90.1,37,17,45.9
4,All Students,2020-21,6647,1109,5538,83.3,40,24,60.0
4,All Students,2021-22,5126,665,4461,87.0,30,17,56.7
4,All Students,2022-23,4200,557,3643,86.7,33,18,54.5
5,All Students,2018-19,8591,1001,7590,88.3,53,27,50.9
5,All Students,2019-20,5376,564,4812,89.5,50,20,40.0
5,All Students,2020-21,5356,602,4754,88.8,31,13,41.9
5,All Students,2021-22,5805,1165,4640,79.9,35,32,91.4
5,All Students,2022-23,5109,521,4588,89.8,34,17,50.0
All Grades,All Students,2018-19,29959,2422,27537,91.9,177,50,28.2
All Grades,All Students,2019-20,23274,1786,21488,92.3,208,55,26.4
All Grades,All Students,2020-21,34359,2328,32031,93.2,202,38,18.8
All Grades,All Students,2021-22,32266,4120,28146,87.2,192,98,51.0
All Grades,All Students,2022-23,27190,3873,23317,85.8,204,122,59.8
6,All Students,2018-19,13273,958,12315,92.8,79,22,27.8
6,All Students,2019-20,7852,552,7300,93.0,70,12,17.1
6,All Students,2020-21,10015,616,9399,93.8,59,11,18.6
6,All Students,2021-22,11366,1496,9870,86.8,69,36,52.2
6,All Students,2022-23,7787,1089,6698,86.0,61,37,60.7
7,All Students,2018-19,9997,653,9344,93.5,59,12,20.3
7,All Students,2019-20,8795,606,8189,93.1,79,23,29.1
7,All Students,2020-21,11266,708,10558,93.7,67,12,17.9
7,All Students,2021-22,9252,1318,7934,85.8,55,31,56.4
7,All Students,2022-23,10038,1429,8609,85.8,69,38,55.1
8,All Students,2018-19,6689,811,5878,87.9,39,16,41.0
8,All Students,2019-20,6627,628,5999,90.5,59,20,33.9
8,All Students,2020-21,13078,1004,12074,92.3,76,15,19.7
8,All Students,2021-22,11648,1306,10342,88.8,68,31,45.6
8,All Students,2022-23,9365,1355,8010,85.5,74,47,63.5
All Grades,All Students,2018-19,274527,16267,258260,94.1,1676,266,15.9
All Grades,All Students,2019-20,181135,9410,171725,94.8,1675,235,14.0
All Grades,All Students,2020-21,284346,16691,267655,94.1,1640,235,14.3
All Grades,All Students,2021-22,262794,9173,253621,96.5,1573,138,8.8
All Grades,All Students,2022-23,267784,15627,252157,94.2,1673,268,16.0
9,All Students,2018-19,67974,2387,65587,96.5,419,45,10.7
9,All Students,2019-20,42150,1079,41071,97.4,395,29,7.3
9,All Students,2020-21,70718,2843,67875,96.0,409,27,6.6
9,All Students,2021-22,58835,1164,57671,98.0,356,13,3.7
9,All Students,2022-23,80538,3488,77050,95.7,507,58,11.4
10,All Students,2018-19,73672,3639,70033,95.1,449,47,10.5
10,All Students,2019-20,45695,1683,44012,96.3,424,38,9.0
10,All Students,2020-21,67212,2817,64395,95.8,388,34,8.8
10,All Students,2021-22,70472,1594,68878,97.7,423,22,5.2
10,All Students,2022-23,58704,2823,55881,95.2,373,46,12.3
11,All Students,2018-19,69866,3827,66039,94.5,428,57,13.3
11,All Students,2019-20,47635,1987,45648,95.8,439,42,9.6
11,All Students,2020-21,70793,4233,66560,94.0,406,60,14.8
11,All Students,2021-22,64269,1352,62917,97.9,382,14,3.7
11,All Students,2022-23,65928,2848,63080,95.7,410,44,10.7
12,All Students,2018-19,63015,6414,56601,89.8,380,117,30.8
12,All Students,2019-20,45655,4661,40994,89.8,418,127,30.4
12,All Students,2020-21,75623,6798,68825,91.0,437,114,26.1
12,All Students,2021-22,69218,5063,64155,92.7,412,89,21.6
12,All Students,2022-23,62614,6468,56146,89.7,383,120,31.3
All Grades,All Students,2018-19,64719,3562,61157,94.5,394,54,13.7
All Grades,All Students,2019-20,41697,1844,39853,95.6,383,52,13.6
All Grades,All Students,2020-21,67179,7209,59970,89.3,388,130,33.5
All Grades,All Students,2021-22,61260,3745,57515,93.9,366,70,19.1
All Grades,All Students,2022-23,63214,4905,58309,92.2,389,109,28.0
9,All Students,2018-19,15173,513,14660,96.6,95,5,5.3
9,All Students,2019-20,10841,289,10552,97.3,100,6,6.0
9,All Students,2020-21,17054,855,16199,95.0,99,15,15.2
9,All Students,2021-22,13638,589,13049,95.7,81,7,8.6
9,All Students,2022-23,15699,1274,14425,91.9,98,35,35.7
10,All Students,2018-19,15865,728,15137,95.4,96,8,8.3
10,All Students,2019-20,10364,455,9909,95.6,96,11,11.5
10,All Students,2020-21,17826,2233,15593,87.5,104,44,42.3
10,All Students,2021-22,16861,778,16083,95.4,101,13,12.9
10,All Students,2022-23,15239,1089,14150,92.9,94,20,21.3
11,All Students,2018-19,15952,1151,14801,92.8,96,19,19.8
11,All Students,2019-20,10346,443,9903,95.7,94,12,12.8
11,All Students,2020-21,16107,2578,13529,84.0,92,44,47.8
11,All Students,2021-22,16158,1118,15040,93.1,96,22,22.9
11,All Students,2022-23,16273,928,15345,94.3,100,15,15.0
12,All Students,2018-19,17729,1170,16559,93.4,107,22,20.6
12,All Students,2019-20,10146,657,9489,93.5,93,23,24.7
12,All Students,2020-21,16192,1543,14649,90.5,93,27,29.0
12,All Students,2021-22,14603,1260,13343,91.4,88,28,31.8
12,All Students,2022-23,16003,1614,14389,89.9,97,39,40.2
All Grades,All Students,2018-19,33283,2439,30844,92.7,192,46,24.0
All Grades,All Students,2019-20,20199,1475,18724,92.7,186,40,21.5
All Grades,All Students,2020-21,26438,2015,24423,92.4,157,30,19.1
All Grades,All Students,2021-22,27199,3402,23797,87.5,164,86,52.4
All Grades,All Students,2022-23,29945,2860,27085,90.4,175,58,33.1
PK in K-12 Schools,All Students,2018-19,5805,597,5208,89.7,33,15,45.5
PK in K-12 Schools,All Students,2019-20,2850,287,2563,89.9,27,11,40.7
PK in K-12 Schools,All Students,2020-21,3745,184,3561,95.1,23,2,8.7
PK in K-12 Schools,All Students,2021-22,4901,611,4290,87.5,30,14,46.7
PK in K-12 Schools,All Students,2022-23,5465,563,4902,89.7,33,8,24.2
0K,All Students,2018-19,4325,337,3988,92.2,26,6,23.1
0K,All Students,2019-20,2999,295,2704,90.2,27,7,25.9
0K,All Students,2020-21,3580,392,3188,89.1,21,5,23.8
0K,All Students,2021-22,3744,503,3241,86.6,22,15,68.2
0K,All Students,2022-23,4059,398,3661,90.2,25,12,48.0
1,All Students,2018-19,3829,347,3482,90.9,23,8,34.8
1,All Students,2019-20,2779,191,2588,93.1,25,4,16.0
1,All Students,2020-21,3295,302,2993,90.8,20,4,20.0
1,All Students,2021-22,3746,521,3225,86.1,23,16,69.6
1,All Students,2022-23,4420,316,4104,92.9,25,4,16.0
2,All Students,2018-19,3916,229,3687,94.2,22,2,9.1
2,All Students,2019-20,2652,190,2462,92.8,26,6,23.1
2,All Students,2020-21,4904,540,4364,89.0,29,8,27.6
2,All Students,2021-22,3315,394,2921,88.1,20,9,45.0
2,All Students,2022-23,4492,443,4049,90.1,26,11,42.3
3,All Students,2018-19,4886,274,4612,94.4,28,3,10.7
3,All Students,2019-20,2703,157,2546,94.2,25,3,12.0
3,All Students,2020-21,3675,249,3426,93.2,21,5,23.8
3,All Students,2021-22,4629,574,4055,87.6,29,13,44.8
3,All Students,2022-23,3574,279,3295,92.2,21,5,23.8
4,All Students,2018-19,5894,339,5555,94.2,34,5,14.7
4,All Students,2019-20,2662,113,2549,95.8,24,2,8.3
4,All Students,2020-21,3564,267,3297,92.5,22,6,27.3
4,All Students,2021-22,3371,385,2986,88.6,20,10,50.0
4,All Students,2022-23,4956,580,4376,88.3,28,11,39.3
5,All Students,2018-19,4628,316,4312,93.2,26,7,26.9
5,All Students,2019-20,3554,242,3312,93.2,32,7,21.9
5,All Students,2020-21,3675,81,3594,97.8,21,0,0.0
5,All Students,2021-22,3493,414,3079,88.1,20,9,45.0
5,All Students,2022-23,2979,281,2698,90.6,17,7,41.2
All Grades,All Students,2018-19,84623,2571,82052,97.0,514,36,7.0
All Grades,All Students,2019-20,56314,1403,54911,97.5,520,30,5.8
All Grades,All Students,2020-21,90204,4211,85993,95.3,522,68,13.0
All Grades,All Students,2021-22,85485,4073,81412,95.2,507,76,15.0
All Grades,All Students,2022-23,82775,3095,79680,96.3,509,40,7.9
9,All Students,2018-19,24446,576,23870,97.6,148,5,3.4
9,All Students,2019-20,14970,289,14681,98.1,138,6,4.3
9,All Students,2020-21,22430,878,21552,96.1,130,12,9.2
9,All Students,2021-22,20790,831,19959,96.0,123,13,10.6
9,All Students,2022-23,21667,1041,20626,95.2,136,21,15.4
10,All Students,2018-19,23484,619,22865,97.4,144,11,7.6
10,All Students,2019-20,15167,426,14741,97.2,142,13,9.2
10,All Students,2020-21,22494,1278,21216,94.3,130,24,18.5
10,All Students,2021-22,21131,933,20198,95.6,127,18,14.2
10,All Students,2022-23,19838,541,19297,97.3,122,3,2.5
11,All Students,2018-19,17854,583,17271,96.7,109,8,7.3
11,All Students,2019-20,13747,226,13521,98.4,127,3,2.4
11,All Students,2020-21,23008,1138,21870,95.1,134,19,14.2
11,All Students,2021-22,21128,1113,20015,94.7,125,20,16.0
11,All Students,2022-23,20317,604,19713,97.0,124,6,4.8
12,All Students,2018-19,18839,793,18046,95.8,113,12,10.6
12,All Students,2019-20,12430,462,11968,96.3,113,8,7.1
12,All Students,2020-21,22272,917,21355,95.9,128,13,10.2
12,All Students,2021-22,22436,1196,21240,94.7,132,25,18.9
12,All Students,2022-23,20953,909,20044,95.7,127,10,7.9
All Grades,All Students,2018-19,82116,4369,77747,94.7,482,81,16.8
All Grades,All Students,2019-20,52779,3237,49542,93.9,478,97,20.3
All Grades,All Students,2020-21,83152,10981,72171,86.8,481,263,54.7
All Grades,All Students,2021-22,78244,10768,67476,86.2,468,254,54.3
All Grades,All Students,2022-23,73864,8402,65462,88.6,451,188,41.7
6,All Students,2018-19,9678,350,9328,96.4,57,5,8.8
6,All Students,2019-20,5250,244,5006,95.4,46,6,13.0
6,All Students,2020-21,9758,1425,8333,85.4,57,40,70.2
6,All Students,2021-22,8069,1055,7014,86.9,48,29,60.4
6,All Students,2022-23,7249,783,6466,89.2,45,19,42.2
7,All Students,2018-19,9971,478,9493,95.2,56,6,10.7
7,All Students,2019-20,5688,240,5448,95.8,50,4,8.0
7,All Students,2020-21,7830,724,7106,90.8,45,16,35.6
7,All Students,2021-22,9380,1238,8142,86.8,55,21,38.2
7,All Students,2022-23,7158,724,6434,89.9,42,15,35.7
8,All Students,2018-19,9790,445,9345,95.5,55,8,14.5
8,All Students,2019-20,6384,314,6070,95.1,56,8,14.3
8,All Students,2020-21,8494,834,7660,90.2,49,13,26.5
8,All Students,2021-22,7755,1085,6670,86.0,45,23,51.1
8,All Students,2022-23,8737,971,7766,88.9,51,21,41.2
9,All Students,2018-19,13086,664,12422,94.9,78,10,12.8
9,All Students,2019-20,9043,580,8463,93.6,83,14,16.9
9,All Students,2020-21,15987,2030,13957,87.3,92,47,51.1
9,All Students,2021-22,12701,1597,11104,87.4,77,37,48.1
9,All Students,2022-23,12460,1346,11114,89.2,78,29,37.2
10,All Students,2018-19,13920,651,13269,95.3,83,13,15.7
10,All Students,2019-20,8665,549,8116,93.7,81,20,24.7
10,All Students,2020-21,14536,1561,12975,89.3,84,36,42.9
10,All Students,2021-22,14427,1827,12600,87.3,88,50,56.8
10,All Students,2022-23,11777,1041,10736,91.2,75,23,30.7
11,All Students,2018-19,13575,836,12739,93.8,81,19,23.5
11,All Students,2019-20,8839,471,8368,94.7,81,14,17.3
11,All Students,2020-21,12801,1759,11042,86.3,75,43,57.3
11,All Students,2021-22,13664,2192,11472,84.0,82,48,58.5
11,All Students,2022-23,13349,1443,11906,89.2,81,33,40.7
12,All Students,2018-19,12096,945,11151,92.2,72,20,27.8
12,All Students,2019-20,8910,839,8071,90.6,81,31,38.3
12,All Students,2020-21,13746,2648,11098,80.7,79,68,86.1
12,All Students,2021-22,12248,1774,10474,85.5,73,46,63.0
12,All Students,2022-23,13134,2094,11040,84.1,79,48,60.8
All Grades,All Students,2018-19,51253,5887,45366,88.5,319,98,30.7
All Grades,All Students,2019-20,33848,4812,29036,85.8,323,111,34.4
All Grades,All Students,2020-21,55682,6897,48785,87.6,322,71,22.0
All Grades,All Students,2021-22,51577,8279,43298,83.9,316,154,48.7
All Grades,All Students,2022-23,49866,6880,42986,86.2,326,123,37.7
9,All Students,2018-19,17186,2360,14826,86.3,108,38,35.2
9,All Students,2019-20,10419,1726,8693,83.4,101,38,37.6
9,All Students,2020-21,15806,1376,14430,91.3,92,20,21.7
9,All Students,2021-22,14996,2211,12785,85.3,91,33,36.3
9,All Students,2022-23,15463,2089,13374,86.5,107,40,37.4
10,All Students,2018-19,10404,1291,9113,87.6,66,21,31.8
10,All Students,2019-20,8132,873,7259,89.3,80,25,31.3
10,All Students,2020-21,16084,2581,13503,84.0,93,27,29.0
10,All Students,2021-22,10918,1774,9144,83.8,67,32,47.8
10,All Students,2022-23,12076,1477,10599,87.8,78,25,32.1
11,All Students,2018-19,11500,1056,10444,90.8,72,18,25.0
11,All Students,2019-20,6656,1270,5386,80.9,62,27,43.5
11,All Students,2020-21,12597,1474,11123,88.3,73,13,17.8
11,All Students,2021-22,12745,2406,10339,81.1,80,46,57.5
11,All Students,2022-23,10508,1470,9038,86.0,66,23,34.8
12,All Students,2018-19,12163,1180,10983,90.3,73,21,28.8
12,All Students,2019-20,8641,943,7698,89.1,80,21,26.3
12,All Students,2020-21,11194,1466,9728,86.9,64,11,17.2
12,All Students,2021-22,12918,1888,11030,85.4,78,43,55.1
12,All Students,2022-23,11819,1844,9975,84.4,75,35,46.7
All Grades,All Students,2018-19,42381,3067,39314,92.8,246,62,25.2
All Grades,All Students,2019-20,32185,2103,30082,93.5,284,59,20.8
All Grades,All Students,2020-21,56659,2472,54187,95.6,327,49,15.0
All Grades,All Students,2021-22,54900,5684,49216,89.6,322,124,38.5
All Grades,All Students,2022-23,55862,5856,50006,89.5,354,156,44.1
6,All Students,2018-19,17269,1199,16070,93.1,101,25,24.8
6,All Students,2019-20,12792,777,12015,93.9,112,22,19.6
6,All Students,2020-21,20914,753,20161,96.4,121,12,9.9
6,All Students,2021-22,16812,1706,15106,89.9,98,37,37.8
6,All Students,2022-23,18438,2088,16350,88.7,111,54,48.6
7,All Students,2018-19,14604,981,13623,93.3,85,19,22.4
7,All Students,2019-20,10833,791,10042,92.7,96,26,27.1
7,All Students,2020-21,19045,831,18214,95.6,109,20,18.3
7,All Students,2021-22,19866,1747,18119,91.2,117,39,33.3
7,All Students,2022-23,17259,1839,15420,89.3,121,54,44.6
8,All Students,2018-19,10508,887,9621,91.6,60,18,30.0
8,All Students,2019-20,8560,535,8025,93.8,76,11,14.5
8,All Students,2020-21,16533,s,s,s,s,s,s
8,All Students,2021-22,18222,2231,15991,87.8,107,48,44.9
8,All Students,2022-23,20165,1929,18236,90.4,122,48,39.3
9,All Students,2020-21,167,s,s,s,s,s,s
All Grades,All Students,2018-19,85311,6669,78642,92.2,524,145,27.7
All Grades,All Students,2019-20,53725,4482,49243,91.7,484,147,30.4
All Grades,All Students,2020-21,75055,1259,73796,98.3,444,11,2.5
All Grades,All Students,2021-22,68670,9405,59265,86.3,409,218,53.3
All Grades,All Students,2022-23,65751,8284,57467,87.4,397,212,53.4
PK in K-12 Schools,All Students,2018-19,5484,691,4793,87.4,35,19,54.3
PK in K-12 Schools,All Students,2019-20,3729,520,3209,86.1,34,21,61.8
PK in K-12 Schools,All Students,2020-21,5523,76,5447,98.6,33,0,0.0
PK in K-12 Schools,All Students,2021-22,4832,723,4109,85.0,30,20,66.7
PK in K-12 Schools,All Students,2022-23,4662,806,3856,82.7,30,21,70.0
0K,All Students,2018-19,7161,592,6569,91.7,44,14,31.8
0K,All Students,2019-20,4996,479,4517,90.4,45,17,37.8
0K,All Students,2020-21,7032,146,6886,97.9,43,1,2.3
0K,All Students,2021-22,5953,611,5342,89.7,36,15,41.7
0K,All Students,2022-23,5373,788,4585,85.3,34,23,67.6
1,All Students,2018-19,7677,646,7031,91.6,53,16,30.2
1,All Students,2019-20,4537,330,4207,92.7,40,12,30.0
1,All Students,2020-21,6948,78,6870,98.9,41,0,0.0
1,All Students,2021-22,6212,894,5318,85.6,39,22,56.4
1,All Students,2022-23,5654,599,5055,89.4,34,16,47.1
2,All Students,2018-19,8455,509,7946,94.0,53,12,22.6
2,All Students,2019-20,4722,370,4352,92.2,42,11,26.2
2,All Students,2020-21,6564,106,6458,98.4,39,1,2.6
2,All Students,2021-22,6537,744,5793,88.6,38,16,42.1
2,All Students,2022-23,5781,725,5056,87.5,35,20,57.1
3,All Students,2018-19,9203,473,8730,94.9,52,6,11.5
3,All Students,2019-20,5280,357,4923,93.2,47,14,29.8
3,All Students,2020-21,6320,25,6295,99.6,38,0,0.0
3,All Students,2021-22,5929,796,5133,86.6,35,16,45.7
3,All Students,2022-23,7274,858,6416,88.2,45,22,48.9
4,All Students,2018-19,10017,663,9354,93.4,60,11,18.3
4,All Students,2019-20,5853,408,5445,93.0,52,11,21.2
4,All Students,2020-21,7671,23,7648,99.7,45,0,0.0
4,All Students,2021-22,6085,878,5207,85.6,36,20,55.6
4,All Students,2022-23,6599,719,5880,89.1,40,20,50.0
5,All Students,2018-19,10208,730,9478,92.8,60,16,26.7
5,All Students,2019-20,6714,626,6088,90.7,58,15,25.9
5,All Students,2020-21,8084,95,7989,98.8,47,1,2.1
5,All Students,2021-22,7282,604,6678,91.7,43,11,25.6
5,All Students,2022-23,6787,909,5878,86.6,39,21,53.8
6,All Students,2018-19,8724,832,7892,90.5,55,19,34.5
6,All Students,2019-20,6127,521,5606,91.5,57,17,29.8
6,All Students,2020-21,9052,197,8855,97.8,53,1,1.9
6,All Students,2021-22,8548,1265,7283,85.2,50,32,64.0
6,All Students,2022-23,6832,725,6107,89.4,40,15,37.5
7,All Students,2018-19,9765,745,9020,92.4,61,19,31.1
7,All Students,2019-20,5828,470,5358,91.9,54,16,29.6
7,All Students,2020-21,8434,119,8315,98.6,50,1,2.0
7,All Students,2021-22,9047,1518,7529,83.2,53,31,58.5
7,All Students,2022-23,7796,844,6952,89.2,47,24,51.1
8,All Students,2018-19,8617,788,7829,90.9,51,13,25.5
8,All Students,2019-20,5939,401,5538,93.2,55,13,23.6
8,All Students,2020-21,9427,394,9033,95.8,55,6,10.9
8,All Students,2021-22,8245,1372,6873,83.4,49,35,71.4
8,All Students,2022-23,8993,1311,7682,85.4,53,30,56.6
All Grades,All Students,2018-19,45378,4650,40728,89.8,283,128,45.2
All Grades,All Students,2019-20,27310,2912,24398,89.3,259,108,41.7
All Grades,All Students,2020-21,36738,5948,30790,83.8,228,117,51.3
All Grades,All Students,2021-22,31233,5083,26150,83.7,197,122,61.9
All Grades,All Students,2022-23,30419,4455,25964,85.4,195,119,61.0
PK in K-12 Schools,All Students,2018-19,5261,708,4553,86.5,34,23,67.6
PK in K-12 Schools,All Students,2019-20,4219,594,3625,85.9,43,22,51.2
PK in K-12 Schools,All Students,2020-21,6501,1106,5395,83.0,41,23,56.1
PK in K-12 Schools,All Students,2021-22,6101,1099,5002,82.0,44,29,65.9
PK in K-12 Schools,All Students,2022-23,6814,1242,5572,81.8,46,33,71.7
0K,All Students,2018-19,7952,1078,6874,86.4,50,30,60.0
0K,All Students,2019-20,3283,500,2783,84.8,32,19,59.4
0K,All Students,2020-21,2987,727,2260,75.7,20,16,80.0
0K,All Students,2021-22,2931,453,2478,84.5,17,9,52.9
0K,All Students,2022-23,4677,800,3877,82.9,29,18,62.1
1,All Students,2018-19,7186,727,6459,89.9,45,17,37.8
1,All Students,2019-20,3447,338,3109,90.2,34,13,38.2
1,All Students,2020-21,4929,1153,3776,76.6,32,21,65.6
1,All Students,2021-22,3972,610,3362,84.6,27,15,55.6
1,All Students,2022-23,2515,s,s,s,s,s,s
2,All Students,2018-19,5683,540,5143,90.5,35,13,37.1
2,All Students,2019-20,4277,453,3824,89.4,41,19,46.3
2,All Students,2020-21,4313,677,3636,84.3,26,14,53.8
2,All Students,2021-22,4971,1043,3928,79.0,29,19,65.5
2,All Students,2022-23,4068,634,3434,84.4,26,17,65.4
3,All Students,2018-19,7119,527,6592,92.6,43,14,32.6
3,All Students,2019-20,3924,316,3608,91.9,35,8,22.9
3,All Students,2020-21,5664,839,4825,85.2,36,16,44.4
3,All Students,2021-22,3267,519,2748,84.1,20,15,75.0
3,All Students,2022-23,3752,579,3173,84.6,25,18,72.0
4,All Students,2018-19,6552,637,5915,90.3,40,19,47.5
4,All Students,2019-20,3804,340,3464,91.1,36,14,38.9
4,All Students,2020-21,6216,748,5468,88.0,38,16,42.1
4,All Students,2021-22,5041,633,4408,87.4,30,14,46.7
4,All Students,2022-23,3029,330,2699,89.1,18,7,38.9
5,All Students,2018-19,5625,433,5192,92.3,36,12,33.3
5,All Students,2019-20,4356,371,3985,91.5,38,13,34.2
5,All Students,2020-21,6128,698,5430,88.6,35,11,31.4
5,All Students,2021-22,4950,726,4224,85.3,30,21,70.0
5,All Students,2022-23,5452,458,4994,91.6,32,14,43.8
7,All Students,2022-23,112,s,s,s,s,s,s
All Grades,All Students,2018-19,64306,6641,57665,89.7,401,180,44.9
All Grades,All Students,2019-20,43515,4507,39008,89.6,398,170,42.7
All Grades,All Students,2020-21,54222,7837,46385,85.5,320,149,46.6
All Grades,All Students,2021-22,49554,8463,41091,82.9,314,212,67.5
All Grades,All Students,2022-23,49354,7537,41817,84.7,333,209,62.8
PK in K-12 Schools,All Students,2018-19,12244,1806,10438,85.2,80,50,62.5
PK in K-12 Schools,All Students,2019-20,10585,1310,9275,87.6,96,54,56.3
PK in K-12 Schools,All Students,2020-21,6975,1023,5952,85.3,43,16,37.2
PK in K-12 Schools,All Students,2021-22,9333,1823,7510,80.5,62,48,77.4
PK in K-12 Schools,All Students,2022-23,9182,2035,7147,77.8,65,46,70.8
0K,All Students,2018-19,8522,968,7554,88.6,56,26,46.4
0K,All Students,2019-20,4861,671,4190,86.2,44,22,50.0
0K,All Students,2020-21,8137,1661,6476,79.6,50,30,60.0
0K,All Students,2021-22,6571,1015,5556,84.6,45,26,57.8
0K,All Students,2022-23,5917,1103,4814,81.4,41,34,82.9
1,All Students,2018-19,8956,938,8018,89.5,53,24,45.3
1,All Students,2019-20,5321,483,4838,90.9,52,23,44.2
1,All Students,2020-21,6958,1112,5846,84.0,40,20,50.0
1,All Students,2021-22,6796,1050,5746,84.5,42,27,64.3
1,All Students,2022-23,6747,942,5805,86.0,47,25,53.2
2,All Students,2018-19,6852,558,6294,91.9,41,14,34.1
2,All Students,2019-20,6005,591,5414,90.2,55,20,36.4
2,All Students,2020-21,8479,1299,7180,84.7,49,29,59.2
2,All Students,2021-22,6425,1310,5115,79.6,43,34,79.1
2,All Students,2022-23,6358,837,5521,86.8,43,29,67.4
3,All Students,2018-19,9701,787,8914,91.9,61,20,32.8
3,All Students,2019-20,4487,378,4109,91.6,41,14,34.1
3,All Students,2020-21,9497,1494,8003,84.3,55,29,52.7
3,All Students,2021-22,7443,1330,6113,82.1,44,28,63.6
3,All Students,2022-23,6478,904,5574,86.0,44,27,61.4
4,All Students,2018-19,9627,827,8800,91.4,60,23,38.3
4,All Students,2019-20,5890,443,5447,92.5,54,13,24.1
4,All Students,2020-21,5981,534,5447,91.1,35,12,34.3
4,All Students,2021-22,7325,1112,6213,84.8,45,28,62.2
4,All Students,2022-23,7422,888,6534,88.0,46,24,52.2
5,All Students,2018-19,8404,757,7647,91.0,50,23,46.0
5,All Students,2019-20,6366,631,5735,90.1,56,24,42.9
5,All Students,2020-21,8195,714,7481,91.3,48,13,27.1
5,All Students,2021-22,5661,823,4838,85.5,33,21,63.6
5,All Students,2022-23,7250,828,6422,88.6,47,24,51.1
All Grades,All Students,2018-19,111776,13073,98703,88.3,679,334,49.2
All Grades,All Students,2019-20,63970,6615,57355,89.7,596,224,37.6
All Grades,All Students,2020-21,86772,17266,69506,80.1,513,289,56.3
All Grades,All Students,2021-22,84050,15183,68867,81.9,514,330,64.2
All Grades,All Students,2022-23,75364,11431,63933,84.8,459,277,60.3
PK in K-12 Schools,All Students,2018-19,8938,1397,7541,84.4,51,35,68.6
PK in K-12 Schools,All Students,2019-20,5127,679,4448,86.8,48,24,50.0
PK in K-12 Schools,All Students,2020-21,6552,1639,4913,75.0,42,24,57.1
PK in K-12 Schools,All Students,2021-22,8614,2136,6478,75.2,55,45,81.8
PK in K-12 Schools,All Students,2022-23,7497,1412,6085,81.2,46,29,63.0
0K,All Students,2018-19,8874,s,s,s,s,s,s
0K,All Students,2019-20,5785,749,5036,87.1,56,29,51.8
0K,All Students,2020-21,6005,1500,4505,75.0,37,24,64.9
0K,All Students,2021-22,8270,1928,6342,76.7,49,38,77.6
0K,All Students,2022-23,9205,1888,7317,79.5,59,46,78.0
1,All Students,2018-19,10364,1321,9043,87.3,66,33,50.0
1,All Students,2019-20,6079,812,5267,86.6,58,33,56.9
1,All Students,2020-21,8958,2473,6485,72.4,54,39,72.2
1,All Students,2021-22,6639,974,5665,85.3,42,27,64.3
1,All Students,2022-23,8228,1330,6898,83.8,50,35,70.0
2,All Students,2018-19,11002,1228,9774,88.8,67,30,44.8
2,All Students,2019-20,6047,703,5344,88.4,58,25,43.1
2,All Students,2020-21,8286,1554,6732,81.2,48,27,56.3
2,All Students,2021-22,10570,2269,8301,78.5,64,45,70.3
2,All Students,2022-23,6712,883,5829,86.8,43,21,48.8
3,All Students,2018-19,11479,1363,10116,88.1,69,38,55.1
3,All Students,2019-20,5465,527,4938,90.4,52,18,34.6
3,All Students,2020-21,8165,1644,6521,79.9,48,25,52.1
3,All Students,2021-22,6200,1047,5153,83.1,38,26,68.4
3,All Students,2022-23,8138,1203,6935,85.2,48,28,58.3
4,All Students,2018-19,11649,1107,10542,90.5,70,26,37.1
4,All Students,2019-20,6048,655,5393,89.2,55,23,41.8
4,All Students,2020-21,7854,976,6878,87.6,47,24,51.1
4,All Students,2021-22,8053,1373,6680,83.0,49,30,61.2
4,All Students,2022-23,4860,642,4218,86.8,29,13,44.8
5,All Students,2018-19,14286,1274,13012,91.1,84,30,35.7
5,All Students,2019-20,7460,644,6816,91.4,68,22,32.4
5,All Students,2020-21,8575,1464,7111,82.9,49,22,44.9
5,All Students,2021-22,8991,1333,7658,85.2,54,26,48.1
5,All Students,2022-23,6794,924,5870,86.4,44,25,56.8
6,All Students,2018-19,13989,1201,12788,91.4,83,29,34.9
6,All Students,2019-20,6836,562,6274,91.8,64,20,31.3
6,All Students,2020-21,10215,2026,8189,80.2,59,31,52.5
6,All Students,2021-22,7010,1349,5661,80.8,43,28,65.1
6,All Students,2022-23,8491,1117,7374,86.8,50,27,54.0
7,All Students,2018-19,10036,893,9143,91.1,61,22,36.1
7,All Students,2019-20,8499,605,7894,92.9,74,13,17.6
7,All Students,2020-21,9906,1821,8085,81.6,59,33,55.9
7,All Students,2021-22,10230,1521,8709,85.1,64,35,54.7
7,All Students,2022-23,6758,819,5939,87.9,39,20,51.3
8,All Students,2018-19,11039,1697,9342,84.6,73,50,68.5
8,All Students,2019-20,6624,679,5945,89.7,63,17,27.0
8,All Students,2020-21,12248,2164,10084,82.3,70,40,57.1
8,All Students,2021-22,9473,1253,8220,86.8,56,30,53.6
8,All Students,2022-23,8681,1213,7468,86.0,51,33,64.7
9,All Students,2018-19,120,s,s,s,s,s,s
All Grades,All Students,2018-19,45530,4937,40593,89.2,280,132,47.1
All Grades,All Students,2019-20,27938,3284,24654,88.2,266,122,45.9
All Grades,All Students,2020-21,38165,4332,33833,88.6,232,110,47.4
All Grades,All Students,2021-22,36280,6671,29609,81.6,233,173,74.2
All Grades,All Students,2022-23,33402,4954,28448,85.2,216,142,65.7
PK in K-12 Schools,All Students,2018-19,3182,596,2586,81.3,18,17,94.4
PK in K-12 Schools,All Students,2019-20,2009,342,1667,83.0,19,14,73.7
PK in K-12 Schools,All Students,2020-21,1831,281,1550,84.7,12,8,66.7
PK in K-12 Schools,All Students,2021-22,2612,507,2105,80.6,20,17,85.0
PK in K-12 Schools,All Students,2022-23,2905,582,2323,80.0,23,20,87.0
0K,All Students,2018-19,4903,866,4037,82.3,34,24,70.6
0K,All Students,2019-20,3948,616,3332,84.4,38,25,65.8
0K,All Students,2020-21,4077,702,3375,82.8,25,19,76.0
0K,All Students,2021-22,4647,798,3849,82.8,33,23,69.7
0K,All Students,2022-23,4177,684,3493,83.6,29,20,69.0
1,All Students,2018-19,4961,556,4405,88.8,33,20,60.6
1,All Students,2019-20,3268,528,2740,83.8,31,20,64.5
1,All Students,2020-21,6440,828,5612,87.1,39,23,59.0
1,All Students,2021-22,4752,941,3811,80.2,30,27,90.0
1,All Students,2022-23,4384,646,3738,85.3,29,19,65.5
2,All Students,2018-19,8225,818,7407,90.1,48,20,41.7
2,All Students,2019-20,3007,267,2740,91.1,28,11,39.3
2,All Students,2020-21,5088,633,4455,87.6,31,13,41.9
2,All Students,2021-22,6710,1389,5321,79.3,41,32,78.0
2,All Students,2022-23,4952,777,4175,84.3,34,22,64.7
3,All Students,2018-19,7471,783,6688,89.5,46,20,43.5
3,All Students,2019-20,4827,485,4342,90.0,44,18,40.9
3,All Students,2020-21,4905,479,4426,90.2,30,12,40.0
3,All Students,2021-22,5445,1227,4218,77.5,33,27,81.8
3,All Students,2022-23,6915,931,5984,86.5,41,23,56.1
4,All Students,2018-19,7885,631,7254,92.0,48,13,27.1
4,All Students,2019-20,5211,564,4647,89.2,51,19,37.3
4,All Students,2020-21,7895,672,7223,91.5,46,14,30.4
4,All Students,2021-22,4696,712,3984,84.8,32,22,68.8
4,All Students,2022-23,5391,795,4596,85.3,33,24,72.7
5,All Students,2018-19,8903,687,8216,92.3,53,18,34.0
5,All Students,2019-20,5668,482,5186,91.5,55,15,27.3
5,All Students,2020-21,7929,737,7192,90.7,49,21,42.9
5,All Students,2021-22,7418,1097,6321,85.2,44,25,56.8
5,All Students,2022-23,4678,539,4139,88.5,27,14,51.9
All Grades,All Students,2018-19,84484,8151,76333,90.4,541,202,37.3
All Grades,All Students,2019-20,52562,5821,46741,88.9,529,202,38.2
All Grades,All Students,2020-21,73453,16684,56769,77.3,454,271,59.7
All Grades,All Students,2021-22,74595,13021,61574,82.5,493,330,66.9
All Grades,All Students,2022-23,69842,9498,60344,86.4,469,248,52.9
PK in K-12 Schools,All Students,2018-19,8532,1118,7414,86.9,57,32,56.1
PK in K-12 Schools,All Students,2019-20,6631,1161,5470,82.5,74,45,60.8
PK in K-12 Schools,All Students,2020-21,6881,2098,4783,69.5,48,39,81.3
PK in K-12 Schools,All Students,2021-22,9222,1866,7356,79.8,66,58,87.9
PK in K-12 Schools,All Students,2022-23,7766,1352,6414,82.6,62,42,67.7
0K,All Students,2018-19,5844,780,5064,86.7,40,23,57.5
0K,All Students,2019-20,4458,553,3905,87.6,47,21,44.7
0K,All Students,2020-21,5139,1530,3609,70.2,34,23,67.6
0K,All Students,2021-22,5253,1062,4191,79.8,38,30,78.9
0K,All Students,2022-23,5692,777,4915,86.3,42,25,59.5
1,All Students,2018-19,4897,490,4407,90.0,37,15,40.5
1,All Students,2019-20,3823,353,3470,90.8,41,10,24.4
1,All Students,2020-21,6534,1322,5212,79.8,42,24,57.1
1,All Students,2021-22,4290,s,s,s,s,s,s
1,All Students,2022-23,4834,660,4174,86.3,31,19,61.3
2,All Students,2018-19,6003,390,5613,93.5,39,9,23.1
2,All Students,2019-20,2541,s,s,s,s,s,s
2,All Students,2020-21,6042,1257,4785,79.2,38,20,52.6
2,All Students,2021-22,6597,1039,5558,84.3,46,28,60.9
2,All Students,2022-23,4905,656,4249,86.6,36,20,55.6
3,All Students,2018-19,9827,807,9020,91.8,65,17,26.2
3,All Students,2019-20,4548,494,4054,89.1,47,18,38.3
3,All Students,2020-21,4250,640,3610,84.9,28,14,50.0
3,All Students,2021-22,7272,1184,6088,83.7,45,25,55.6
3,All Students,2022-23,6669,701,5968,89.5,43,19,44.2
4,All Students,2018-19,9671,746,8925,92.3,60,17,28.3
4,All Students,2019-20,5693,487,5206,91.4,55,19,34.5
4,All Students,2020-21,7314,1196,6118,83.6,42,20,47.6
4,All Students,2021-22,4319,553,3766,87.2,30,15,50.0
4,All Students,2022-23,6275,611,5664,90.3,39,14,35.9
5,All Students,2018-19,7830,623,7207,92.0,48,12,25.0
5,All Students,2019-20,5335,482,4853,91.0,49,14,28.6
5,All Students,2020-21,8488,1341,7147,84.2,51,23,45.1
5,All Students,2021-22,6611,1009,5602,84.7,48,30,62.5
5,All Students,2022-23,4366,545,3821,87.5,28,13,46.4
6,All Students,2018-19,9622,1178,8444,87.8,61,28,45.9
6,All Students,2019-20,6627,666,5961,90.0,70,18,25.7
6,All Students,2020-21,9794,2045,7749,79.1,57,34,59.6
6,All Students,2021-22,11144,1656,9488,85.1,68,43,63.2
6,All Students,2022-23,8865,869,7996,90.2,57,23,40.4
7,All Students,2018-19,11959,1184,10775,90.1,72,28,38.9
7,All Students,2019-20,5346,538,4808,89.9,55,20,36.4
7,All Students,2020-21,11006,3115,7891,71.7,65,44,67.7
7,All Students,2021-22,9668,1891,7777,80.4,59,36,61.0
7,All Students,2022-23,11446,1949,9497,83.0,73,42,57.5
8,All Students,2018-19,10299,835,9464,91.9,62,21,33.9
8,All Students,2019-20,7558,872,6686,88.5,67,28,41.8
8,All Students,2020-21,7969,2138,5831,73.2,48,30,62.5
8,All Students,2021-22,10213,1885,8328,81.5,61,40,65.6
8,All Students,2022-23,9024,1378,7646,84.7,58,31,53.4
9,All Students,2019-20,2,s,s,s,s,s,s
9,All Students,2021-22,6,s,s,s,s,s,s
All Grades,All Students,2018-19,51601,4818,46783,90.7,311,112,36.0
All Grades,All Students,2019-20,34755,2919,31836,91.6,322,97,30.1
All Grades,All Students,2020-21,50500,5936,44564,88.2,300,112,37.3
All Grades,All Students,2021-22,46962,6056,40906,87.1,285,143,50.2
All Grades,All Students,2022-23,46588,5210,41378,88.8,274,118,43.1
PK in K-12 Schools,All Students,2018-19,6148,560,5588,90.9,37,13,35.1
PK in K-12 Schools,All Students,2019-20,4082,266,3816,93.5,38,5,13.2
PK in K-12 Schools,All Students,2020-21,4974,381,4593,92.3,31,10,32.3
PK in K-12 Schools,All Students,2021-22,3943,677,3266,82.8,25,18,72.0
PK in K-12 Schools,All Students,2022-23,6335,707,5628,88.8,37,17,45.9
0K,All Students,2018-19,10422,1148,9274,89.0,64,28,43.8
0K,All Students,2019-20,6180,611,5569,90.1,60,23,38.3
0K,All Students,2020-21,8427,733,7694,91.3,51,16,31.4
0K,All Students,2021-22,6287,911,5376,85.5,37,21,56.8
0K,All Students,2022-23,5260,657,4603,87.5,32,18,56.3
1,All Students,2018-19,8986,689,8297,92.3,53,16,30.2
1,All Students,2019-20,5650,551,5099,90.2,51,20,39.2
1,All Students,2020-21,7769,951,6818,87.8,45,15,33.3
1,All Students,2021-22,8847,1191,7656,86.5,54,26,48.1
1,All Students,2022-23,7103,882,6221,87.6,42,20,47.6
2,All Students,2018-19,7236,620,6616,91.4,44,16,36.4
2,All Students,2019-20,5422,411,5011,92.4,51,15,29.4
2,All Students,2020-21,8146,1114,7032,86.3,48,17,35.4
2,All Students,2021-22,7402,953,6449,87.1,47,26,55.3
2,All Students,2022-23,7576,683,6893,91.0,43,13,30.2
3,All Students,2018-19,7830,712,7118,90.9,46,14,30.4
3,All Students,2019-20,4859,339,4520,93.0,45,11,24.4
3,All Students,2020-21,7842,1023,6819,87.0,47,23,48.9
3,All Students,2021-22,7301,877,6424,88.0,43,17,39.5
3,All Students,2022-23,7101,808,6293,88.6,41,17,41.5
4,All Students,2018-19,7472,708,6764,90.5,45,16,35.6
4,All Students,2019-20,4638,385,4253,91.7,42,10,23.8
4,All Students,2020-21,6722,639,6083,90.5,39,14,35.9
4,All Students,2021-22,7407,723,6684,90.2,45,18,40.0
4,All Students,2022-23,6683,887,5796,86.7,41,21,51.2
5,All Students,2018-19,3507,381,3126,89.1,22,9,40.9
5,All Students,2019-20,3924,356,3568,90.9,35,13,37.1
5,All Students,2020-21,6620,1095,5525,83.5,39,17,43.6
5,All Students,2021-22,5775,724,5051,87.5,34,17,50.0
5,All Students,2022-23,6530,586,5944,91.0,38,12,31.6
All Grades,All Students,2018-19,73836,8452,65384,88.6,479,229,47.8
All Grades,All Students,2019-20,44603,5379,39224,87.9,421,201,47.7
All Grades,All Students,2020-21,53833,11330,42503,79.0,324,210,64.8
All Grades,All Students,2021-22,43894,8579,35315,80.5,282,191,67.7
All Grades,All Students,2022-23,35655,5579,30076,84.4,231,146,63.2
PK in K-12 Schools,All Students,2018-19,10778,1551,9227,85.6,71,43,60.6
PK in K-12 Schools,All Students,2019-20,7049,1029,6020,85.4,67,38,56.7
PK in K-12 Schools,All Students,2020-21,7549,2182,5367,71.1,50,38,76.0
PK in K-12 Schools,All Students,2021-22,9680,2021,7659,79.1,64,45,70.3
PK in K-12 Schools,All Students,2022-23,8562,1695,6867,80.2,57,41,71.9
0K,All Students,2018-19,3879,562,3317,85.5,29,14,48.3
0K,All Students,2019-20,3613,395,3218,89.1,34,14,41.2
0K,All Students,2020-21,5107,1113,3994,78.2,30,22,73.3
0K,All Students,2021-22,5143,966,4177,81.2,35,23,65.7
0K,All Students,2022-23,3472,651,2821,81.3,25,17,68.0
1,All Students,2018-19,5210,551,4659,89.4,30,13,43.3
1,All Students,2019-20,2765,357,2408,87.1,27,12,44.4
1,All Students,2020-21,5606,919,4687,83.6,33,16,48.5
1,All Students,2021-22,4340,724,3616,83.3,27,15,55.6
1,All Students,2022-23,5244,728,4516,86.1,35,21,60.0
2,All Students,2018-19,5438,569,4869,89.5,36,16,44.4
2,All Students,2019-20,2949,293,2656,90.1,27,10,37.0
2,All Students,2020-21,4192,s,s,s,s,s,s
2,All Students,2021-22,5970,973,4997,83.7,38,24,63.2
2,All Students,2022-23,4949,604,4345,87.8,32,17,53.1
3,All Students,2018-19,6277,668,5609,89.4,40,19,47.5
3,All Students,2019-20,3806,396,3410,89.6,34,14,41.2
3,All Students,2020-21,4872,944,3928,80.6,28,17,60.7
3,All Students,2021-22,4076,753,3323,81.5,25,15,60.0
3,All Students,2022-23,6395,698,5697,89.1,38,22,57.9
4,All Students,2018-19,4482,584,3898,87.0,29,17,58.6
4,All Students,2019-20,4060,470,3590,88.4,40,21,52.5
4,All Students,2020-21,5279,1270,4009,75.9,30,20,66.7
4,All Students,2021-22,3855,920,2935,76.1,27,19,70.4
4,All Students,2022-23,3100,504,2596,83.7,20,12,60.0
5,All Students,2018-19,7084,598,6486,91.6,43,14,32.6
5,All Students,2019-20,3148,435,2713,86.2,29,17,58.6
5,All Students,2020-21,6453,1339,5114,79.2,38,27,71.1
5,All Students,2021-22,4391,729,3662,83.4,27,17,63.0
5,All Students,2022-23,3933,699,3234,82.2,24,16,66.7
6,All Students,2018-19,8079,936,7143,88.4,56,28,50.0
6,All Students,2019-20,4868,550,4318,88.7,47,22,46.8
6,All Students,2020-21,18,s,s,s,s,s,s
7,All Students,2018-19,11481,1169,10312,89.8,72,30,41.7
7,All Students,2019-20,5028,559,4469,88.9,49,20,40.8
7,All Students,2020-21,6841,982,5859,85.6,39,23,59.0
8,All Students,2018-19,11128,1264,9864,88.6,73,35,47.9
8,All Students,2019-20,7317,895,6422,87.8,67,33,49.3
8,All Students,2020-21,7900,1769,6131,77.6,48,28,58.3
8,All Students,2021-22,6439,1493,4946,76.8,39,33,84.6
All Grades,All Students,2018-19,41194,4563,36631,88.9,262,120,45.8
All Grades,All Students,2019-20,26657,2440,24217,90.8,267,97,36.3
All Grades,All Students,2020-21,36474,3959,32515,89.1,225,88,39.1
All Grades,All Students,2021-22,36195,5097,31098,85.9,231,134,58.0
All Grades,All Students,2022-23,33813,3974,29839,88.2,212,110,51.9
PK in K-12 Schools,All Students,2018-19,4804,683,4121,85.8,30,21,70.0
PK in K-12 Schools,All Students,2019-20,5539,666,4873,88.0,60,29,48.3
PK in K-12 Schools,All Students,2020-21,6844,1163,5681,83.0,45,26,57.8
PK in K-12 Schools,All Students,2021-22,7147,1246,5901,82.6,46,35,76.1
PK in K-12 Schools,All Students,2022-23,6594,1044,5550,84.2,45,28,62.2
0K,All Students,2018-19,6932,880,6052,87.3,45,19,42.2
0K,All Students,2019-20,2614,272,2342,89.6,28,15,53.6
0K,All Students,2020-21,5430,984,4446,81.9,34,24,70.6
0K,All Students,2021-22,5465,864,4601,84.2,34,18,52.9
0K,All Students,2022-23,2996,368,2628,87.7,19,10,52.6
1,All Students,2018-19,4544,573,3971,87.4,30,15,50.0
1,All Students,2019-20,3802,409,3393,89.2,37,16,43.2
1,All Students,2020-21,4070,341,3729,91.6,26,9,34.6
1,All Students,2021-22,4595,643,3952,86.0,30,17,56.7
1,All Students,2022-23,5690,749,4941,86.8,35,20,57.1
2,All Students,2018-19,6990,697,6293,90.0,44,19,43.2
2,All Students,2019-20,3077,237,2840,92.3,32,9,28.1
2,All Students,2020-21,5528,567,4961,89.7,33,13,39.4
2,All Students,2021-22,4276,510,3766,88.1,28,14,50.0
2,All Students,2022-23,5022,510,4512,89.8,29,14,48.3
3,All Students,2018-19,4417,s,s,s,s,s,s
3,All Students,2019-20,3534,241,3293,93.2,33,6,18.2
3,All Students,2020-21,4583,374,4209,91.8,28,7,25.0
3,All Students,2021-22,5096,607,4489,88.1,32,13,40.6
3,All Students,2022-23,5127,460,4667,91.0,33,14,42.4
4,All Students,2018-19,6720,646,6074,90.4,43,18,41.9
4,All Students,2019-20,3228,155,3073,95.2,31,4,12.9
4,All Students,2020-21,5077,259,4818,94.9,30,5,16.7
4,All Students,2021-22,4003,566,3437,85.9,27,20,74.1
4,All Students,2022-23,4304,416,3888,90.3,27,13,48.1
5,All Students,2018-19,6778,695,6083,89.7,40,18,45.0
5,All Students,2019-20,4863,460,4403,90.5,46,18,39.1
5,All Students,2020-21,4942,271,4671,94.5,29,4,13.8
5,All Students,2021-22,5613,661,4952,88.2,34,17,50.0
5,All Students,2022-23,4080,427,3653,89.5,24,11,45.8
6,All Students,2018-19,9,s,s,s,s,s,s
All Grades,All Students,2018-19,64061,9015,55046,85.9,398,200,50.3
All Grades,All Students,2019-20,42221,6174,36047,85.4,391,190,48.6
All Grades,All Students,2020-21,56397,17698,38699,68.6,330,278,84.2
All Grades,All Students,2021-22,43352,12242,31110,71.8,265,217,81.9
All Grades,All Students,2022-23,34058,6510,27548,80.9,227,121,53.3
6,All Students,2018-19,10371,966,9405,90.7,65,19,29.2
6,All Students,2019-20,4875,486,4389,90.0,44,18,40.9
6,All Students,2020-21,5286,2230,3056,57.8,31,31,100.0
6,All Students,2021-22,2787,578,2209,79.3,19,17,89.5
6,All Students,2022-23,2590,187,2403,92.8,17,4,23.5
7,All Students,2018-19,10027,965,9062,90.4,60,20,33.3
7,All Students,2019-20,5509,530,4979,90.4,50,12,24.0
7,All Students,2020-21,6684,1997,4687,70.1,39,34,87.2
7,All Students,2021-22,4106,841,3265,79.5,24,17,70.8
7,All Students,2022-23,2680,333,2347,87.6,16,5,31.3
8,All Students,2018-19,11640,1636,10004,85.9,69,43,62.3
8,All Students,2019-20,5921,765,5156,87.1,55,21,38.2
8,All Students,2020-21,9347,3279,6068,64.9,53,47,88.7
8,All Students,2021-22,5853,1093,4760,81.3,35,28,80.0
8,All Students,2022-23,3822,540,3282,85.9,23,9,39.1
9,All Students,2018-19,12886,2535,10351,80.3,84,54,64.3
9,All Students,2019-20,10253,2038,8215,80.1,95,62,65.3
9,All Students,2020-21,13217,4377,8840,66.9,79,68,86.1
9,All Students,2021-22,12272,4675,7597,61.9,71,59,83.1
9,All Students,2022-23,7128,2540,4588,64.4,53,41,77.4
10,All Students,2018-19,8393,1599,6794,80.9,55,32,58.2
10,All Students,2019-20,5776,939,4837,83.7,55,30,54.5
10,All Students,2020-21,10712,2345,8367,78.1,63,40,63.5
10,All Students,2021-22,6141,1871,4270,69.5,39,33,84.6
10,All Students,2022-23,5877,1086,4791,81.5,38,23,60.5
11,All Students,2018-19,10744,1314,9430,87.8,65,32,49.2
11,All Students,2019-20,3426,501,2925,85.4,32,14,43.8
11,All Students,2020-21,4506,1165,3341,74.1,26,21,80.8
11,All Students,2021-22,6885,1830,5055,73.4,43,35,81.4
11,All Students,2022-23,4103,425,3678,89.6,28,11,39.3
12,All Students,2019-20,6461,915,5546,85.8,61,34,55.7
12,All Students,2020-21,6645,2305,4340,65.3,39,37,94.9
12,All Students,2021-22,5308,1354,3954,74.5,34,28,82.4
12,All Students,2022-23,7858,1399,6459,82.2,52,28,53.8
All Grades,All Students,2018-19,50069,4633,45436,90.7,317,118,37.2
All Grades,All Students,2019-20,32553,2956,29597,90.9,298,111,37.2
All Grades,All Students,2020-21,38725,5640,33085,85.4,238,120,50.4
All Grades,All Students,2021-22,40173,6811,33362,83.0,241,152,63.1
All Grades,All Students,2022-23,37229,5343,31886,85.6,244,148,60.7
PK in K-12 Schools,All Students,2018-19,8702,1220,7482,86.0,59,36,61.0
PK in K-12 Schools,All Students,2019-20,7423,826,6597,88.9,67,30,44.8
PK in K-12 Schools,All Students,2020-21,5555,852,4703,84.7,34,17,50.0
PK in K-12 Schools,All Students,2021-22,8997,1920,7077,78.7,55,44,80.0
PK in K-12 Schools,All Students,2022-23,7929,1482,6447,81.3,57,43,75.4
0K,All Students,2018-19,4578,540,4038,88.2,29,15,51.7
0K,All Students,2019-20,4846,530,4316,89.1,46,20,43.5
0K,All Students,2020-21,3933,725,3208,81.6,28,16,57.1
0K,All Students,2021-22,4239,785,3454,81.5,26,17,65.4
0K,All Students,2022-23,4479,725,3754,83.8,28,20,71.4
1,All Students,2018-19,5648,390,5258,93.1,34,8,23.5
1,All Students,2019-20,2792,294,2498,89.5,27,13,48.1
1,All Students,2020-21,6938,1289,5649,81.4,42,28,66.7
1,All Students,2021-22,4474,627,3847,86.0,26,14,53.8
1,All Students,2022-23,4053,626,3427,84.6,27,19,70.4
2,All Students,2018-19,7087,650,6437,90.8,48,17,35.4
2,All Students,2019-20,3446,242,3204,93.0,31,10,32.3
2,All Students,2020-21,4034,601,3433,85.1,24,15,62.5
2,All Students,2021-22,5990,1027,4963,82.9,37,24,64.9
2,All Students,2022-23,5111,596,4515,88.3,32,17,53.1
3,All Students,2018-19,7049,488,6561,93.1,43,11,25.6
3,All Students,2019-20,4428,402,4026,90.9,41,15,36.6
3,All Students,2020-21,5509,845,4664,84.7,34,18,52.9
3,All Students,2021-22,4656,796,3860,82.9,28,19,67.9
3,All Students,2022-23,6304,813,5491,87.1,40,20,50.0
4,All Students,2018-19,8917,644,8273,92.8,55,13,23.6
4,All Students,2019-20,4266,318,3948,92.5,39,13,33.3
4,All Students,2020-21,6659,755,5904,88.7,40,17,42.5
4,All Students,2021-22,5226,611,4615,88.3,30,10,33.3
4,All Students,2022-23,4576,638,3938,86.1,29,18,62.1
5,All Students,2018-19,8088,701,7387,91.3,49,18,36.7
5,All Students,2019-20,5352,344,5008,93.6,47,10,21.3
5,All Students,2020-21,6097,573,5524,90.6,36,9,25.0
5,All Students,2021-22,6591,1045,5546,84.1,39,24,61.5
5,All Students,2022-23,4777,463,4314,90.3,31,11,35.5
All Grades,All Students,2018-19,39849,9365,30484,76.5,274,184,67.2
All Grades,All Students,2019-20,25560,5745,19815,77.5,255,171,67.1
All Grades,All Students,2020-21,33979,3968,30011,88.3,213,75,35.2
All Grades,All Students,2021-22,29705,7335,22370,75.3,199,139,69.8
All Grades,All Students,2022-23,24370,6168,18202,74.7,162,108,66.7
9,All Students,2018-19,11771,2836,8935,75.9,79,57,72.2
9,All Students,2019-20,7578,2178,5400,71.3,78,64,82.1
9,All Students,2020-21,5109,612,4497,88.0,34,13,38.2
9,All Students,2021-22,7578,1277,6301,83.1,51,29,56.9
9,All Students,2022-23,7440,1829,5611,75.4,54,37,68.5
10,All Students,2018-19,11081,2616,8465,76.4,80,56,70.0
10,All Students,2019-20,7434,1957,5477,73.7,71,51,71.8
10,All Students,2020-21,11423,2088,9335,81.7,73,36,49.3
10,All Students,2021-22,7248,2377,4871,67.2,49,34,69.4
10,All Students,2022-23,7379,1903,5476,74.2,49,27,55.1
11,All Students,2018-19,8150,1579,6571,80.6,54,32,59.3
11,All Students,2019-20,5061,827,4234,83.7,52,30,57.7
11,All Students,2020-21,9107,601,8506,93.4,56,15,26.8
11,All Students,2021-22,7027,1943,5084,72.3,50,38,76.0
11,All Students,2022-23,4175,1190,2985,71.5,23,15,65.2
12,All Students,2018-19,8847,2334,6513,73.6,61,39,63.9
12,All Students,2019-20,5487,783,4704,85.7,53,25,47.2
12,All Students,2020-21,8340,667,7673,92.0,50,11,22.0
12,All Students,2021-22,7852,1738,6114,77.9,49,38,77.6
12,All Students,2022-23,5376,1246,4130,76.8,36,29,80.6
All Grades,All Students,2018-19,143388,14348,129040,90.0,869,347,39.9
All Grades,All Students,2019-20,86680,7939,78741,90.8,801,279,34.8
All Grades,All Students,2020-21,119772,18894,100878,84.2,715,389,54.4
All Grades,All Students,2021-22,107490,17377,90113,83.8,654,396,60.6
All Grades,All Students,2022-23,93119,11906,81213,87.2,635,342,53.9
0K,All Students,2018-19,8614,1185,7429,86.2,56,34,60.7
0K,All Students,2019-20,4739,630,4109,86.7,46,21,45.7
0K,All Students,2020-21,5782,844,4938,85.4,39,21,53.8
0K,All Students,2021-22,6511,1365,5146,79.0,42,35,83.3
0K,All Students,2022-23,4964,732,4232,85.3,44,33,75.0
1,All Students,2018-19,10176,1375,8801,86.5,68,37,54.4
1,All Students,2019-20,5906,558,5348,90.6,54,19,35.2
1,All Students,2020-21,7757,1445,6312,81.4,48,30,62.5
1,All Students,2021-22,6500,1052,5448,83.8,40,23,57.5
1,All Students,2022-23,6909,1135,5774,83.6,51,34,66.7
2,All Students,2018-19,11384,1236,10148,89.1,72,33,45.8
2,All Students,2019-20,7272,844,6428,88.4,67,31,46.3
2,All Students,2020-21,9351,1162,8189,87.6,56,24,42.9
2,All Students,2021-22,8578,1693,6885,80.3,50,29,58.0
2,All Students,2022-23,7267,806,6461,88.9,54,31,57.4
3,All Students,2018-19,14047,1237,12810,91.2,87,32,36.8
3,All Students,2019-20,7499,648,6851,91.4,68,21,30.9
3,All Students,2020-21,10910,1939,8971,82.2,63,41,65.1
3,All Students,2021-22,8994,1537,7457,82.9,53,29,54.7
3,All Students,2022-23,8495,1117,7378,86.9,58,28,48.3
4,All Students,2018-19,18046,1697,16349,90.6,105,42,40.0
4,All Students,2019-20,9197,702,8495,92.4,84,24,28.6
4,All Students,2020-21,11669,1556,10113,86.7,70,36,51.4
4,All Students,2021-22,9804,1698,8106,82.7,64,44,68.8
4,All Students,2022-23,9455,1368,8087,85.5,73,41,56.2
5,All Students,2018-19,16023,1242,14781,92.2,94,27,28.7
5,All Students,2019-20,11006,994,10012,91.0,101,35,34.7
5,All Students,2020-21,14526,1770,12756,87.8,87,31,35.6
5,All Students,2021-22,10776,1547,9229,85.6,62,35,56.5
5,All Students,2022-23,9326,1375,7951,85.3,59,40,67.8
6,All Students,2018-19,19839,1762,18077,91.1,119,38,31.9
6,All Students,2019-20,13924,1042,12882,92.5,127,34,26.8
6,All Students,2020-21,18696,2793,15903,85.1,110,59,53.6
6,All Students,2021-22,16991,2454,14537,85.6,103,54,52.4
6,All Students,2022-23,12378,1394,10984,88.7,83,43,51.8
7,All Students,2018-19,22158,2228,19930,89.9,134,51,38.1
7,All Students,2019-20,13002,1155,11847,91.1,123,43,35.0
7,All Students,2020-21,21925,3709,18216,83.1,130,72,55.4
7,All Students,2021-22,18552,2810,15742,84.9,115,68,59.1
7,All Students,2022-23,15999,1790,14209,88.8,99,40,40.4
8,All Students,2018-19,23101,2386,20715,89.7,134,53,39.6
8,All Students,2019-20,14135,1366,12769,90.3,131,51,38.9
8,All Students,2020-21,19156,3676,15480,80.8,112,75,67.0
8,All Students,2021-22,20784,3221,17563,84.5,125,79,63.2
8,All Students,2022-23,18326,2189,16137,88.1,114,52,45.6
All Grades,All Students,2018-19,62068,6102,55966,90.2,385,175,45.5
All Grades,All Students,2019-20,39216,3485,35731,91.1,379,135,35.6
All Grades,All Students,2020-21,55625,11811,43814,78.8,338,213,63.0
All Grades,All Students,2021-22,51802,8327,43475,83.9,329,209,63.5
All Grades,All Students,2022-23,53214,7356,45858,86.2,334,198,59.3
PK in K-12 Schools,All Students,2018-19,8216,1008,7208,87.7,54,35,64.8
PK in K-12 Schools,All Students,2019-20,6899,768,6131,88.9,66,31,47.0
PK in K-12 Schools,All Students,2020-21,10118,2300,7818,77.3,63,39,61.9
PK in K-12 Schools,All Students,2021-22,10027,1601,8426,84.0,63,41,65.1
PK in K-12 Schools,All Students,2022-23,10729,1647,9082,84.6,69,41,59.4
0K,All Students,2018-19,8800,1008,7792,88.5,53,27,50.9
0K,All Students,2019-20,3413,368,3045,89.2,34,16,47.1
0K,All Students,2020-21,5121,1347,3774,73.7,35,27,77.1
0K,All Students,2021-22,4998,882,4116,82.4,31,25,80.6
0K,All Students,2022-23,7523,941,6582,87.5,47,27,57.4
1,All Students,2018-19,10027,1181,8846,88.2,64,38,59.4
1,All Students,2019-20,5640,554,5086,90.2,58,24,41.4
1,All Students,2020-21,5793,1277,4516,78.0,36,27,75.0
1,All Students,2021-22,5474,777,4697,85.8,38,25,65.8
1,All Students,2022-23,5273,745,4528,85.9,33,25,75.8
2,All Students,2018-19,7996,734,7262,90.8,50,20,40.0
2,All Students,2019-20,6099,562,5537,90.8,57,19,33.3
2,All Students,2020-21,8345,1964,6381,76.5,50,36,72.0
2,All Students,2021-22,5923,1085,4838,81.7,40,23,57.5
2,All Students,2022-23,6821,932,5889,86.3,44,23,52.3
3,All Students,2018-19,7853,703,7150,91.0,49,18,36.7
3,All Students,2019-20,6221,451,5770,92.8,60,16,26.7
3,All Students,2020-21,8736,2274,6462,74.0,51,35,68.6
3,All Students,2021-22,7470,1254,6216,83.2,46,29,63.0
3,All Students,2022-23,6429,1017,5412,84.2,39,23,59.0
4,All Students,2018-19,8486,722,7764,91.5,52,19,36.5
4,All Students,2019-20,5682,445,5237,92.2,53,16,30.2
4,All Students,2020-21,9221,1411,7810,84.7,54,24,44.4
4,All Students,2021-22,7492,1178,6314,84.3,48,30,62.5
4,All Students,2022-23,7526,933,6593,87.6,47,28,59.6
5,All Students,2018-19,10690,746,9944,93.0,63,18,28.6
5,All Students,2019-20,5262,337,4925,93.6,51,13,25.5
5,All Students,2020-21,8291,1238,7053,85.1,49,25,51.0
5,All Students,2021-22,10418,1550,8868,85.1,63,36,57.1
5,All Students,2022-23,8913,1141,7772,87.2,55,31,56.4
All Grades,All Students,2018-19,36552,3025,33527,91.7,253,81,32.0
All Grades,All Students,2019-20,21419,2115,19304,90.1,211,90,42.7
All Grades,All Students,2020-21,30593,3497,27096,88.6,189,75,39.7
All Grades,All Students,2021-22,28858,4723,24135,83.6,197,115,58.4
All Grades,All Students,2022-23,27335,3748,23587,86.3,186,107,57.5
PK in K-12 Schools,All Students,2018-19,2261,140,2121,93.8,20,4,20.0
PK in K-12 Schools,All Students,2019-20,1913,199,1714,89.6,21,9,42.9
PK in K-12 Schools,All Students,2020-21,1601,158,1443,90.1,12,4,33.3
PK in K-12 Schools,All Students,2021-22,1121,237,884,78.9,10,8,80.0
PK in K-12 Schools,All Students,2022-23,2079,337,1742,83.8,18,12,66.7
0K,All Students,2018-19,4061,346,3715,91.5,31,11,35.5
0K,All Students,2019-20,3027,353,2674,88.3,30,18,60.0
0K,All Students,2020-21,4048,788,3260,80.5,26,18,69.2
0K,All Students,2021-22,4088,652,3436,84.1,31,17,54.8
0K,All Students,2022-23,3597,571,3026,84.1,23,15,65.2
1,All Students,2018-19,4818,442,4376,90.8,33,12,36.4
1,All Students,2019-20,2441,315,2126,87.1,25,11,44.0
1,All Students,2020-21,4342,504,3838,88.4,27,11,40.7
1,All Students,2021-22,4760,952,3808,80.0,34,28,82.4
1,All Students,2022-23,4348,715,3633,83.6,30,20,66.7
2,All Students,2018-19,6173,625,5548,89.9,43,16,37.2
2,All Students,2019-20,2758,195,2563,92.9,28,11,39.3
2,All Students,2020-21,3736,357,3379,90.4,25,7,28.0
2,All Students,2021-22,4399,807,3592,81.7,29,15,51.7
2,All Students,2022-23,4920,631,4289,87.2,34,23,67.6
3,All Students,2018-19,7378,609,6769,91.7,52,20,38.5
3,All Students,2019-20,4157,435,3722,89.5,39,16,41.0
3,All Students,2020-21,4307,445,3862,89.7,25,12,48.0
3,All Students,2021-22,4035,597,3438,85.2,26,13,50.0
3,All Students,2022-23,4538,733,3805,83.8,32,18,56.3
4,All Students,2018-19,4907,358,4549,92.7,32,7,21.9
4,All Students,2019-20,4024,372,3652,90.8,40,16,40.0
4,All Students,2020-21,6345,659,5686,89.6,38,12,31.6
4,All Students,2021-22,4562,689,3873,84.9,29,18,62.1
4,All Students,2022-23,3852,373,3479,90.3,25,10,40.0
5,All Students,2018-19,6954,505,6449,92.7,42,11,26.2
5,All Students,2019-20,3099,246,2853,92.1,28,9,32.1
5,All Students,2020-21,6214,586,5628,90.6,36,11,30.6
5,All Students,2021-22,5893,789,5104,86.6,38,16,42.1
5,All Students,2022-23,4001,388,3613,90.3,24,9,37.5
All Grades,All Students,2018-19,55401,6515,48886,88.2,361,176,48.8
All Grades,All Students,2019-20,33017,3449,29568,89.6,307,132,43.0
All Grades,All Students,2020-21,41050,5622,35428,86.3,248,111,44.8
All Grades,All Students,2021-22,39228,6425,32803,83.6,251,157,62.5
All Grades,All Students,2022-23,35468,4189,31279,88.2,218,103,47.2
PK in K-12 Schools,All Students,2018-19,8341,1149,7192,86.2,54,30,55.6
PK in K-12 Schools,All Students,2019-20,5469,766,4703,86.0,54,30,55.6
PK in K-12 Schools,All Students,2020-21,4297,943,3354,78.1,29,19,65.5
PK in K-12 Schools,All Students,2021-22,7346,1147,6199,84.4,46,29,63.0
PK in K-12 Schools,All Students,2022-23,4996,557,4439,88.9,30,16,53.3
0K,All Students,2018-19,6395,933,5462,85.4,50,32,64.0
0K,All Students,2019-20,4531,474,4057,89.5,43,21,48.8
0K,All Students,2020-21,5439,894,4545,83.6,34,21,61.8
0K,All Students,2021-22,3807,s,s,s,s,s,s
0K,All Students,2022-23,6252,755,5497,87.9,39,21,53.8
1,All Students,2018-19,4584,341,4243,92.6,34,10,29.4
1,All Students,2019-20,3519,416,3103,88.2,34,18,52.9
1,All Students,2020-21,6238,652,5586,89.5,37,12,32.4
1,All Students,2021-22,5361,875,4486,83.7,34,19,55.9
1,All Students,2022-23,4123,510,3613,87.6,26,12,46.2
2,All Students,2018-19,8988,999,7989,88.9,56,22,39.3
2,All Students,2019-20,3312,199,3113,94.0,30,6,20.0
2,All Students,2020-21,5544,1314,4230,76.3,34,25,73.5
2,All Students,2021-22,5971,910,5061,84.8,39,26,66.7
2,All Students,2022-23,4776,615,4161,87.1,29,14,48.3
3,All Students,2018-19,8456,973,7483,88.5,53,28,52.8
3,All Students,2019-20,5505,484,5021,91.2,50,15,30.0
3,All Students,2020-21,4658,428,4230,90.8,29,9,31.0
3,All Students,2021-22,3890,1032,2858,73.5,26,20,76.9
3,All Students,2022-23,5876,725,5151,87.7,37,19,51.4
4,All Students,2018-19,9054,1087,7967,88.0,56,28,50.0
4,All Students,2019-20,4578,525,4053,88.5,42,22,52.4
4,All Students,2020-21,7879,520,7359,93.4,45,10,22.2
4,All Students,2021-22,5351,735,4616,86.3,34,18,52.9
4,All Students,2022-23,3829,558,3271,85.4,24,11,45.8
5,All Students,2018-19,9583,1033,8550,89.2,58,26,44.8
5,All Students,2019-20,6103,585,5518,90.4,54,20,37.0
5,All Students,2020-21,6995,871,6124,87.5,40,15,37.5
5,All Students,2021-22,7480,1016,6464,86.4,44,27,61.4
5,All Students,2022-23,5616,469,5147,91.6,33,10,30.3
6,All Students,2021-22,22,s,s,s,s,s,s
All Grades,All Students,2018-19,69160,9517,59643,86.2,455,261,57.4
All Grades,All Students,2019-20,42646,6047,36599,85.8,410,232,56.6
All Grades,All Students,2020-21,51752,12558,39194,75.7,327,219,67.0
All Grades,All Students,2021-22,55083,12996,42087,76.4,349,279,79.9
All Grades,All Students,2022-23,50780,7183,43597,85.9,314,182,58.0
PK in K-12 Schools,All Students,2018-19,11554,2444,9110,78.8,85,72,84.7
PK in K-12 Schools,All Students,2019-20,8932,1807,7125,79.8,87,66,75.9
PK in K-12 Schools,All Students,2020-21,9119,2719,6400,70.2,64,54,84.4
PK in K-12 Schools,All Students,2021-22,10741,2947,7794,72.6,73,68,93.2
PK in K-12 Schools,All Students,2022-23,8840,1759,7081,80.1,57,46,80.7
0K,All Students,2018-19,9077,1586,7491,82.5,63,42,66.7
0K,All Students,2019-20,5287,828,4459,84.3,53,31,58.5
0K,All Students,2020-21,5982,1146,4836,80.8,43,25,58.1
0K,All Students,2021-22,6945,1594,5351,77.0,49,41,83.7
0K,All Students,2022-23,6217,909,5308,85.4,39,21,53.8
1,All Students,2018-19,8653,1104,7549,87.2,60,30,50.0
1,All Students,2019-20,5336,715,4621,86.6,53,28,52.8
1,All Students,2020-21,7079,1852,5227,73.8,42,31,73.8
1,All Students,2021-22,8039,2149,5890,73.3,49,40,81.6
1,All Students,2022-23,5572,623,4949,88.8,33,17,51.5
2,All Students,2018-19,7663,s,s,s,s,s,s
2,All Students,2019-20,4527,572,3955,87.4,45,23,51.1
2,All Students,2020-21,7715,1802,5913,76.6,48,27,56.3
2,All Students,2021-22,8179,1610,6569,80.3,51,39,76.5
2,All Students,2022-23,8286,1248,7038,84.9,52,33,63.5
3,All Students,2018-19,10397,1300,9097,87.5,63,32,50.8
3,All Students,2019-20,4538,553,3985,87.8,44,24,54.5
3,All Students,2020-21,6508,1570,4938,75.9,39,27,69.2
3,All Students,2021-22,7767,1678,6089,78.4,49,35,71.4
3,All Students,2022-23,8076,1039,7037,87.1,49,26,53.1
4,All Students,2018-19,11076,1279,9797,88.5,66,35,53.0
4,All Students,2019-20,6594,801,5793,87.9,61,31,50.8
4,All Students,2020-21,6695,1691,5004,74.7,41,26,63.4
4,All Students,2021-22,6376,1442,4934,77.4,36,27,75.0
4,All Students,2022-23,7413,847,6566,88.6,46,21,45.7
5,All Students,2018-19,10651,884,9767,91.7,66,20,30.3
5,All Students,2019-20,7432,771,6661,89.6,67,29,43.3
5,All Students,2020-21,8654,1778,6876,79.5,50,29,58.0
5,All Students,2021-22,7036,1576,5460,77.6,42,29,69.0
5,All Students,2022-23,6376,758,5618,88.1,38,18,47.4
6,All Students,2018-19,89,s,s,s,s,s,s
All Grades,All Students,2018-19,22880,3169,19711,86.1,152,83,54.6
All Grades,All Students,2019-20,11650,1302,10348,88.8,111,51,45.9
All Grades,All Students,2020-21,16337,2319,14018,85.8,97,42,43.3
All Grades,All Students,2021-22,14117,2468,11649,82.5,88,63,71.6
All Grades,All Students,2022-23,13411,1925,11486,85.6,83,48,57.8
6,All Students,2018-19,4511,548,3963,87.9,31,18,58.1
6,All Students,2019-20,2888,s,s,s,s,s,s
6,All Students,2020-21,6381,973,5408,84.8,39,18,46.2
6,All Students,2021-22,3264,655,2609,79.9,20,14,70.0
6,All Students,2022-23,4186,641,3545,84.7,26,16,61.5
7,All Students,2018-19,8008,1331,6677,83.4,53,35,66.0
7,All Students,2019-20,3705,426,3279,88.5,36,15,41.7
7,All Students,2020-21,4881,607,4274,87.6,29,11,37.9
7,All Students,2021-22,5421,924,4497,83.0,33,22,66.7
7,All Students,2022-23,3496,550,2946,84.3,21,14,66.7
8,All Students,2018-19,10361,1290,9071,87.5,68,30,44.1
8,All Students,2019-20,4991,603,4388,87.9,46,26,56.5
8,All Students,2020-21,5075,739,4336,85.4,29,13,44.8
8,All Students,2021-22,5432,889,4543,83.6,35,27,77.1
8,All Students,2022-23,5729,734,4995,87.2,36,18,50.0
9,All Students,2019-20,66,s,s,s,s,s,s
All Grades,All Students,2018-19,46942,7020,39922,85.0,328,128,39.0
All Grades,All Students,2019-20,25980,5211,20769,79.9,257,120,46.7
All Grades,All Students,2020-21,35203,10138,25065,71.2,210,126,60.0
All Grades,All Students,2021-22,31833,8601,23232,73.0,212,159,75.0
All Grades,All Students,2022-23,32242,8500,23742,73.6,232,156,67.2
8,All Students,2020-21,29,s,s,s,s,s,s
9,All Students,2018-19,14912,3309,11603,77.8,105,56,53.3
9,All Students,2019-20,8045,1923,6122,76.1,80,39,48.8
9,All Students,2020-21,8695,2456,6239,71.8,51,29,56.9
9,All Students,2021-22,8874,1836,7038,79.3,60,37,61.7
9,All Students,2022-23,8599,2120,6479,75.3,77,42,54.5
10,All Students,2018-19,11176,1645,9531,85.3,76,33,43.4
10,All Students,2019-20,7220,1567,5653,78.3,72,38,52.8
10,All Students,2020-21,11805,3512,8293,70.2,73,44,60.3
10,All Students,2021-22,7863,2421,5442,69.2,56,45,80.4
10,All Students,2022-23,8365,2500,5865,70.1,56,42,75.0
11,All Students,2018-19,10613,1083,9530,89.8,76,17,22.4
11,All Students,2019-20,4288,710,3578,83.4,44,21,47.7
11,All Students,2020-21,7671,2152,5519,71.9,44,27,61.4
11,All Students,2021-22,7534,1817,5717,75.9,48,33,68.8
11,All Students,2022-23,7693,2064,5629,73.2,52,39,75.0
12,All Students,2018-19,10241,983,9258,90.4,71,22,31.0
12,All Students,2019-20,6427,1011,5416,84.3,61,22,36.1
12,All Students,2020-21,7003,s,s,s,s,s,s
12,All Students,2021-22,7562,2527,5035,66.6,48,44,91.7
12,All Students,2022-23,7585,1816,5769,76.1,47,33,70.2
All Grades,All Students,2018-19,37398,3362,34036,91.0,215,69,32.1
All Grades,All Students,2019-20,23783,1927,21856,91.9,209,60,28.7
All Grades,All Students,2020-21,32328,2634,29694,91.9,192,54,28.1
All Grades,All Students,2021-22,31582,4694,26888,85.1,187,120,64.2
All Grades,All Students,2022-23,29994,4142,25852,86.2,178,110,61.8
0K,All Students,2018-19,4335,467,3868,89.2,26,13,50.0
0K,All Students,2019-20,2640,283,2357,89.3,23,9,39.1
0K,All Students,2020-21,3960,393,3567,90.1,24,8,33.3
0K,All Students,2021-22,5986,978,5008,83.7,36,29,80.6
0K,All Students,2022-23,3560,572,2988,83.9,22,15,68.2
1,All Students,2018-19,5360,540,4820,89.9,31,11,35.5
1,All Students,2019-20,4083,365,3718,91.1,36,9,25.0
1,All Students,2020-21,4162,622,3540,85.1,25,13,52.0
1,All Students,2021-22,3923,544,3379,86.1,25,15,60.0
1,All Students,2022-23,5766,825,4941,85.7,36,27,75.0
2,All Students,2018-19,6198,505,5693,91.9,35,9,25.7
2,All Students,2019-20,4083,289,3794,92.9,36,11,30.6
2,All Students,2020-21,6674,731,5943,89.0,41,18,43.9
2,All Students,2021-22,4082,756,3326,81.5,24,15,62.5
2,All Students,2022-23,3685,421,3264,88.6,21,12,57.1
3,All Students,2018-19,6415,421,5994,93.4,38,7,18.4
3,All Students,2019-20,4062,269,3793,93.4,36,9,25.0
3,All Students,2020-21,5962,315,5647,94.7,35,5,14.3
3,All Students,2021-22,6375,1114,5261,82.5,37,27,73.0
3,All Students,2022-23,4394,694,3700,84.2,25,16,64.0
4,All Students,2018-19,8007,768,7239,90.4,45,15,33.3
4,All Students,2019-20,4110,282,3828,93.1,36,7,19.4
4,All Students,2020-21,5620,353,5267,93.7,33,6,18.2
4,All Students,2021-22,6164,668,5496,89.2,36,21,58.3
4,All Students,2022-23,5846,813,5033,86.1,34,19,55.9
5,All Students,2018-19,7083,661,6422,90.7,40,14,35.0
5,All Students,2019-20,4805,439,4366,90.9,42,15,35.7
5,All Students,2020-21,5950,220,5730,96.3,34,4,11.8
5,All Students,2021-22,5052,634,4418,87.5,29,13,44.8
5,All Students,2022-23,6743,817,5926,87.9,40,21,52.5
All Grades,All Students,2018-19,121751,6928,114823,94.3,720,114,15.8
All Grades,All Students,2019-20,77876,3923,73953,95.0,703,94,13.4
All Grades,All Students,2020-21,122161,5012,117149,95.9,704,89,12.6
All Grades,All Students,2021-22,112303,9177,103126,91.8,665,170,25.6
All Grades,All Students,2022-23,117113,5427,111686,95.4,706,77,10.9
6,All Students,2018-19,17091,639,16452,96.3,98,9,9.2
6,All Students,2019-20,10943,277,10666,97.5,96,4,4.2
6,All Students,2020-21,17323,326,16997,98.1,99,4,4.0
6,All Students,2021-22,14832,1188,13644,92.0,85,20,23.5
6,All Students,2022-23,17339,563,16776,96.8,100,7,7.0
7,All Students,2018-19,17313,589,16724,96.6,99,6,6.1
7,All Students,2019-20,11287,393,10894,96.5,99,5,5.1
7,All Students,2020-21,17190,398,16792,97.7,100,4,4.0
7,All Students,2021-22,16039,693,15346,95.7,99,12,12.1
7,All Students,2022-23,17391,804,16587,95.4,102,15,14.7
8,All Students,2018-19,17403,645,16758,96.3,101,6,5.9
8,All Students,2019-20,11071,372,10699,96.6,98,5,5.1
8,All Students,2020-21,17325,311,17014,98.2,99,1,1.0
8,All Students,2021-22,16260,1013,15247,93.8,94,11,11.7
8,All Students,2022-23,16514,587,15927,96.4,100,6,6.0
9,All Students,2018-19,18584,833,17751,95.5,112,13,11.6
9,All Students,2019-20,11219,414,10805,96.3,102,8,7.8
9,All Students,2020-21,18443,1148,17295,93.8,108,28,25.9
9,All Students,2021-22,15890,856,15034,94.6,94,14,14.9
9,All Students,2022-23,17444,758,16686,95.7,108,7,6.5
10,All Students,2018-19,18806,1196,17610,93.6,114,19,16.7
10,All Students,2019-20,12147,803,11344,93.4,112,18,16.1
10,All Students,2020-21,18285,1098,17187,94.0,105,18,17.1
10,All Students,2021-22,16868,1346,15522,92.0,99,24,24.2
10,All Students,2022-23,17605,770,16835,95.6,108,9,8.3
11,All Students,2018-19,16217,1142,15075,93.0,98,17,17.3
11,All Students,2019-20,10644,614,10030,94.2,98,20,20.4
11,All Students,2020-21,17325,830,16495,95.2,99,15,15.2
11,All Students,2021-22,16002,1456,14546,90.9,97,30,30.9
11,All Students,2022-23,15223,813,14410,94.7,94,13,13.8
12,All Students,2018-19,16337,1884,14453,88.5,98,44,44.9
12,All Students,2019-20,10565,1050,9515,90.1,98,34,34.7
12,All Students,2020-21,16270,901,15369,94.5,94,19,20.2
12,All Students,2021-22,16412,2625,13787,84.0,97,59,60.8
12,All Students,2022-23,15597,1132,14465,92.7,94,20,21.3
All Grades,All Students,2018-19,60846,10353,50493,83.0,395,209,52.9
All Grades,All Students,2019-20,41504,6870,34634,83.4,383,180,47.0
All Grades,All Students,2020-21,65157,11767,53390,81.9,381,174,45.7
All Grades,All Students,2021-22,54169,13146,41023,75.7,339,243,71.7
All Grades,All Students,2022-23,41696,9964,31732,76.1,280,208,74.3
9,All Students,2018-19,22279,4125,18154,81.5,147,73,49.7
9,All Students,2019-20,14358,3036,11322,78.9,131,71,54.2
9,All Students,2020-21,21540,5819,15721,73.0,128,79,61.7
9,All Students,2021-22,13356,3649,9707,72.7,82,58,70.7
9,All Students,2022-23,11258,1941,9317,82.8,76,47,61.8
10,All Students,2018-19,17602,2858,14744,83.8,116,63,54.3
10,All Students,2019-20,11742,1976,9766,83.2,111,48,43.2
10,All Students,2020-21,15842,2943,12899,81.4,93,45,48.4
10,All Students,2021-22,15266,4599,10667,69.9,100,79,79.0
10,All Students,2022-23,10069,3087,6982,69.3,71,57,80.3
11,All Students,2018-19,10593,1518,9075,85.7,69,38,55.1
11,All Students,2019-20,8642,842,7800,90.3,80,28,35.0
11,All Students,2020-21,13501,985,12516,92.7,78,13,16.7
11,All Students,2021-22,10255,2011,8244,80.4,64,45,70.3
11,All Students,2022-23,10669,2385,8284,77.6,71,54,76.1
12,All Students,2018-19,10372,1852,8520,82.1,63,35,55.6
12,All Students,2019-20,6762,1016,5746,85.0,61,33,54.1
12,All Students,2020-21,14274,2020,12254,85.8,82,37,45.1
12,All Students,2021-22,15292,2887,12405,81.1,93,61,65.6
12,All Students,2022-23,9700,2551,7149,73.7,62,50,80.6
All Grades,All Students,2020-21,13526,2998,10528,77.8,79,54,68.4
All Grades,All Students,2021-22,21702,4976,16726,77.1,148,108,73.0
All Grades,All Students,2022-23,22224,3703,18521,83.3,135,90,66.7
6,All Students,2020-21,13526,2998,10528,77.8,79,54,68.4
6,All Students,2021-22,9963,2253,7710,77.4,69,52,75.4
6,All Students,2022-23,4598,608,3990,86.8,28,17,60.7
7,All Students,2021-22,11558,2651,8907,77.1,77,55,71.4
7,All Students,2022-23,7288,1095,6193,85.0,45,25,55.6
8,All Students,2021-22,167,s,s,s,s,s,s
8,All Students,2022-23,10338,2000,8338,80.7,62,48,77.4
9,All Students,2021-22,14,s,s,s,s,s,s
All Grades,All Students,2018-19,207983,21054,186929,89.9,1323,417,31.5
All Grades,All Students,2019-20,118838,12621,106217,89.4,1113,365,32.8
All Grades,All Students,2020-21,171984,33849,138135,80.3,1002,586,58.5
All Grades,All Students,2021-22,147469,26464,121005,82.1,917,511,55.7
All Grades,All Students,2022-23,131045,20406,110639,84.4,836,455,54.4
6,All Students,2018-19,15514,1220,14294,92.1,92,27,29.3
6,All Students,2019-20,6853,665,6188,90.3,64,19,29.7
6,All Students,2020-21,9841,2075,7766,78.9,58,40,69.0
6,All Students,2021-22,10178,1399,8779,86.3,62,30,48.4
6,All Students,2022-23,8411,1140,7271,86.4,52,31,59.6
7,All Students,2018-19,16483,1414,15069,91.4,102,25,24.5
7,All Students,2019-20,10706,1035,9671,90.3,94,28,29.8
7,All Students,2020-21,9774,1907,7867,80.5,57,35,61.4
7,All Students,2021-22,10329,1564,8765,84.9,64,34,53.1
7,All Students,2022-23,10453,1286,9167,87.7,62,30,48.4
8,All Students,2018-19,17098,1277,15821,92.5,102,28,27.5
8,All Students,2019-20,9259,688,8571,92.6,86,20,23.3
8,All Students,2020-21,15306,2797,12509,81.7,88,60,68.2
8,All Students,2021-22,10745,1620,9125,84.9,68,34,50.0
8,All Students,2022-23,11158,1616,9542,85.5,70,38,54.3
9,All Students,2018-19,41493,4760,36733,88.5,272,108,39.7
9,All Students,2019-20,27136,2890,24246,89.3,260,95,36.5
9,All Students,2020-21,34350,7642,26708,77.8,204,135,66.2
9,All Students,2021-22,28008,5307,22701,81.1,174,98,56.3
9,All Students,2022-23,26306,4195,22111,84.1,170,85,50.0
10,All Students,2018-19,40162,4588,35574,88.6,266,80,30.1
10,All Students,2019-20,21163,2649,18514,87.5,205,83,40.5
10,All Students,2020-21,41297,6408,34889,84.5,240,103,42.9
10,All Students,2021-22,29846,6144,23702,79.4,189,112,59.3
10,All Students,2022-23,24572,4536,20036,81.5,161,95,59.0
11,All Students,2018-19,39669,3945,35724,90.1,250,75,30.0
11,All Students,2019-20,21546,2523,19023,88.3,197,55,27.9
11,All Students,2020-21,30032,7218,22814,76.0,175,114,65.1
11,All Students,2021-22,35401,6446,28955,81.8,219,114,52.1
11,All Students,2022-23,22649,3581,19068,84.2,147,76,51.7
12,All Students,2018-19,37564,3850,33714,89.8,239,74,31.0
12,All Students,2019-20,22175,2171,20004,90.2,206,64,31.1
12,All Students,2020-21,31384,5802,25582,81.5,180,99,55.0
12,All Students,2021-22,22962,3984,18978,82.6,141,89,63.1
12,All Students,2022-23,27496,4052,23444,85.3,174,100,57.5
All Grades,All Students,2018-19,24994,3857,21137,84.6,160,99,61.9
All Grades,All Students,2019-20,16102,2639,13463,83.6,152,89,58.6
All Grades,All Students,2020-21,22931,6095,16836,73.4,144,95,66.0
All Grades,All Students,2021-22,17964,4268,13696,76.2,122,100,82.0
All Grades,All Students,2022-23,13410,2830,10580,78.9,94,66,70.2
6,All Students,2018-19,7677,1072,6605,86.0,46,27,58.7
6,All Students,2019-20,5657,720,4937,87.3,55,30,54.5
6,All Students,2020-21,6214,1464,4750,76.4,40,26,65.0
6,All Students,2021-22,4659,856,3803,81.6,30,21,70.0
6,All Students,2022-23,3307,930,2377,71.9,26,19,73.1
7,All Students,2018-19,5115,730,4385,85.7,38,24,63.2
7,All Students,2019-20,5535,847,4688,84.7,49,25,51.0
7,All Students,2020-21,8045,2196,5849,72.7,52,33,63.5
7,All Students,2021-22,5356,1575,3781,70.6,39,37,94.9
7,All Students,2022-23,5078,997,4081,80.4,33,22,66.7
8,All Students,2018-19,12202,2055,10147,83.2,76,48,63.2
8,All Students,2019-20,4910,1072,3838,78.2,48,34,70.8
8,All Students,2020-21,8672,2435,6237,71.9,52,36,69.2
8,All Students,2021-22,7949,1837,6112,76.9,53,42,79.2
8,All Students,2022-23,5025,903,4122,82.0,35,25,71.4
All Grades,All Students,2018-19,56081,3122,52959,94.4,331,60,18.1
All Grades,All Students,2019-20,43037,2625,40412,93.9,396,80,20.2
All Grades,All Students,2020-21,64308,8492,55816,86.8,384,149,38.8
All Grades,All Students,2021-22,60548,7145,53403,88.2,362,159,43.9
All Grades,All Students,2022-23,56991,5852,51139,89.7,344,131,38.1
PK in K-12 Schools,All Students,2018-19,3125,188,2937,94.0,18,4,22.2
PK in K-12 Schools,All Students,2019-20,3576,417,3159,88.3,34,16,47.1
PK in K-12 Schools,All Students,2020-21,4660,925,3735,80.2,30,15,50.0
PK in K-12 Schools,All Students,2021-22,4761,659,4102,86.2,30,16,53.3
PK in K-12 Schools,All Students,2022-23,3269,419,2850,87.2,19,10,52.6
0K,All Students,2018-19,5471,374,5097,93.2,32,7,21.9
0K,All Students,2019-20,4031,281,3750,93.0,38,13,34.2
0K,All Students,2020-21,7201,616,6585,91.4,46,17,37.0
0K,All Students,2021-22,4959,560,4399,88.7,31,14,45.2
0K,All Students,2022-23,4424,471,3953,89.4,28,10,35.7
1,All Students,2018-19,7146,486,6660,93.2,42,8,19.0
1,All Students,2019-20,3983,340,3643,91.5,36,14,38.9
1,All Students,2020-21,4682,350,4332,92.5,28,7,25.0
1,All Students,2021-22,5982,796,5186,86.7,36,21,58.3
1,All Students,2022-23,4246,375,3871,91.2,24,10,41.7
2,All Students,2018-19,6630,334,6296,95.0,39,6,15.4
2,All Students,2019-20,4140,269,3871,93.5,36,9,25.0
2,All Students,2020-21,4594,552,4042,88.0,27,10,37.0
2,All Students,2021-22,4205,345,3860,91.8,26,11,42.3
2,All Students,2022-23,5109,591,4518,88.4,30,13,43.3
3,All Students,2018-19,6804,339,6465,95.0,39,6,15.4
3,All Students,2019-20,3619,140,3479,96.1,33,1,3.0
3,All Students,2020-21,5568,730,4838,86.9,32,12,37.5
3,All Students,2021-22,3964,s,s,s,s,s,s
3,All Students,2022-23,3640,369,3271,89.9,21,6,28.6
4,All Students,2018-19,8594,347,8247,96.0,49,5,10.2
4,All Students,2019-20,4851,249,4602,94.9,45,6,13.3
4,All Students,2020-21,5153,622,4531,87.9,30,10,33.3
4,All Students,2021-22,5588,588,5000,89.5,33,12,36.4
4,All Students,2022-23,3575,314,3261,91.2,23,7,30.4
5,All Students,2018-19,5668,271,5397,95.2,33,6,18.2
5,All Students,2019-20,5063,165,4898,96.7,44,1,2.3
5,All Students,2020-21,6334,466,5868,92.6,38,8,21.1
5,All Students,2021-22,5066,548,4518,89.2,31,12,38.7
5,All Students,2022-23,5063,453,4610,91.1,32,10,31.3
6,All Students,2018-19,8818,590,8228,93.3,55,15,27.3
6,All Students,2019-20,5370,293,5077,94.5,49,7,14.3
6,All Students,2020-21,9524,1437,8087,84.9,55,26,47.3
6,All Students,2021-22,10827,1481,9346,86.3,63,25,39.7
6,All Students,2022-23,8903,1006,7897,88.7,55,24,43.6
7,All Students,2018-19,3825,193,3632,95.0,24,3,12.5
7,All Students,2019-20,5573,311,5262,94.4,55,9,16.4
7,All Students,2020-21,7418,1360,6058,81.7,45,23,51.1
7,All Students,2021-22,9262,908,8354,90.2,54,17,31.5
7,All Students,2022-23,9390,1076,8314,88.5,57,22,38.6
8,All Students,2019-20,2831,160,2671,94.3,26,4,15.4
8,All Students,2020-21,9174,1434,7740,84.4,53,21,39.6
8,All Students,2021-22,5912,749,5163,87.3,34,18,52.9
8,All Students,2022-23,9372,778,8594,91.7,55,19,34.5
9,All Students,2021-22,22,s,s,s,s,s,s
All Grades,All Students,2018-19,93339,7290,86049,92.2,552,110,19.9
All Grades,All Students,2019-20,60088,5014,55074,91.7,552,125,22.6
All Grades,All Students,2020-21,93126,22378,70748,76.0,542,386,71.2
All Grades,All Students,2021-22,87127,8462,78665,90.3,555,168,30.3
All Grades,All Students,2022-23,79434,8995,70439,88.7,502,153,30.5
6,All Students,2018-19,10321,333,9988,96.8,58,3,5.2
6,All Students,2019-20,5845,302,5543,94.8,54,8,14.8
6,All Students,2020-21,9452,2337,7115,75.3,56,48,85.7
6,All Students,2021-22,10010,800,9210,92.0,63,16,25.4
6,All Students,2022-23,8456,728,7728,91.4,50,11,22.0
7,All Students,2018-19,10378,599,9779,94.2,59,7,11.9
7,All Students,2019-20,6610,390,6220,94.1,60,9,15.0
7,All Students,2020-21,8300,1716,6584,79.3,48,40,83.3
7,All Students,2021-22,9730,879,8851,91.0,61,16,26.2
7,All Students,2022-23,9164,1074,8090,88.3,54,22,40.7
8,All Students,2018-19,10026,798,9228,92.0,56,11,19.6
8,All Students,2019-20,6390,323,6067,94.9,56,4,7.1
8,All Students,2020-21,9817,2258,7559,77.0,57,40,70.2
8,All Students,2021-22,9022,717,8305,92.1,56,16,28.6
8,All Students,2022-23,10152,1091,9061,89.3,65,17,26.2
9,All Students,2018-19,19159,2128,17031,88.9,114,27,23.7
9,All Students,2019-20,12036,1397,10639,88.4,112,37,33.0
9,All Students,2020-21,23829,7174,16655,69.9,137,106,77.4
9,All Students,2021-22,15097,1709,13388,88.7,97,29,29.9
9,All Students,2022-23,14483,1702,12781,88.2,93,24,25.8
10,All Students,2018-19,15430,1294,14136,91.6,97,28,28.9
10,All Students,2019-20,11183,1106,10077,90.1,104,26,25.0
10,All Students,2020-21,15029,4567,10462,69.6,86,58,67.4
10,All Students,2021-22,15759,1418,14341,91.0,103,31,30.1
10,All Students,2022-23,12952,1523,11429,88.2,86,25,29.1
11,All Students,2018-19,15513,1113,14400,92.8,93,16,17.2
11,All Students,2019-20,8456,617,7839,92.7,80,15,18.8
11,All Students,2020-21,14731,2344,12387,84.1,86,50,58.1
11,All Students,2021-22,12759,1296,11463,89.8,81,27,33.3
11,All Students,2022-23,12345,1419,10926,88.5,79,24,30.4
12,All Students,2018-19,12512,1025,11487,91.8,75,18,24.0
12,All Students,2019-20,9568,879,8689,90.8,86,26,30.2
12,All Students,2020-21,11968,1982,9986,83.4,72,44,61.1
12,All Students,2021-22,14750,1643,13107,88.9,94,33,35.1
12,All Students,2022-23,11882,1458,10424,87.7,75,30,40.0
All Grades,All Students,2018-19,81114,3745,77369,95.4,490,57,11.6
All Grades,All Students,2019-20,53235,2123,51112,96.0,488,53,10.9
All Grades,All Students,2020-21,86337,6169,80168,92.9,497,96,19.3
All Grades,All Students,2021-22,88141,5394,82747,93.9,525,96,18.3
All Grades,All Students,2022-23,92385,4120,88265,95.5,556,68,12.2
9,All Students,2018-19,17793,368,17425,97.9,108,6,5.6
9,All Students,2019-20,13097,334,12763,97.4,121,6,5.0
9,All Students,2020-21,24186,1396,22790,94.2,139,16,11.5
9,All Students,2021-22,26106,962,25144,96.3,157,13,8.3
9,All Students,2022-23,22894,765,22129,96.7,138,10,7.2
10,All Students,2018-19,24262,624,23638,97.4,148,5,3.4
10,All Students,2019-20,10921,336,10585,96.9,100,5,5.0
10,All Students,2020-21,21115,1210,19905,94.3,122,19,15.6
10,All Students,2021-22,25463,1406,24057,94.5,151,18,11.9
10,All Students,2022-23,25965,760,25205,97.1,156,8,5.1
11,All Students,2018-19,21379,774,20605,96.4,128,8,6.3
11,All Students,2019-20,15494,481,15013,96.9,141,9,6.4
11,All Students,2020-21,16850,813,16037,95.2,97,5,5.2
11,All Students,2021-22,20588,1387,19201,93.3,122,25,20.5
11,All Students,2022-23,23909,875,23034,96.3,144,12,8.3
12,All Students,2018-19,17680,1979,15701,88.8,106,38,35.8
12,All Students,2019-20,13723,972,12751,92.9,126,33,26.2
12,All Students,2020-21,24186,2750,21436,88.6,139,56,40.3
12,All Students,2021-22,15984,1639,14345,89.7,95,40,42.1
12,All Students,2022-23,19617,1720,17897,91.2,118,38,32.2
All Grades,All Students,2018-19,89612,7468,82144,91.7,535,159,29.7
All Grades,All Students,2019-20,57058,5183,51875,90.9,518,180,34.7
All Grades,All Students,2020-21,79026,10942,68084,86.2,478,213,44.6
All Grades,All Students,2021-22,82011,10786,71225,86.8,503,284,56.5
All Grades,All Students,2022-23,78566,9564,69002,87.8,468,230,49.1
PK in K-12 Schools,All Students,2018-19,6299,831,5468,86.8,38,21,55.3
PK in K-12 Schools,All Students,2019-20,7302,859,6443,88.2,66,35,53.0
PK in K-12 Schools,All Students,2020-21,12614,1887,10727,85.0,81,38,46.9
PK in K-12 Schools,All Students,2021-22,14822,2344,12478,84.2,98,69,70.4
PK in K-12 Schools,All Students,2022-23,16436,2966,13470,82.0,100,71,71.0
0K,All Students,2018-19,11962,1229,10733,89.7,75,32,42.7
0K,All Students,2019-20,8231,1071,7160,87.0,75,37,49.3
0K,All Students,2020-21,9110,1372,7738,84.9,58,26,44.8
0K,All Students,2021-22,11594,1672,9922,85.6,72,46,63.9
0K,All Students,2022-23,10260,1829,8431,82.2,61,46,75.4
1,All Students,2018-19,9989,906,9083,90.9,61,24,39.3
1,All Students,2019-20,8776,790,7986,91.0,79,26,32.9
1,All Students,2020-21,10448,1932,8516,81.5,63,31,49.2
1,All Students,2021-22,9524,1202,8322,87.4,58,33,56.9
1,All Students,2022-23,10785,987,9798,90.8,64,23,35.9
2,All Students,2018-19,12116,1159,10957,90.4,73,23,31.5
2,All Students,2019-20,5630,518,5112,90.8,52,21,40.4
2,All Students,2020-21,12804,1611,11193,87.4,75,33,44.0
2,All Students,2021-22,9850,1679,8171,83.0,62,37,59.7
2,All Students,2022-23,9988,1048,8940,89.5,57,22,38.6
3,All Students,2018-19,14691,1025,13666,93.0,86,20,23.3
3,All Students,2019-20,8484,571,7913,93.3,79,15,19.0
3,All Students,2020-21,8547,1139,7408,86.7,52,27,51.9
3,All Students,2021-22,13480,1550,11930,88.5,80,42,52.5
3,All Students,2022-23,9704,1092,8612,88.7,58,28,48.3
4,All Students,2018-19,15860,1097,14763,93.1,94,20,21.3
4,All Students,2019-20,8888,675,8213,92.4,79,21,26.6
4,All Students,2020-21,12604,1555,11049,87.7,75,28,37.3
4,All Students,2021-22,8809,879,7930,90.0,51,22,43.1
4,All Students,2022-23,12960,1024,11936,92.1,79,28,35.4
5,All Students,2018-19,18695,1221,17474,93.5,108,19,17.6
5,All Students,2019-20,9747,699,9048,92.8,88,25,28.4
5,All Students,2020-21,12899,1446,11453,88.8,74,30,40.5
5,All Students,2021-22,13932,1460,12472,89.5,82,35,42.7
5,All Students,2022-23,8433,618,7815,92.7,49,12,24.5
All Grades,All Students,2018-19,98080,8073,90007,91.8,595,185,31.1
All Grades,All Students,2019-20,63698,5590,58108,91.2,597,199,33.3
All Grades,All Students,2020-21,90306,9438,80868,89.5,539,183,34.0
All Grades,All Students,2021-22,82967,13467,69500,83.8,520,317,61.0
All Grades,All Students,2022-23,75569,10796,64773,85.7,469,277,59.1
PK in K-12 Schools,All Students,2018-19,6441,1212,5229,81.2,46,34,73.9
PK in K-12 Schools,All Students,2019-20,8875,1233,7642,86.1,85,45,52.9
PK in K-12 Schools,All Students,2020-21,11898,758,11140,93.6,77,17,22.1
PK in K-12 Schools,All Students,2021-22,12971,3002,9969,76.9,87,72,82.8
PK in K-12 Schools,All Students,2022-23,13452,2846,10606,78.8,87,70,80.5
0K,All Students,2018-19,12633,1456,11177,88.5,81,45,55.6
0K,All Students,2019-20,8779,1060,7719,87.9,84,39,46.4
0K,All Students,2020-21,11839,1334,10505,88.7,70,25,35.7
0K,All Students,2021-22,9403,1812,7591,80.7,63,41,65.1
0K,All Students,2022-23,10058,1538,8520,84.7,64,44,68.8
1,All Students,2018-19,14211,1089,13122,92.3,86,24,27.9
1,All Students,2019-20,8174,s,s,s,s,s,s
1,All Students,2020-21,13103,1679,11424,87.2,77,32,41.6
1,All Students,2021-22,10248,1644,8604,84.0,62,36,58.1
1,All Students,2022-23,8643,1076,7567,87.6,53,30,56.6
2,All Students,2018-19,16126,1194,14932,92.6,95,26,27.4
2,All Students,2019-20,8792,680,8112,92.3,84,24,28.6
2,All Students,2020-21,13105,1803,11302,86.2,79,38,48.1
2,All Students,2021-22,12229,1924,10305,84.3,76,44,57.9
2,All Students,2022-23,10004,1104,8900,89.0,59,26,44.1
3,All Students,2018-19,17293,1124,16169,93.5,102,18,17.6
3,All Students,2019-20,9420,741,8679,92.1,87,26,29.9
3,All Students,2020-21,13023,1539,11484,88.2,76,26,34.2
3,All Students,2021-22,12846,1743,11103,86.4,77,43,55.8
3,All Students,2022-23,11845,1418,10427,88.0,73,32,43.8
4,All Students,2018-19,19687,1313,18374,93.3,115,25,21.7
4,All Students,2019-20,10698,664,10034,93.8,98,20,20.4
4,All Students,2020-21,14312,1526,12786,89.3,84,30,35.7
4,All Students,2021-22,12778,1798,10980,85.9,78,45,57.7
4,All Students,2022-23,11654,1472,10182,87.4,72,41,56.9
5,All Students,2018-19,11689,685,11004,94.1,70,13,18.6
5,All Students,2019-20,8889,480,8409,94.6,82,13,15.9
5,All Students,2020-21,13026,799,12227,93.9,76,15,19.7
5,All Students,2021-22,12492,1544,10948,87.6,77,36,46.8
5,All Students,2022-23,9913,1342,8571,86.5,61,34,55.7
7,All Students,2019-20,71,s,s,s,s,s,s
All Grades,All Students,2018-19,88512,5951,82561,93.3,529,118,22.3
All Grades,All Students,2019-20,55228,3642,51586,93.4,496,111,22.4
All Grades,All Students,2020-21,76357,10691,65666,86.0,451,196,43.5
All Grades,All Students,2021-22,64082,7832,56250,87.8,389,196,50.4
All Grades,All Students,2022-23,62367,6786,55581,89.1,383,169,44.1
PK in K-12 Schools,All Students,2018-19,6738,525,6213,92.2,41,13,31.7
PK in K-12 Schools,All Students,2019-20,5750,477,5273,91.7,52,18,34.6
PK in K-12 Schools,All Students,2020-21,8482,1583,6899,81.3,51,29,56.9
PK in K-12 Schools,All Students,2021-22,8738,1360,7378,84.4,53,35,66.0
PK in K-12 Schools,All Students,2022-23,10937,1626,9311,85.1,70,45,64.3
0K,All Students,2018-19,11090,1011,10079,90.9,69,26,37.7
0K,All Students,2019-20,5480,396,5084,92.8,50,14,28.0
0K,All Students,2020-21,8376,2142,6234,74.4,51,34,66.7
0K,All Students,2021-22,7129,1029,6100,85.6,43,25,58.1
0K,All Students,2022-23,8031,989,7042,87.7,48,25,52.1
1,All Students,2018-19,14614,1170,13444,92.0,88,24,27.3
1,All Students,2019-20,7186,615,6571,91.4,65,23,35.4
1,All Students,2020-21,8461,1316,7145,84.4,50,24,48.0
1,All Students,2021-22,6436,914,5522,85.8,42,26,61.9
1,All Students,2022-23,7718,959,6759,87.6,47,26,55.3
2,All Students,2018-19,16034,1031,15003,93.6,94,17,18.1
2,All Students,2019-20,8330,562,7768,93.3,74,18,24.3
2,All Students,2020-21,10239,1393,8846,86.4,61,28,45.9
2,All Students,2021-22,7951,843,7108,89.4,50,18,36.0
2,All Students,2022-23,6705,715,5990,89.3,43,17,39.5
3,All Students,2018-19,15618,876,14742,94.4,94,16,17.0
3,All Students,2019-20,9632,549,9083,94.3,86,14,16.3
3,All Students,2020-21,12408,1328,11080,89.3,72,29,40.3
3,All Students,2021-22,8539,895,7644,89.5,51,22,43.1
3,All Students,2022-23,7967,599,7368,92.5,50,13,26.0
4,All Students,2018-19,13925,811,13114,94.2,81,13,16.0
4,All Students,2019-20,10036,507,9529,94.9,92,11,12.0
4,All Students,2020-21,14287,1430,12857,90.0,83,29,34.9
4,All Students,2021-22,12138,1315,10823,89.2,71,34,47.9
4,All Students,2022-23,8811,768,8043,91.3,53,13,24.5
5,All Students,2018-19,10493,527,9966,95.0,62,9,14.5
5,All Students,2019-20,8814,536,8278,93.9,77,13,16.9
5,All Students,2020-21,14104,1499,12605,89.4,83,23,27.7
5,All Students,2021-22,13151,1476,11675,88.8,79,36,45.6
5,All Students,2022-23,12198,1130,11068,90.7,72,30,41.7
All Grades,All Students,2018-19,63293,3687,59606,94.2,370,54,14.6
All Grades,All Students,2019-20,39838,2367,37471,94.1,358,60,16.8
All Grades,All Students,2020-21,55527,4182,51345,92.5,325,72,22.2
All Grades,All Students,2021-22,49593,4711,44882,90.5,295,109,36.9
All Grades,All Students,2022-23,41338,3399,37939,91.8,244,65,26.6
0K,All Students,2018-19,3082,333,2749,89.2,19,7,36.8
0K,All Students,2019-20,2833,253,2580,91.1,27,9,33.3
0K,All Students,2020-21,3205,38,3167,98.8,20,0,0.0
0K,All Students,2021-22,2023,193,1830,90.5,13,5,38.5
0K,All Students,2022-23,1104,71,1033,93.6,7,1,14.3
1,All Students,2018-19,4258,272,3986,93.6,24,4,16.7
1,All Students,2019-20,2056,212,1844,89.7,18,6,33.3
1,All Students,2020-21,4167,56,4111,98.7,25,1,4.0
1,All Students,2021-22,3314,491,2823,85.2,20,11,55.0
1,All Students,2022-23,2082,201,1881,90.3,12,3,25.0
2,All Students,2018-19,7099,437,6662,93.8,41,6,14.6
2,All Students,2019-20,2687,183,2504,93.2,25,6,24.0
2,All Students,2020-21,4025,433,3592,89.2,23,7,30.4
2,All Students,2021-22,4389,476,3913,89.2,26,12,46.2
2,All Students,2022-23,3282,274,3008,91.7,20,5,25.0
3,All Students,2018-19,6888,388,6500,94.4,40,7,17.5
3,All Students,2019-20,5139,304,4835,94.1,47,8,17.0
3,All Students,2020-21,3106,188,2918,93.9,19,4,21.1
3,All Students,2021-22,4412,441,3971,90.0,26,12,46.2
3,All Students,2022-23,4660,427,4233,90.8,28,9,32.1
4,All Students,2018-19,8263,497,7766,94.0,49,6,12.2
4,All Students,2019-20,4297,188,4109,95.6,39,2,5.1
4,All Students,2020-21,8094,338,7756,95.8,47,8,17.0
4,All Students,2021-22,3879,410,3469,89.4,23,10,43.5
4,All Students,2022-23,4785,428,4357,91.1,28,9,32.1
5,All Students,2018-19,6797,356,6441,94.8,39,4,10.3
5,All Students,2019-20,4602,273,4329,94.1,40,9,22.5
5,All Students,2020-21,5788,408,5380,93.0,34,5,14.7
5,All Students,2021-22,7467,602,6865,91.9,44,15,34.1
5,All Students,2022-23,4033,281,3752,93.0,23,4,17.4
6,All Students,2018-19,10891,617,10274,94.3,64,9,14.1
6,All Students,2019-20,5939,305,5634,94.9,53,7,13.2
6,All Students,2020-21,8234,517,7717,93.7,48,6,12.5
6,All Students,2021-22,9104,898,8206,90.1,54,17,31.5
6,All Students,2022-23,7112,575,6537,91.9,41,12,29.3
7,All Students,2018-19,9021,349,8672,96.1,53,4,7.5
7,All Students,2019-20,6889,417,6472,93.9,61,9,14.8
7,All Students,2020-21,8897,580,8317,93.5,51,10,19.6
7,All Students,2021-22,6413,476,5937,92.6,39,11,28.2
7,All Students,2022-23,8344,708,7636,91.5,50,13,26.0
8,All Students,2018-19,6994,438,6556,93.7,41,7,17.1
8,All Students,2019-20,5396,232,5164,95.7,48,4,8.3
8,All Students,2020-21,10011,1624,8387,83.8,58,31,53.4
8,All Students,2021-22,8592,724,7868,91.6,50,16,32.0
8,All Students,2022-23,5936,434,5502,92.7,35,9,25.7
All Grades,All Students,2018-19,106779,8262,98517,92.3,646,196,30.3
All Grades,All Students,2019-20,61070,4974,56096,91.9,574,187,32.6
All Grades,All Students,2020-21,80104,10422,69682,87.0,497,231,46.5
All Grades,All Students,2021-22,77807,11484,66323,85.2,489,298,60.9
All Grades,All Students,2022-23,68552,7549,61003,89.0,432,195,45.1
PK in K-12 Schools,All Students,2018-19,5669,718,4951,87.3,38,20,52.6
PK in K-12 Schools,All Students,2019-20,5679,567,5112,90.0,52,26,50.0
PK in K-12 Schools,All Students,2020-21,6763,1321,5442,80.5,46,32,69.6
PK in K-12 Schools,All Students,2021-22,9464,1699,7765,82.0,68,51,75.0
PK in K-12 Schools,All Students,2022-23,10598,1542,9056,85.5,69,43,62.3
0K,All Students,2018-19,13566,1279,12287,90.6,83,33,39.8
0K,All Students,2019-20,6804,730,6074,89.3,66,29,43.9
0K,All Students,2020-21,10295,1566,8729,84.8,65,42,64.6
0K,All Students,2021-22,7447,1537,5910,79.4,49,37,75.5
0K,All Students,2022-23,6701,911,5790,86.4,45,28,62.2
1,All Students,2018-19,16147,1089,15058,93.3,99,29,29.3
1,All Students,2019-20,9499,831,8668,91.3,89,32,36.0
1,All Students,2020-21,9971,1236,8735,87.6,62,28,45.2
1,All Students,2021-22,12219,1814,10405,85.2,78,54,69.2
1,All Students,2022-23,8163,1066,7097,86.9,54,29,53.7
2,All Students,2018-19,17332,1369,15963,92.1,105,29,27.6
2,All Students,2019-20,10154,684,9470,93.3,93,24,25.8
2,All Students,2020-21,13660,2060,11600,84.9,85,39,45.9
2,All Students,2021-22,9954,1425,8529,85.7,61,32,52.5
2,All Students,2022-23,12465,1215,11250,90.3,77,30,39.0
3,All Students,2018-19,15529,1237,14292,92.0,92,27,29.3
3,All Students,2019-20,9267,620,8647,93.3,87,23,26.4
3,All Students,2020-21,14215,1354,12861,90.5,85,31,36.5
3,All Students,2021-22,12815,1930,10885,84.9,75,48,64.0
3,All Students,2022-23,8455,818,7637,90.3,52,16,30.8
4,All Students,2018-19,18729,1229,17500,93.4,112,28,25.0
4,All Students,2019-20,9367,863,8504,90.8,89,33,37.1
4,All Students,2020-21,12890,1465,11425,88.6,79,29,36.7
4,All Students,2021-22,13633,1468,12165,89.2,85,36,42.4
4,All Students,2022-23,11907,1132,10775,90.5,72,30,41.7
5,All Students,2018-19,19807,1341,18466,93.2,117,30,25.6
5,All Students,2019-20,10300,679,9621,93.4,98,20,20.4
5,All Students,2020-21,12310,1420,10890,88.5,75,30,40.0
5,All Students,2021-22,12275,1611,10664,86.9,73,40,54.8
5,All Students,2022-23,10263,865,9398,91.6,63,19,30.2
All Grades,All Students,2018-19,84575,5367,79208,93.7,500,93,18.6
All Grades,All Students,2019-20,52526,3536,48990,93.3,480,116,24.2
All Grades,All Students,2020-21,72829,6843,65986,90.6,439,137,31.2
All Grades,All Students,2021-22,64236,7880,56356,87.7,394,204,51.8
All Grades,All Students,2022-23,63305,7091,56214,88.8,396,184,46.5
PK in K-12 Schools,All Students,2018-19,6248,s,s,s,s,s,s
PK in K-12 Schools,All Students,2019-20,7267,753,6514,89.6,68,37,54.4
PK in K-12 Schools,All Students,2020-21,12500,1227,11273,90.2,82,30,36.6
PK in K-12 Schools,All Students,2021-22,12609,1763,10846,86.0,80,55,68.8
PK in K-12 Schools,All Students,2022-23,15513,2174,13339,86.0,98,59,60.2
0K,All Students,2018-19,10057,682,9375,93.2,60,12,20.0
0K,All Students,2019-20,5368,543,4825,89.9,51,21,41.2
0K,All Students,2020-21,7426,1013,6413,86.4,45,23,51.1
0K,All Students,2021-22,7732,1432,6300,81.5,47,39,83.0
0K,All Students,2022-23,7247,1018,6229,86.0,46,26,56.5
1,All Students,2018-19,10986,715,10271,93.5,66,14,21.2
1,All Students,2019-20,6749,460,6289,93.2,62,14,22.6
1,All Students,2020-21,8342,1256,7086,84.9,50,26,52.0
1,All Students,2021-22,6599,841,5758,87.3,39,25,64.1
1,All Students,2022-23,7175,944,6231,86.8,47,28,59.6
2,All Students,2018-19,12164,639,11525,94.7,73,10,13.7
2,All Students,2019-20,6901,473,6428,93.1,63,14,22.2
2,All Students,2020-21,9386,520,8866,94.5,55,10,18.2
2,All Students,2021-22,7709,1047,6662,86.4,48,25,52.1
2,All Students,2022-23,6741,654,6087,90.3,42,18,42.9
3,All Students,2018-19,15207,752,14455,95.1,88,12,13.6
3,All Students,2019-20,7077,302,6775,95.7,65,4,6.2
3,All Students,2020-21,11424,1079,10345,90.6,69,16,23.2
3,All Students,2021-22,9360,931,8429,90.1,57,18,31.6
3,All Students,2022-23,6579,794,5785,87.9,40,20,50.0
4,All Students,2018-19,16751,953,15798,94.3,99,15,15.2
4,All Students,2019-20,9584,504,9080,94.7,85,15,17.6
4,All Students,2020-21,11144,778,10366,93.0,64,12,18.8
4,All Students,2021-22,9741,959,8782,90.2,60,23,38.3
4,All Students,2022-23,9796,803,8993,91.8,62,18,29.0
5,All Students,2018-19,13079,863,12216,93.4,77,16,20.8
5,All Students,2019-20,9580,501,9079,94.8,86,11,12.8
5,All Students,2020-21,12607,970,11637,92.3,74,20,27.0
5,All Students,2021-22,10486,907,9579,91.4,63,19,30.2
5,All Students,2022-23,10254,704,9550,93.1,61,15,24.6
6,All Students,2018-19,83,s,s,s,s,s,s
All Grades,All Students,2018-19,47081,3796,43285,91.9,282,85,30.1
All Grades,All Students,2019-20,30797,2520,28277,91.8,280,83,29.6
All Grades,All Students,2020-21,43291,4708,38583,89.1,249,87,34.9
All Grades,All Students,2021-22,34048,4717,29331,86.1,203,102,50.2
All Grades,All Students,2022-23,27402,3116,24286,88.6,177,65,36.7
5,All Students,2020-21,9,s,s,s,s,s,s
6,All Students,2018-19,17756,1272,16484,92.8,105,26,24.8
6,All Students,2019-20,9119,672,8447,92.6,83,23,27.7
6,All Students,2020-21,12304,s,s,s,s,s,s
6,All Students,2021-22,7494,1044,6450,86.1,44,22,50.0
6,All Students,2022-23,6703,779,5924,88.4,47,16,34.0
7,All Students,2018-19,14441,1143,13298,92.1,88,26,29.5
7,All Students,2019-20,10913,817,10096,92.5,100,26,26.0
7,All Students,2020-21,13726,1178,12548,91.4,79,23,29.1
7,All Students,2021-22,12586,1756,10830,86.0,78,40,51.3
7,All Students,2022-23,8834,1012,7822,88.5,56,20,35.7
8,All Students,2018-19,14884,1381,13503,90.7,89,33,37.1
8,All Students,2019-20,10765,1031,9734,90.4,97,34,35.1
8,All Students,2020-21,17252,2285,14967,86.8,99,41,41.4
8,All Students,2021-22,13968,1917,12051,86.3,81,40,49.4
8,All Students,2022-23,11865,1325,10540,88.8,74,29,39.2
All Grades,All Students,2018-19,75536,6874,68662,90.9,463,175,37.8
All Grades,All Students,2019-20,47367,4460,42907,90.6,443,176,39.7
All Grades,All Students,2020-21,63411,8832,54579,86.1,379,180,47.5
All Grades,All Students,2021-22,59173,9028,50145,84.7,376,233,62.0
All Grades,All Students,2022-23,52410,6181,46229,88.2,330,158,47.9
PK in K-12 Schools,All Students,2018-19,10987,1355,9632,87.7,68,37,54.4
PK in K-12 Schools,All Students,2019-20,11122,1212,9910,89.1,107,47,43.9
PK in K-12 Schools,All Students,2020-21,12008,1359,10649,88.7,73,36,49.3
PK in K-12 Schools,All Students,2021-22,17546,3025,14521,82.8,113,81,71.7
PK in K-12 Schools,All Students,2022-23,14033,2155,11878,84.6,91,56,61.5
0K,All Students,2018-19,9949,1067,8882,89.3,64,34,53.1
0K,All Students,2019-20,6222,742,5480,88.1,57,29,50.9
0K,All Students,2020-21,9422,1785,7637,81.1,59,32,54.2
0K,All Students,2021-22,5668,1039,4629,81.7,38,25,65.8
0K,All Students,2022-23,6752,790,5962,88.3,44,22,50.0
1,All Students,2018-19,10562,823,9739,92.2,64,13,20.3
1,All Students,2019-20,5124,474,4650,90.7,50,20,40.0
1,All Students,2020-21,8738,943,7795,89.2,52,19,36.5
1,All Students,2021-22,8220,1135,7085,86.2,49,28,57.1
1,All Students,2022-23,4972,585,4387,88.2,31,19,61.3
2,All Students,2018-19,9009,875,8134,90.3,57,28,49.1
2,All Students,2019-20,5316,489,4827,90.8,49,18,36.7
2,All Students,2020-21,7787,998,6789,87.2,45,18,40.0
2,All Students,2021-22,7410,993,6417,86.6,49,29,59.2
2,All Students,2022-23,7239,655,6584,91.0,47,16,34.0
3,All Students,2018-19,11671,907,10764,92.2,70,22,31.4
3,All Students,2019-20,5008,436,4572,91.3,47,18,38.3
3,All Students,2020-21,7148,1174,5974,83.6,42,22,52.4
3,All Students,2021-22,7350,1114,6236,84.8,46,24,52.2
3,All Students,2022-23,7415,853,6562,88.5,43,18,41.9
4,All Students,2018-19,12828,1043,11785,91.9,78,24,30.8
4,All Students,2019-20,7970,584,7386,92.7,71,25,35.2
4,All Students,2020-21,7052,s,s,s,s,s,s
4,All Students,2021-22,6023,738,5285,87.7,39,20,51.3
4,All Students,2022-23,5535,592,4943,89.3,34,17,50.0
5,All Students,2018-19,10530,804,9726,92.4,62,17,27.4
5,All Students,2019-20,6605,523,6082,92.1,62,19,30.6
5,All Students,2020-21,11227,1677,9550,85.1,67,34,50.7
5,All Students,2021-22,6956,984,5972,85.9,42,26,61.9
5,All Students,2022-23,6464,551,5913,91.5,40,10,25.0
6,All Students,2020-21,25,s,s,s,s,s,s
All Grades,All Students,2018-19,73276,3368,69908,95.4,421,37,8.8
All Grades,All Students,2019-20,47686,2344,45342,95.1,430,59,13.7
All Grades,All Students,2020-21,72620,4250,68370,94.1,434,90,20.7
All Grades,All Students,2021-22,71720,5056,66664,93.0,422,110,26.1
All Grades,All Students,2022-23,76135,5573,70562,92.7,457,116,25.4
0K,All Students,2018-19,13258,643,12615,95.2,77,7,9.1
0K,All Students,2019-20,7674,475,7199,93.8,70,13,18.6
0K,All Students,2020-21,12743,948,11795,92.6,79,21,26.6
0K,All Students,2021-22,12162,1085,11077,91.1,71,25,35.2
0K,All Students,2022-23,12984,1181,11803,90.9,78,28,35.9
1,All Students,2018-19,13208,630,12578,95.2,75,5,6.7
1,All Students,2019-20,8695,462,8233,94.7,78,11,14.1
1,All Students,2020-21,11201,601,10600,94.6,69,13,18.8
1,All Students,2021-22,13288,1049,12239,92.1,78,29,37.2
1,All Students,2022-23,12160,1147,11013,90.6,74,25,33.8
2,All Students,2018-19,13758,730,13028,94.7,81,6,7.4
2,All Students,2019-20,8404,403,8001,95.2,76,9,11.8
2,All Students,2020-21,12155,751,11404,93.8,73,19,26.0
2,All Students,2021-22,11343,713,10630,93.7,68,11,16.2
2,All Students,2022-23,13097,1044,12053,92.0,80,26,32.5
3,All Students,2018-19,11723,510,11213,95.6,67,10,14.9
3,All Students,2019-20,8725,476,8249,94.5,78,12,15.4
3,All Students,2020-21,13556,630,12926,95.4,78,12,15.4
3,All Students,2021-22,11951,775,11176,93.5,70,16,22.9
3,All Students,2022-23,11907,750,11157,93.7,74,11,14.9
4,All Students,2018-19,11356,407,10949,96.4,65,3,4.6
4,All Students,2019-20,7292,247,7045,96.6,68,8,11.8
4,All Students,2020-21,11862,692,11170,94.2,70,13,18.6
4,All Students,2021-22,13051,753,12298,94.2,76,14,18.4
4,All Students,2022-23,12917,682,12235,94.7,76,10,13.2
5,All Students,2018-19,9973,448,9525,95.5,56,6,10.7
5,All Students,2019-20,6896,281,6615,95.9,60,6,10.0
5,All Students,2020-21,11055,627,10428,94.3,64,12,18.8
5,All Students,2021-22,9925,681,9244,93.1,59,15,25.4
5,All Students,2022-23,13070,769,12301,94.1,75,16,21.3
All Grades,All Students,2018-19,81956,8044,73912,90.2,484,182,37.6
All Grades,All Students,2019-20,51756,4736,47020,90.8,477,167,35.0
All Grades,All Students,2020-21,69312,8842,60470,87.2,406,176,43.3
All Grades,All Students,2021-22,68503,7837,60666,88.6,412,202,49.0
All Grades,All Students,2022-23,63784,7408,56376,88.4,388,182,46.9
PK in K-12 Schools,All Students,2018-19,6020,1010,5010,83.2,37,24,64.9
PK in K-12 Schools,All Students,2019-20,3659,450,3209,87.7,36,16,44.4
PK in K-12 Schools,All Students,2020-21,2963,103,2860,96.5,18,1,5.6
PK in K-12 Schools,All Students,2021-22,6184,s,s,s,s,s,s
PK in K-12 Schools,All Students,2022-23,4758,983,3775,79.3,35,28,80.0
0K,All Students,2018-19,12462,1575,10887,87.4,74,36,48.6
0K,All Students,2019-20,8183,991,7192,87.9,75,40,53.3
0K,All Students,2020-21,11212,2159,9053,80.7,66,41,62.1
0K,All Students,2021-22,8010,1105,6905,86.2,49,30,61.2
0K,All Students,2022-23,9333,1376,7957,85.3,55,37,67.3
1,All Students,2018-19,10594,985,9609,90.7,62,23,37.1
1,All Students,2019-20,8811,762,8049,91.4,82,27,32.9
1,All Students,2020-21,11928,1807,10121,84.9,69,37,53.6
1,All Students,2021-22,11219,1257,9962,88.8,67,35,52.2
1,All Students,2022-23,8184,1082,7102,86.8,51,33,64.7
2,All Students,2018-19,12006,1318,10688,89.0,69,32,46.4
2,All Students,2019-20,6598,562,6036,91.5,60,18,30.0
2,All Students,2020-21,12164,1168,10996,90.4,70,25,35.7
2,All Students,2021-22,9420,1120,8300,88.1,58,31,53.4
2,All Students,2022-23,10515,1004,9511,90.5,63,21,33.3
3,All Students,2018-19,11250,921,10329,91.8,66,20,30.3
3,All Students,2019-20,7515,693,6822,90.8,72,21,29.2
3,All Students,2020-21,9131,820,8311,91.0,55,18,32.7
3,All Students,2021-22,12222,1176,11046,90.4,73,25,34.2
3,All Students,2022-23,8568,915,7653,89.3,51,24,47.1
4,All Students,2018-19,15485,1105,14380,92.9,93,24,25.8
4,All Students,2019-20,7097,616,6481,91.3,65,25,38.5
4,All Students,2020-21,12265,1341,10924,89.1,72,23,31.9
4,All Students,2021-22,10536,1276,9260,87.9,62,35,56.5
4,All Students,2022-23,12862,1114,11748,91.3,77,23,29.9
5,All Students,2018-19,14139,1130,13009,92.0,83,23,27.7
5,All Students,2019-20,9893,662,9231,93.3,87,20,23.0
5,All Students,2020-21,9649,1444,8205,85.0,56,31,55.4
5,All Students,2021-22,10911,1154,9757,89.4,66,28,42.4
5,All Students,2022-23,9564,934,8630,90.2,56,16,28.6
6,All Students,2021-22,1,s,s,s,s,s,s
All Grades,All Students,2018-19,106574,9211,97363,91.4,629,194,30.8
All Grades,All Students,2019-20,68955,5690,63265,91.7,619,169,27.3
All Grades,All Students,2020-21,98148,15320,82828,84.4,587,272,46.3
All Grades,All Students,2021-22,93176,13270,79906,85.8,565,313,55.4
All Grades,All Students,2022-23,85716,10181,75535,88.1,514,247,48.1
PK in K-12 Schools,All Students,2018-19,13332,1600,11732,88.0,83,37,44.6
PK in K-12 Schools,All Students,2019-20,11618,1072,10546,90.8,106,38,35.8
PK in K-12 Schools,All Students,2020-21,14988,3502,11486,76.6,95,63,66.3
PK in K-12 Schools,All Students,2021-22,16650,3294,13356,80.2,105,78,74.3
PK in K-12 Schools,All Students,2022-23,14954,2197,12757,85.3,91,54,59.3
0K,All Students,2018-19,14803,1564,13239,89.4,86,35,40.7
0K,All Students,2019-20,9776,945,8831,90.3,88,31,35.2
0K,All Students,2020-21,15038,2547,12491,83.1,91,40,44.0
0K,All Students,2021-22,11629,1531,10098,86.8,69,36,52.2
0K,All Students,2022-23,9703,1286,8417,86.7,60,33,55.0
1,All Students,2018-19,14799,1079,13720,92.7,88,27,30.7
1,All Students,2019-20,8843,874,7969,90.1,81,31,38.3
1,All Students,2020-21,14676,2778,11898,81.1,87,45,51.7
1,All Students,2021-22,14000,1636,12364,88.3,85,41,48.2
1,All Students,2022-23,11981,1383,10598,88.5,73,35,47.9
2,All Students,2018-19,16225,1236,14989,92.4,93,23,24.7
2,All Students,2019-20,8879,620,8259,93.0,79,15,19.0
2,All Students,2020-21,11254,1755,9499,84.4,66,29,43.9
2,All Students,2021-22,14089,2460,11629,82.5,87,59,67.8
2,All Students,2022-23,12375,1137,11238,90.8,75,33,44.0
3,All Students,2018-19,16701,1285,15416,92.3,99,21,21.2
3,All Students,2019-20,9700,716,8984,92.6,86,19,22.1
3,All Students,2020-21,12307,1446,10861,88.3,73,27,37.0
3,All Students,2021-22,10269,1443,8826,85.9,63,34,54.0
3,All Students,2022-23,12184,1626,10558,86.7,73,35,47.9
4,All Students,2018-19,14926,1199,13727,92.0,90,27,30.0
4,All Students,2019-20,11213,802,10411,92.8,100,20,20.0
4,All Students,2020-21,14529,1631,12898,88.8,84,34,40.5
4,All Students,2021-22,12704,1329,11375,89.5,73,27,37.0
4,All Students,2022-23,10943,1310,9633,88.0,65,30,46.2
5,All Students,2018-19,15788,1248,14540,92.1,90,24,26.7
5,All Students,2019-20,8926,661,8265,92.6,79,15,19.0
5,All Students,2020-21,15355,1660,13695,89.2,91,34,37.4
5,All Students,2021-22,13835,1577,12258,88.6,83,38,45.8
5,All Students,2022-23,13576,1242,12334,90.9,77,27,35.1
All Grades,All Students,2018-19,45160,3063,42097,93.2,272,72,26.5
All Grades,All Students,2019-20,23274,1366,21908,94.1,218,39,17.9
All Grades,All Students,2020-21,32842,1825,31017,94.4,195,34,17.4
All Grades,All Students,2021-22,26863,2963,23900,89.0,166,80,48.2
All Grades,All Students,2022-23,29636,2436,27200,91.8,199,56,28.1
0K,All Students,2018-19,4038,375,3663,90.7,28,12,42.9
0K,All Students,2019-20,1872,161,1711,91.4,20,7,35.0
0K,All Students,2020-21,4472,439,4033,90.2,28,10,35.7
0K,All Students,2021-22,2793,387,2406,86.1,19,13,68.4
0K,All Students,2022-23,4450,532,3918,88.0,31,15,48.4
1,All Students,2018-19,6166,518,5648,91.6,37,14,37.8
1,All Students,2019-20,2504,196,2308,92.2,25,6,24.0
1,All Students,2020-21,2901,287,2614,90.1,20,6,30.0
1,All Students,2021-22,5043,597,4446,88.2,32,14,43.8
1,All Students,2022-23,4549,383,4166,91.6,29,9,31.0
2,All Students,2018-19,6747,388,6359,94.2,40,8,20.0
2,All Students,2019-20,3323,203,3120,93.9,30,7,23.3
2,All Students,2020-21,3730,265,3465,92.9,22,6,27.3
2,All Students,2021-22,3390,373,3017,89.0,20,8,40.0
2,All Students,2022-23,5400,510,4890,90.6,36,15,41.7
3,All Students,2018-19,9996,644,9352,93.6,61,17,27.9
3,All Students,2019-20,4797,225,4572,95.3,45,4,8.9
3,All Students,2020-21,4784,206,4578,95.7,28,4,14.3
3,All Students,2021-22,3195,396,2799,87.6,21,14,66.7
3,All Students,2022-23,4569,295,4274,93.5,30,6,20.0
4,All Students,2018-19,8682,510,8172,94.1,51,8,15.7
4,All Students,2019-20,6116,313,5803,94.9,55,7,12.7
4,All Students,2020-21,7680,257,7423,96.7,44,3,6.8
4,All Students,2021-22,5161,561,4600,89.1,31,19,61.3
4,All Students,2022-23,4617,329,4288,92.9,32,6,18.8
5,All Students,2018-19,9531,628,8903,93.4,55,13,23.6
5,All Students,2019-20,4662,268,4394,94.3,43,8,18.6
5,All Students,2020-21,9275,371,8904,96.0,53,5,9.4
5,All Students,2021-22,7281,649,6632,91.1,43,12,27.9
5,All Students,2022-23,6051,387,5664,93.6,41,5,12.2
All Grades,All Students,2018-19,45043,3626,41417,91.9,275,80,29.1
All Grades,All Students,2019-20,25630,2289,23341,91.1,239,77,32.2
All Grades,All Students,2020-21,39471,6842,32629,82.7,236,135,57.2
All Grades,All Students,2021-22,35647,3300,32347,90.7,220,86,39.1
All Grades,All Students,2022-23,35686,3681,32005,89.7,230,96,41.7
6,All Students,2018-19,11987,s,s,s,s,s,s
6,All Students,2019-20,7887,693,7194,91.2,75,26,34.7
6,All Students,2020-21,10538,1637,8901,84.5,63,36,57.1
6,All Students,2021-22,10071,939,9132,90.7,62,31,50.0
6,All Students,2022-23,8941,927,8014,89.6,59,25,42.4
7,All Students,2018-19,14436,1144,13292,92.1,89,27,30.3
7,All Students,2019-20,8880,769,8111,91.3,82,24,29.3
7,All Students,2020-21,13400,2225,11175,83.4,80,46,57.5
7,All Students,2021-22,11947,1099,10848,90.8,77,25,32.5
7,All Students,2022-23,13258,1377,11881,89.6,83,36,43.4
8,All Students,2018-19,18481,1447,17034,92.2,108,30,27.8
8,All Students,2019-20,8863,827,8036,90.7,82,27,32.9
8,All Students,2020-21,15533,2980,12553,80.8,93,53,57.0
8,All Students,2021-22,13629,1262,12367,90.7,81,30,37.0
8,All Students,2022-23,13487,1377,12110,89.8,88,35,39.8
9,All Students,2018-19,139,s,s,s,s,s,s
All Grades,All Students,2018-19,100356,8055,92301,92.0,595,181,30.4
All Grades,All Students,2019-20,62918,4746,58172,92.5,584,155,26.5
All Grades,All Students,2020-21,85189,12476,72713,85.4,514,252,49.0
All Grades,All Students,2021-22,86476,10341,76135,88.0,528,271,51.3
All Grades,All Students,2022-23,86479,9381,77098,89.2,527,254,48.2
PK in K-12 Schools,All Students,2018-19,11972,1809,10163,84.9,71,47,66.2
PK in K-12 Schools,All Students,2019-20,9134,1044,8090,88.6,92,45,48.9
PK in K-12 Schools,All Students,2020-21,11514,2621,8893,77.2,72,53,73.6
PK in K-12 Schools,All Students,2021-22,16853,2708,14145,83.9,105,72,68.6
PK in K-12 Schools,All Students,2022-23,15289,2289,13000,85.0,97,66,68.0
0K,All Students,2018-19,14119,1522,12597,89.2,84,35,41.7
0K,All Students,2019-20,9057,902,8155,90.0,83,33,39.8
0K,All Students,2020-21,12175,2417,9758,80.1,73,45,61.6
0K,All Students,2021-22,11313,1508,9805,86.7,73,44,60.3
0K,All Students,2022-23,13992,1860,12132,86.7,85,52,61.2
1,All Students,2018-19,13425,1102,12323,91.8,81,24,29.6
1,All Students,2019-20,7446,552,6894,92.6,69,13,18.8
1,All Students,2020-21,13620,1932,11688,85.8,81,41,50.6
1,All Students,2021-22,11919,1491,10428,87.5,73,39,53.4
1,All Students,2022-23,9941,943,8998,90.5,62,26,41.9
2,All Students,2018-19,14151,1116,13035,92.1,83,26,31.3
2,All Students,2019-20,8622,576,8046,93.3,81,18,22.2
2,All Students,2020-21,10548,1119,9429,89.4,65,25,38.5
2,All Students,2021-22,12350,1451,10899,88.3,73,33,45.2
2,All Students,2022-23,11430,1076,10354,90.6,70,25,35.7
3,All Students,2018-19,13639,709,12930,94.8,82,12,14.6
3,All Students,2019-20,8904,551,8353,93.8,80,13,16.3
3,All Students,2020-21,13234,1785,11449,86.5,79,39,49.4
3,All Students,2021-22,10641,903,9738,91.5,64,24,37.5
3,All Students,2022-23,12521,1135,11386,90.9,75,32,42.7
4,All Students,2018-19,18537,1049,17488,94.3,109,22,20.2
4,All Students,2019-20,8326,442,7884,94.7,77,11,14.3
4,All Students,2020-21,12353,1416,10937,88.5,74,27,36.5
4,All Students,2021-22,11279,1094,10185,90.3,70,30,42.9
4,All Students,2022-23,12182,1054,11128,91.3,71,25,35.2
5,All Students,2018-19,14513,748,13765,94.8,85,15,17.6
5,All Students,2019-20,11429,679,10750,94.1,102,22,21.6
5,All Students,2020-21,11745,1186,10559,89.9,70,22,31.4
5,All Students,2021-22,12121,1186,10935,90.2,70,29,41.4
5,All Students,2022-23,11124,1024,10100,90.8,67,28,41.8
All Grades,All Students,2018-19,95350,7045,88305,92.6,586,152,25.9
All Grades,All Students,2019-20,55964,4208,51756,92.5,522,144,27.6
All Grades,All Students,2020-21,76120,7647,68473,90.0,464,151,32.5
All Grades,All Students,2021-22,71378,8443,62935,88.2,446,203,45.5
All Grades,All Students,2022-23,69042,8352,60690,87.9,435,200,46.0
PK in K-12 Schools,All Students,2018-19,8116,744,7372,90.8,53,18,34.0
PK in K-12 Schools,All Students,2019-20,7151,784,6367,89.0,68,28,41.2
PK in K-12 Schools,All Students,2020-21,10305,819,9486,92.1,67,18,26.9
PK in K-12 Schools,All Students,2021-22,12875,1960,10915,84.8,88,57,64.8
PK in K-12 Schools,All Students,2022-23,12902,1946,10956,84.9,81,48,59.3
0K,All Students,2018-19,13243,1275,11968,90.4,81,30,37.0
0K,All Students,2019-20,6321,614,5707,90.3,60,26,43.3
0K,All Students,2020-21,8257,s,s,s,s,s,s
0K,All Students,2021-22,8644,1054,7590,87.8,55,25,45.5
0K,All Students,2022-23,8158,1050,7108,87.1,53,28,52.8
1,All Students,2018-19,14530,1275,13255,91.2,87,26,29.9
1,All Students,2019-20,7598,660,6938,91.3,73,28,38.4
1,All Students,2020-21,8351,980,7371,88.3,52,21,40.4
1,All Students,2021-22,8618,1071,7547,87.6,53,25,47.2
1,All Students,2022-23,9384,1351,8033,85.6,60,29,48.3
2,All Students,2018-19,12762,849,11913,93.3,80,14,17.5
2,All Students,2019-20,8107,617,7490,92.4,74,20,27.0
2,All Students,2020-21,11843,1573,10270,86.7,72,34,47.2
2,All Students,2021-22,8430,s,s,s,s,s,s
2,All Students,2022-23,10058,1327,8731,86.8,63,33,52.4
3,All Students,2018-19,17436,1030,16406,94.1,104,20,19.2
3,All Students,2019-20,7876,504,7372,93.6,74,15,20.3
3,All Students,2020-21,11107,805,10302,92.8,64,13,20.3
3,All Students,2021-22,12705,1318,11387,89.6,79,32,40.5
3,All Students,2022-23,7517,837,6680,88.9,47,21,44.7
4,All Students,2018-19,16698,969,15729,94.2,100,21,21.0
4,All Students,2019-20,11496,576,10920,95.0,101,14,13.9
4,All Students,2020-21,12164,1731,10433,85.8,71,33,46.5
4,All Students,2021-22,10957,927,10030,91.5,66,17,25.8
4,All Students,2022-23,12117,1080,11037,91.1,76,25,32.9
5,All Students,2018-19,12565,903,11662,92.8,81,23,28.4
5,All Students,2019-20,7415,453,6962,93.9,72,13,18.1
5,All Students,2020-21,14083,867,13216,93.8,86,19,22.1
5,All Students,2021-22,9148,994,8154,89.1,55,24,43.6
5,All Students,2022-23,8906,761,8145,91.5,55,16,29.1
6,All Students,2020-21,10,s,s,s,s,s,s
6,All Students,2021-22,1,s,s,s,s,s,s
All Grades,All Students,2018-19,86841,6802,80039,92.2,516,145,28.1
All Grades,All Students,2019-20,58381,4652,53729,92.0,541,154,28.5
All Grades,All Students,2020-21,76459,6675,69784,91.3,463,134,28.9
All Grades,All Students,2021-22,71772,9034,62738,87.4,447,235,52.6
All Grades,All Students,2022-23,76044,9034,67010,88.1,461,221,47.9
PK in K-12 Schools,All Students,2018-19,12556,1301,11255,89.6,76,35,46.1
PK in K-12 Schools,All Students,2019-20,12152,1173,10979,90.3,114,34,29.8
PK in K-12 Schools,All Students,2020-21,13865,896,12969,93.5,88,21,23.9
PK in K-12 Schools,All Students,2021-22,17170,2584,14586,85.0,107,66,61.7
PK in K-12 Schools,All Students,2022-23,18034,2495,15539,86.2,111,63,56.8
0K,All Students,2018-19,10670,1115,9555,89.6,65,24,36.9
0K,All Students,2019-20,8066,683,7383,91.5,77,25,32.5
0K,All Students,2020-21,9094,995,8099,89.1,58,23,39.7
0K,All Students,2021-22,8497,1022,7475,88.0,53,24,45.3
0K,All Students,2022-23,10352,1456,8896,85.9,65,34,52.3
1,All Students,2018-19,11757,976,10781,91.7,72,22,30.6
1,All Students,2019-20,7003,631,6372,91.0,66,23,34.8
1,All Students,2020-21,11498,936,10562,91.9,68,20,29.4
1,All Students,2021-22,8413,1089,7324,87.1,53,27,50.9
1,All Students,2022-23,9566,1088,8478,88.6,59,27,45.8
2,All Students,2018-19,11908,966,10942,91.9,71,18,25.4
2,All Students,2019-20,7251,550,6701,92.4,66,22,33.3
2,All Students,2020-21,9722,1049,8673,89.2,60,20,33.3
2,All Students,2021-22,10469,1244,9225,88.1,65,36,55.4
2,All Students,2022-23,8420,942,7478,88.8,50,25,50.0
3,All Students,2018-19,14586,925,13661,93.7,85,16,18.8
3,All Students,2019-20,6976,590,6386,91.5,64,20,31.3
3,All Students,2020-21,10129,1281,8848,87.4,59,23,39.0
3,All Students,2021-22,8913,912,8001,89.8,56,25,44.6
3,All Students,2022-23,10323,1022,9301,90.1,63,29,46.0
4,All Students,2018-19,12565,772,11793,93.9,73,15,20.5
4,All Students,2019-20,8693,577,8116,93.4,79,17,21.5
4,All Students,2020-21,9944,588,9356,94.1,59,11,18.6
4,All Students,2021-22,9502,965,8537,89.8,59,27,45.8
4,All Students,2022-23,9592,1015,8577,89.4,56,26,46.4
5,All Students,2018-19,12799,747,12052,94.2,74,15,20.3
5,All Students,2019-20,8240,448,7792,94.6,75,13,17.3
5,All Students,2020-21,12199,928,11271,92.4,71,16,22.5
5,All Students,2021-22,8808,1218,7590,86.2,54,30,55.6
5,All Students,2022-23,9757,1016,8741,89.6,57,17,29.8
All Grades,All Students,2018-19,50386,2684,47702,94.7,289,36,12.5
All Grades,All Students,2019-20,33751,1999,31752,94.1,299,45,15.1
All Grades,All Students,2020-21,45599,2789,42810,93.9,265,50,18.9
All Grades,All Students,2021-22,44989,3963,41026,91.2,265,86,32.5
All Grades,All Students,2022-23,40106,3301,36805,91.8,236,70,29.7
0K,All Students,2018-19,10012,669,9343,93.3,57,13,22.8
0K,All Students,2019-20,6149,500,5649,91.9,54,16,29.6
0K,All Students,2020-21,7263,441,6822,93.9,43,8,18.6
0K,All Students,2021-22,7729,1011,6718,86.9,44,25,56.8
0K,All Students,2022-23,6443,590,5853,90.8,38,16,42.1
1,All Students,2018-19,9521,498,9023,94.8,54,6,11.1
1,All Students,2019-20,6654,333,6321,95.0,59,4,6.8
1,All Students,2020-21,8090,592,7498,92.7,47,9,19.1
1,All Students,2021-22,7101,558,6543,92.1,41,11,26.8
1,All Students,2022-23,7340,824,6516,88.8,43,22,51.2
2,All Students,2018-19,9545,414,9131,95.7,55,3,5.5
2,All Students,2019-20,6026,330,5696,94.5,53,6,11.3
2,All Students,2020-21,9038,409,8629,95.5,52,7,13.5
2,All Students,2021-22,7493,520,6973,93.1,45,11,24.4
2,All Students,2022-23,7130,494,6636,93.1,43,6,14.0
3,All Students,2018-19,7189,384,6805,94.7,41,4,9.8
3,All Students,2019-20,5517,334,5183,93.9,50,6,12.0
3,All Students,2020-21,8546,528,8018,93.8,49,7,14.3
3,All Students,2021-22,8615,698,7917,91.9,52,20,38.5
3,All Students,2022-23,6828,470,6358,93.1,40,11,27.5
4,All Students,2018-19,8957,446,8511,95.0,53,7,13.2
4,All Students,2019-20,4485,276,4209,93.8,39,9,23.1
4,All Students,2020-21,8031,430,7601,94.6,47,11,23.4
4,All Students,2021-22,6951,689,6262,90.1,42,14,33.3
4,All Students,2022-23,8142,574,7568,93.0,46,8,17.4
5,All Students,2018-19,5162,273,4889,94.7,29,3,10.3
5,All Students,2019-20,4920,226,4694,95.4,44,4,9.1
5,All Students,2020-21,4631,389,4242,91.6,27,8,29.6
5,All Students,2021-22,7100,487,6613,93.1,41,5,12.2
5,All Students,2022-23,4223,349,3874,91.7,26,7,26.9
All Grades,All Students,2018-19,138529,7151,131378,94.8,795,103,13.0
All Grades,All Students,2019-20,89852,4938,84914,94.5,802,126,15.7
All Grades,All Students,2020-21,129663,6676,122987,94.9,764,115,15.1
All Grades,All Students,2021-22,129869,11799,118070,90.9,757,258,34.1
All Grades,All Students,2022-23,135124,10506,124618,92.2,780,214,27.4
PK in K-12 Schools,All Students,2018-19,3198,301,2897,90.6,18,7,38.9
PK in K-12 Schools,All Students,2019-20,2056,153,1903,92.6,19,4,21.1
PK in K-12 Schools,All Students,2020-21,2948,263,2685,91.1,18,5,27.8
PK in K-12 Schools,All Students,2021-22,3152,492,2660,84.4,18,10,55.6
PK in K-12 Schools,All Students,2022-23,3158,162,2996,94.9,19,4,21.1
0K,All Students,2018-19,16191,921,15270,94.3,94,15,16.0
0K,All Students,2019-20,9540,600,8940,93.7,87,17,19.5
0K,All Students,2020-21,12948,566,12382,95.6,78,8,10.3
0K,All Students,2021-22,15391,1363,14028,91.1,91,32,35.2
0K,All Students,2022-23,16369,1375,14994,91.6,96,30,31.3
1,All Students,2018-19,13196,760,12436,94.2,76,12,15.8
1,All Students,2019-20,9696,580,9116,94.0,87,17,19.5
1,All Students,2020-21,12826,584,12242,95.4,77,13,16.9
1,All Students,2021-22,11766,948,10818,91.9,69,19,27.5
1,All Students,2022-23,14485,1028,13457,92.9,83,18,21.7
2,All Students,2018-19,14136,719,13417,94.9,81,8,9.9
2,All Students,2019-20,9082,503,8579,94.5,80,15,18.8
2,All Students,2020-21,13421,480,12941,96.4,79,9,11.4
2,All Students,2021-22,13370,1300,12070,90.3,77,25,32.5
2,All Students,2022-23,11613,777,10836,93.3,67,17,25.4
3,All Students,2018-19,14513,790,13723,94.6,84,12,14.3
3,All Students,2019-20,9310,506,8804,94.6,85,10,11.8
3,All Students,2020-21,12652,560,12092,95.6,76,9,11.8
3,All Students,2021-22,13765,1037,12728,92.5,82,21,25.6
3,All Students,2022-23,13495,1012,12483,92.5,78,17,21.8
4,All Students,2018-19,14987,633,14354,95.8,85,4,4.7
4,All Students,2019-20,9722,553,9169,94.3,87,14,16.1
4,All Students,2020-21,13388,675,12713,95.0,77,10,13.0
4,All Students,2021-22,13007,1151,11856,91.2,75,27,36.0
4,All Students,2022-23,14840,934,13906,93.7,86,18,20.9
5,All Students,2018-19,13772,671,13101,95.1,79,10,12.7
5,All Students,2019-20,9276,393,8883,95.8,82,9,11.0
5,All Students,2020-21,14253,614,13639,95.7,85,11,12.9
5,All Students,2021-22,13793,942,12851,93.2,79,21,26.6
5,All Students,2022-23,13303,1035,12268,92.2,76,22,28.9
6,All Students,2018-19,16637,728,15909,95.6,94,9,9.6
6,All Students,2019-20,10178,723,9455,92.9,89,21,23.6
6,All Students,2020-21,16209,1054,15155,93.5,94,18,19.1
6,All Students,2021-22,16335,1519,14816,90.7,95,39,41.1
6,All Students,2022-23,15032,1065,13967,92.9,87,21,24.1
7,All Students,2018-19,15241,473,14768,96.9,89,6,6.7
7,All Students,2019-20,10666,379,10287,96.4,95,6,6.3
7,All Students,2020-21,14869,876,13993,94.1,86,14,16.3
7,All Students,2021-22,15423,1189,14234,92.3,91,24,26.4
7,All Students,2022-23,17291,1358,15933,92.1,99,26,26.3
8,All Students,2018-19,16658,1155,15503,93.1,95,20,21.1
8,All Students,2019-20,10326,548,9778,94.7,91,13,14.3
8,All Students,2020-21,16146,1003,15143,93.8,94,18,19.1
8,All Students,2021-22,13867,1858,12009,86.6,80,40,50.0
8,All Students,2022-23,15538,1760,13778,88.7,89,41,46.1
All Grades,All Students,2018-19,132401,10041,122360,92.4,781,225,28.8
All Grades,All Students,2019-20,75326,5767,69559,92.3,686,201,29.3
All Grades,All Students,2020-21,100126,7542,92584,92.5,591,154,26.1
All Grades,All Students,2021-22,87295,10948,76347,87.5,531,262,49.3
All Grades,All Students,2022-23,81788,8381,73407,89.8,501,197,39.3
PK in K-12 Schools,All Students,2018-19,12266,1379,10887,88.8,74,39,52.7
PK in K-12 Schools,All Students,2019-20,7555,877,6678,88.4,73,33,45.2
PK in K-12 Schools,All Students,2020-21,8677,651,8026,92.5,55,15,27.3
PK in K-12 Schools,All Students,2021-22,11397,2117,9280,81.4,73,49,67.1
PK in K-12 Schools,All Students,2022-23,12044,1730,10314,85.6,72,41,56.9
0K,All Students,2018-19,14511,1398,13113,90.4,86,35,40.7
0K,All Students,2019-20,7941,793,7148,90.0,71,29,40.8
0K,All Students,2020-21,13069,1252,11817,90.4,80,30,37.5
0K,All Students,2021-22,11273,1370,9903,87.8,68,39,57.4
0K,All Students,2022-23,10279,1235,9044,88.0,62,26,41.9
1,All Students,2018-19,17900,1450,16450,91.9,107,35,32.7
1,All Students,2019-20,9245,768,8477,91.7,85,27,31.8
1,All Students,2020-21,12823,1410,11413,89.0,74,28,37.8
1,All Students,2021-22,12291,1637,10654,86.7,76,41,53.9
1,All Students,2022-23,11957,1276,10681,89.3,76,34,44.7
2,All Students,2018-19,19262,1235,18027,93.6,111,23,20.7
2,All Students,2019-20,10917,818,10099,92.5,99,32,32.3
2,All Students,2020-21,13226,1008,12218,92.4,77,20,26.0
2,All Students,2021-22,10920,1227,9693,88.8,67,31,46.3
2,All Students,2022-23,12090,1152,10938,90.5,75,30,40.0
3,All Students,2018-19,20545,1573,18972,92.3,123,33,26.8
3,All Students,2019-20,11790,750,11040,93.6,106,25,23.6
3,All Students,2020-21,15793,1145,14648,92.7,93,21,22.6
3,All Students,2021-22,12831,1475,11356,88.5,76,29,38.2
3,All Students,2022-23,11189,987,10202,91.2,68,23,33.8
4,All Students,2018-19,27688,1762,25926,93.6,162,35,21.6
4,All Students,2019-20,13110,879,12231,93.3,122,29,23.8
4,All Students,2020-21,17702,980,16722,94.5,102,21,20.6
4,All Students,2021-22,13196,1502,11694,88.6,80,37,46.3
4,All Students,2022-23,12012,905,11107,92.5,74,22,29.7
5,All Students,2018-19,20229,1244,18985,93.9,118,25,21.2
5,All Students,2019-20,14768,882,13886,94.0,130,26,20.0
5,All Students,2020-21,18836,1096,17740,94.2,110,19,17.3
5,All Students,2021-22,15387,1620,13767,89.5,91,36,39.6
5,All Students,2022-23,12217,1096,11121,91.0,74,21,28.4
All Grades,All Students,2018-19,70062,6162,63900,91.2,417,135,32.4
All Grades,All Students,2019-20,38847,3072,35775,92.1,366,116,31.7
All Grades,All Students,2020-21,54505,6546,47959,88.0,329,129,39.2
All Grades,All Students,2021-22,51379,6909,44470,86.6,320,175,54.7
All Grades,All Students,2022-23,44848,5253,39595,88.3,276,130,47.1
PK in K-12 Schools,All Students,2018-19,8644,867,7777,90.0,54,24,44.4
PK in K-12 Schools,All Students,2019-20,4843,518,4325,89.3,48,24,50.0
PK in K-12 Schools,All Students,2020-21,6887,1204,5683,82.5,45,30,66.7
PK in K-12 Schools,All Students,2021-22,8259,1308,6951,84.2,51,35,68.6
PK in K-12 Schools,All Students,2022-23,5156,704,4452,86.3,34,21,61.8
0K,All Students,2018-19,11011,1250,9761,88.6,66,30,45.5
0K,All Students,2019-20,4723,526,4197,88.9,47,25,53.2
0K,All Students,2020-21,6387,1028,5359,83.9,39,18,46.2
0K,All Students,2021-22,7282,1106,6176,84.8,48,27,56.3
0K,All Students,2022-23,6838,1023,5815,85.0,48,28,58.3
1,All Students,2018-19,9945,806,9139,91.9,63,12,19.0
1,All Students,2019-20,5969,460,5509,92.3,56,14,25.0
1,All Students,2020-21,6901,1247,5654,81.9,44,21,47.7
1,All Students,2021-22,6666,1024,5642,84.6,41,28,68.3
1,All Students,2022-23,6427,729,5698,88.7,40,18,45.0
2,All Students,2018-19,10554,866,9688,91.8,62,19,30.6
2,All Students,2019-20,6137,437,5700,92.9,56,13,23.2
2,All Students,2020-21,8309,650,7659,92.2,50,12,24.0
2,All Students,2021-22,5587,837,4750,85.0,35,21,60.0
2,All Students,2022-23,6652,854,5798,87.2,39,20,51.3
3,All Students,2018-19,8495,663,7832,92.2,48,15,31.3
3,All Students,2019-20,6121,409,5712,93.3,56,13,23.2
3,All Students,2020-21,9220,1121,8099,87.8,53,21,39.6
3,All Students,2021-22,7540,855,6685,88.7,46,22,47.8
3,All Students,2022-23,5366,657,4709,87.8,32,14,43.8
4,All Students,2018-19,9222,769,8453,91.7,55,17,30.9
4,All Students,2019-20,5091,337,4754,93.4,48,15,31.3
4,All Students,2020-21,8502,746,7756,91.2,50,14,28.0
4,All Students,2021-22,8169,908,7261,88.9,51,21,41.2
4,All Students,2022-23,6014,476,5538,92.1,34,8,23.5
5,All Students,2018-19,12191,941,11250,92.3,69,18,26.1
5,All Students,2019-20,5963,385,5578,93.5,55,12,21.8
5,All Students,2020-21,8299,550,7749,93.4,48,13,27.1
5,All Students,2021-22,7876,871,7005,88.9,48,21,43.8
5,All Students,2022-23,8395,810,7585,90.4,49,21,42.9
All Grades,All Students,2018-19,52629,3110,49519,94.1,302,57,18.9
All Grades,All Students,2019-20,36778,2243,34535,93.9,328,75,22.9
All Grades,All Students,2020-21,58630,5743,52887,90.2,342,115,33.6
All Grades,All Students,2021-22,56174,6400,49774,88.6,331,144,43.5
All Grades,All Students,2022-23,55389,4780,50609,91.4,323,93,28.8
6,All Students,2018-19,20570,958,19612,95.3,120,17,14.2
6,All Students,2019-20,13596,825,12771,93.9,121,29,24.0
6,All Students,2020-21,19162,1200,17962,93.7,112,27,24.1
6,All Students,2021-22,19125,1798,17327,90.6,112,41,36.6
6,All Students,2022-23,19633,1610,18023,91.8,116,31,26.7
7,All Students,2018-19,15791,990,14801,93.7,90,20,22.2
7,All Students,2019-20,13350,729,12621,94.5,119,19,16.0
7,All Students,2020-21,19597,2556,17041,87.0,114,49,43.0
7,All Students,2021-22,17674,1867,15807,89.4,105,42,40.0
7,All Students,2022-23,17722,1508,16214,91.5,103,32,31.1
8,All Students,2018-19,16268,1162,15106,92.9,92,20,21.7
8,All Students,2019-20,9832,689,9143,93.0,88,27,30.7
8,All Students,2020-21,19871,1987,17884,90.0,116,39,33.6
8,All Students,2021-22,19375,2735,16640,85.9,114,61,53.5
8,All Students,2022-23,18034,1662,16372,90.8,104,30,28.8
All Grades,All Students,2018-19,75345,4816,70529,93.6,439,91,20.7
All Grades,All Students,2019-20,49482,3501,45981,92.9,441,113,25.6
All Grades,All Students,2020-21,74463,6970,67493,90.6,435,134,30.8
All Grades,All Students,2021-22,72969,7235,65734,90.1,445,168,37.8
All Grades,All Students,2022-23,71886,6387,65499,91.1,435,143,32.9
PK in K-12 Schools,All Students,2018-19,2923,364,2559,87.5,19,11,57.9
PK in K-12 Schools,All Students,2019-20,1946,270,1676,86.1,19,10,52.6
PK in K-12 Schools,All Students,2020-21,2647,251,2396,90.5,18,7,38.9
PK in K-12 Schools,All Students,2021-22,3404,435,2969,87.2,22,11,50.0
PK in K-12 Schools,All Students,2022-23,3208,425,2783,86.8,19,11,57.9
0K,All Students,2018-19,7681,738,6943,90.4,45,16,35.6
0K,All Students,2019-20,4887,490,4397,90.0,44,20,45.5
0K,All Students,2020-21,6645,655,5990,90.1,39,14,35.9
0K,All Students,2021-22,7671,963,6708,87.4,48,26,54.2
0K,All Students,2022-23,7554,943,6611,87.5,47,25,53.2
1,All Students,2018-19,7932,562,7370,92.9,46,10,21.7
1,All Students,2019-20,5382,413,4969,92.3,47,12,25.5
1,All Students,2020-21,6509,585,5924,91.0,37,11,29.7
1,All Students,2021-22,7158,773,6385,89.2,45,22,48.9
1,All Students,2022-23,7544,731,6813,90.3,47,20,42.6
2,All Students,2018-19,7988,506,7482,93.7,45,10,22.2
2,All Students,2019-20,5036,335,4701,93.3,44,9,20.5
2,All Students,2020-21,7210,635,6575,91.2,42,10,23.8
2,All Students,2021-22,5678,533,5145,90.6,36,15,41.7
2,All Students,2022-23,7288,644,6644,91.2,43,15,34.9
3,All Students,2018-19,8559,492,8067,94.3,49,10,20.4
3,All Students,2019-20,4841,379,4462,92.2,43,15,34.9
3,All Students,2020-21,7877,387,7490,95.1,46,7,15.2
3,All Students,2021-22,6782,580,6202,91.4,41,10,24.4
3,All Students,2022-23,5896,513,5383,91.3,34,8,23.5
4,All Students,2018-19,6719,296,6423,95.6,39,1,2.6
4,All Students,2019-20,5460,319,5141,94.2,48,9,18.8
4,All Students,2020-21,7627,339,7288,95.6,44,6,13.6
4,All Students,2021-22,8216,660,7556,92.0,50,13,26.0
4,All Students,2022-23,6337,492,5845,92.2,37,7,18.9
5,All Students,2018-19,6290,333,5957,94.7,38,7,18.4
5,All Students,2019-20,4420,236,4184,94.7,40,8,20.0
5,All Students,2020-21,7702,482,7220,93.7,44,7,15.9
5,All Students,2021-22,6898,659,6239,90.4,43,13,30.2
5,All Students,2022-23,8446,583,7863,93.1,52,13,25.0
6,All Students,2018-19,9293,566,8727,93.9,54,9,16.7
6,All Students,2019-20,5364,348,5016,93.5,48,11,22.9
6,All Students,2020-21,9714,1033,8681,89.4,57,22,38.6
6,All Students,2021-22,9818,948,8870,90.3,58,21,36.2
6,All Students,2022-23,7279,424,6855,94.2,47,11,23.4
7,All Students,2018-19,8173,494,7679,94.0,47,10,21.3
7,All Students,2019-20,6631,380,6251,94.3,59,8,13.6
7,All Students,2020-21,8259,1111,7148,86.5,49,21,42.9
7,All Students,2021-22,9140,751,8389,91.8,54,19,35.2
7,All Students,2022-23,10143,948,9195,90.7,60,19,31.7
8,All Students,2018-19,9787,465,9322,95.2,57,7,12.3
8,All Students,2019-20,5515,331,5184,94.0,49,11,22.4
8,All Students,2020-21,10273,1492,8781,85.5,59,29,49.2
8,All Students,2021-22,8204,933,7271,88.6,48,18,37.5
8,All Students,2022-23,8191,684,7507,91.6,49,14,28.6
All Grades,All Students,2018-19,69208,11613,57595,83.2,437,220,50.3
All Grades,All Students,2019-20,46777,4062,42715,91.3,469,111,23.7
All Grades,All Students,2020-21,72221,9987,62234,86.2,432,165,38.2
All Grades,All Students,2021-22,68708,6323,62385,90.8,429,123,28.7
All Grades,All Students,2022-23,60859,8773,52086,85.6,396,177,44.7
9,All Students,2018-19,18794,2806,15988,85.1,120,45,37.5
9,All Students,2019-20,12918,1055,11863,91.8,129,29,22.5
9,All Students,2020-21,16646,2489,14157,85.0,99,38,38.4
9,All Students,2021-22,16967,1537,15430,90.9,108,27,25.0
9,All Students,2022-23,16500,2165,14335,86.9,109,37,33.9
10,All Students,2018-19,20880,3392,17488,83.8,131,60,45.8
10,All Students,2019-20,13386,1093,12293,91.8,130,34,26.2
10,All Students,2020-21,22379,4302,18077,80.8,137,73,53.3
10,All Students,2021-22,15856,1702,14154,89.3,99,30,30.3
10,All Students,2022-23,18073,3067,15006,83.0,116,57,49.1
11,All Students,2018-19,12621,2350,10271,81.4,84,54,64.3
11,All Students,2019-20,10635,586,10049,94.5,101,15,14.9
11,All Students,2020-21,14622,1314,13308,91.0,86,21,24.4
11,All Students,2021-22,19205,1677,17528,91.3,120,41,34.2
11,All Students,2022-23,10770,1337,9433,87.6,69,24,34.8
12,All Students,2018-19,16913,3065,13848,81.9,102,61,59.8
12,All Students,2019-20,9838,1328,8510,86.5,109,33,30.3
12,All Students,2020-21,18574,1882,16692,89.9,110,33,30.0
12,All Students,2021-22,16680,1407,15273,91.6,102,25,24.5
12,All Students,2022-23,15516,2204,13312,85.8,102,59,57.8
All Grades,All Students,2018-19,53283,2485,50798,95.3,301,28,9.3
All Grades,All Students,2019-20,33244,1438,31806,95.7,292,29,9.9
All Grades,All Students,2020-21,47014,1547,45467,96.7,272,28,10.3
All Grades,All Students,2021-22,43839,3271,40568,92.5,251,63,25.1
All Grades,All Students,2022-23,43929,2859,41070,93.5,254,56,22.0
6,All Students,2018-19,18062,835,17227,95.4,103,9,8.7
6,All Students,2019-20,11280,466,10814,95.9,99,9,9.1
6,All Students,2020-21,15125,319,14806,97.9,87,5,5.7
6,All Students,2021-22,15375,1087,14288,92.9,88,20,22.7
6,All Students,2022-23,15691,1067,14624,93.2,91,18,19.8
7,All Students,2018-19,16911,693,16218,95.9,95,9,9.5
7,All Students,2019-20,11155,402,10753,96.4,99,7,7.1
7,All Students,2020-21,15789,437,15352,97.2,93,9,9.7
7,All Students,2021-22,14253,805,13448,94.4,81,12,14.8
7,All Students,2022-23,14274,821,13453,94.2,82,14,17.1
8,All Students,2018-19,18310,957,17353,94.8,103,10,9.7
8,All Students,2019-20,10809,570,10239,94.7,94,13,13.8
8,All Students,2020-21,16100,791,15309,95.1,92,14,15.2
8,All Students,2021-22,14211,1379,12832,90.3,82,31,37.8
8,All Students,2022-23,13964,971,12993,93.0,81,24,29.6
All Grades,All Students,2018-19,97735,5302,92433,94.6,566,83,14.7
All Grades,All Students,2019-20,60185,3424,56761,94.3,533,67,12.6
All Grades,All Students,2020-21,82331,6627,75704,92.0,475,125,26.3
All Grades,All Students,2021-22,72694,6602,66092,90.9,424,151,35.6
All Grades,All Students,2022-23,59704,5180,54524,91.3,348,112,32.2
0K,All Students,2018-19,7802,518,7284,93.4,47,12,25.5
0K,All Students,2019-20,5687,349,5338,93.9,50,8,16.0
0K,All Students,2020-21,5678,396,5282,93.0,34,7,20.6
0K,All Students,2021-22,4802,461,4341,90.4,29,11,37.9
0K,All Students,2022-23,2745,251,2494,90.9,17,3,17.6
1,All Students,2018-19,10181,489,9692,95.2,59,5,8.5
1,All Students,2019-20,4489,240,4249,94.7,39,3,7.7
1,All Students,2020-21,8406,659,7747,92.2,48,12,25.0
1,All Students,2021-22,5666,480,5186,91.5,32,12,37.5
1,All Students,2022-23,4725,349,4376,92.6,28,8,28.6
2,All Students,2018-19,9706,436,9270,95.5,58,5,8.6
2,All Students,2019-20,6319,371,5948,94.1,57,6,10.5
2,All Students,2020-21,6825,387,6438,94.3,39,6,15.4
2,All Students,2021-22,7783,665,7118,91.5,44,12,27.3
2,All Students,2022-23,5211,531,4680,89.8,30,11,36.7
3,All Students,2018-19,10574,459,10115,95.7,60,4,6.7
3,All Students,2019-20,6270,347,5923,94.5,57,7,12.3
3,All Students,2020-21,9632,545,9087,94.3,55,10,18.2
3,All Students,2021-22,6856,592,6264,91.4,41,15,36.6
3,All Students,2022-23,6812,545,6267,92.0,40,10,25.0
4,All Students,2018-19,11285,661,10624,94.1,66,11,16.7
4,All Students,2019-20,6670,334,6336,95.0,58,5,8.6
4,All Students,2020-21,9079,910,8169,90.0,53,20,37.7
4,All Students,2021-22,10613,965,9648,90.9,62,21,33.9
4,All Students,2022-23,6025,454,5571,92.5,35,10,28.6
5,All Students,2018-19,11342,517,10825,95.4,64,7,10.9
5,All Students,2019-20,7044,388,6656,94.5,63,7,11.1
5,All Students,2020-21,8759,751,8008,91.4,50,12,24.0
5,All Students,2021-22,7872,731,7141,90.7,45,15,33.3
5,All Students,2022-23,9093,775,8318,91.5,52,15,28.8
6,All Students,2018-19,12021,730,11291,93.9,71,15,21.1
6,All Students,2019-20,7839,409,7430,94.8,69,8,11.6
6,All Students,2020-21,10810,1007,9803,90.7,63,21,33.3
6,All Students,2021-22,9425,864,8561,90.8,58,24,41.4
6,All Students,2022-23,7945,682,7263,91.4,46,18,39.1
7,All Students,2018-19,13076,653,12423,95.0,75,11,14.7
7,All Students,2019-20,8018,512,7506,93.6,70,10,14.3
7,All Students,2020-21,11417,807,10610,92.9,66,16,24.2
7,All Students,2021-22,9294,970,8324,89.6,54,23,42.6
7,All Students,2022-23,8229,614,7615,92.5,49,14,28.6
8,All Students,2018-19,11748,839,10909,92.9,66,13,19.7
8,All Students,2019-20,7849,474,7375,94.0,70,13,18.6
8,All Students,2020-21,11725,1165,10560,90.1,67,21,31.3
8,All Students,2021-22,10383,874,9509,91.6,59,18,30.5
8,All Students,2022-23,8919,979,7940,89.0,51,23,45.1
All Grades,All Students,2018-19,103351,5604,97747,94.6,612,91,14.9
All Grades,All Students,2019-20,68549,3588,64961,94.8,625,87,13.9
All Grades,All Students,2020-21,106755,10612,96143,90.1,622,202,32.5
All Grades,All Students,2021-22,100968,12296,88672,87.8,600,263,43.8
All Grades,All Students,2022-23,99403,8891,90512,91.1,599,196,32.7
5,All Students,2020-21,19,s,s,s,s,s,s
6,All Students,2018-19,15940,720,15220,95.5,91,11,12.1
6,All Students,2019-20,9420,359,9061,96.2,89,8,9.0
6,All Students,2020-21,16229,1408,14821,91.3,96,24,25.0
6,All Students,2021-22,13898,1428,12470,89.7,83,35,42.2
6,All Students,2022-23,14456,1367,13089,90.5,85,34,40.0
7,All Students,2018-19,16288,645,15643,96.0,93,7,7.5
7,All Students,2019-20,9747,466,9281,95.2,85,7,8.2
7,All Students,2020-21,13591,s,s,s,s,s,s
7,All Students,2021-22,15397,1367,14030,91.1,90,30,33.3
7,All Students,2022-23,13203,1075,12128,91.9,78,23,29.5
8,All Students,2018-19,14068,632,13436,95.5,80,11,13.8
8,All Students,2019-20,10323,472,9851,95.4,91,6,6.6
8,All Students,2020-21,15253,1471,13782,90.4,88,23,26.1
8,All Students,2021-22,13161,1267,11894,90.4,74,29,39.2
8,All Students,2022-23,14972,967,14005,93.5,86,21,24.4
9,All Students,2018-19,14976,806,14170,94.6,92,13,14.1
9,All Students,2019-20,9330,434,8896,95.3,88,12,13.6
9,All Students,2020-21,15849,1634,14215,89.7,91,35,38.5
9,All Students,2021-22,15318,1962,13356,87.2,94,41,43.6
9,All Students,2022-23,14550,1294,13256,91.1,90,30,33.3
10,All Students,2018-19,15483,1172,14311,92.4,95,22,23.2
10,All Students,2019-20,9923,483,9440,95.1,90,11,12.2
10,All Students,2020-21,15238,1676,13562,89.0,88,33,37.5
10,All Students,2021-22,15690,2677,13013,82.9,95,52,54.7
10,All Students,2022-23,16255,1857,14398,88.6,100,40,40.0
11,All Students,2018-19,14905,1158,13747,92.2,90,20,22.2
11,All Students,2019-20,9921,635,9286,93.6,91,18,19.8
11,All Students,2020-21,15404,1444,13960,90.6,88,24,27.3
11,All Students,2021-22,13453,1747,11706,87.0,80,41,51.3
11,All Students,2022-23,13364,1145,12219,91.4,79,21,26.6
12,All Students,2018-19,11691,471,11220,96.0,71,7,9.9
12,All Students,2019-20,9885,739,9146,92.5,91,25,27.5
12,All Students,2020-21,15166,1265,13901,91.7,89,27,30.3
12,All Students,2021-22,14051,1848,12203,86.8,84,35,41.7
12,All Students,2022-23,12603,1186,11417,90.6,81,27,33.3
All Grades,All Students,2018-19,72505,3180,69325,95.6,422,42,10.0
All Grades,All Students,2019-20,49259,2300,46959,95.3,439,47,10.7
All Grades,All Students,2020-21,71898,5314,66584,92.6,423,101,23.9
All Grades,All Students,2021-22,69750,5958,63792,91.5,409,137,33.5
All Grades,All Students,2022-23,70067,5546,64521,92.1,416,126,30.3
0K,All Students,2018-19,7850,504,7346,93.6,50,7,14.0
0K,All Students,2019-20,5652,365,5287,93.5,50,10,20.0
0K,All Students,2020-21,7998,727,7271,90.9,50,17,34.0
0K,All Students,2021-22,7848,838,7010,89.3,47,19,40.4
0K,All Students,2022-23,7887,786,7101,90.0,48,20,41.7
1,All Students,2018-19,8358,407,7951,95.1,48,4,8.3
1,All Students,2019-20,5241,224,5017,95.7,48,5,10.4
1,All Students,2020-21,8206,602,7604,92.7,50,13,26.0
1,All Students,2021-22,7446,761,6685,89.8,46,23,50.0
1,All Students,2022-23,7874,681,7193,91.4,45,14,31.1
2,All Students,2018-19,7207,353,6854,95.1,43,7,16.3
2,All Students,2019-20,6195,368,5827,94.1,55,8,14.5
2,All Students,2020-21,7240,475,6765,93.4,43,9,20.9
2,All Students,2021-22,7214,744,6470,89.7,42,18,42.9
2,All Students,2022-23,7022,584,6438,91.7,42,14,33.3
3,All Students,2018-19,7652,373,7279,95.1,43,7,16.3
3,All Students,2019-20,5041,250,4791,95.0,44,5,11.4
3,All Students,2020-21,8800,625,8175,92.9,51,11,21.6
3,All Students,2021-22,6837,529,6308,92.3,39,10,25.6
3,All Students,2022-23,6726,556,6170,91.7,40,15,37.5
4,All Students,2018-19,9068,462,8606,94.9,51,8,15.7
4,All Students,2019-20,5131,253,4878,95.1,46,5,10.9
4,All Students,2020-21,7761,296,7465,96.2,46,4,8.7
4,All Students,2021-22,8450,580,7870,93.1,49,10,20.4
4,All Students,2022-23,7747,534,7213,93.1,48,13,27.1
5,All Students,2018-19,5900,187,5713,96.8,35,2,5.7
5,All Students,2019-20,5079,234,4845,95.4,46,6,13.0
5,All Students,2020-21,6826,389,6437,94.3,39,9,23.1
5,All Students,2021-22,7291,578,6713,92.1,43,12,27.9
5,All Students,2022-23,8093,579,7514,92.8,47,13,27.7
6,All Students,2018-19,8988,275,8713,96.9,53,2,3.8
6,All Students,2019-20,5744,251,5493,95.6,51,4,7.8
6,All Students,2020-21,7813,696,7117,91.1,45,11,24.4
6,All Students,2021-22,8166,643,7523,92.1,47,13,27.7
6,All Students,2022-23,8439,571,7868,93.2,50,10,20.0
7,All Students,2018-19,8900,235,8665,97.4,50,0,0.0
7,All Students,2019-20,5351,120,5231,97.8,48,0,0.0
7,All Students,2020-21,9029,885,8144,90.2,52,18,34.6
7,All Students,2021-22,7708,595,7113,92.3,46,15,32.6
7,All Students,2022-23,8331,709,7622,91.5,50,15,30.0
8,All Students,2018-19,8582,384,8198,95.5,49,5,10.2
8,All Students,2019-20,5825,235,5590,96.0,51,4,7.8
8,All Students,2020-21,8225,619,7606,92.5,47,9,19.1
8,All Students,2021-22,8790,690,8100,92.2,50,17,34.0
8,All Students,2022-23,7948,546,7402,93.1,46,12,26.1
All Grades,All Students,2018-19,52260,2226,50034,95.7,299,13,4.3
All Grades,All Students,2019-20,34518,1617,32901,95.3,305,30,9.8
All Grades,All Students,2020-21,50562,2043,48519,96.0,296,26,8.8
All Grades,All Students,2021-22,42977,2105,40872,95.1,247,24,9.7
All Grades,All Students,2022-23,44455,2754,41701,93.8,260,37,14.2
0K,All Students,2018-19,8834,411,8423,95.3,52,3,5.8
0K,All Students,2019-20,5548,307,5241,94.5,49,9,18.4
0K,All Students,2020-21,7800,457,7343,94.1,48,7,14.6
0K,All Students,2021-22,7833,448,7385,94.3,45,8,17.8
0K,All Students,2022-23,8745,698,8047,92.0,52,14,26.9
1,All Students,2018-19,9060,338,8722,96.3,52,0,0.0
1,All Students,2019-20,6005,301,5704,95.0,54,6,11.1
1,All Students,2020-21,8545,445,8100,94.8,50,5,10.0
1,All Students,2021-22,5681,246,5435,95.7,34,2,5.9
1,All Students,2022-23,7638,535,7103,93.0,45,6,13.3
2,All Students,2018-19,9239,429,8810,95.4,52,4,7.7
2,All Students,2019-20,5865,260,5605,95.6,51,4,7.8
2,All Students,2020-21,9099,314,8785,96.5,52,4,7.7
2,All Students,2021-22,7852,424,7428,94.6,45,5,11.1
2,All Students,2022-23,5352,336,5016,93.7,34,6,17.6
3,All Students,2018-19,8909,440,8469,95.1,51,3,5.9
3,All Students,2019-20,6199,309,5890,95.0,55,4,7.3
3,All Students,2020-21,8389,278,8111,96.7,49,4,8.2
3,All Students,2021-22,8319,317,8002,96.2,47,1,2.1
3,All Students,2022-23,8029,555,7474,93.1,46,8,17.4
4,All Students,2018-19,8743,350,8393,96.0,50,2,4.0
4,All Students,2019-20,6020,240,5780,96.0,53,4,7.5
4,All Students,2020-21,8089,338,7751,95.8,47,4,8.5
4,All Students,2021-22,6971,279,6692,96.0,40,2,5.0
4,All Students,2022-23,7788,358,7430,95.4,44,1,2.3
5,All Students,2018-19,7475,258,7217,96.5,42,1,2.4
5,All Students,2019-20,4881,200,4681,95.9,43,3,7.0
5,All Students,2020-21,8640,211,8429,97.6,50,2,4.0
5,All Students,2021-22,6321,391,5930,93.8,36,6,16.7
5,All Students,2022-23,6903,272,6631,96.1,39,2,5.1
All Grades,All Students,2018-19,68996,3106,65890,95.5,401,29,7.2
All Grades,All Students,2019-20,44389,1167,43222,97.4,394,20,5.1
All Grades,All Students,2020-21,55959,799,55160,98.6,329,10,3.0
All Grades,All Students,2021-22,49003,2399,46604,95.1,290,25,8.6
All Grades,All Students,2022-23,42490,3217,39273,92.4,259,64,24.7
6,All Students,2018-19,22071,1093,20978,95.0,129,9,7.0
6,All Students,2019-20,14655,561,14094,96.2,129,7,5.4
6,All Students,2020-21,15485,305,15180,98.0,92,6,6.5
6,All Students,2021-22,14342,760,13582,94.7,83,9,10.8
6,All Students,2022-23,13314,853,12461,93.6,80,18,22.5
7,All Students,2018-19,26409,1379,25030,94.8,151,13,8.6
7,All Students,2019-20,13318,461,12857,96.5,120,11,9.2
7,All Students,2020-21,21455,253,21202,98.8,124,1,0.8
7,All Students,2021-22,14262,688,13574,95.2,83,5,6.0
7,All Students,2022-23,14291,1032,13259,92.8,89,22,24.7
8,All Students,2018-19,20472,s,s,s,s,s,s
8,All Students,2019-20,16416,145,16271,99.1,145,2,1.4
8,All Students,2020-21,19019,241,18778,98.7,113,3,2.7
8,All Students,2021-22,20399,951,19448,95.3,124,11,8.9
8,All Students,2022-23,14885,1332,13553,91.1,90,24,26.7
9,All Students,2018-19,44,s,s,s,s,s,s
All Grades,All Students,2018-19,71840,5527,66313,92.3,425,131,30.8
All Grades,All Students,2019-20,37683,2421,35262,93.6,348,71,20.4
All Grades,All Students,2020-21,50694,4778,45916,90.6,297,100,33.7
All Grades,All Students,2021-22,46871,4864,42007,89.6,286,110,38.5
All Grades,All Students,2022-23,45548,4272,41276,90.6,279,95,34.1
6,All Students,2018-19,18443,s,s,s,s,s,s
6,All Students,2019-20,9470,s,s,s,s,s,s
6,All Students,2020-21,15332,1384,13948,91.0,89,27,30.3
6,All Students,2021-22,14357,1463,12894,89.8,89,32,36.0
6,All Students,2022-23,13713,1033,12680,92.5,84,23,27.4
7,All Students,2018-19,23656,1720,21936,92.7,142,39,27.5
7,All Students,2019-20,12631,790,11841,93.7,117,25,21.4
7,All Students,2020-21,16194,1554,14640,90.4,95,34,35.8
7,All Students,2021-22,15807,1842,13965,88.3,96,43,44.8
7,All Students,2022-23,15178,1285,13893,91.5,93,32,34.4
8,All Students,2018-19,29719,2531,27188,91.5,172,60,34.9
8,All Students,2019-20,15573,1069,14504,93.1,140,28,20.0
8,All Students,2020-21,19168,1840,17328,90.4,113,39,34.5
8,All Students,2021-22,16707,1559,15148,90.7,101,35,34.7
8,All Students,2022-23,16657,1954,14703,88.3,102,40,39.2
9,All Students,2018-19,22,s,s,s,s,s,s
9,All Students,2019-20,9,s,s,s,s,s,s
All Grades,All Students,2018-19,60332,4251,56081,93.0,363,79,21.8
All Grades,All Students,2019-20,36858,2206,34652,94.0,334,70,21.0
All Grades,All Students,2020-21,47430,4307,43123,90.9,280,79,28.2
All Grades,All Students,2021-22,47896,5006,42890,89.5,296,116,39.2
All Grades,All Students,2022-23,41898,3965,37933,90.5,270,102,37.8
6,All Students,2018-19,14301,770,13531,94.6,86,13,15.1
6,All Students,2019-20,9971,510,9461,94.9,92,17,18.5
6,All Students,2020-21,14363,1319,13044,90.8,84,19,22.6
6,All Students,2021-22,13613,1388,12225,89.8,86,34,39.5
6,All Students,2022-23,9102,788,8314,91.3,61,23,37.7
7,All Students,2018-19,21984,1344,20640,93.9,134,24,17.9
7,All Students,2019-20,10767,542,10225,95.0,96,17,17.7
7,All Students,2020-21,16698,1285,15413,92.3,101,25,24.8
7,All Students,2021-22,15395,1654,13741,89.3,92,36,39.1
7,All Students,2022-23,15199,1519,13680,90.0,99,40,40.4
8,All Students,2018-19,24047,2137,21910,91.1,143,42,29.4
8,All Students,2019-20,16120,1154,14966,92.8,146,36,24.7
8,All Students,2020-21,16369,1703,14666,89.6,95,35,36.8
8,All Students,2021-22,18888,1964,16924,89.6,118,46,39.0
8,All Students,2022-23,17597,1658,15939,90.6,110,39,35.5
All Grades,All Students,2018-19,37605,4246,33359,88.7,240,93,38.8
All Grades,All Students,2019-20,19111,1879,17232,90.2,177,59,33.3
All Grades,All Students,2020-21,23356,3284,20072,85.9,138,57,41.3
All Grades,All Students,2021-22,26098,3465,22633,86.7,165,94,57.0
All Grades,All Students,2022-23,25885,2393,23492,90.8,168,63,37.5
6,All Students,2018-19,10248,1137,9111,88.9,69,30,43.5
6,All Students,2019-20,4473,400,4073,91.1,43,12,27.9
6,All Students,2020-21,6761,597,6164,91.2,40,8,20.0
6,All Students,2021-22,11206,1349,9857,88.0,71,39,54.9
6,All Students,2022-23,4830,380,4450,92.1,33,9,27.3
7,All Students,2018-19,12712,1317,11395,89.6,77,26,33.8
7,All Students,2019-20,6613,522,6091,92.1,60,17,28.3
7,All Students,2020-21,6749,965,5784,85.7,39,17,43.6
7,All Students,2021-22,8334,1076,7258,87.1,54,28,51.9
7,All Students,2022-23,11512,1093,10419,90.5,73,25,34.2
8,All Students,2018-19,14645,1792,12853,87.8,94,37,39.4
8,All Students,2019-20,8025,957,7068,88.1,74,30,40.5
8,All Students,2020-21,9846,1722,8124,82.5,59,32,54.2
8,All Students,2021-22,6558,1040,5518,84.1,40,27,67.5
8,All Students,2022-23,9543,920,8623,90.4,62,29,46.8
All Grades,All Students,2018-19,119570,15698,103872,86.9,706,265,37.5
All Grades,All Students,2019-20,76467,7190,69277,90.6,683,120,17.6
All Grades,All Students,2020-21,114565,5594,108971,95.1,663,72,10.9
All Grades,All Students,2021-22,107303,14718,92585,86.3,652,329,50.5
All Grades,All Students,2022-23,104416,12596,91820,87.9,645,264,40.9
6,All Students,2018-19,15744,599,15145,96.2,92,9,9.8
6,All Students,2019-20,9870,406,9464,95.9,88,5,5.7
6,All Students,2020-21,14703,470,14233,96.8,86,8,9.3
6,All Students,2021-22,14301,1710,12591,88.0,85,36,42.4
6,All Students,2022-23,13143,1189,11954,91.0,82,30,36.6
7,All Students,2018-19,15828,1086,14742,93.1,92,23,25.0
7,All Students,2019-20,10612,340,10272,96.8,95,7,7.4
7,All Students,2020-21,15520,655,14865,95.8,89,12,13.5
7,All Students,2021-22,14206,1504,12702,89.4,86,32,37.2
7,All Students,2022-23,14716,1318,13398,91.0,89,30,33.7
8,All Students,2018-19,17617,1355,16262,92.3,102,26,25.5
8,All Students,2019-20,10482,613,9869,94.2,95,16,16.8
8,All Students,2020-21,16670,663,16007,96.0,97,7,7.2
8,All Students,2021-22,15730,2091,13639,86.7,97,50,51.5
8,All Students,2022-23,16478,1770,14708,89.3,98,29,29.6
9,All Students,2018-19,17892,2991,14901,83.3,107,31,29.0
9,All Students,2019-20,10616,879,9737,91.7,100,22,22.0
9,All Students,2020-21,16522,975,15547,94.1,99,14,14.1
9,All Students,2021-22,16528,1673,14855,89.9,102,39,38.2
9,All Students,2022-23,13866,1998,11868,85.6,87,47,54.0
10,All Students,2018-19,19042,3634,15408,80.9,118,64,54.2
10,All Students,2019-20,11028,1331,9697,87.9,100,23,23.0
10,All Students,2020-21,17213,1155,16058,93.3,100,13,13.0
10,All Students,2021-22,15760,2344,13416,85.1,97,55,56.7
10,All Students,2022-23,16082,1799,14283,88.8,100,37,37.0
11,All Students,2018-19,17917,2574,15343,85.6,106,53,50.0
11,All Students,2019-20,12564,2192,10372,82.6,106,31,29.2
11,All Students,2020-21,16158,372,15786,97.7,92,3,3.3
11,All Students,2021-22,14803,2284,12519,84.6,90,48,53.3
11,All Students,2022-23,15921,2512,13409,84.2,100,48,48.0
12,All Students,2018-19,15530,3459,12071,77.7,89,59,66.3
12,All Students,2019-20,11295,1429,9866,87.3,99,16,16.2
12,All Students,2020-21,17779,1304,16475,92.7,100,15,15.0
12,All Students,2021-22,15975,3112,12863,80.5,95,69,72.6
12,All Students,2022-23,14210,2010,12200,85.9,89,43,48.3
All Grades,All Students,2018-19,147697,12365,135332,91.6,878,226,25.7
All Grades,All Students,2019-20,100475,8005,92470,92.0,911,244,26.8
All Grades,All Students,2020-21,167167,19882,147285,88.1,958,364,38.0
All Grades,All Students,2021-22,163113,23698,139415,85.5,964,509,52.8
All Grades,All Students,2022-23,162982,23589,139393,85.5,976,521,53.4
PK in K-12 Schools,All Students,2018-19,5859,552,5307,90.6,35,12,34.3
PK in K-12 Schools,All Students,2019-20,3644,428,3216,88.3,33,17,51.5
PK in K-12 Schools,All Students,2020-21,5532,931,4601,83.2,33,20,60.6
PK in K-12 Schools,All Students,2021-22,5815,1031,4784,82.3,36,28,77.8
PK in K-12 Schools,All Students,2022-23,5909,851,5058,85.6,34,24,70.6
0K,All Students,2018-19,7888,665,7223,91.6,45,17,37.8
0K,All Students,2019-20,4860,489,4371,89.9,45,18,40.0
0K,All Students,2020-21,8111,1128,6983,86.1,46,21,45.7
0K,All Students,2021-22,7454,1044,6410,86.0,43,26,60.5
0K,All Students,2022-23,7337,812,6525,88.9,43,20,46.5
1,All Students,2018-19,6196,507,5689,91.8,37,15,40.5
1,All Students,2019-20,5144,415,4729,91.9,46,16,34.8
1,All Students,2020-21,6704,901,5803,86.6,39,20,51.3
1,All Students,2021-22,7600,1213,6387,84.0,44,32,72.7
1,All Students,2022-23,6682,777,5905,88.4,39,19,48.7
2,All Students,2018-19,6102,288,5814,95.3,37,4,10.8
2,All Students,2019-20,3366,208,3158,93.8,30,6,20.0
2,All Students,2020-21,7849,731,7118,90.7,45,17,37.8
2,All Students,2021-22,6570,864,5706,86.8,38,23,60.5
2,All Students,2022-23,7483,875,6608,88.3,43,25,58.1
3,All Students,2018-19,5882,407,5475,93.1,35,10,28.6
3,All Students,2019-20,4162,252,3910,93.9,37,6,16.2
3,All Students,2020-21,4048,164,3884,95.9,23,3,13.0
3,All Students,2021-22,7017,785,6232,88.8,41,22,53.7
3,All Students,2022-23,7093,813,6280,88.5,43,23,53.5
4,All Students,2018-19,5841,330,5511,94.4,33,4,12.1
4,All Students,2019-20,3916,266,3650,93.2,34,9,26.5
4,All Students,2020-21,5804,175,5629,97.0,33,3,9.1
4,All Students,2021-22,4322,391,3931,91.0,25,7,28.0
4,All Students,2022-23,6580,592,5988,91.0,38,20,52.6
5,All Students,2019-20,3556,193,3363,94.6,32,3,9.4
5,All Students,2020-21,5343,439,4904,91.8,31,10,32.3
5,All Students,2021-22,5538,585,4953,89.4,32,14,43.8
5,All Students,2022-23,4632,481,4151,89.6,27,12,44.4
6,All Students,2018-19,17294,865,16429,95.0,98,12,12.2
6,All Students,2019-20,9936,558,9378,94.4,88,15,17.0
6,All Students,2020-21,17823,1354,16469,92.4,102,21,20.6
6,All Students,2021-22,15382,1742,13640,88.7,90,41,45.6
6,All Students,2022-23,14794,1538,13256,89.6,86,30,34.9
7,All Students,2018-19,15120,874,14246,94.2,87,17,19.5
7,All Students,2019-20,9965,519,9446,94.8,88,14,15.9
7,All Students,2020-21,14268,1346,12922,90.6,81,22,27.2
7,All Students,2021-22,15572,1672,13900,89.3,90,36,40.0
7,All Students,2022-23,12995,1398,11597,89.2,75,32,42.7
8,All Students,2018-19,14986,1090,13896,92.7,87,25,28.7
8,All Students,2019-20,9553,726,8827,92.4,85,23,27.1
8,All Students,2020-21,15493,1252,14241,91.9,88,25,28.4
8,All Students,2021-22,13672,1469,12203,89.3,79,34,43.0
8,All Students,2022-23,15481,1756,13725,88.7,91,41,45.1
9,All Students,2018-19,15147,1302,13845,91.4,92,23,25.0
9,All Students,2019-20,11586,1082,10504,90.7,110,33,30.0
9,All Students,2020-21,23948,3723,20225,84.5,136,68,50.0
9,All Students,2021-22,20063,2866,17197,85.7,121,64,52.9
9,All Students,2022-23,19479,3156,16323,83.8,121,68,56.2
10,All Students,2018-19,16933,1726,15207,89.8,106,26,24.5
10,All Students,2019-20,10675,963,9712,91.0,101,30,29.7
10,All Students,2020-21,18946,3052,15894,83.9,110,51,46.4
10,All Students,2021-22,21618,3245,18373,85.0,132,66,50.0
10,All Students,2022-23,18412,2908,15504,84.2,114,57,50.0
11,All Students,2018-19,15229,1419,13810,90.7,92,22,23.9
11,All Students,2019-20,10608,929,9679,91.2,98,27,27.6
11,All Students,2020-21,15984,2131,13853,86.7,92,37,40.2
11,All Students,2021-22,17434,3547,13887,79.7,104,66,63.5
11,All Students,2022-23,20017,3445,16572,82.8,122,68,55.7
12,All Students,2018-19,15220,2340,12880,84.6,94,39,41.5
12,All Students,2019-20,9504,977,8527,89.7,85,28,32.9
12,All Students,2020-21,17314,2555,14759,85.2,99,46,46.5
12,All Students,2021-22,15056,3244,11812,78.5,89,50,56.2
12,All Students,2022-23,16088,4187,11901,74.0,100,82,82.0
All Grades,All Students,2018-19,23986,1650,22336,93.1,163,37,22.7
All Grades,All Students,2019-20,14223,1065,13158,92.5,137,44,32.1
All Grades,All Students,2020-21,17238,1018,16220,94.1,105,17,16.2
All Grades,All Students,2021-22,13461,1098,12363,91.8,89,33,37.1
All Grades,All Students,2022-23,12486,847,11639,93.2,83,26,31.3
6,All Students,2018-19,4658,502,4156,89.2,36,14,38.9
6,All Students,2019-20,3563,325,3238,90.9,35,14,40.0
6,All Students,2020-21,3946,139,3807,96.5,25,1,4.0
6,All Students,2021-22,2229,280,1949,87.4,16,9,56.3
6,All Students,2022-23,2654,208,2446,92.2,20,8,40.0
7,All Students,2018-19,7625,394,7231,94.8,52,9,17.3
7,All Students,2019-20,4684,332,4352,92.9,47,16,34.0
7,All Students,2020-21,5631,326,5305,94.2,34,5,14.7
7,All Students,2021-22,4954,321,4633,93.5,33,7,21.2
7,All Students,2022-23,3690,318,3372,91.4,26,10,38.5
8,All Students,2018-19,11703,754,10949,93.6,75,14,18.7
8,All Students,2019-20,5976,408,5568,93.2,55,14,25.5
8,All Students,2020-21,7661,553,7108,92.8,46,11,23.9
8,All Students,2021-22,6278,497,5781,92.1,40,17,42.5
8,All Students,2022-23,6142,321,5821,94.8,37,8,21.6
All Grades,All Students,2018-19,102882,6941,95941,93.3,597,127,21.3
All Grades,All Students,2019-20,66719,4327,62392,93.5,586,121,20.6
All Grades,All Students,2020-21,94674,8352,86322,91.2,563,154,27.4
All Grades,All Students,2021-22,90564,11199,79365,87.6,521,255,48.9
All Grades,All Students,2022-23,88543,8643,79900,90.2,514,206,40.1
PK in K-12 Schools,All Students,2018-19,9231,822,8409,91.1,55,20,36.4
PK in K-12 Schools,All Students,2019-20,6088,556,5532,90.9,55,23,41.8
PK in K-12 Schools,All Students,2020-21,7842,894,6948,88.6,48,17,35.4
PK in K-12 Schools,All Students,2021-22,9219,1401,7818,84.8,53,27,50.9
PK in K-12 Schools,All Students,2022-23,8831,1163,7668,86.8,51,27,52.9
0K,All Students,2018-19,9645,772,8873,92.0,58,15,25.9
0K,All Students,2019-20,5646,482,5164,91.5,50,14,28.0
0K,All Students,2020-21,7416,421,6995,94.3,46,8,17.4
0K,All Students,2021-22,7250,1001,6249,86.2,42,29,69.0
0K,All Students,2022-23,9018,975,8043,89.2,51,24,47.1
1,All Students,2018-19,9763,823,8940,91.6,57,16,28.1
1,All Students,2019-20,6282,417,5865,93.4,56,10,17.9
1,All Students,2020-21,8679,892,7787,89.7,51,11,21.6
1,All Students,2021-22,7263,807,6456,88.9,41,12,29.3
1,All Students,2022-23,7513,738,6775,90.2,46,19,41.3
2,All Students,2018-19,10258,689,9569,93.3,60,13,21.7
2,All Students,2019-20,6920,515,6405,92.6,60,15,25.0
2,All Students,2020-21,9037,813,8224,91.0,53,17,32.1
2,All Students,2021-22,8566,1039,7527,87.9,51,24,47.1
2,All Students,2022-23,7874,669,7205,91.5,46,17,37.0
3,All Students,2018-19,10201,540,9661,94.7,58,7,12.1
3,All Students,2019-20,7322,420,6902,94.3,64,12,18.8
3,All Students,2020-21,10395,766,9629,92.6,63,12,19.0
3,All Students,2021-22,8693,888,7805,89.8,49,19,38.8
3,All Students,2022-23,8023,736,7287,90.8,46,16,34.8
4,All Students,2018-19,11291,752,10539,93.3,64,12,18.8
4,All Students,2019-20,7136,401,6735,94.4,62,7,11.3
4,All Students,2020-21,10107,645,9462,93.6,61,12,19.7
4,All Students,2021-22,9588,1008,8580,89.5,55,28,50.9
4,All Students,2022-23,9243,906,8337,90.2,55,23,41.8
5,All Students,2018-19,10965,674,10291,93.9,64,14,21.9
5,All Students,2019-20,6670,379,6291,94.3,58,7,12.1
5,All Students,2020-21,9513,1012,8501,89.4,57,24,42.1
5,All Students,2021-22,10000,1256,8744,87.4,57,30,52.6
5,All Students,2022-23,9136,807,8329,91.2,52,14,26.9
6,All Students,2018-19,10575,600,9975,94.3,63,9,14.3
6,All Students,2019-20,7364,416,6948,94.4,64,11,17.2
6,All Students,2020-21,11098,948,10150,91.5,65,21,32.3
6,All Students,2021-22,9566,1150,8416,88.0,56,26,46.4
6,All Students,2022-23,9435,863,8572,90.9,56,18,32.1
7,All Students,2018-19,11240,580,10660,94.8,63,11,17.5
7,All Students,2019-20,6273,373,5900,94.1,56,10,17.9
7,All Students,2020-21,11072,1249,9823,88.7,64,22,34.4
7,All Students,2021-22,10467,1288,9179,87.7,61,29,47.5
7,All Students,2022-23,9512,797,8715,91.6,54,20,37.0
8,All Students,2018-19,9713,689,9024,92.9,55,10,18.2
8,All Students,2019-20,7018,368,6650,94.8,61,12,19.7
8,All Students,2020-21,9515,712,8803,92.5,55,10,18.2
8,All Students,2021-22,9952,1361,8591,86.3,56,31,55.4
8,All Students,2022-23,9958,989,8969,90.1,57,28,49.1
All Grades,All Students,2018-19,27202,1809,25393,93.3,164,37,22.6
All Grades,All Students,2019-20,18581,1221,17360,93.4,178,43,24.2
All Grades,All Students,2020-21,37047,4367,32680,88.2,229,78,34.1
All Grades,All Students,2021-22,37987,5538,32449,85.4,236,128,54.2
All Grades,All Students,2022-23,41187,5167,36020,87.5,246,117,47.6
PK in K-12 Schools,All Students,2020-21,5715,672,5043,88.2,37,11,29.7
PK in K-12 Schools,All Students,2021-22,5840,980,4860,83.2,34,22,64.7
PK in K-12 Schools,All Students,2022-23,5802,809,4993,86.1,35,20,57.1
0K,All Students,2018-19,2097,207,1890,90.1,12,7,58.3
0K,All Students,2019-20,3223,276,2947,91.4,34,14,41.2
0K,All Students,2020-21,6854,1060,5794,84.5,44,18,40.9
0K,All Students,2021-22,7490,1334,6156,82.2,50,33,66.0
0K,All Students,2022-23,7340,1136,6204,84.5,43,23,53.5
1,All Students,2018-19,3872,284,3588,92.7,26,3,11.5
1,All Students,2019-20,1828,153,1675,91.6,16,5,31.3
1,All Students,2020-21,5519,849,4670,84.6,35,19,54.3
1,All Students,2021-22,6330,808,5522,87.2,41,18,43.9
1,All Students,2022-23,6939,810,6129,88.3,41,20,48.8
2,All Students,2018-19,3985,253,3732,93.7,27,8,29.6
2,All Students,2019-20,3021,204,2817,93.2,29,5,17.2
2,All Students,2020-21,3588,548,3040,84.7,21,10,47.6
2,All Students,2021-22,5076,646,4430,87.3,31,15,48.4
2,All Students,2022-23,5948,641,5307,89.2,37,11,29.7
3,All Students,2018-19,5796,393,5403,93.2,34,7,20.6
3,All Students,2019-20,3166,179,2987,94.3,31,6,19.4
3,All Students,2020-21,5155,491,4664,90.5,30,9,30.0
3,All Students,2021-22,3056,428,2628,86.0,20,11,55.0
3,All Students,2022-23,6002,726,5276,87.9,35,19,54.3
4,All Students,2018-19,6496,397,6099,93.9,37,7,18.9
4,All Students,2019-20,3658,204,3454,94.4,34,5,14.7
4,All Students,2020-21,5015,406,4609,91.9,31,7,22.6
4,All Students,2021-22,5240,659,4581,87.4,32,14,43.8
4,All Students,2022-23,4146,478,3668,88.5,26,13,50.0
5,All Students,2018-19,4956,275,4681,94.5,28,5,17.9
5,All Students,2019-20,3685,205,3480,94.4,34,8,23.5
5,All Students,2020-21,5201,341,4860,93.4,31,4,12.9
5,All Students,2021-22,4955,683,4272,86.2,28,15,53.6
5,All Students,2022-23,5010,567,4443,88.7,29,11,37.9
All Grades,All Students,2018-19,67883,12319,55564,81.9,450,242,53.8
All Grades,All Students,2019-20,40783,6543,34240,84.0,403,208,51.6
All Grades,All Students,2020-21,60022,11364,48658,81.1,371,190,51.2
All Grades,All Students,2021-22,51331,8483,42848,83.5,353,195,55.2
All Grades,All Students,2022-23,53246,9097,44149,82.9,345,176,51.0
9,All Students,2018-19,15796,1872,13924,88.1,114,41,36.0
9,All Students,2019-20,10895,1464,9431,86.6,111,52,46.8
9,All Students,2020-21,16116,1775,14341,89.0,100,33,33.0
9,All Students,2021-22,14506,1657,12849,88.6,102,40,39.2
9,All Students,2022-23,19916,2889,17027,85.5,130,52,40.0
10,All Students,2018-19,18376,2810,15566,84.7,121,54,44.6
10,All Students,2019-20,9557,1355,8202,85.8,98,44,44.9
10,All Students,2020-21,15134,2532,12602,83.3,89,38,42.7
10,All Students,2021-22,12326,1979,10347,83.9,84,49,58.3
10,All Students,2022-23,11512,2629,8883,77.2,75,47,62.7
11,All Students,2018-19,16109,3104,13005,80.7,105,67,63.8
11,All Students,2019-20,11620,1945,9675,83.3,111,60,54.1
11,All Students,2020-21,15834,2992,12842,81.1,94,48,51.1
11,All Students,2021-22,14411,2713,11698,81.2,96,52,54.2
11,All Students,2022-23,11700,1739,9961,85.1,74,44,59.5
12,All Students,2018-19,17602,4533,13069,74.2,110,80,72.7
12,All Students,2019-20,8711,1779,6932,79.6,83,52,62.7
12,All Students,2020-21,12938,4065,8873,68.6,88,71,80.7
12,All Students,2021-22,10088,2134,7954,78.8,71,54,76.1
12,All Students,2022-23,10118,1840,8278,81.8,66,33,50.0
All Grades,All Students,2018-19,62084,6525,55559,89.5,417,94,22.5
All Grades,All Students,2019-20,38081,4829,33252,87.3,356,87,24.4
All Grades,All Students,2020-21,53456,4468,48988,91.6,331,72,21.8
All Grades,All Students,2021-22,54847,5550,49297,89.9,348,109,31.3
All Grades,All Students,2022-23,55034,9521,45513,82.7,378,201,53.2
9,All Students,2018-19,18794,2355,16439,87.5,131,31,23.7
9,All Students,2019-20,10188,1207,8981,88.2,98,22,22.4
9,All Students,2020-21,9169,371,8798,96.0,57,8,14.0
9,All Students,2021-22,14852,1123,13729,92.4,96,22,22.9
9,All Students,2022-23,16197,2624,13573,83.8,126,67,53.2
10,All Students,2018-19,18175,1956,16219,89.2,124,31,25.0
10,All Students,2019-20,11998,1533,10465,87.2,112,28,25.0
10,All Students,2020-21,13999,917,13082,93.4,90,17,18.9
10,All Students,2021-22,9528,718,8810,92.5,62,16,25.8
10,All Students,2022-23,13387,2327,11060,82.6,93,48,51.6
11,All Students,2018-19,14215,1072,13143,92.5,92,17,18.5
11,All Students,2019-20,7254,660,6594,90.9,70,12,17.1
11,All Students,2020-21,14085,1013,13072,92.8,86,13,15.1
11,All Students,2021-22,14976,1123,13853,92.5,93,19,20.4
11,All Students,2022-23,11366,2031,9335,82.1,76,41,53.9
12,All Students,2018-19,10900,1142,9758,89.5,70,15,21.4
12,All Students,2019-20,8641,1429,7212,83.5,76,25,32.9
12,All Students,2020-21,16203,2167,14036,86.6,98,34,34.7
12,All Students,2021-22,15491,2586,12905,83.3,97,52,53.6
12,All Students,2022-23,14084,2539,11545,82.0,83,45,54.2
All Grades,All Students,2018-19,77248,15339,61909,80.1,511,311,60.9
All Grades,All Students,2019-20,48739,9477,39262,80.6,472,271,57.4
All Grades,All Students,2020-21,72686,20258,52428,72.1,452,275,60.8
All Grades,All Students,2021-22,60015,14142,45873,76.4,401,291,72.6
All Grades,All Students,2022-23,61918,12126,49792,80.4,446,261,58.5
7,All Students,2022-23,1,s,s,s,s,s,s
8,All Students,2019-20,8,s,s,s,s,s,s
9,All Students,2018-19,19591,5094,14497,74.0,140,97,69.3
9,All Students,2019-20,11059,2023,9036,81.7,114,58,50.9
9,All Students,2020-21,19189,6880,12309,64.1,119,84,70.6
9,All Students,2021-22,17810,4733,13077,73.4,125,87,69.6
9,All Students,2022-23,22615,4068,18547,82.0,171,80,46.8
10,All Students,2018-19,20850,4205,16645,79.8,137,85,62.0
10,All Students,2019-20,14798,3412,11386,76.9,143,93,65.0
10,All Students,2020-21,25710,9192,16518,64.2,160,114,71.3
10,All Students,2021-22,17721,4031,13690,77.3,121,89,73.6
10,All Students,2022-23,18556,4099,14457,77.9,134,89,66.4
11,All Students,2018-19,19565,2932,16633,85.0,125,67,53.6
11,All Students,2019-20,12768,2103,10665,83.5,123,70,56.9
11,All Students,2020-21,11515,1110,10405,90.4,71,21,29.6
11,All Students,2021-22,9072,2076,6996,77.1,61,47,77.0
11,All Students,2022-23,9263,s,s,s,s,s,s
12,All Students,2018-19,17242,3108,14134,82.0,109,62,56.9
12,All Students,2019-20,10106,s,s,s,s,s,s
12,All Students,2020-21,16272,3076,13196,81.1,102,56,54.9
12,All Students,2021-22,15412,3302,12110,78.6,94,68,72.3
12,All Students,2022-23,11483,2595,8888,77.4,75,60,80.0
All Grades,All Students,2018-19,68040,7617,60423,88.8,455,128,28.1
All Grades,All Students,2019-20,42979,6083,36896,85.8,435,186,42.8
All Grades,All Students,2020-21,66616,5472,61144,91.8,406,82,20.2
All Grades,All Students,2021-22,64447,9837,54610,84.7,433,203,46.9
All Grades,All Students,2022-23,66624,9501,57123,85.7,472,204,43.2
8,All Students,2021-22,3,s,s,s,s,s,s
8,All Students,2022-23,20,s,s,s,s,s,s
9,All Students,2018-19,19340,2900,16440,85.0,141,51,36.2
9,All Students,2019-20,9783,1425,8358,85.4,104,38,36.5
9,All Students,2020-21,21414,1694,19720,92.1,127,22,17.3
9,All Students,2021-22,22072,3110,18962,85.9,151,61,40.4
9,All Students,2022-23,20074,2660,17414,86.7,174,78,44.8
10,All Students,2018-19,23255,3045,20210,86.9,153,54,35.3
10,All Students,2019-20,13205,2718,10487,79.4,137,72,52.6
10,All Students,2020-21,17330,1923,15407,88.9,106,29,27.4
10,All Students,2021-22,18122,3120,15002,82.8,120,56,46.7
10,All Students,2022-23,19748,2949,16799,85.1,128,46,35.9
11,All Students,2018-19,15102,959,14143,93.6,96,13,13.5
11,All Students,2019-20,10641,1121,9520,89.5,105,41,39.0
11,All Students,2020-21,14807,885,13922,94.0,86,15,17.4
11,All Students,2021-22,12529,1624,10905,87.0,81,41,50.6
11,All Students,2022-23,15329,2156,13173,85.9,100,44,44.0
12,All Students,2018-19,10343,713,9630,93.1,65,10,15.4
12,All Students,2019-20,9350,819,8531,91.2,89,35,39.3
12,All Students,2020-21,13065,970,12095,92.6,87,16,18.4
12,All Students,2021-22,11721,s,s,s,s,s,s
12,All Students,2022-23,11453,s,s,s,s,s,s
All Grades,All Students,2018-19,36634,2015,34619,94.5,216,29,13.4
All Grades,All Students,2019-20,21671,1219,20452,94.4,196,30,15.3
All Grades,All Students,2020-21,31284,1194,30090,96.2,185,17,9.2
All Grades,All Students,2021-22,34490,3287,31203,90.5,201,77,38.3
All Grades,All Students,2022-23,34483,2815,31668,91.8,203,54,26.6
PK in K-12 Schools,All Students,2018-19,3201,239,2962,92.5,18,3,16.7
PK in K-12 Schools,All Students,2019-20,1873,100,1773,94.7,19,4,21.1
PK in K-12 Schools,All Students,2020-21,3093,28,3065,99.1,19,0,0.0
PK in K-12 Schools,All Students,2021-22,3186,372,2814,88.3,18,7,38.9
PK in K-12 Schools,All Students,2022-23,3150,s,s,s,s,s,s
0K,All Students,2018-19,7381,455,6926,93.8,42,5,11.9
0K,All Students,2019-20,3127,213,2914,93.2,28,6,21.4
0K,All Students,2020-21,5834,374,5460,93.6,35,4,11.4
0K,All Students,2021-22,8012,889,7123,88.9,47,23,48.9
0K,All Students,2022-23,5246,563,4683,89.3,31,15,48.4
1,All Students,2018-19,4885,245,4640,95.0,28,3,10.7
1,All Students,2019-20,4291,247,4044,94.2,39,6,15.4
1,All Students,2020-21,4365,77,4288,98.2,25,0,0.0
1,All Students,2021-22,5663,541,5122,90.4,32,11,34.4
1,All Students,2022-23,8226,700,7526,91.5,48,10,20.8
2,All Students,2018-19,6311,324,5987,94.9,39,6,15.4
2,All Students,2019-20,3220,156,3064,95.2,28,3,10.7
2,All Students,2020-21,5218,186,5032,96.4,30,3,10.0
2,All Students,2021-22,4096,390,3706,90.5,25,11,44.0
2,All Students,2022-23,5600,471,5129,91.6,33,8,24.2
3,All Students,2018-19,4798,291,4507,93.9,27,5,18.5
3,All Students,2019-20,4081,243,3838,94.0,37,7,18.9
3,All Students,2020-21,5332,211,5121,96.0,31,2,6.5
3,All Students,2021-22,4779,327,4452,93.2,27,5,18.5
3,All Students,2022-23,3569,215,3354,94.0,21,3,14.3
4,All Students,2018-19,4492,174,4318,96.1,28,2,7.1
4,All Students,2019-20,2697,114,2583,95.8,24,2,8.3
4,All Students,2020-21,4623,237,4386,94.9,28,6,21.4
4,All Students,2021-22,4455,430,4025,90.3,27,10,37.0
4,All Students,2022-23,4762,338,4424,92.9,29,8,27.6
5,All Students,2018-19,5566,287,5279,94.8,34,5,14.7
5,All Students,2019-20,2382,146,2236,93.9,21,2,9.5
5,All Students,2020-21,2800,73,2727,97.4,16,1,6.3
5,All Students,2021-22,4299,338,3961,92.1,25,10,40.0
5,All Students,2022-23,3872,263,3609,93.2,22,5,22.7
7,All Students,2022-23,58,s,s,s,s,s,s
All Grades,All Students,2018-19,41485,1195,40290,97.1,237,14,5.9
All Grades,All Students,2019-20,28351,997,27354,96.5,250,22,8.8
All Grades,All Students,2020-21,44757,1041,43716,97.7,257,20,7.8
All Grades,All Students,2021-22,41688,4052,37636,90.3,238,84,35.3
All Grades,All Students,2022-23,43443,3611,39832,91.7,258,81,31.4
6,All Students,2018-19,15150,424,14726,97.2,86,6,7.0
6,All Students,2019-20,8829,s,s,s,s,s,s
6,All Students,2020-21,17771,461,17310,97.4,102,8,7.8
6,All Students,2021-22,13062,1157,11905,91.1,75,26,34.7
6,All Students,2022-23,14625,1074,13551,92.7,89,28,31.5
7,All Students,2018-19,16276,526,15750,96.8,94,7,7.4
7,All Students,2019-20,9602,347,9255,96.4,84,10,11.9
7,All Students,2020-21,12986,275,12711,97.9,75,6,8.0
7,All Students,2021-22,15924,1623,14301,89.8,91,34,37.4
7,All Students,2022-23,13444,1151,12293,91.4,81,25,30.9
8,All Students,2018-19,10059,245,9814,97.6,57,1,1.8
8,All Students,2019-20,9918,323,9595,96.7,87,6,6.9
8,All Students,2020-21,14000,305,13695,97.8,80,6,7.5
8,All Students,2021-22,12702,1272,11430,90.0,72,24,33.3
8,All Students,2022-23,15374,1386,13988,91.0,88,28,31.8
9,All Students,2019-20,2,s,s,s,s,s,s
All Grades,All Students,2018-19,242633,34130,208503,85.9,1532,640,41.8
All Grades,All Students,2019-20,153251,22977,130274,85.0,1459,618,42.4
All Grades,All Students,2020-21,259313,64672,194641,75.1,1516,789,52.0
All Grades,All Students,2021-22,239819,47769,192050,80.1,1530,847,55.4
All Grades,All Students,2022-23,205257,36025,169232,82.4,1389,652,46.9
9,All Students,2018-19,44846,13070,31776,70.9,306,214,69.9
9,All Students,2019-20,58763,12447,46316,78.8,572,298,52.1
9,All Students,2020-21,102606,37023,65583,63.9,599,394,65.8
9,All Students,2021-22,85518,19408,66110,77.3,548,302,55.1
9,All Students,2022-23,60932,13490,47442,77.9,442,228,51.6
10,All Students,2018-19,68323,7448,60875,89.1,429,143,33.3
10,All Students,2019-20,37551,4101,33450,89.1,361,133,36.8
10,All Students,2020-21,61724,12311,49413,80.1,363,164,45.2
10,All Students,2021-22,61875,12324,49551,80.1,407,223,54.8
10,All Students,2022-23,57958,9242,48716,84.1,394,164,41.6
11,All Students,2018-19,70541,5237,65304,92.6,435,99,22.8
11,All Students,2019-20,32444,3073,29371,90.5,303,88,29.0
11,All Students,2020-21,42262,4865,37397,88.5,247,71,28.7
11,All Students,2021-22,46963,7579,39384,83.9,300,147,49.0
11,All Students,2022-23,44237,5504,38733,87.6,284,115,40.5
12,All Students,2018-19,58923,8375,50548,85.8,362,184,50.8
12,All Students,2019-20,24493,3356,21137,86.3,223,99,44.4
12,All Students,2020-21,52721,10473,42248,80.1,307,160,52.1
12,All Students,2021-22,45463,8458,37005,81.4,275,175,63.6
12,All Students,2022-23,42130,7789,34341,81.5,269,145,53.9
All Grades,All Students,2018-19,86526,7467,79059,91.4,552,122,22.1
All Grades,All Students,2019-20,57256,4727,52529,91.7,549,114,20.8
All Grades,All Students,2020-21,91137,9211,81926,89.9,556,179,32.2
All Grades,All Students,2021-22,90452,11079,79373,87.8,587,217,37.0
All Grades,All Students,2022-23,95736,9667,86069,89.9,611,187,30.6
9,All Students,2018-19,17569,1115,16454,93.7,123,14,11.4
9,All Students,2019-20,10454,567,9887,94.6,111,17,15.3
9,All Students,2020-21,19646,1698,17948,91.4,115,39,33.9
9,All Students,2021-22,20422,1546,18876,92.4,137,34,24.8
9,All Students,2022-23,24895,1374,23521,94.5,164,28,17.1
10,All Students,2018-19,22855,1347,21508,94.1,151,31,20.5
10,All Students,2019-20,15993,1131,14862,92.9,152,24,15.8
10,All Students,2020-21,22420,1825,20595,91.9,136,29,21.3
10,All Students,2021-22,23606,2395,21211,89.9,154,54,35.1
10,All Students,2022-23,23372,2184,21188,90.7,147,36,24.5
11,All Students,2018-19,20978,1624,19354,92.3,128,25,19.5
11,All Students,2019-20,15682,1225,14457,92.2,149,32,21.5
11,All Students,2020-21,25770,2679,23091,89.6,151,49,32.5
11,All Students,2021-22,21852,2832,19020,87.0,143,51,35.7
11,All Students,2022-23,25707,2908,22799,88.7,165,60,36.4
12,All Students,2018-19,25124,3381,21743,86.5,150,52,34.7
12,All Students,2019-20,15127,1804,13323,88.1,137,41,29.9
12,All Students,2020-21,23301,3009,20292,87.1,154,62,40.3
12,All Students,2021-22,24572,4306,20266,82.5,153,78,51.0
12,All Students,2022-23,21762,3201,18561,85.3,135,63,46.7
All Grades,All Students,2018-19,116598,12232,104366,89.5,712,315,44.2
All Grades,All Students,2019-20,71509,6466,65043,91.0,660,243,36.8
All Grades,All Students,2020-21,93901,13250,80651,85.9,560,268,47.9
All Grades,All Students,2021-22,85258,9994,75264,88.3,527,256,48.6
All Grades,All Students,2022-23,83131,8652,74479,89.6,510,215,42.2
PK in K-12 Schools,All Students,2018-19,16561,2445,14116,85.2,102,64,62.7
PK in K-12 Schools,All Students,2019-20,11004,1273,9731,88.4,103,51,49.5
PK in K-12 Schools,All Students,2020-21,12478,2200,10278,82.4,78,46,59.0
PK in K-12 Schools,All Students,2021-22,13437,1804,11633,86.6,85,50,58.8
PK in K-12 Schools,All Students,2022-23,13419,1687,11732,87.4,89,53,59.6
0K,All Students,2018-19,15532,1832,13700,88.2,95,49,51.6
0K,All Students,2019-20,7011,821,6190,88.3,69,32,46.4
0K,All Students,2020-21,8994,1292,7702,85.6,57,24,42.1
0K,All Students,2021-22,11522,1532,9990,86.7,77,38,49.4
0K,All Students,2022-23,11490,1338,10152,88.4,69,34,49.3
1,All Students,2018-19,17077,1703,15374,90.0,104,47,45.2
1,All Students,2019-20,10679,1075,9604,89.9,99,42,42.4
1,All Students,2020-21,10307,1365,8942,86.8,62,29,46.8
1,All Students,2021-22,7905,777,7128,90.2,48,18,37.5
1,All Students,2022-23,11890,1326,10564,88.8,74,32,43.2
2,All Students,2018-19,15957,1498,14459,90.6,95,36,37.9
2,All Students,2019-20,10264,901,9363,91.2,93,34,36.6
2,All Students,2020-21,15873,2758,13115,82.6,93,49,52.7
2,All Students,2021-22,9497,1183,8314,87.5,57,28,49.1
2,All Students,2022-23,6967,682,6285,90.2,45,20,44.4
3,All Students,2018-19,17262,1668,15594,90.3,106,38,35.8
3,All Students,2019-20,9703,693,9010,92.9,87,22,25.3
3,All Students,2020-21,15620,1764,13856,88.7,91,39,42.9
3,All Students,2021-22,14670,1849,12821,87.4,92,49,53.3
3,All Students,2022-23,9659,989,8670,89.8,58,23,39.7
4,All Students,2018-19,18011,1596,16415,91.1,112,44,39.3
4,All Students,2019-20,11709,917,10792,92.2,108,33,30.6
4,All Students,2020-21,14061,1644,12417,88.3,82,37,45.1
4,All Students,2021-22,15236,1509,13727,90.1,92,37,40.2
4,All Students,2022-23,14284,1340,12944,90.6,86,31,36.0
5,All Students,2018-19,16198,1490,14708,90.8,98,37,37.8
5,All Students,2019-20,11139,786,10353,92.9,102,29,28.4
5,All Students,2020-21,16568,2227,14341,86.6,97,44,45.4
5,All Students,2021-22,12991,1340,11651,89.7,76,36,47.4
5,All Students,2022-23,15422,1290,14132,91.6,89,22,24.7
All Grades,All Students,2018-19,129196,13404,115792,89.6,815,331,40.6
All Grades,All Students,2019-20,76452,6733,69719,91.2,703,223,31.7
All Grades,All Students,2020-21,108151,11545,96606,89.3,652,245,37.6
All Grades,All Students,2021-22,101022,10447,90575,89.7,626,256,40.9
All Grades,All Students,2022-23,110517,9689,100828,91.2,703,234,33.3
PK in K-12 Schools,All Students,2018-19,5456,634,4822,88.4,37,18,48.6
PK in K-12 Schools,All Students,2019-20,3685,s,s,s,s,s,s
PK in K-12 Schools,All Students,2020-21,4910,347,4563,92.9,28,4,14.3
PK in K-12 Schools,All Students,2021-22,5515,691,4824,87.5,33,18,54.5
PK in K-12 Schools,All Students,2022-23,5457,793,4664,85.5,36,21,58.3
0K,All Students,2018-19,9795,1351,8444,86.2,63,37,58.7
0K,All Students,2019-20,7036,739,6297,89.5,68,28,41.2
0K,All Students,2020-21,7846,598,7248,92.4,49,12,24.5
0K,All Students,2021-22,6855,783,6072,88.6,44,21,47.7
0K,All Students,2022-23,10020,1203,8817,88.0,68,37,54.4
1,All Students,2018-19,12364,1271,11093,89.7,79,33,41.8
1,All Students,2019-20,6050,655,5395,89.2,58,26,44.8
1,All Students,2020-21,10407,1368,9039,86.9,64,26,40.6
1,All Students,2021-22,7273,786,6487,89.2,47,21,44.7
1,All Students,2022-23,9035,934,8101,89.7,59,26,44.1
2,All Students,2018-19,10546,892,9654,91.5,68,23,33.8
2,All Students,2019-20,7209,602,6607,91.6,66,19,28.8
2,All Students,2020-21,8815,930,7885,89.4,53,21,39.6
2,All Students,2021-22,10489,1195,9294,88.6,62,28,45.2
2,All Students,2022-23,8655,937,7718,89.2,55,21,38.2
3,All Students,2018-19,11885,1295,10590,89.1,77,30,39.0
3,All Students,2019-20,6403,448,5955,93.0,60,13,21.7
3,All Students,2020-21,10319,1205,9114,88.3,64,28,43.8
3,All Students,2021-22,8538,726,7812,91.5,52,19,36.5
3,All Students,2022-23,11040,996,10044,91.0,74,24,32.4
4,All Students,2018-19,13967,1256,12711,91.0,87,30,34.5
4,All Students,2019-20,6708,547,6161,91.8,59,19,32.2
4,All Students,2020-21,10135,1053,9082,89.6,62,23,37.1
4,All Students,2021-22,9154,948,8206,89.6,62,28,45.2
4,All Students,2022-23,10202,810,9392,92.1,66,19,28.8
5,All Students,2018-19,12537,1102,11435,91.2,75,20,26.7
5,All Students,2019-20,8595,665,7930,92.3,77,22,28.6
5,All Students,2020-21,10415,1119,9296,89.3,62,20,32.3
5,All Students,2021-22,9037,710,8327,92.1,57,17,29.8
5,All Students,2022-23,9833,862,8971,91.2,61,22,36.1
6,All Students,2018-19,16676,1578,15098,90.5,103,37,35.9
6,All Students,2019-20,9799,753,9046,92.3,90,23,25.6
6,All Students,2020-21,17204,1659,15545,90.4,103,38,36.9
6,All Students,2021-22,15337,1650,13687,89.2,95,35,36.8
6,All Students,2022-23,15139,1181,13958,92.2,98,27,27.6
7,All Students,2018-19,18737,1974,16763,89.5,123,55,44.7
7,All Students,2019-20,10409,826,9583,92.1,93,25,26.9
7,All Students,2020-21,13986,1818,12168,87.0,82,39,47.6
7,All Students,2021-22,15407,1442,13965,90.6,92,36,39.1
7,All Students,2022-23,15309,994,14315,93.5,91,20,22.0
8,All Students,2018-19,17233,2051,15182,88.1,103,48,46.6
8,All Students,2019-20,10547,1086,9461,89.7,100,33,33.0
8,All Students,2020-21,14114,1448,12666,89.7,85,34,40.0
8,All Students,2021-22,13417,1516,11901,88.7,82,33,40.2
8,All Students,2022-23,15827,979,14848,93.8,95,17,17.9
9,All Students,2019-20,11,s,s,s,s,s,s
All Grades,All Students,2018-19,103507,10419,93088,89.9,635,272,42.8
All Grades,All Students,2019-20,63293,6073,57220,90.4,583,212,36.4
All Grades,All Students,2020-21,77840,11174,66666,85.6,468,232,49.6
All Grades,All Students,2021-22,64206,6682,57524,89.6,393,164,41.7
All Grades,All Students,2022-23,62357,5830,56527,90.7,385,123,31.9
PK in K-12 Schools,All Students,2018-19,6238,990,5248,84.1,39,21,53.8
PK in K-12 Schools,All Students,2019-20,4021,465,3556,88.4,37,17,45.9
PK in K-12 Schools,All Students,2020-21,2739,s,s,s,s,s,s
PK in K-12 Schools,All Students,2021-22,2137,298,1839,86.1,14,8,57.1
PK in K-12 Schools,All Students,2022-23,3164,359,2805,88.7,20,11,55.0
0K,All Students,2018-19,13266,1453,11813,89.0,84,43,51.2
0K,All Students,2019-20,6991,824,6167,88.2,67,29,43.3
0K,All Students,2020-21,9624,1254,8370,87.0,58,29,50.0
0K,All Students,2021-22,8085,974,7111,88.0,53,26,49.1
0K,All Students,2022-23,7123,871,6252,87.8,44,23,52.3
1,All Students,2018-19,16094,1805,14289,88.8,100,49,49.0
1,All Students,2019-20,9786,1070,8716,89.1,93,47,50.5
1,All Students,2020-21,9298,2017,7281,78.3,57,39,68.4
1,All Students,2021-22,9178,995,8183,89.2,55,23,41.8
1,All Students,2022-23,8725,781,7944,91.0,55,16,29.1
2,All Students,2018-19,15189,1326,13863,91.3,93,34,36.6
2,All Students,2019-20,10102,955,9147,90.5,90,34,37.8
2,All Students,2020-21,13566,1946,11620,85.7,81,35,43.2
2,All Students,2021-22,8613,802,7811,90.7,54,22,40.7
2,All Students,2022-23,9830,977,8853,90.1,60,20,33.3
3,All Students,2018-19,18157,1951,16206,89.3,111,53,47.7
3,All Students,2019-20,9091,767,8324,91.6,85,23,27.1
3,All Students,2020-21,14730,1492,13238,89.9,89,33,37.1
3,All Students,2021-22,13146,1306,11840,90.1,80,32,40.0
3,All Students,2022-23,9150,757,8393,91.7,57,17,29.8
4,All Students,2018-19,19370,1624,17746,91.6,118,44,37.3
4,All Students,2019-20,12157,1199,10958,90.1,111,40,36.0
4,All Students,2020-21,11924,1801,10123,84.9,70,35,50.0
4,All Students,2021-22,12515,1255,11260,90.0,76,31,40.8
4,All Students,2022-23,11993,1044,10949,91.3,75,20,26.7
5,All Students,2018-19,15193,1270,13923,91.6,90,28,31.1
5,All Students,2019-20,11145,793,10352,92.9,100,22,22.0
5,All Students,2020-21,15935,2076,13859,87.0,94,48,51.1
5,All Students,2021-22,10532,1052,9480,90.0,61,22,36.1
5,All Students,2022-23,12372,1041,11331,91.6,74,16,21.6
6,All Students,2020-21,24,s,s,s,s,s,s
All Grades,All Students,2018-19,97058,8654,88404,91.1,591,229,38.7
All Grades,All Students,2019-20,61506,5246,56260,91.5,557,181,32.5
All Grades,All Students,2020-21,92073,9796,82277,89.4,544,196,36.0
All Grades,All Students,2021-22,86828,11186,75642,87.1,519,291,56.1
All Grades,All Students,2022-23,78582,7894,70688,90.0,486,194,39.9
2,All Students,2021-22,9376,1258,8118,86.6,62,34,54.8
PK in K-12 Schools,All Students,2018-19,8901,1126,7775,87.3,58,30,51.7
PK in K-12 Schools,All Students,2019-20,5797,828,4969,85.7,52,28,53.8
PK in K-12 Schools,All Students,2020-21,7833,778,7055,90.1,46,17,37.0
PK in K-12 Schools,All Students,2021-22,8716,s,s,s,s,s,s
PK in K-12 Schools,All Students,2022-23,7620,s,s,s,s,s,s
0K,All Students,2018-19,13719,1593,12126,88.4,84,44,52.4
0K,All Students,2019-20,9372,885,8487,90.6,87,40,46.0
0K,All Students,2020-21,13157,1658,11499,87.4,80,38,47.5
0K,All Students,2021-22,14141,2188,11953,84.5,84,56,66.7
0K,All Students,2022-23,10198,1053,9145,89.7,66,25,37.9
1,All Students,2018-19,15239,1308,13931,91.4,91,31,34.1
1,All Students,2019-20,8414,700,7714,91.7,74,22,29.7
1,All Students,2020-21,14025,2250,11775,84.0,85,44,51.8
1,All Students,2021-22,12294,1674,10620,86.4,74,43,58.1
1,All Students,2022-23,12936,1469,11467,88.6,80,40,50.0
2,All Students,2018-19,15750,1404,14346,91.1,95,39,41.1
2,All Students,2019-20,9807,745,9062,92.4,89,28,31.5
2,All Students,2020-21,11650,1112,10538,90.5,69,21,30.4
2,All Students,2021-22,12293,1607,10686,86.9,75,46,61.3
2,All Students,2022-23,11266,1119,10147,90.1,68,25,36.8
3,All Students,2018-19,14333,997,13336,93.0,88,26,29.5
3,All Students,2019-20,10260,907,9353,91.2,94,29,30.9
3,All Students,2020-21,14813,1115,13698,92.5,87,18,20.7
3,All Students,2021-22,12183,1375,10808,88.7,72,34,47.2
3,All Students,2022-23,11233,900,10333,92.0,68,19,27.9
4,All Students,2018-19,12635,1030,11605,91.8,75,28,37.3
4,All Students,2019-20,9810,554,9256,94.4,89,11,12.4
4,All Students,2020-21,15414,1833,13581,88.1,90,37,41.1
4,All Students,2021-22,13235,1422,11813,89.3,76,35,46.1
4,All Students,2022-23,11245,1122,10123,90.0,67,25,37.3
5,All Students,2018-19,16481,1196,15285,92.7,100,31,31.0
5,All Students,2019-20,8046,627,7419,92.2,72,23,31.9
5,All Students,2020-21,15172,1049,14123,93.1,87,21,24.1
5,All Students,2021-22,13799,1549,12250,88.8,82,38,46.3
5,All Students,2022-23,13915,1217,12698,91.3,82,27,32.9
6,All Students,2021-22,167,s,s,s,s,s,s
6,All Students,2022-23,169,s,s,s,s,s,s
All Grades,All Students,2018-19,144705,14264,130441,90.1,882,365,41.4
All Grades,All Students,2019-20,92200,8777,83423,90.5,868,339,39.1
All Grades,All Students,2020-21,137288,23670,113618,82.8,810,402,49.6
All Grades,All Students,2021-22,126666,17295,109371,86.3,802,444,55.4
All Grades,All Students,2022-23,128382,14686,113696,88.6,786,342,43.5
PK in K-12 Schools,All Students,2018-19,10924,1245,9679,88.6,71,35,49.3
PK in K-12 Schools,All Students,2019-20,7257,725,6532,90.0,68,29,42.6
PK in K-12 Schools,All Students,2020-21,8903,2999,5904,66.3,54,40,74.1
PK in K-12 Schools,All Students,2021-22,8855,1766,7089,80.1,61,46,75.4
PK in K-12 Schools,All Students,2022-23,10463,1695,8768,83.8,67,42,62.7
0K,All Students,2018-19,12708,1495,11213,88.2,82,47,57.3
0K,All Students,2019-20,7413,852,6561,88.5,72,38,52.8
0K,All Students,2020-21,10467,2322,8145,77.8,65,45,69.2
0K,All Students,2021-22,10773,1587,9186,85.3,73,47,64.4
0K,All Students,2022-23,9047,1289,7758,85.8,55,33,60.0
1,All Students,2018-19,11505,1311,10194,88.6,76,43,56.6
1,All Students,2019-20,10228,1045,9183,89.8,100,49,49.0
1,All Students,2020-21,12011,2499,9512,79.2,71,37,52.1
1,All Students,2021-22,10603,1526,9077,85.6,70,42,60.0
1,All Students,2022-23,11380,1381,9999,87.9,75,30,40.0
2,All Students,2018-19,12949,1260,11689,90.3,81,27,33.3
2,All Students,2019-20,7221,s,s,s,s,s,s
2,All Students,2020-21,16922,3096,13826,81.7,99,52,52.5
2,All Students,2022-23,10897,1238,9659,88.6,68,30,44.1
3,All Students,2018-19,16127,1575,14552,90.2,94,35,37.2
3,All Students,2019-20,8785,660,8125,92.5,85,22,25.9
3,All Students,2020-21,10338,1358,8980,86.9,61,27,44.3
3,All Students,2021-22,15026,1999,13027,86.7,95,46,48.4
3,All Students,2022-23,10716,1188,9528,88.9,66,29,43.9
4,All Students,2018-19,15504,1226,14278,92.1,94,38,40.4
4,All Students,2019-20,9860,973,8887,90.1,96,39,40.6
4,All Students,2020-21,13472,1496,11976,88.9,79,26,32.9
4,All Students,2021-22,11222,1612,9610,85.6,70,42,60.0
4,All Students,2022-23,15044,1555,13489,89.7,93,38,40.9
5,All Students,2018-19,15777,1383,14394,91.2,92,32,34.8
5,All Students,2019-20,10272,982,9290,90.4,98,42,42.9
5,All Students,2020-21,14509,2097,12412,85.5,86,35,40.7
5,All Students,2021-22,14029,1680,12349,88.0,87,43,49.4
5,All Students,2022-23,11338,1133,10205,90.0,68,28,41.2
6,All Students,2018-19,16154,1413,14741,91.3,97,31,32.0
6,All Students,2019-20,10339,863,9476,91.7,97,28,28.9
6,All Students,2020-21,18460,2852,15608,84.6,107,52,48.6
6,All Students,2021-22,15222,1768,13454,88.4,91,39,42.9
6,All Students,2022-23,16248,1391,14857,91.4,96,33,34.4
7,All Students,2018-19,15862,1662,14200,89.5,95,37,38.9
7,All Students,2019-20,10975,1056,9919,90.4,97,37,38.1
7,All Students,2020-21,16390,2643,13747,83.9,96,51,53.1
7,All Students,2021-22,16876,2327,14549,86.2,104,59,56.7
7,All Students,2022-23,15662,1713,13949,89.1,96,37,38.5
8,All Students,2018-19,17195,1694,15501,90.1,100,40,40.0
8,All Students,2019-20,9848,965,8883,90.2,89,31,34.8
8,All Students,2020-21,15744,2248,13496,85.7,91,36,39.6
8,All Students,2021-22,14684,1772,12912,87.9,89,46,51.7
8,All Students,2022-23,17587,2103,15484,88.0,102,42,41.2
9,All Students,2019-20,2,s,s,s,s,s,s
All Grades,All Students,2018-19,97974,10332,87642,89.5,610,257,42.1
All Grades,All Students,2019-20,60822,5878,54944,90.3,567,216,38.1
All Grades,All Students,2020-21,83619,10869,72750,87.0,510,206,40.4
All Grades,All Students,2021-22,80380,10565,69815,86.9,494,235,47.6
All Grades,All Students,2022-23,73498,8015,65483,89.1,447,169,37.8
PK in K-12 Schools,All Students,2018-19,14544,1995,12549,86.3,92,54,58.7
PK in K-12 Schools,All Students,2019-20,8981,1071,7910,88.1,85,46,54.1
PK in K-12 Schools,All Students,2020-21,11794,2643,9151,77.6,75,47,62.7
PK in K-12 Schools,All Students,2021-22,13568,2222,11346,83.6,87,51,58.6
PK in K-12 Schools,All Students,2022-23,12793,1626,11167,87.3,79,36,45.6
0K,All Students,2018-19,10783,s,s,s,s,s,s
0K,All Students,2019-20,7864,764,7100,90.3,75,29,38.7
0K,All Students,2020-21,11160,1353,9807,87.9,72,31,43.1
0K,All Students,2021-22,9599,1423,8176,85.2,61,33,54.1
0K,All Students,2022-23,8966,1153,7813,87.1,56,28,50.0
1,All Students,2018-19,11233,1191,10042,89.4,73,34,46.6
1,All Students,2019-20,7011,831,6180,88.1,67,31,46.3
1,All Students,2020-21,11706,1732,9974,85.2,72,32,44.4
1,All Students,2021-22,10799,1427,9372,86.8,65,36,55.4
1,All Students,2022-23,8046,953,7093,88.2,51,20,39.2
2,All Students,2018-19,14668,1495,13173,89.8,92,41,44.6
2,All Students,2019-20,7811,658,7153,91.6,73,25,34.2
2,All Students,2020-21,10428,1602,8826,84.6,63,32,50.8
2,All Students,2021-22,11750,1159,10591,90.1,70,26,37.1
2,All Students,2022-23,10365,962,9403,90.7,63,22,34.9
3,All Students,2018-19,15775,1570,14205,90.0,97,38,39.2
3,All Students,2019-20,9193,884,8309,90.4,84,29,34.5
3,All Students,2020-21,11299,648,10651,94.3,68,11,16.2
3,All Students,2021-22,10341,1248,9093,87.9,64,26,40.6
3,All Students,2022-23,11531,1283,10248,88.9,69,26,37.7
4,All Students,2018-19,16690,1419,15271,91.5,101,31,30.7
4,All Students,2019-20,9542,839,8703,91.2,89,27,30.3
4,All Students,2020-21,13781,1759,12022,87.2,81,32,39.5
4,All Students,2021-22,10558,1092,9466,89.7,63,24,38.1
4,All Students,2022-23,11050,1314,9736,88.1,66,25,37.9
5,All Students,2018-19,14111,1235,12876,91.2,85,28,32.9
5,All Students,2019-20,10420,831,9589,92.0,94,29,30.9
5,All Students,2020-21,13451,1132,12319,91.6,79,21,26.6
5,All Students,2021-22,13765,1994,11771,85.5,84,39,46.4
5,All Students,2022-23,10747,724,10023,93.3,63,12,19.0
6,All Students,2018-19,170,s,s,s,s,s,s
All Grades,All Students,2018-19,126019,9978,116041,92.1,763,239,31.3
All Grades,All Students,2019-20,78481,6352,72129,91.9,720,203,28.2
All Grades,All Students,2020-21,107729,12729,95000,88.2,640,198,30.9
All Grades,All Students,2021-22,115801,12893,102908,88.9,716,309,43.2
All Grades,All Students,2022-23,104286,8765,95521,91.6,652,198,30.4
PK in K-12 Schools,All Students,2018-19,9488,1207,8281,87.3,57,32,56.1
PK in K-12 Schools,All Students,2019-20,5621,689,4932,87.7,55,27,49.1
PK in K-12 Schools,All Students,2020-21,5580,s,s,s,s,s,s
PK in K-12 Schools,All Students,2021-22,7587,1001,6586,86.8,51,27,52.9
PK in K-12 Schools,All Students,2022-23,8028,1012,7016,87.4,53,29,54.7
0K,All Students,2018-19,14220,1164,13056,91.8,87,30,34.5
0K,All Students,2019-20,7332,810,6522,89.0,69,26,37.7
0K,All Students,2020-21,8998,1246,7752,86.2,54,19,35.2
0K,All Students,2021-22,8890,876,8014,90.1,57,26,45.6
0K,All Students,2022-23,6807,697,6110,89.8,45,19,42.2
1,All Students,2018-19,12657,921,11736,92.7,81,22,27.2
1,All Students,2019-20,8438,709,7729,91.6,78,22,28.2
1,All Students,2020-21,9297,1000,8297,89.2,56,19,33.9
1,All Students,2021-22,8698,901,7797,89.6,53,20,37.7
1,All Students,2022-23,8757,724,8033,91.7,55,19,34.5
2,All Students,2018-19,11331,792,10539,93.0,68,19,27.9
2,All Students,2019-20,8344,561,7783,93.3,77,14,18.2
2,All Students,2020-21,11064,1718,9346,84.5,66,27,40.9
2,All Students,2021-22,8687,1036,7651,88.1,55,27,49.1
2,All Students,2022-23,8800,826,7974,90.6,53,16,30.2
3,All Students,2018-19,11637,763,10874,93.4,72,18,25.0
3,All Students,2019-20,6194,451,5743,92.7,56,17,30.4
3,All Students,2020-21,11771,1351,10420,88.5,70,20,28.6
3,All Students,2021-22,9004,827,8177,90.8,59,27,45.8
3,All Students,2022-23,7733,752,6981,90.3,51,21,41.2
4,All Students,2018-19,11910,864,11046,92.7,69,18,26.1
4,All Students,2019-20,8151,587,7564,92.8,75,18,24.0
4,All Students,2020-21,8693,946,7747,89.1,52,11,21.2
4,All Students,2021-22,10574,1120,9454,89.4,63,24,38.1
4,All Students,2022-23,8554,643,7911,92.5,55,13,23.6
5,All Students,2018-19,11070,769,10301,93.1,66,17,25.8
5,All Students,2019-20,8108,563,7545,93.1,74,18,24.3
5,All Students,2020-21,11636,1152,10484,90.1,68,19,27.9
5,All Students,2021-22,9118,1056,8062,88.4,53,28,52.8
5,All Students,2022-23,11226,833,10393,92.6,69,18,26.1
6,All Students,2018-19,15971,1238,14733,92.2,93,27,29.0
6,All Students,2019-20,8409,627,7782,92.5,76,18,23.7
6,All Students,2020-21,13440,1063,12377,92.1,81,16,19.8
6,All Students,2021-22,17068,1892,15176,88.9,105,42,40.0
6,All Students,2022-23,12490,1131,11359,90.9,77,25,32.5
7,All Students,2018-19,12626,967,11659,92.3,77,22,28.6
7,All Students,2019-20,9986,836,9150,91.6,91,30,33.0
7,All Students,2020-21,12255,1448,10807,88.2,71,23,32.4
7,All Students,2021-22,16662,1712,14950,89.7,101,33,32.7
7,All Students,2022-23,14769,1113,13656,92.5,91,20,22.0
8,All Students,2018-19,15109,1293,13816,91.4,93,34,36.6
8,All Students,2019-20,7898,519,7379,93.4,69,13,18.8
8,All Students,2020-21,14828,1889,12939,87.3,85,30,35.3
8,All Students,2021-22,19513,2472,17041,87.3,119,55,46.2
8,All Students,2022-23,17122,1034,16088,94.0,103,18,17.5
9,All Students,2020-21,167,s,s,s,s,s,s
All Grades,All Students,2018-19,80609,8048,72561,90.0,490,194,39.6
All Grades,All Students,2019-20,47821,4768,43053,90.0,441,175,39.7
All Grades,All Students,2020-21,61074,8610,52464,85.9,362,177,48.9
All Grades,All Students,2021-22,57151,6373,50778,88.8,364,162,44.5
All Grades,All Students,2022-23,62463,5888,56575,90.6,394,151,38.3
PK in K-12 Schools,All Students,2018-19,16716,2384,14332,85.7,107,62,57.9
PK in K-12 Schools,All Students,2019-20,10787,1509,9278,86.0,101,58,57.4
PK in K-12 Schools,All Students,2020-21,11035,2097,8938,81.0,67,47,70.1
PK in K-12 Schools,All Students,2021-22,9947,1546,8401,84.5,70,42,60.0
PK in K-12 Schools,All Students,2022-23,13501,1794,11707,86.7,92,51,55.4
0K,All Students,2018-19,7262,751,6511,89.7,45,17,37.8
0K,All Students,2019-20,5916,706,5210,88.1,54,27,50.0
0K,All Students,2020-21,8092,1488,6604,81.6,48,26,54.2
0K,All Students,2021-22,8512,1067,7445,87.5,53,28,52.8
0K,All Students,2022-23,7760,787,6973,89.9,48,21,43.8
1,All Students,2018-19,9344,793,8551,91.5,59,21,35.6
1,All Students,2019-20,5153,429,4724,91.7,47,15,31.9
1,All Students,2020-21,8616,1252,7364,85.5,51,23,45.1
1,All Students,2021-22,6779,722,6057,89.3,44,15,34.1
1,All Students,2022-23,9069,847,8222,90.7,58,21,36.2
2,All Students,2018-19,10351,924,9427,91.1,62,19,30.6
2,All Students,2019-20,5943,515,5428,91.3,56,21,37.5
2,All Students,2020-21,8005,1171,6834,85.4,48,24,50.0
2,All Students,2021-22,7580,865,6715,88.6,46,23,50.0
2,All Students,2022-23,7771,653,7118,91.6,46,13,28.3
3,All Students,2018-19,9982,973,9009,90.3,61,25,41.0
3,All Students,2019-20,6187,484,5703,92.2,56,17,30.4
3,All Students,2020-21,8510,957,7553,88.8,50,19,38.0
3,All Students,2021-22,7140,784,6356,89.0,46,22,47.8
3,All Students,2022-23,8571,719,7852,91.6,54,21,38.9
4,All Students,2018-19,13010,997,12013,92.3,76,24,31.6
4,All Students,2019-20,5098,459,4639,91.0,48,15,31.3
4,All Students,2020-21,9119,933,8186,89.8,54,21,38.9
4,All Students,2021-22,7998,643,7355,92.0,50,14,28.0
4,All Students,2022-23,7024,581,6443,91.7,44,15,34.1
5,All Students,2018-19,13944,1226,12718,91.2,80,26,32.5
5,All Students,2019-20,8737,666,8071,92.4,79,22,27.8
5,All Students,2020-21,7697,712,6985,90.7,44,17,38.6
5,All Students,2021-22,9195,746,8449,91.9,55,18,32.7
5,All Students,2022-23,8767,507,8260,94.2,52,9,17.3
All Grades,All Students,2018-19,115404,9863,105541,91.5,692,224,32.4
All Grades,All Students,2019-20,74859,5687,69172,92.4,680,165,24.3
All Grades,All Students,2020-21,104109,9982,94127,90.4,631,229,36.3
All Grades,All Students,2021-22,99032,10953,88079,88.9,617,302,48.9
All Grades,All Students,2022-23,98410,8796,89614,91.1,605,231,38.2
PK in K-12 Schools,All Students,2018-19,14700,1587,13113,89.2,88,39,44.3
PK in K-12 Schools,All Students,2019-20,10192,1045,9147,89.7,102,39,38.2
PK in K-12 Schools,All Students,2020-21,15295,1536,13759,90.0,95,43,45.3
PK in K-12 Schools,All Students,2021-22,15497,1884,13613,87.8,106,61,57.5
PK in K-12 Schools,All Students,2022-23,15184,1571,13613,89.7,103,56,54.4
0K,All Students,2018-19,14500,1678,12822,88.4,91,42,46.2
0K,All Students,2019-20,9553,955,8598,90.0,88,32,36.4
0K,All Students,2020-21,13493,1556,11937,88.5,81,34,42.0
0K,All Students,2021-22,12893,1811,11082,86.0,82,49,59.8
0K,All Students,2022-23,15676,1453,14223,90.7,96,38,39.6
1,All Students,2018-19,16006,1193,14813,92.5,97,26,26.8
1,All Students,2019-20,9475,782,8693,91.7,84,21,25.0
1,All Students,2020-21,13974,1300,12674,90.7,87,31,35.6
1,All Students,2021-22,13509,1305,12204,90.3,84,38,45.2
1,All Students,2022-23,11831,1325,10506,88.8,72,39,54.2
2,All Students,2018-19,18162,1486,16676,91.8,110,35,31.8
2,All Students,2019-20,10933,669,10264,93.9,99,18,18.2
2,All Students,2020-21,14342,1497,12845,89.6,86,30,34.9
2,All Students,2021-22,13329,1419,11910,89.4,84,42,50.0
2,All Students,2022-23,13533,888,12645,93.4,83,19,22.9
3,All Students,2018-19,17443,1428,16015,91.8,105,32,30.5
3,All Students,2019-20,10331,697,9634,93.3,92,19,20.7
3,All Students,2020-21,15198,1279,13919,91.6,91,28,30.8
3,All Students,2021-22,14881,1654,13227,88.9,89,39,43.8
3,All Students,2022-23,12552,971,11581,92.3,75,21,28.0
4,All Students,2018-19,18846,1553,17293,91.8,111,32,28.8
4,All Students,2019-20,11507,744,10763,93.5,103,17,16.5
4,All Students,2020-21,15013,1679,13334,88.8,91,38,41.8
4,All Students,2021-22,14585,1427,13158,90.2,89,39,43.8
4,All Students,2022-23,14438,1427,13011,90.1,87,33,37.9
5,All Students,2018-19,15747,938,14809,94.0,90,18,20.0
5,All Students,2019-20,12868,795,12073,93.8,113,19,16.8
5,All Students,2020-21,16735,1126,15609,93.3,99,24,24.2
5,All Students,2021-22,14338,1453,12885,89.9,83,34,41.0
5,All Students,2022-23,15196,1161,14035,92.4,89,25,28.1
All Grades,All Students,2018-19,66406,8046,58360,87.9,419,210,50.1
All Grades,All Students,2019-20,40969,5193,35776,87.3,396,208,52.5
All Grades,All Students,2020-21,54448,9180,45268,83.1,357,208,58.3
All Grades,All Students,2021-22,44693,6096,38597,86.4,292,173,59.2
All Grades,All Students,2022-23,49716,4978,44738,90.0,321,118,36.8
PK in K-12 Schools,All Students,2018-19,6010,975,5035,83.8,43,25,58.1
PK in K-12 Schools,All Students,2019-20,2833,606,2227,78.6,30,22,73.3
PK in K-12 Schools,All Students,2020-21,3000,688,2312,77.1,22,17,77.3
PK in K-12 Schools,All Students,2021-22,5831,1162,4669,80.1,37,31,83.8
PK in K-12 Schools,All Students,2022-23,5367,786,4581,85.4,39,24,61.5
0K,All Students,2018-19,8651,1188,7463,86.3,57,31,54.4
0K,All Students,2019-20,6678,1021,5657,84.7,69,43,62.3
0K,All Students,2020-21,5361,1388,3973,74.1,42,34,81.0
0K,All Students,2021-22,4428,653,3775,85.3,35,23,65.7
0K,All Students,2022-23,6145,883,5262,85.6,43,25,58.1
1,All Students,2018-19,9791,1155,8636,88.2,62,33,53.2
1,All Students,2019-20,4982,601,4381,87.9,48,26,54.2
1,All Students,2020-21,9441,1761,7680,81.3,62,40,64.5
1,All Students,2021-22,4935,695,4240,85.9,34,21,61.8
1,All Students,2022-23,5248,471,4777,91.0,35,12,34.3
2,All Students,2018-19,11284,1399,9885,87.6,72,36,50.0
2,All Students,2019-20,5797,675,5122,88.4,57,30,52.6
2,All Students,2020-21,7238,1414,5824,80.5,50,33,66.0
2,All Students,2021-22,6905,907,5998,86.9,48,28,58.3
2,All Students,2022-23,6407,680,5727,89.4,42,16,38.1
3,All Students,2018-19,11322,1095,10227,90.3,69,26,37.7
3,All Students,2019-20,6801,751,6050,89.0,63,28,44.4
3,All Students,2020-21,9451,1378,8073,85.4,58,29,50.0
3,All Students,2021-22,7103,1014,6089,85.7,45,30,66.7
3,All Students,2022-23,7880,655,7225,91.7,51,14,27.5
4,All Students,2018-19,11441,1458,9983,87.3,70,40,57.1
4,All Students,2019-20,7039,709,6330,89.9,66,25,37.9
4,All Students,2020-21,9380,1382,7998,85.3,59,30,50.8
4,All Students,2021-22,7607,824,6783,89.2,45,22,48.9
4,All Students,2022-23,9634,957,8677,90.1,59,21,35.6
5,All Students,2018-19,7907,776,7131,90.2,46,19,41.3
5,All Students,2019-20,6839,830,6009,87.9,63,34,54.0
5,All Students,2020-21,10577,1169,9408,88.9,64,25,39.1
5,All Students,2021-22,7884,841,7043,89.3,48,18,37.5
5,All Students,2022-23,9035,546,8489,94.0,52,6,11.5
All Grades,All Students,2018-19,41738,4704,37034,88.7,261,105,40.2
All Grades,All Students,2019-20,21803,2243,19560,89.7,207,78,37.7
All Grades,All Students,2020-21,23797,2890,20907,87.9,140,47,33.6
6,All Students,2018-19,10361,1238,9123,88.1,69,32,46.4
6,All Students,2019-20,4857,s,s,s,s,s,s
6,All Students,2020-21,5795,779,5016,86.6,34,13,38.2
7,All Students,2018-19,15533,1706,13827,89.0,96,34,35.4
7,All Students,2019-20,6927,610,6317,91.2,67,25,37.3
7,All Students,2020-21,7393,727,6666,90.2,44,14,31.8
8,All Students,2018-19,15844,1760,14084,88.9,96,39,40.6
8,All Students,2019-20,9952,1159,8793,88.4,93,37,39.8
8,All Students,2020-21,10609,1384,9225,87.0,62,20,32.3
9,All Students,2019-20,67,s,s,s,s,s,s
All Grades,All Students,2018-19,59647,4222,55425,92.9,353,91,25.8
All Grades,All Students,2019-20,35077,2411,32666,93.1,333,88,26.4
All Grades,All Students,2020-21,53660,6947,46713,87.1,315,129,41.0
All Grades,All Students,2021-22,45543,3824,41719,91.6,273,83,30.4
All Grades,All Students,2022-23,39225,2786,36439,92.9,232,52,22.4
PK in K-12 Schools,All Students,2018-19,6225,841,5384,86.5,39,19,48.7
PK in K-12 Schools,All Students,2019-20,2386,264,2122,88.9,25,12,48.0
PK in K-12 Schools,All Students,2020-21,3865,1020,2845,73.6,24,16,66.7
PK in K-12 Schools,All Students,2021-22,5116,s,s,s,s,s,s
PK in K-12 Schools,All Students,2022-23,3678,455,3223,87.6,23,12,52.2
0K,All Students,2018-19,6459,568,5891,91.2,39,14,35.9
0K,All Students,2019-20,5394,519,4875,90.4,53,23,43.4
0K,All Students,2020-21,7146,1174,5972,83.6,43,26,60.5
0K,All Students,2021-22,5737,690,5047,88.0,33,12,36.4
0K,All Students,2022-23,6725,519,6206,92.3,40,14,35.0
1,All Students,2018-19,7948,370,7578,95.3,47,7,14.9
1,All Students,2019-20,4112,234,3878,94.3,39,8,20.5
1,All Students,2020-21,9051,1547,7504,82.9,53,28,52.8
1,All Students,2021-22,7364,630,6734,91.4,44,15,34.1
1,All Students,2022-23,5576,526,5050,90.6,35,12,34.3
2,All Students,2018-19,8926,473,8453,94.7,53,10,18.9
2,All Students,2019-20,4815,221,4594,95.4,46,8,17.4
2,All Students,2020-21,6622,838,5784,87.3,38,15,39.5
2,All Students,2021-22,5181,493,4688,90.5,33,14,42.4
2,All Students,2022-23,6245,355,5890,94.3,36,4,11.1
3,All Students,2018-19,9593,791,8802,91.8,56,17,30.4
3,All Students,2019-20,6248,310,5938,95.0,59,9,15.3
3,All Students,2020-21,8101,684,7417,91.6,48,10,20.8
3,All Students,2021-22,6263,514,5749,91.8,36,11,30.6
3,All Students,2022-23,4626,283,4343,93.9,27,4,14.8
4,All Students,2018-19,9471,602,8869,93.6,55,11,20.0
4,All Students,2019-20,6008,427,5581,92.9,57,16,28.1
4,All Students,2020-21,9098,815,8283,91.0,53,17,32.1
4,All Students,2021-22,7694,388,7306,95.0,46,4,8.7
4,All Students,2022-23,5676,367,5309,93.5,32,5,15.6
5,All Students,2018-19,11025,577,10448,94.8,64,13,20.3
5,All Students,2019-20,6114,436,5678,92.9,54,12,22.2
5,All Students,2020-21,9777,869,8908,91.1,56,17,30.4
5,All Students,2021-22,8182,588,7594,92.8,47,11,23.4
5,All Students,2022-23,6699,281,6418,95.8,39,1,2.6
6,All Students,2021-22,6,s,s,s,s,s,s
All Grades,All Students,2018-19,111839,13006,98833,88.4,678,331,48.8
All Grades,All Students,2019-20,68288,7646,60642,88.8,626,280,44.7
All Grades,All Students,2020-21,93453,12724,80729,86.4,554,261,47.1
All Grades,All Students,2021-22,87446,12896,74550,85.3,530,321,60.6
All Grades,All Students,2022-23,76487,9539,66948,87.5,468,242,51.7
PK in K-12 Schools,All Students,2018-19,9195,1239,7956,86.5,59,29,49.2
PK in K-12 Schools,All Students,2019-20,5655,754,4901,86.7,51,27,52.9
PK in K-12 Schools,All Students,2020-21,8263,s,s,s,s,s,s
PK in K-12 Schools,All Students,2021-22,9734,1279,8455,86.9,62,38,61.3
PK in K-12 Schools,All Students,2022-23,9571,1218,8353,87.3,60,34,56.7
0K,All Students,2018-19,17300,2425,14875,86.0,103,59,57.3
0K,All Students,2019-20,10246,1241,9005,87.9,99,53,53.5
0K,All Students,2020-21,9430,1749,7681,81.5,60,35,58.3
0K,All Students,2021-22,10503,1509,8994,85.6,62,38,61.3
0K,All Students,2022-23,8966,1235,7731,86.2,56,32,57.1
1,All Students,2018-19,14297,1697,12600,88.1,88,47,53.4
1,All Students,2019-20,11209,1387,9822,87.6,99,49,49.5
1,All Students,2020-21,15844,2261,13583,85.7,93,46,49.5
1,All Students,2021-22,10433,1571,8862,84.9,65,36,55.4
1,All Students,2022-23,9822,1165,8657,88.1,63,30,47.6
2,All Students,2018-19,17847,2131,15716,88.1,109,57,52.3
2,All Students,2019-20,9136,1007,8129,89.0,84,36,42.9
2,All Students,2020-21,16733,2316,14417,86.2,101,47,46.5
2,All Students,2021-22,14279,2035,12244,85.7,86,57,66.3
2,All Students,2022-23,9662,1089,8573,88.7,59,28,47.5
3,All Students,2018-19,17819,1974,15845,88.9,108,51,47.2
3,All Students,2019-20,10161,1056,9105,89.6,95,40,42.1
3,All Students,2020-21,12722,1576,11146,87.6,73,29,39.7
3,All Students,2021-22,15878,2748,13130,82.7,96,68,70.8
3,All Students,2022-23,13062,1538,11524,88.2,79,38,48.1
4,All Students,2018-19,17435,2011,15424,88.5,105,49,46.7
4,All Students,2019-20,10881,1135,9746,89.6,99,39,39.4
4,All Students,2020-21,15226,2044,13182,86.6,90,46,51.1
4,All Students,2021-22,11521,1691,9830,85.3,69,37,53.6
4,All Students,2022-23,14417,1914,12503,86.7,85,48,56.5
5,All Students,2018-19,17946,1529,16417,91.5,106,39,36.8
5,All Students,2019-20,11000,1066,9934,90.3,99,36,36.4
5,All Students,2020-21,15141,1784,13357,88.2,87,35,40.2
5,All Students,2021-22,15098,2063,13035,86.3,90,47,52.2
5,All Students,2022-23,10987,1380,9607,87.4,66,32,48.5
6,All Students,2020-21,94,s,s,s,s,s,s
All Grades,All Students,2018-19,86163,9350,76813,89.1,529,240,45.4
All Grades,All Students,2019-20,52037,4687,47350,91.0,482,177,36.7
All Grades,All Students,2020-21,66022,7050,58972,89.3,402,135,33.6
All Grades,All Students,2021-22,58971,8053,50918,86.3,362,205,56.6
All Grades,All Students,2022-23,58510,6823,51687,88.3,352,165,46.9
PK in K-12 Schools,All Students,2018-19,16171,2334,13837,85.6,102,62,60.8
PK in K-12 Schools,All Students,2019-20,10108,1133,8975,88.8,99,49,49.5
PK in K-12 Schools,All Students,2020-21,11026,680,10346,93.8,71,14,19.7
PK in K-12 Schools,All Students,2021-22,8848,1254,7594,85.8,55,35,63.6
PK in K-12 Schools,All Students,2022-23,10428,1238,9190,88.1,67,34,50.7
0K,All Students,2018-19,12599,1810,10789,85.6,82,47,57.3
0K,All Students,2019-20,7092,729,6363,89.7,65,23,35.4
0K,All Students,2020-21,7477,595,6882,92.0,46,12,26.1
0K,All Students,2021-22,9042,1482,7560,83.6,55,38,69.1
0K,All Students,2022-23,6539,929,5610,85.8,39,21,53.8
1,All Students,2018-19,11298,996,10302,91.2,70,26,37.1
1,All Students,2019-20,7653,786,6867,89.7,71,31,43.7
1,All Students,2020-21,9536,1436,8100,84.9,59,25,42.4
1,All Students,2021-22,7226,939,6287,87.0,46,22,47.8
1,All Students,2022-23,7608,812,6796,89.3,46,21,45.7
2,All Students,2018-19,11025,1051,9974,90.5,65,25,38.5
2,All Students,2019-20,7133,530,6603,92.6,67,20,29.9
2,All Students,2020-21,9959,1361,8598,86.3,59,27,45.8
2,All Students,2021-22,8242,1195,7047,85.5,51,30,58.8
2,All Students,2022-23,7804,849,6955,89.1,46,18,39.1
3,All Students,2018-19,10831,1018,9813,90.6,64,23,35.9
3,All Students,2019-20,5581,431,5150,92.3,52,15,28.8
3,All Students,2020-21,11127,1307,9820,88.3,68,25,36.8
3,All Students,2021-22,10146,1352,8794,86.7,59,31,52.5
3,All Students,2022-23,7994,982,7012,87.7,47,25,53.2
4,All Students,2018-19,12946,1230,11716,90.5,78,35,44.9
4,All Students,2019-20,7119,525,6594,92.6,65,18,27.7
4,All Students,2020-21,7304,804,6500,89.0,44,18,40.9
4,All Students,2021-22,9636,1214,8422,87.4,58,30,51.7
4,All Students,2022-23,9404,1071,8333,88.6,55,24,43.6
5,All Students,2018-19,11293,911,10382,91.9,68,22,32.4
5,All Students,2019-20,7351,553,6798,92.5,65,21,32.3
5,All Students,2020-21,9593,867,8726,91.0,55,14,25.5
5,All Students,2021-22,5831,617,5214,89.4,38,19,50.0
5,All Students,2022-23,8733,942,7791,89.2,52,22,42.3
All Grades,All Students,2018-19,54812,5915,48897,89.2,325,142,43.7
All Grades,All Students,2019-20,35312,3888,31424,89.0,331,139,42.0
All Grades,All Students,2020-21,48042,8099,39943,83.1,294,156,53.1
All Grades,All Students,2021-22,42455,5840,36615,86.2,267,133,49.8
All Grades,All Students,2022-23,40113,4594,35519,88.5,249,107,43.0
PK in K-12 Schools,All Students,2018-19,5357,956,4401,82.2,34,24,70.6
PK in K-12 Schools,All Students,2019-20,6571,1017,5554,84.5,64,40,62.5
PK in K-12 Schools,All Students,2020-21,10096,2295,7801,77.3,63,39,61.9
PK in K-12 Schools,All Students,2021-22,8618,1433,7185,83.4,62,40,64.5
PK in K-12 Schools,All Students,2022-23,10853,1713,9140,84.2,68,43,63.2
0K,All Students,2018-19,3874,493,3381,87.3,24,11,45.8
0K,All Students,2019-20,2941,395,2546,86.6,30,14,46.7
0K,All Students,2020-21,4652,777,3875,83.3,30,18,60.0
0K,All Students,2021-22,5719,1099,4620,80.8,36,26,72.2
0K,All Students,2022-23,5065,479,4586,90.5,33,14,42.4
1,All Students,2018-19,8471,964,7507,88.6,50,23,46.0
1,All Students,2019-20,3097,336,2761,89.2,29,11,37.9
1,All Students,2020-21,4117,737,3380,82.1,27,16,59.3
1,All Students,2021-22,4827,531,4296,89.0,30,11,36.7
1,All Students,2022-23,5484,782,4702,85.7,31,17,54.8
2,All Students,2018-19,8291,948,7343,88.6,49,22,44.9
2,All Students,2019-20,4631,541,4090,88.3,45,17,37.8
2,All Students,2020-21,4088,886,3202,78.3,25,16,64.0
2,All Students,2021-22,3897,s,s,s,s,s,s
2,All Students,2022-23,4503,336,4167,92.5,27,6,22.2
3,All Students,2018-19,11091,1221,9870,89.0,65,30,46.2
3,All Students,2019-20,5609,497,5112,91.1,51,19,37.3
3,All Students,2020-21,6791,1130,5661,83.4,42,24,57.1
3,All Students,2021-22,3992,706,3286,82.3,24,13,54.2
3,All Students,2022-23,3906,425,3481,89.1,25,7,28.0
4,All Students,2018-19,8958,725,8233,91.9,52,19,36.5
4,All Students,2019-20,7107,710,6397,90.0,65,26,40.0
4,All Students,2020-21,8099,1205,6894,85.1,47,22,46.8
4,All Students,2021-22,6860,772,6088,88.7,40,15,37.5
4,All Students,2022-23,4097,394,3703,90.4,27,9,33.3
5,All Students,2018-19,8770,608,8162,93.1,51,13,25.5
5,All Students,2019-20,5356,392,4964,92.7,47,12,25.5
5,All Students,2020-21,10199,1069,9130,89.5,60,21,35.0
5,All Students,2021-22,8539,887,7652,89.6,51,19,37.3
5,All Students,2022-23,6205,465,5740,92.5,38,11,28.9
6,All Students,2021-22,3,s,s,s,s,s,s
All Grades,All Students,2018-19,111871,7493,104378,93.3,669,128,19.1
All Grades,All Students,2019-20,72413,5353,67060,92.6,659,144,21.9
All Grades,All Students,2020-21,111437,6056,105381,94.6,645,105,16.3
All Grades,All Students,2021-22,108581,9429,99152,91.3,653,218,33.4
All Grades,All Students,2022-23,107314,9238,98076,91.4,678,205,30.2
6,All Students,2018-19,15777,733,15044,95.4,90,13,14.4
6,All Students,2019-20,9079,491,8588,94.6,83,12,14.5
6,All Students,2020-21,16880,872,16008,94.8,98,18,18.4
6,All Students,2021-22,15845,1335,14510,91.6,96,37,38.5
6,All Students,2022-23,16364,1246,15118,92.4,98,23,23.5
7,All Students,2018-19,14597,684,13913,95.3,83,7,8.4
7,All Students,2019-20,9991,511,9480,94.9,89,12,13.5
7,All Students,2020-21,14226,848,13378,94.0,82,14,17.1
7,All Students,2021-22,14565,1188,13377,91.8,87,25,28.7
7,All Students,2022-23,14537,1190,13347,91.8,89,30,33.7
8,All Students,2018-19,17434,1178,16256,93.2,100,19,19.0
8,All Students,2019-20,9749,704,9045,92.8,85,13,15.3
8,All Students,2020-21,15225,622,14603,95.9,87,10,11.5
8,All Students,2021-22,13678,963,12715,93.0,79,18,22.8
8,All Students,2022-23,13885,1204,12681,91.3,88,28,31.8
9,All Students,2018-19,15969,710,15259,95.6,98,9,9.2
9,All Students,2019-20,11788,923,10865,92.2,110,24,21.8
9,All Students,2020-21,16895,1094,15801,93.5,99,22,22.2
9,All Students,2021-22,18250,1561,16689,91.4,111,36,32.4
9,All Students,2022-23,16986,1463,15523,91.4,113,37,32.7
10,All Students,2018-19,15020,917,14103,93.9,94,18,19.1
10,All Students,2019-20,10588,601,9987,94.3,97,20,20.6
10,All Students,2020-21,17366,922,16444,94.7,101,17,16.8
10,All Students,2021-22,14899,1518,13381,89.8,91,34,37.4
10,All Students,2022-23,16635,1689,14946,89.8,106,36,34.0
11,All Students,2018-19,17270,1179,16091,93.2,107,27,25.2
11,All Students,2019-20,9715,1040,8675,89.3,91,33,36.3
11,All Students,2020-21,16491,726,15765,95.6,95,15,15.8
11,All Students,2021-22,15584,1553,14031,90.0,96,36,37.5
11,All Students,2022-23,14280,1409,12871,90.1,94,31,33.0
12,All Students,2018-19,15804,2092,13712,86.8,97,35,36.1
12,All Students,2019-20,11503,1083,10420,90.6,104,30,28.8
12,All Students,2020-21,14354,972,13382,93.2,83,9,10.8
12,All Students,2021-22,15760,1311,14449,91.7,93,32,34.4
12,All Students,2022-23,14627,1037,13590,92.9,90,20,22.2
All Grades,All Students,2018-19,115916,9285,106631,92.0,685,176,25.7
All Grades,All Students,2019-20,77058,6275,70783,91.9,697,193,27.7
All Grades,All Students,2020-21,123940,13982,109958,88.7,720,262,36.4
All Grades,All Students,2021-22,114989,12319,102670,89.3,669,267,39.9
All Grades,All Students,2022-23,107369,9968,97401,90.7,650,218,33.5
6,All Students,2018-19,20768,1332,19436,93.6,118,25,21.2
6,All Students,2019-20,12345,868,11477,93.0,108,23,21.3
6,All Students,2020-21,19316,1615,17701,91.6,111,28,25.2
6,All Students,2021-22,14774,1023,13751,93.1,86,24,27.9
6,All Students,2022-23,16045,1090,14955,93.2,94,22,23.4
7,All Students,2018-19,14785,999,13786,93.2,84,23,27.4
7,All Students,2019-20,12781,979,11802,92.3,112,30,26.8
7,All Students,2020-21,17765,1826,15939,89.7,102,34,33.3
7,All Students,2021-22,17344,1780,15564,89.7,100,38,38.0
7,All Students,2022-23,14331,933,13398,93.5,84,21,25.0
8,All Students,2018-19,16915,1006,15909,94.1,97,22,22.7
8,All Students,2019-20,9140,458,8682,95.0,82,13,15.9
8,All Students,2020-21,19334,2412,16922,87.5,112,47,42.0
8,All Students,2021-22,16908,1552,15356,90.8,96,37,38.5
8,All Students,2022-23,16213,1502,14711,90.7,96,34,35.4
9,All Students,2018-19,17165,886,16279,94.8,102,19,18.6
9,All Students,2019-20,12637,1060,11577,91.6,118,38,32.2
9,All Students,2020-21,17255,2624,14631,84.8,101,45,44.6
9,All Students,2021-22,17183,2201,14982,87.2,99,48,48.5
9,All Students,2022-23,16324,1377,14947,91.6,100,32,32.0
10,All Students,2018-19,15602,1378,14224,91.2,98,22,22.4
10,All Students,2019-20,10940,732,10208,93.3,101,20,19.8
10,All Students,2020-21,18973,2460,16513,87.0,109,47,43.1
10,All Students,2021-22,16121,1939,14182,88.0,92,33,35.9
10,All Students,2022-23,15269,1761,13508,88.5,95,42,44.2
11,All Students,2018-19,15878,1612,14266,89.8,94,25,26.6
11,All Students,2019-20,9666,866,8800,91.0,88,29,33.0
11,All Students,2020-21,16605,1284,15321,92.3,98,23,23.5
11,All Students,2021-22,18032,2084,15948,88.4,104,41,39.4
11,All Students,2022-23,14960,1561,13399,89.6,93,33,35.5
12,All Students,2018-19,14803,2072,12731,86.0,92,40,43.5
12,All Students,2019-20,9549,1312,8237,86.3,88,40,45.5
12,All Students,2020-21,14692,1761,12931,88.0,87,38,43.7
12,All Students,2021-22,14627,1740,12887,88.1,92,46,50.0
12,All Students,2022-23,14227,1744,12483,87.7,88,34,38.6
All Grades,All Students,2018-19,57412,6238,51174,89.1,348,148,42.5
All Grades,All Students,2019-20,32716,3093,29623,90.5,305,105,34.4
All Grades,All Students,2020-21,42990,6978,36012,83.8,254,126,49.6
All Grades,All Students,2021-22,40855,5850,35005,85.7,249,131,52.6
All Grades,All Students,2022-23,36391,4181,32210,88.5,228,98,43.0
6,All Students,2018-19,17651,1814,15837,89.7,105,47,44.8
6,All Students,2019-20,10578,948,9630,91.0,101,32,31.7
6,All Students,2020-21,11367,s,s,s,s,s,s
6,All Students,2021-22,13063,2268,10795,82.6,81,48,59.3
6,All Students,2022-23,9552,1054,8498,89.0,63,25,39.7
7,All Students,2018-19,16349,s,s,s,s,s,s
7,All Students,2019-20,10612,1202,9410,88.7,100,45,45.0
7,All Students,2020-21,15833,2084,13749,86.8,92,45,48.9
7,All Students,2021-22,11918,s,s,s,s,s,s
7,All Students,2022-23,14035,1972,12063,85.9,87,45,51.7
8,All Students,2018-19,23298,2804,20494,88.0,139,65,46.8
8,All Students,2019-20,11526,943,10583,91.8,104,28,26.9
8,All Students,2020-21,15623,3396,12227,78.3,92,56,60.9
8,All Students,2021-22,15792,2051,13741,87.0,93,49,52.7
8,All Students,2022-23,12804,1155,11649,91.0,78,28,35.9
9,All Students,2018-19,114,s,s,s,s,s,s
9,All Students,2020-21,167,s,s,s,s,s,s
9,All Students,2021-22,82,s,s,s,s,s,s
All Grades,All Students,2018-19,84719,12414,72305,85.3,534,216,40.4
All Grades,All Students,2019-20,57904,8714,49190,85.0,551,235,42.6
All Grades,All Students,2020-21,83974,15016,68958,82.1,512,218,42.6
All Grades,All Students,2021-22,110274,23534,86740,78.7,685,409,59.7
All Grades,All Students,2022-23,106889,22728,84161,78.7,680,408,60.0
8,All Students,2020-21,1,s,s,s,s,s,s
9,All Students,2018-19,19097,2813,16284,85.3,119,46,38.7
9,All Students,2019-20,14668,2219,12449,84.9,142,63,44.4
9,All Students,2020-21,21141,3337,17804,84.2,130,56,43.1
9,All Students,2021-22,41481,9383,32098,77.4,252,147,58.3
9,All Students,2022-23,33552,6016,27536,82.1,215,114,53.0
10,All Students,2018-19,20229,3441,16788,83.0,129,64,49.6
10,All Students,2019-20,12757,2198,10559,82.8,124,63,50.8
10,All Students,2020-21,20894,3417,17477,83.6,127,51,40.2
10,All Students,2021-22,22905,4811,18094,79.0,152,99,65.1
10,All Students,2022-23,29468,6928,22540,76.5,192,130,67.7
11,All Students,2018-19,16882,2532,14350,85.0,108,48,44.4
11,All Students,2019-20,10527,1561,8966,85.2,103,50,48.5
11,All Students,2020-21,17610,s,s,s,s,s,s
11,All Students,2021-22,18285,3385,14900,81.5,111,63,56.8
11,All Students,2022-23,17207,3612,13595,79.0,110,71,64.5
12,All Students,2018-19,28511,3628,24883,87.3,178,58,32.6
12,All Students,2019-20,19952,2736,17216,86.3,182,59,32.4
12,All Students,2020-21,24318,4686,19632,80.7,147,64,43.5
12,All Students,2021-22,27603,5955,21648,78.4,170,100,58.8
12,All Students,2022-23,26662,6172,20490,76.9,163,93,57.1
All Grades,All Students,2018-19,85522,10005,75517,88.3,516,247,47.9
All Grades,All Students,2019-20,49818,5271,44547,89.4,460,179,38.9
All Grades,All Students,2020-21,64951,9667,55284,85.1,391,190,48.6
All Grades,All Students,2021-22,58092,6991,51101,88.0,355,165,46.5
All Grades,All Students,2022-23,55954,5802,50152,89.6,350,145,41.4
PK in K-12 Schools,All Students,2018-19,18133,2653,15480,85.4,118,70,59.3
PK in K-12 Schools,All Students,2019-20,10877,1432,9445,86.8,107,48,44.9
PK in K-12 Schools,All Students,2020-21,11657,1651,10006,85.8,73,34,46.6
PK in K-12 Schools,All Students,2021-22,11048,1534,9514,86.1,72,37,51.4
PK in K-12 Schools,All Students,2022-23,12069,1867,10202,84.5,78,48,61.5
0K,All Students,2018-19,10057,1393,8664,86.1,61,35,57.4
0K,All Students,2019-20,6431,675,5756,89.5,58,26,44.8
0K,All Students,2020-21,8078,1291,6787,84.0,49,24,49.0
0K,All Students,2021-22,5549,622,4927,88.8,34,13,38.2
0K,All Students,2022-23,7028,745,6283,89.4,46,21,45.7
1,All Students,2018-19,11732,1383,10349,88.2,70,35,50.0
1,All Students,2019-20,6100,748,5352,87.7,55,21,38.2
1,All Students,2020-21,8590,1528,7062,82.2,52,29,55.8
1,All Students,2021-22,8321,872,7449,89.5,50,24,48.0
1,All Students,2022-23,5302,425,4877,92.0,32,10,31.3
2,All Students,2018-19,12406,1156,11250,90.7,72,25,34.7
2,All Students,2019-20,6724,662,6062,90.2,63,23,36.5
2,All Students,2020-21,8287,1277,7010,84.6,50,26,52.0
2,All Students,2021-22,6969,946,6023,86.4,43,20,46.5
2,All Students,2022-23,8175,733,7442,91.0,52,18,34.6
3,All Students,2018-19,8979,800,8179,91.1,53,19,35.8
3,All Students,2019-20,7029,678,6351,90.4,64,26,40.6
3,All Students,2020-21,9624,1273,8351,86.8,58,27,46.6
3,All Students,2021-22,7436,901,6535,87.9,44,21,47.7
3,All Students,2022-23,6674,634,6040,90.5,41,14,34.1
4,All Students,2018-19,12836,1479,11357,88.5,76,34,44.7
4,All Students,2019-20,5518,400,5118,92.8,51,12,23.5
4,All Students,2020-21,10060,1758,8302,82.5,59,33,55.9
4,All Students,2021-22,9877,1181,8696,88.0,58,26,44.8
4,All Students,2022-23,7134,676,6458,90.5,43,16,37.2
5,All Students,2018-19,11379,1141,10238,90.0,66,29,43.9
5,All Students,2019-20,7139,676,6463,90.5,63,24,38.1
5,All Students,2020-21,8655,889,7766,89.7,50,17,34.0
5,All Students,2021-22,8892,935,7957,89.5,54,24,44.4
5,All Students,2022-23,9572,722,8850,92.5,58,18,31.0
All Grades,All Students,2018-19,41763,4181,37582,90.0,259,99,38.2
All Grades,All Students,2019-20,24542,2437,22105,90.1,224,72,32.1
All Grades,All Students,2020-21,42235,4965,37270,88.2,248,100,40.3
All Grades,All Students,2021-22,38885,4428,34457,88.6,235,102,43.4
All Grades,All Students,2022-23,40109,3576,36533,91.1,243,78,32.1
6,All Students,2018-19,13325,1143,12182,91.4,82,26,31.7
6,All Students,2019-20,8299,716,7583,91.4,76,23,30.3
6,All Students,2020-21,17308,2350,14958,86.4,101,45,44.6
6,All Students,2021-22,10576,s,s,s,s,s,s
6,All Students,2022-23,13477,1030,12447,92.4,82,24,29.3
7,All Students,2018-19,11982,1311,10671,89.1,71,27,38.0
7,All Students,2019-20,8517,777,7740,90.9,80,27,33.8
7,All Students,2020-21,12722,1539,11183,87.9,76,31,40.8
7,All Students,2021-22,15572,1706,13866,89.0,95,41,43.2
7,All Students,2022-23,10719,896,9823,91.6,66,18,27.3
8,All Students,2018-19,16456,1727,14729,89.5,106,46,43.4
8,All Students,2019-20,7524,s,s,s,s,s,s
8,All Students,2020-21,12205,1076,11129,91.2,71,24,33.8
8,All Students,2021-22,12644,1469,11175,88.4,74,33,44.6
8,All Students,2022-23,15913,1650,14263,89.6,95,36,37.9
9,All Students,2019-20,202,s,s,s,s,s,s
9,All Students,2021-22,93,s,s,s,s,s,s
All Grades,All Students,2018-19,47552,4607,42945,90.3,290,102,35.2
All Grades,All Students,2019-20,28674,2483,26191,91.3,270,79,29.3
All Grades,All Students,2020-21,34065,3966,30099,88.4,199,73,36.7
All Grades,All Students,2021-22,28619,3613,25006,87.4,177,82,46.3
All Grades,All Students,2022-23,23185,2130,21055,90.8,145,45,31.0
6,All Students,2018-19,15278,1505,13773,90.1,95,33,34.7
6,All Students,2019-20,8303,842,7461,89.9,79,28,35.4
6,All Students,2020-21,7585,745,6840,90.2,44,16,36.4
6,All Students,2021-22,9571,1002,8569,89.5,60,23,38.3
6,All Students,2022-23,7253,s,s,s,s,s,s
7,All Students,2018-19,16333,1680,14653,89.7,101,40,39.6
7,All Students,2019-20,9945,1012,8933,89.8,91,31,34.1
7,All Students,2020-21,12229,1516,10713,87.6,71,24,33.8
7,All Students,2021-22,7701,s,s,s,s,s,s
7,All Students,2022-23,8358,701,7657,91.6,52,15,28.8
8,All Students,2018-19,15941,1422,14519,91.1,94,29,30.9
8,All Students,2019-20,10426,629,9797,94.0,100,20,20.0
8,All Students,2020-21,14232,1688,12544,88.1,83,32,38.6
8,All Students,2021-22,11329,1540,9789,86.4,70,34,48.6
8,All Students,2022-23,7423,749,6674,89.9,46,15,32.6
9,All Students,2021-22,18,s,s,s,s,s,s
9,All Students,2022-23,151,s,s,s,s,s,s
All Grades,All Students,2018-19,67900,7510,60390,88.9,431,139,32.3
All Grades,All Students,2019-20,43564,4544,39020,89.6,414,125,30.2
All Grades,All Students,2020-21,66566,19723,46843,70.4,393,280,71.2
All Grades,All Students,2021-22,59368,9135,50233,84.6,383,185,48.3
All Grades,All Students,2022-23,57039,8287,48752,85.5,389,185,47.6
9,All Students,2018-19,20493,2585,17908,87.4,139,46,33.1
9,All Students,2019-20,12478,1244,11234,90.0,122,30,24.6
9,All Students,2020-21,11759,3462,8297,70.6,70,46,65.7
9,All Students,2021-22,14526,2307,12219,84.1,98,43,43.9
9,All Students,2022-23,18261,2476,15785,86.4,138,56,40.6
10,All Students,2018-19,19523,1603,17920,91.8,119,24,20.2
10,All Students,2019-20,13295,1437,11858,89.2,127,39,30.7
10,All Students,2020-21,19538,6036,13502,69.1,118,83,70.3
10,All Students,2021-22,12639,1755,10884,86.1,83,40,48.2
10,All Students,2022-23,13305,1749,11556,86.9,88,36,40.9
11,All Students,2018-19,11373,1188,10185,89.6,72,20,27.8
11,All Students,2019-20,9956,959,8997,90.4,92,26,28.3
11,All Students,2020-21,18505,4860,13645,73.7,109,76,69.7
11,All Students,2021-22,14515,2094,12421,85.6,93,41,44.1
11,All Students,2022-23,12577,1589,10988,87.4,84,44,52.4
12,All Students,2018-19,16511,2134,14377,87.1,101,49,48.5
12,All Students,2019-20,7835,904,6931,88.5,73,30,41.1
12,All Students,2020-21,16764,5365,11399,68.0,96,75,78.1
12,All Students,2021-22,17688,2979,14709,83.2,109,61,56.0
12,All Students,2022-23,12896,2473,10423,80.8,79,49,62.0
All Grades,All Students,2018-19,54723,3976,50747,92.7,315,72,22.9
All Grades,All Students,2019-20,34417,2091,32326,93.9,304,49,16.1
All Grades,All Students,2020-21,52238,4686,47552,91.0,304,93,30.6
All Grades,All Students,2021-22,51327,6161,45166,88.0,305,143,46.9
All Grades,All Students,2022-23,52676,4658,48018,91.2,318,109,34.3
6,All Students,2018-19,18921,1099,17822,94.2,108,19,17.6
6,All Students,2019-20,11152,673,10479,94.0,99,22,22.2
6,All Students,2020-21,18021,1638,16383,90.9,106,38,35.8
6,All Students,2021-22,17841,2027,15814,88.6,105,47,44.8
6,All Students,2022-23,18387,1266,17121,93.1,108,29,26.9
7,All Students,2018-19,18114,1076,17038,94.1,104,16,15.4
7,All Students,2019-20,11936,636,11300,94.7,105,13,12.4
7,All Students,2020-21,16495,1518,14977,90.8,96,24,25.0
7,All Students,2021-22,16782,2171,14611,87.1,102,51,50.0
7,All Students,2022-23,17251,1395,15856,91.9,104,35,33.7
8,All Students,2018-19,17688,1801,15887,89.8,103,37,35.9
8,All Students,2019-20,11329,782,10547,93.1,100,14,14.0
8,All Students,2020-21,17722,1530,16192,91.4,102,31,30.4
8,All Students,2021-22,16704,1963,14741,88.2,98,45,45.9
8,All Students,2022-23,17038,1997,15041,88.3,106,45,42.5
All Grades,All Students,2018-19,61718,4326,57392,93.0,362,83,22.9
All Grades,All Students,2019-20,38528,2339,36189,93.9,346,70,20.2
All Grades,All Students,2020-21,49924,2180,47744,95.6,300,43,14.3
All Grades,All Students,2021-22,43695,3051,40644,93.0,264,65,24.6
All Grades,All Students,2022-23,39923,2346,37577,94.1,238,38,16.0
PK in K-12 Schools,All Students,2018-19,5591,471,5120,91.6,35,12,34.3
PK in K-12 Schools,All Students,2019-20,5120,515,4605,89.9,48,21,43.8
PK in K-12 Schools,All Students,2020-21,6221,190,6031,96.9,39,3,7.7
PK in K-12 Schools,All Students,2021-22,7597,901,6696,88.1,49,27,55.1
PK in K-12 Schools,All Students,2022-23,8427,977,7450,88.4,53,23,43.4
0K,All Students,2018-19,8834,839,7995,90.5,56,22,39.3
0K,All Students,2019-20,5459,396,5063,92.7,50,14,28.0
0K,All Students,2020-21,7180,315,6865,95.6,43,5,11.6
0K,All Students,2021-22,7411,586,6825,92.1,44,12,27.3
0K,All Students,2022-23,4399,297,4102,93.2,26,6,23.1
1,All Students,2018-19,9480,623,8857,93.4,55,10,18.2
1,All Students,2019-20,4702,247,4455,94.7,42,8,19.0
1,All Students,2020-21,6370,422,5948,93.4,40,11,27.5
1,All Students,2021-22,5172,303,4869,94.1,32,5,15.6
1,All Students,2022-23,5507,267,5240,95.2,32,2,6.3
2,All Students,2018-19,9231,620,8611,93.3,52,9,17.3
2,All Students,2019-20,5321,283,5038,94.7,49,7,14.3
2,All Students,2020-21,5953,319,5634,94.6,35,5,14.3
2,All Students,2021-22,5541,372,5169,93.3,32,6,18.8
2,All Students,2022-23,5251,256,4995,95.1,31,1,3.2
3,All Students,2018-19,10093,538,9555,94.7,59,7,11.9
3,All Students,2019-20,5232,223,5009,95.7,46,3,6.5
3,All Students,2020-21,7432,302,7130,95.9,44,6,13.6
3,All Students,2021-22,4768,218,4550,95.4,31,3,9.7
3,All Students,2022-23,5083,159,4924,96.9,30,1,3.3
4,All Students,2018-19,10658,882,9776,91.7,61,18,29.5
4,All Students,2019-20,6250,281,5969,95.5,55,7,12.7
4,All Students,2020-21,7469,376,7093,95.0,44,9,20.5
4,All Students,2021-22,6653,309,6344,95.4,39,4,10.3
4,All Students,2022-23,4173,159,4014,96.2,25,4,16.0
5,All Students,2018-19,7831,353,7478,95.5,44,5,11.4
5,All Students,2019-20,6444,394,6050,93.9,56,10,17.9
5,All Students,2020-21,9299,256,9043,97.2,55,4,7.3
5,All Students,2021-22,6553,362,6191,94.5,37,8,21.6
5,All Students,2022-23,7083,231,6852,96.7,41,1,2.4
All Grades,All Students,2018-19,45124,3523,41601,92.2,265,75,28.3
All Grades,All Students,2019-20,28443,2198,26245,92.3,263,80,30.4
All Grades,All Students,2020-21,44754,5173,39581,88.4,266,111,41.7
All Grades,All Students,2021-22,41896,5244,36652,87.5,259,124,47.9
All Grades,All Students,2022-23,38468,4193,34275,89.1,236,97,41.1
PK in K-12 Schools,All Students,2018-19,7980,827,7153,89.6,48,18,37.5
7,All Students,2019-20,5805,356,5449,93.9,52,12,23.1
PK in K-12 Schools,All Students,2019-20,6398,748,5650,88.3,62,30,48.4
PK in K-12 Schools,All Students,2020-21,8906,1331,7575,85.1,55,31,56.4
PK in K-12 Schools,All Students,2021-22,8855,1542,7313,82.6,62,39,62.9
PK in K-12 Schools,All Students,2022-23,7531,1151,6380,84.7,48,24,50.0
0K,All Students,2018-19,4821,s,s,s,s,s,s
0K,All Students,2019-20,4396,374,4022,91.5,39,14,35.9
0K,All Students,2020-21,7107,966,6141,86.4,44,22,50.0
0K,All Students,2021-22,6001,925,5076,84.6,36,21,58.3
0K,All Students,2022-23,4809,582,4227,87.9,29,14,48.3
1,All Students,2018-19,6248,420,5828,93.3,37,10,27.0
1,All Students,2019-20,2227,192,2035,91.4,22,8,36.4
1,All Students,2020-21,7384,832,6552,88.7,44,16,36.4
1,All Students,2021-22,6204,659,5545,89.4,39,18,46.2
1,All Students,2022-23,6221,683,5538,89.0,38,16,42.1
2,All Students,2018-19,6008,314,5694,94.8,34,5,14.7
2,All Students,2019-20,4654,320,4334,93.1,42,11,26.2
2,All Students,2020-21,3494,334,3160,90.4,20,5,25.0
2,All Students,2021-22,5501,547,4954,90.1,32,12,37.5
2,All Students,2022-23,5637,588,5049,89.6,36,14,38.9
3,All Students,2018-19,7007,431,6576,93.8,42,11,26.2
3,All Students,2019-20,3488,153,3335,95.6,32,3,9.4
3,All Students,2020-21,6315,830,5485,86.9,37,20,54.1
3,All Students,2021-22,4291,449,3842,89.5,25,9,36.0
3,All Students,2022-23,4913,405,4508,91.8,29,10,34.5
4,All Students,2018-19,5814,413,5401,92.9,34,9,26.5
4,All Students,2019-20,4199,240,3959,94.3,38,10,26.3
4,All Students,2020-21,4898,375,4523,92.3,28,8,28.6
4,All Students,2021-22,5875,667,5208,88.6,35,14,40.0
4,All Students,2022-23,3786,368,3418,90.3,23,10,43.5
5,All Students,2018-19,7244,479,6765,93.4,41,10,24.4
5,All Students,2019-20,3081,171,2910,94.4,28,4,14.3
5,All Students,2020-21,6650,505,6145,92.4,38,9,23.7
5,All Students,2021-22,5169,455,4714,91.2,30,11,36.7
5,All Students,2022-23,5571,416,5155,92.5,33,9,27.3
6,All Students,2018-19,2,s,s,s,s,s,s
All Grades,All Students,2018-19,52525,9750,42775,81.4,339,184,54.3
All Grades,All Students,2019-20,34484,7262,27222,78.9,337,185,54.9
All Grades,All Students,2020-21,58472,22258,36214,61.9,347,336,96.8
All Grades,All Students,2021-22,47164,13603,33561,71.2,303,239,78.9
All Grades,All Students,2022-23,34760,8694,26066,75.0,239,166,69.5
9,All Students,2018-19,18664,3519,15145,81.1,118,52,44.1
9,All Students,2019-20,12398,3725,8673,70.0,127,85,66.9
9,All Students,2020-21,15625,6248,9377,60.0,95,94,98.9
9,All Students,2021-22,10796,3612,7184,66.5,73,58,79.5
9,All Students,2022-23,8232,3073,5159,62.7,62,44,71.0
10,All Students,2018-19,13697,3183,10514,76.8,94,62,66.0
10,All Students,2019-20,10659,1926,8733,81.9,104,46,44.2
10,All Students,2020-21,17537,7283,10254,58.5,105,103,98.1
10,All Students,2021-22,11225,3761,7464,66.5,72,63,87.5
10,All Students,2022-23,8927,2005,6922,77.5,61,39,63.9
11,All Students,2018-19,10610,1676,8934,84.2,67,38,56.7
11,All Students,2019-20,6979,1036,5943,85.2,64,32,50.0
11,All Students,2020-21,14760,4935,9825,66.6,86,78,90.7
11,All Students,2021-22,11947,3216,8731,73.1,76,60,78.9
11,All Students,2022-23,8254,1621,6633,80.4,56,39,69.6
12,All Students,2018-19,9554,1372,8182,85.6,60,32,53.3
12,All Students,2019-20,4448,575,3873,87.1,42,22,52.4
12,All Students,2020-21,10550,3792,6758,64.1,61,61,100.0
12,All Students,2021-22,13196,3014,10182,77.2,82,58,70.7
12,All Students,2022-23,9347,1995,7352,78.7,60,44,73.3
All Grades,All Students,2018-19,52087,12172,39915,76.6,358,215,60.1
All Grades,All Students,2019-20,32381,6604,25777,79.6,318,177,55.7
All Grades,All Students,2020-21,41638,7618,34020,81.7,253,116,45.8
All Grades,All Students,2021-22,32984,7226,25758,78.1,212,134,63.2
All Grades,All Students,2022-23,28356,4966,23390,82.5,188,96,51.1
8,All Students,2019-20,3,s,s,s,s,s,s
9,All Students,2018-19,16380,4686,11694,71.4,117,72,61.5
9,All Students,2019-20,10451,2921,7530,72.1,104,68,65.4
9,All Students,2020-21,12288,2973,9315,75.8,75,44,58.7
9,All Students,2021-22,9726,2315,7411,76.2,61,37,60.7
9,All Students,2022-23,7228,1711,5517,76.3,50,32,64.0
10,All Students,2018-19,16270,3884,12386,76.1,109,68,62.4
10,All Students,2019-20,9791,1914,7877,80.5,96,56,58.3
10,All Students,2020-21,12187,2016,10171,83.5,74,33,44.6
10,All Students,2021-22,8464,1945,6519,77.0,56,40,71.4
10,All Students,2022-23,8003,1236,6767,84.6,52,25,48.1
11,All Students,2018-19,8878,1353,7525,84.8,62,30,48.4
11,All Students,2019-20,5607,s,s,s,s,s,s
11,All Students,2020-21,7517,656,6861,91.3,44,8,18.2
11,All Students,2021-22,8170,1497,6673,81.7,51,26,51.0
11,All Students,2022-23,6798,1234,5564,81.8,45,23,51.1
12,All Students,2018-19,10559,2249,8310,78.7,70,45,64.3
12,All Students,2019-20,6529,1038,5491,84.1,63,27,42.9
12,All Students,2020-21,9646,1973,7673,79.5,60,31,51.7
12,All Students,2021-22,6624,1469,5155,77.8,44,31,70.5
12,All Students,2022-23,6327,785,5542,87.6,41,16,39.0
All Grades,All Students,2018-19,87001,5338,81663,93.9,531,95,17.9
All Grades,All Students,2019-20,63950,3282,60668,94.9,591,90,15.2
All Grades,All Students,2020-21,102574,4485,98089,95.6,598,69,11.5
All Grades,All Students,2021-22,100491,6804,93687,93.2,576,124,21.5
All Grades,All Students,2022-23,95025,6437,88588,93.2,575,119,20.7
9,All Students,2018-19,21188,1012,20176,95.2,133,9,6.8
9,All Students,2019-20,17737,639,17098,96.4,165,15,9.1
9,All Students,2020-21,25886,1520,24366,94.1,151,24,15.9
9,All Students,2021-22,23922,1492,22430,93.8,138,24,17.4
9,All Students,2022-23,23148,1380,21768,94.0,144,26,18.1
10,All Students,2018-19,25904,1203,24701,95.4,157,18,11.5
10,All Students,2019-20,14990,628,14362,95.8,138,17,12.3
10,All Students,2020-21,27496,802,26694,97.1,161,9,5.6
10,All Students,2021-22,27006,1716,25290,93.6,155,30,19.4
10,All Students,2022-23,22929,1360,21569,94.1,137,25,18.2
11,All Students,2018-19,22345,1354,20991,93.9,136,26,19.1
11,All Students,2019-20,16639,708,15931,95.7,154,17,11.0
11,All Students,2020-21,23220,829,22391,96.4,135,13,9.6
11,All Students,2021-22,26475,1491,24984,94.4,150,21,14.0
11,All Students,2022-23,24401,1577,22824,93.5,146,28,19.2
12,All Students,2018-19,17564,1769,15795,89.9,105,42,40.0
12,All Students,2019-20,14584,1307,13277,91.0,134,41,30.6
12,All Students,2020-21,25972,1334,24638,94.9,151,23,15.2
12,All Students,2021-22,23088,2105,20983,90.9,133,49,36.8
12,All Students,2022-23,24547,2120,22427,91.4,148,40,27.0
All Grades,All Students,2018-19,92503,7425,85078,92.0,555,152,27.4
All Grades,All Students,2019-20,59579,4074,55505,93.2,548,111,20.3
All Grades,All Students,2020-21,98570,10746,87824,89.1,571,231,40.5
All Grades,All Students,2021-22,93033,12031,81002,87.1,563,233,41.4
All Grades,All Students,2022-23,85591,9957,75634,88.4,519,190,36.6
6,All Students,2018-19,10343,743,9600,92.8,61,19,31.1
6,All Students,2019-20,7705,533,7172,93.1,69,17,24.6
6,All Students,2020-21,14280,1563,12717,89.1,83,41,49.4
6,All Students,2021-22,13100,1440,11660,89.0,78,34,43.6
6,All Students,2022-23,9489,897,8592,90.5,57,23,40.4
7,All Students,2018-19,8806,693,8113,92.1,51,10,19.6
7,All Students,2020-21,11550,929,10621,92.0,66,24,36.4
7,All Students,2021-22,12416,1957,10459,84.2,75,43,57.3
7,All Students,2022-23,11987,1043,10944,91.3,69,26,37.7
8,All Students,2018-19,11870,1110,10760,90.6,70,22,31.4
8,All Students,2019-20,5222,360,4862,93.1,46,11,23.9
8,All Students,2020-21,8659,657,8002,92.4,50,15,30.0
8,All Students,2021-22,10597,1429,9168,86.5,62,36,58.1
8,All Students,2022-23,10681,1629,9052,84.7,62,34,54.8
9,All Students,2018-19,15619,1155,14464,92.6,96,27,28.1
9,All Students,2019-20,11101,1037,10064,90.7,104,21,20.2
9,All Students,2020-21,16091,2415,13676,85.0,94,40,42.6
9,All Students,2021-22,16400,2659,13741,83.8,97,38,39.2
9,All Students,2022-23,16612,2283,14329,86.3,104,34,32.7
10,All Students,2018-19,18191,1293,16898,92.9,110,22,20.0
10,All Students,2019-20,10875,588,10287,94.6,102,15,14.7
10,All Students,2020-21,17970,1956,16014,89.1,104,41,39.4
10,All Students,2021-22,14095,2028,12067,85.6,85,34,40.0
10,All Students,2022-23,14209,2076,12133,85.4,88,29,33.0
11,All Students,2018-19,13574,918,12656,93.2,83,18,21.7
11,All Students,2019-20,9796,534,9262,94.5,91,14,15.4
11,All Students,2020-21,15244,1490,13754,90.2,88,33,37.5
11,All Students,2021-22,12416,949,11467,92.4,77,19,24.7
11,All Students,2022-23,9949,736,9213,92.6,61,17,27.9
12,All Students,2018-19,14100,1513,12587,89.3,84,34,40.5
12,All Students,2019-20,9075,666,8409,92.7,84,21,25.0
12,All Students,2020-21,14776,1736,13040,88.3,86,37,43.0
12,All Students,2021-22,14009,1569,12440,88.8,89,29,32.6
12,All Students,2022-23,12664,1293,11371,89.8,78,27,34.6
All Grades,All Students,2018-19,70466,13570,56896,80.7,474,236,49.8
All Grades,All Students,2019-20,41061,6527,34534,84.1,389,178,45.8
All Grades,All Students,2020-21,50917,6919,43998,86.4,306,112,36.6
All Grades,All Students,2021-22,42323,7728,34595,81.7,269,146,54.3
All Grades,All Students,2022-23,36525,5135,31390,85.9,242,122,50.4
9,All Students,2018-19,17840,3178,14662,82.2,122,60,49.2
9,All Students,2019-20,13535,3134,10401,76.8,129,81,62.8
9,All Students,2020-21,16692,3424,13268,79.5,96,46,47.9
9,All Students,2021-22,12762,3111,9651,75.6,81,44,54.3
9,All Students,2022-23,14699,2577,12122,82.5,96,57,59.4
10,All Students,2018-19,18478,4536,13942,75.5,127,73,57.5
10,All Students,2019-20,10006,1479,8527,85.2,94,42,44.7
10,All Students,2020-21,13225,1625,11600,87.7,82,27,32.9
10,All Students,2021-22,11157,1979,9178,82.3,73,43,58.9
10,All Students,2022-23,8197,989,7208,87.9,54,23,42.6
11,All Students,2018-19,19606,2889,16717,85.3,124,47,37.9
11,All Students,2019-20,6713,649,6064,90.3,63,27,42.9
11,All Students,2020-21,9444,506,8938,94.6,57,14,24.6
11,All Students,2021-22,7691,1047,6644,86.4,48,21,43.8
11,All Students,2022-23,6638,739,5899,88.9,44,18,40.9
12,All Students,2018-19,14542,2967,11575,79.6,101,56,55.4
12,All Students,2019-20,10807,1265,9542,88.3,103,28,27.2
12,All Students,2020-21,11556,1364,10192,88.2,71,25,35.2
12,All Students,2021-22,10713,1591,9122,85.1,67,38,56.7
12,All Students,2022-23,6991,830,6161,88.1,48,24,50.0
All Grades,All Students,2018-19,84775,12260,72515,85.5,533,265,49.7
All Grades,All Students,2019-20,54484,8973,45511,83.5,519,294,56.6
All Grades,All Students,2020-21,84483,20249,64234,76.0,497,274,55.1
All Grades,All Students,2021-22,74593,17185,57408,77.0,477,324,67.9
All Grades,All Students,2022-23,64478,13077,51401,79.7,443,276,62.3
9,All Students,2018-19,22953,3547,19406,84.5,150,79,52.7
9,All Students,2019-20,15120,2723,12397,82.0,149,82,55.0
9,All Students,2020-21,27020,7548,19472,72.1,155,89,57.4
9,All Students,2021-22,20647,4708,15939,77.2,135,85,63.0
9,All Students,2022-23,19370,4463,14907,77.0,132,78,59.1
10,All Students,2018-19,25128,4079,21049,83.8,159,79,49.7
10,All Students,2019-20,15803,2655,13148,83.2,150,91,60.7
10,All Students,2020-21,22756,5722,17034,74.9,137,82,59.9
10,All Students,2021-22,26269,6577,19692,75.0,165,119,72.1
10,All Students,2022-23,19225,3643,15582,81.1,135,82,60.7
11,All Students,2018-19,21074,2740,18334,87.0,128,60,46.9
11,All Students,2019-20,12699,1803,10896,85.8,119,63,52.9
11,All Students,2020-21,15341,2956,12385,80.7,90,44,48.9
11,All Students,2021-22,12840,2610,10230,79.7,83,58,69.9
11,All Students,2022-23,12797,1995,10802,84.4,94,58,61.7
12,All Students,2018-19,15620,1894,13726,87.9,96,47,49.0
12,All Students,2019-20,10862,1792,9070,83.5,101,58,57.4
12,All Students,2020-21,19366,4023,15343,79.2,115,59,51.3
12,All Students,2021-22,14837,3290,11547,77.8,94,62,66.0
12,All Students,2022-23,13086,2976,10110,77.3,82,58,70.7
All Grades,All Students,2022-23,43006,7334,35672,82.9,281,190,67.6
PK in K-12 Schools,All Students,2022-23,42957,s,s,s,s,s,s
0K,All Students,2022-23,49,s,s,s,s,s,s
All Grades,All Students,2018-19,83818,14870,68948,82.3,545,290,53.2
All Grades,All Students,2019-20,54327,9998,44329,81.6,530,299,56.4
All Grades,All Students,2020-21,88835,16664,72171,81.2,516,238,46.1
All Grades,All Students,2021-22,83491,18947,64544,77.3,519,338,65.1
All Grades,All Students,2022-23,69950,12765,57185,81.8,460,219,47.6
9,All Students,2018-19,26593,4536,22057,82.9,170,77,45.3
9,All Students,2019-20,15403,3411,11992,77.9,155,91,58.7
9,All Students,2020-21,29737,6662,23075,77.6,170,81,47.6
9,All Students,2021-22,21869,4400,17469,79.9,135,73,54.1
9,All Students,2022-23,18533,3574,14959,80.7,122,53,43.4
10,All Students,2018-19,22817,4837,17980,78.8,153,90,58.8
10,All Students,2019-20,16613,2835,13778,82.9,167,90,53.9
10,All Students,2020-21,23389,4390,18999,81.2,136,71,52.2
10,All Students,2021-22,24929,7013,17916,71.9,160,115,71.9
10,All Students,2022-23,20261,4130,16131,79.6,140,68,48.6
11,All Students,2018-19,16960,2072,14888,87.8,109,43,39.4
11,All Students,2019-20,10596,1540,9056,85.5,99,51,51.5
11,All Students,2020-21,20133,3491,16642,82.7,117,51,43.6
11,All Students,2021-22,16601,3131,13470,81.1,102,65,63.7
11,All Students,2022-23,16961,2684,14277,84.2,108,50,46.3
12,All Students,2018-19,17448,3425,14023,80.4,113,80,70.8
12,All Students,2019-20,11715,2212,9503,81.1,109,67,61.5
12,All Students,2020-21,15576,2121,13455,86.4,93,35,37.6
12,All Students,2021-22,20092,4403,15689,78.1,122,85,69.7
12,All Students,2022-23,14195,2377,11818,83.3,90,48,53.3
All Grades,All Students,2018-19,102299,15827,86472,84.5,627,334,53.3
All Grades,All Students,2019-20,65336,10825,54511,83.4,616,295,47.9
All Grades,All Students,2020-21,105289,31778,73511,69.8,617,475,77.0
All Grades,All Students,2021-22,92397,21859,70538,76.3,592,458,77.4
All Grades,All Students,2022-23,91004,20041,70963,78.0,569,412,72.4
6,All Students,2018-19,15356,1393,13963,90.9,89,33,37.1
6,All Students,2019-20,9095,803,8292,91.2,86,24,27.9
6,All Students,2020-21,13834,3027,10807,78.1,86,56,65.1
6,All Students,2021-22,10163,1463,8700,85.6,61,40,65.6
6,All Students,2022-23,8266,1195,7071,85.5,50,27,54.0
7,All Students,2018-19,14211,1443,12768,89.8,86,32,37.2
7,All Students,2019-20,10057,1037,9020,89.7,92,35,38.0
7,All Students,2020-21,14663,3080,11583,79.0,84,54,64.3
7,All Students,2021-22,13579,2320,11259,82.9,83,57,68.7
7,All Students,2022-23,10796,1855,8941,82.8,65,42,64.6
8,All Students,2018-19,14960,2070,12890,86.2,87,44,50.6
8,All Students,2019-20,9731,1150,8581,88.2,89,29,32.6
8,All Students,2020-21,15250,4450,10800,70.8,89,74,83.1
8,All Students,2021-22,14607,2493,12114,82.9,88,60,68.2
8,All Students,2022-23,14256,2711,11545,81.0,87,63,72.4
9,All Students,2018-19,15379,2332,13047,84.8,100,57,57.0
9,All Students,2019-20,9696,1719,7977,82.3,94,45,47.9
9,All Students,2020-21,19352,6349,13003,67.2,114,86,75.4
9,All Students,2021-22,19103,5157,13946,73.0,118,99,83.9
9,All Students,2022-23,18563,4634,13929,75.0,117,90,76.9
10,All Students,2018-19,17179,3855,13324,77.6,110,68,61.8
10,All Students,2019-20,11149,2887,8262,74.1,110,79,71.8
10,All Students,2020-21,17273,7067,10206,59.1,99,86,86.9
10,All Students,2021-22,15364,4459,10905,71.0,102,76,74.5
10,All Students,2022-23,15757,3728,12029,76.3,106,84,79.2
11,All Students,2018-19,12414,2039,10375,83.6,79,43,54.4
11,All Students,2019-20,7717,1589,6128,79.4,72,41,56.9
11,All Students,2020-21,13325,4119,9206,69.1,77,63,81.8
11,All Students,2021-22,9629,2429,7200,74.8,59,47,79.7
11,All Students,2022-23,12318,2592,9726,79.0,77,48,62.3
12,All Students,2018-19,12800,2695,10105,78.9,76,57,75.0
12,All Students,2019-20,7891,1640,6251,79.2,73,42,57.5
12,All Students,2020-21,11592,3686,7906,68.2,68,56,82.4
12,All Students,2021-22,9952,3538,6414,64.4,81,79,97.5
12,All Students,2022-23,11048,3326,7722,69.9,67,58,86.6
All Grades,All Students,2018-19,43898,4570,39328,89.6,281,131,46.6
All Grades,All Students,2019-20,28324,2839,25485,90.0,262,103,39.3
All Grades,All Students,2020-21,40248,6734,33514,83.3,240,117,48.8
All Grades,All Students,2021-22,38785,6329,32456,83.7,245,138,56.3
All Grades,All Students,2022-23,31627,2796,28831,91.2,202,63,31.2
6,All Students,2018-19,12927,1628,11299,87.4,86,47,54.7
6,All Students,2019-20,9791,1019,8772,89.6,90,37,41.1
6,All Students,2020-21,11712,2373,9339,79.7,71,42,59.2
6,All Students,2021-22,11492,1803,9689,84.3,72,38,52.8
6,All Students,2022-23,6780,s,s,s,s,s,s
7,All Students,2018-19,13564,1143,12421,91.6,89,33,37.1
7,All Students,2019-20,9147,1050,8097,88.5,87,41,47.1
7,All Students,2020-21,14492,2188,12304,84.9,87,38,43.7
7,All Students,2021-22,13263,2597,10666,80.4,89,60,67.4
7,All Students,2022-23,11775,1076,10699,90.9,74,25,33.8
8,All Students,2018-19,17407,1799,15608,89.7,106,51,48.1
8,All Students,2019-20,9386,770,8616,91.8,85,25,29.4
8,All Students,2020-21,14044,2173,11871,84.5,82,37,45.1
8,All Students,2021-22,14030,1929,12101,86.3,84,40,47.6
8,All Students,2022-23,13041,950,12091,92.7,81,19,23.5
9,All Students,2022-23,31,s,s,s,s,s,s
All Grades,All Students,2018-19,75256,10096,65160,86.6,470,240,51.1
All Grades,All Students,2019-20,47666,5918,41748,87.6,444,207,46.6
All Grades,All Students,2020-21,76844,12449,64395,83.8,448,199,44.4
All Grades,All Students,2021-22,72635,12491,60144,82.8,443,257,58.0
All Grades,All Students,2022-23,67047,12455,54592,81.4,420,221,52.6
9,All Students,2018-19,21859,3162,18697,85.5,141,69,48.9
9,All Students,2019-20,15708,2006,13702,87.2,148,61,41.2
9,All Students,2020-21,26435,5533,20902,79.1,155,81,52.3
9,All Students,2021-22,25468,4384,21084,82.8,157,88,56.1
9,All Students,2022-23,21077,4209,16868,80.0,133,69,51.9
10,All Students,2018-19,20543,2395,18148,88.3,130,57,43.8
10,All Students,2019-20,9596,1047,8549,89.1,91,43,47.3
10,All Students,2020-21,18176,1864,16312,89.7,106,34,32.1
10,All Students,2021-22,17759,2590,15169,85.4,109,58,53.2
10,All Students,2022-23,15363,1928,13435,87.5,95,37,38.9
11,All Students,2018-19,16217,2057,14160,87.3,99,53,53.5
11,All Students,2019-20,11927,1509,10418,87.3,110,54,49.1
11,All Students,2020-21,14402,1904,12498,86.8,84,34,40.5
11,All Students,2021-22,16535,2900,13635,82.5,99,58,58.6
11,All Students,2022-23,16105,3397,12708,78.9,102,59,57.8
12,All Students,2018-19,16637,2482,14155,85.1,100,61,61.0
12,All Students,2019-20,10435,1356,9079,87.0,95,49,51.6
12,All Students,2020-21,17831,3148,14683,82.3,103,50,48.5
12,All Students,2021-22,12873,2617,10256,79.7,78,53,67.9
12,All Students,2022-23,14502,2921,11581,79.9,90,56,62.2
All Grades,All Students,2020-21,8925,927,7998,89.6,51,18,35.3
All Grades,All Students,2021-22,19612,1916,17696,90.2,119,36,30.3
All Grades,All Students,2022-23,28519,4120,24399,85.6,191,92,48.2
9,All Students,2020-21,8925,927,7998,89.6,51,18,35.3
9,All Students,2021-22,10993,1107,9886,89.9,67,18,26.9
9,All Students,2022-23,11381,1863,9518,83.6,79,40,50.6
10,All Students,2021-22,8599,s,s,s,s,s,s
10,All Students,2022-23,8940,1218,7722,86.4,60,26,43.3
11,All Students,2021-22,20,s,s,s,s,s,s
11,All Students,2022-23,8198,1039,7159,87.3,52,26,50.0
All Grades,All Students,2018-19,80156,14153,66003,82.3,540,287,53.1
All Grades,All Students,2019-20,51337,11455,39882,77.7,499,324,64.9
All Grades,All Students,2020-21,64572,11172,53400,82.7,393,233,59.3
All Grades,All Students,2021-22,48607,9892,38715,79.6,317,198,62.5
All Grades,All Students,2022-23,35827,6350,29477,82.3,242,126,52.1
9,All Students,2018-19,21868,4816,17052,78.0,143,81,56.6
9,All Students,2019-20,15592,4316,11276,72.3,152,107,70.4
9,All Students,2020-21,10440,2632,7808,74.8,62,39,62.9
9,All Students,2021-22,10005,1957,8048,80.4,67,37,55.2
9,All Students,2022-23,7098,1192,5906,83.2,48,25,52.1
10,All Students,2018-19,22827,4001,18826,82.5,161,84,52.2
10,All Students,2019-20,13751,2905,10846,78.9,138,86,62.3
10,All Students,2020-21,22781,4007,18774,82.4,137,87,63.5
10,All Students,2021-22,9286,2229,7057,76.0,62,40,64.5
10,All Students,2022-23,10558,2288,8270,78.3,72,42,58.3
11,All Students,2018-19,15126,2031,13095,86.6,103,41,39.8
11,All Students,2019-20,10466,1820,8646,82.6,102,53,52.0
11,All Students,2020-21,15589,2344,13245,85.0,95,56,58.9
11,All Students,2021-22,13843,2829,11014,79.6,89,55,61.8
11,All Students,2022-23,6581,1004,5577,84.7,46,25,54.3
12,All Students,2018-19,20335,3305,17030,83.7,133,81,60.9
12,All Students,2019-20,11528,2414,9114,79.1,108,79,73.1
12,All Students,2020-21,15762,2189,13573,86.1,99,51,51.5
12,All Students,2021-22,15473,2877,12596,81.4,99,66,66.7
12,All Students,2022-23,11590,1866,9724,83.9,76,34,44.7
All Grades,All Students,2018-19,102708,7161,95547,93.0,610,155,25.4
All Grades,All Students,2019-20,64891,4453,60438,93.1,586,136,23.2
All Grades,All Students,2020-21,101171,8108,93063,92.0,611,155,25.4
All Grades,All Students,2021-22,107277,11673,95604,89.1,659,280,42.5
All Grades,All Students,2022-23,111728,11371,100357,89.8,664,273,41.1
PK in K-12 Schools,All Students,2020-21,11093,1144,9949,89.7,65,23,35.4
PK in K-12 Schools,All Students,2021-22,11420,1383,10037,87.9,70,33,47.1
PK in K-12 Schools,All Students,2022-23,11611,1490,10121,87.2,66,33,50.0
0K,All Students,2018-19,14671,1309,13362,91.1,92,32,34.8
0K,All Students,2019-20,9241,705,8536,92.4,84,20,23.8
0K,All Students,2020-21,14549,1186,13363,91.8,91,27,29.7
0K,All Students,2021-22,18216,2430,15786,86.7,116,63,54.3
0K,All Students,2022-23,18597,2166,16431,88.4,111,54,48.6
1,All Students,2018-19,15030,1292,13738,91.4,88,29,33.0
1,All Students,2019-20,11161,1013,10148,90.9,103,41,39.8
1,All Students,2020-21,15433,1001,14432,93.5,95,16,16.8
1,All Students,2021-22,16612,1753,14859,89.4,102,40,39.2
1,All Students,2022-23,18955,2111,16844,88.9,112,52,46.4
2,All Students,2018-19,12852,s,s,s,s,s,s
2,All Students,2019-20,8497,690,7807,91.9,77,21,27.3
2,All Students,2020-21,17063,1233,15830,92.8,103,29,28.2
2,All Students,2021-22,17324,1764,15560,89.8,103,39,37.9
2,All Students,2022-23,16575,1702,14873,89.7,99,45,45.5
3,All Students,2018-19,17730,1117,16613,93.7,103,21,20.4
3,All Students,2019-20,8750,558,8192,93.6,79,13,16.5
3,All Students,2020-21,12686,882,11804,93.0,78,14,17.9
3,All Students,2021-22,16688,1770,14918,89.4,100,45,45.0
3,All Students,2022-23,16679,1328,15351,92.0,99,28,28.3
4,All Students,2018-19,23459,1501,21958,93.6,137,34,24.8
4,All Students,2019-20,11614,632,10982,94.6,104,19,18.3
4,All Students,2020-21,12530,1207,11323,90.4,74,20,27.0
4,All Students,2021-22,12632,1291,11341,89.8,82,31,37.8
4,All Students,2022-23,17125,1724,15401,89.9,105,44,41.9
5,All Students,2018-19,18912,1100,17812,94.2,112,22,19.6
5,All Students,2019-20,15628,855,14773,94.5,139,22,15.8
5,All Students,2020-21,17817,1455,16362,91.8,105,26,24.8
5,All Students,2021-22,14385,1282,13103,91.1,86,29,33.7
5,All Students,2022-23,12186,850,11336,93.0,72,17,23.6
6,All Students,2018-19,54,s,s,s,s,s,s
All Grades,All Students,2018-19,136164,9146,127018,93.3,816,208,25.5
All Grades,All Students,2019-20,86345,5700,80645,93.4,786,179,22.8
All Grades,All Students,2020-21,127853,11562,116291,91.0,756,240,31.7
All Grades,All Students,2021-22,125194,13523,111671,89.2,760,325,42.8
All Grades,All Students,2022-23,124981,12489,112492,90.0,759,319,42.0
PK in K-12 Schools,All Students,2018-19,9361,780,8581,91.7,58,21,36.2
PK in K-12 Schools,All Students,2019-20,6117,529,5588,91.4,54,17,31.5
PK in K-12 Schools,All Students,2020-21,9135,721,8414,92.1,57,20,35.1
PK in K-12 Schools,All Students,2021-22,9418,1258,8160,86.6,61,30,49.2
PK in K-12 Schools,All Students,2022-23,9237,s,s,s,s,s,s
0K,All Students,2018-19,22412,1813,20599,91.9,138,47,34.1
0K,All Students,2019-20,11294,924,10370,91.8,104,35,33.7
0K,All Students,2020-21,18117,2457,15660,86.4,111,48,43.2
0K,All Students,2021-22,18477,2383,16094,87.1,116,63,54.3
0K,All Students,2022-23,21437,2432,19005,88.7,132,71,53.8
1,All Students,2018-19,20489,1549,18940,92.4,120,35,29.2
1,All Students,2019-20,14530,1088,13442,92.5,132,34,25.8
1,All Students,2020-21,17764,1572,16192,91.2,105,30,28.6
1,All Students,2021-22,19361,2377,16984,87.7,116,59,50.9
1,All Students,2022-23,18474,2084,16390,88.7,112,54,48.2
2,All Students,2018-19,22800,1565,21235,93.1,136,35,25.7
2,All Students,2019-20,13334,850,12484,93.6,122,27,22.1
2,All Students,2020-21,22671,1962,20709,91.3,132,43,32.6
2,All Students,2021-22,17801,1993,15808,88.8,108,45,41.7
2,All Students,2022-23,19613,2020,17593,89.7,121,54,44.6
3,All Students,2018-19,19658,1248,18410,93.7,118,30,25.4
3,All Students,2019-20,13508,826,12682,93.9,123,22,17.9
3,All Students,2020-21,19309,1414,17895,92.7,113,27,23.9
3,All Students,2021-22,20494,2020,18474,90.1,127,46,36.2
3,All Students,2022-23,18127,1788,16339,90.1,108,39,36.1
4,All Students,2018-19,20894,978,19916,95.3,126,15,11.9
4,All Students,2019-20,13118,790,12328,94.0,118,23,19.5
4,All Students,2020-21,21063,1602,19461,92.4,122,31,25.4
4,All Students,2021-22,18555,1615,16940,91.3,108,38,35.2
4,All Students,2022-23,19202,1497,17705,92.2,112,31,27.7
5,All Students,2018-19,20550,1213,19337,94.1,120,25,20.8
5,All Students,2019-20,14444,693,13751,95.2,133,21,15.8
5,All Students,2020-21,19794,1834,17960,90.7,116,41,35.3
5,All Students,2021-22,21088,1877,19211,91.1,124,44,35.5
5,All Students,2022-23,18603,1398,17205,92.5,112,32,28.6
6,All Students,2022-23,288,s,s,s,s,s,s
All Grades,All Students,2018-19,120476,12438,108038,89.7,773,322,41.7
All Grades,All Students,2019-20,74510,7518,66992,89.9,733,299,40.8
All Grades,All Students,2020-21,97925,11914,86011,87.8,598,261,43.6
All Grades,All Students,2021-22,89975,15100,74875,83.2,585,393,67.2
All Grades,All Students,2022-23,87505,13334,74171,84.8,571,351,61.5
PK in K-12 Schools,All Students,2018-19,10808,1546,9262,85.7,71,39,54.9
PK in K-12 Schools,All Students,2019-20,9752,1598,8154,83.6,109,77,70.6
PK in K-12 Schools,All Students,2020-21,11390,1324,10066,88.4,79,36,45.6
PK in K-12 Schools,All Students,2021-22,15574,3058,12516,80.4,111,85,76.6
PK in K-12 Schools,All Students,2022-23,17654,3305,14349,81.3,115,89,77.4
0K,All Students,2018-19,11050,1359,9691,87.7,73,39,53.4
0K,All Students,2019-20,9614,1173,8441,87.8,94,51,54.3
0K,All Students,2020-21,11808,1762,10046,85.1,72,37,51.4
0K,All Students,2021-22,9496,1896,7600,80.0,66,50,75.8
0K,All Students,2022-23,13380,1954,11426,85.4,89,53,59.6
1,All Students,2018-19,19413,1933,17480,90.0,124,54,43.5
1,All Students,2019-20,7789,864,6925,88.9,80,36,45.0
1,All Students,2020-21,11756,1307,10449,88.9,72,26,36.1
1,All Students,2021-22,11523,2419,9104,79.0,78,57,73.1
1,All Students,2022-23,9691,1743,7948,82.0,69,44,63.8
2,All Students,2018-19,18303,1807,16496,90.1,120,42,35.0
2,All Students,2019-20,11247,896,10351,92.0,109,30,27.5
2,All Students,2020-21,12651,1836,10815,85.5,80,43,53.8
2,All Students,2021-22,9940,1599,8341,83.9,65,42,64.6
2,All Students,2022-23,11310,1632,9678,85.6,75,45,60.0
3,All Students,2018-19,18657,1932,16725,89.6,118,57,48.3
3,All Students,2019-20,12390,994,11396,92.0,117,31,26.5
3,All Students,2020-21,15834,1879,13955,88.1,94,42,44.7
3,All Students,2021-22,12194,1928,10266,84.2,73,54,74.0
3,All Students,2022-23,9796,1654,8142,83.1,64,45,70.3
4,All Students,2018-19,21158,1943,19215,90.8,135,48,35.6
4,All Students,2019-20,11614,921,10693,92.1,111,38,34.2
4,All Students,2020-21,17364,1996,15368,88.5,101,45,44.6
4,All Students,2021-22,15345,2106,13239,86.3,93,56,60.2
4,All Students,2022-23,11350,1493,9857,86.8,70,38,54.3
5,All Students,2018-19,21087,1918,19169,90.9,132,43,32.6
5,All Students,2019-20,12104,1072,11032,91.1,113,36,31.9
5,All Students,2020-21,17122,1810,15312,89.4,100,32,32.0
5,All Students,2021-22,15903,2094,13809,86.8,99,49,49.5
5,All Students,2022-23,14324,1553,12771,89.2,89,37,41.6
All Grades,All Students,2018-19,118265,12093,106172,89.8,730,326,44.7
All Grades,All Students,2019-20,70437,6064,64373,91.4,662,237,35.8
All Grades,All Students,2020-21,92470,12312,80158,86.7,566,241,42.6
All Grades,All Students,2021-22,90137,12946,77191,85.6,572,331,57.9
All Grades,All Students,2022-23,83263,9960,73303,88.0,512,261,51.0
PK in K-12 Schools,All Students,2018-19,9371,1130,8241,87.9,60,32,53.3
PK in K-12 Schools,All Students,2019-20,5886,593,5293,89.9,58,27,46.6
PK in K-12 Schools,All Students,2020-21,8544,1150,7394,86.5,57,23,40.4
PK in K-12 Schools,All Students,2021-22,11559,1945,9614,83.2,75,51,68.0
PK in K-12 Schools,All Students,2022-23,10578,1369,9209,87.1,66,34,51.5
0K,All Students,2018-19,16699,1830,14869,89.0,109,54,49.5
0K,All Students,2019-20,9384,1012,8372,89.2,91,44,48.4
0K,All Students,2020-21,11220,2060,9160,81.6,69,40,58.0
0K,All Students,2021-22,12513,2175,10338,82.6,80,57,71.3
0K,All Students,2022-23,11250,1480,9770,86.8,72,43,59.7
1,All Students,2018-19,15347,2067,13280,86.5,97,56,57.7
1,All Students,2019-20,10683,818,9865,92.3,99,30,30.3
1,All Students,2020-21,12844,2397,10447,81.3,77,46,59.7
1,All Students,2021-22,11544,s,s,s,s,s,s
1,All Students,2022-23,11395,1524,9871,86.6,67,45,67.2
2,All Students,2018-19,17564,1813,15751,89.7,108,50,46.3
2,All Students,2019-20,9171,931,8240,89.8,86,38,44.2
2,All Students,2020-21,14482,2045,12437,85.9,86,43,50.0
2,All Students,2021-22,12336,1599,10737,87.0,81,40,49.4
2,All Students,2022-23,11289,1170,10119,89.6,67,30,44.8
3,All Students,2018-19,20625,1848,18777,91.0,128,49,38.3
3,All Students,2019-20,11250,885,10365,92.1,104,35,33.7
3,All Students,2020-21,13275,1264,12011,90.5,79,21,26.6
3,All Students,2021-22,13314,1636,11678,87.7,81,40,49.4
3,All Students,2022-23,12079,1440,10639,88.1,78,37,47.4
4,All Students,2018-19,20025,1800,18225,91.0,119,45,37.8
4,All Students,2019-20,12061,903,11158,92.5,114,33,28.9
4,All Students,2020-21,14844,1560,13284,89.5,93,23,24.7
4,All Students,2021-22,13266,2013,11253,84.8,86,47,54.7
4,All Students,2022-23,13705,1197,12508,91.3,86,29,33.7
5,All Students,2018-19,18634,1605,17029,91.4,109,40,36.7
5,All Students,2019-20,12002,922,11080,92.3,110,30,27.3
5,All Students,2020-21,17261,1836,15425,89.4,105,45,42.9
5,All Students,2021-22,15595,1882,13713,87.9,93,50,53.8
5,All Students,2022-23,12967,1780,11187,86.3,76,43,56.6
6,All Students,2021-22,10,s,s,s,s,s,s
All Grades,All Students,2018-19,111579,8879,102700,92.0,663,201,30.3
All Grades,All Students,2019-20,69658,5464,64194,92.2,635,177,27.9
All Grades,All Students,2020-21,99814,8479,91335,91.5,584,158,27.1
All Grades,All Students,2021-22,92746,13069,79677,85.9,556,324,58.3
All Grades,All Students,2022-23,86999,9204,77795,89.4,523,227,43.4
PK in K-12 Schools,All Students,2018-19,9521,909,8612,90.5,56,28,50.0
PK in K-12 Schools,All Students,2019-20,6077,670,5407,89.0,56,28,50.0
PK in K-12 Schools,All Students,2020-21,7759,631,7128,91.9,47,14,29.8
PK in K-12 Schools,All Students,2021-22,8636,1673,6963,80.6,55,42,76.4
PK in K-12 Schools,All Students,2022-23,7975,1078,6897,86.5,52,27,51.9
0K,All Students,2018-19,16355,1740,14615,89.4,98,40,40.8
0K,All Students,2019-20,10300,972,9328,90.6,95,32,33.7
0K,All Students,2020-21,13525,1034,12491,92.4,81,20,24.7
0K,All Students,2021-22,12890,1873,11017,85.5,77,46,59.7
0K,All Students,2022-23,11415,1495,9920,86.9,71,40,56.3
1,All Students,2018-19,15834,1277,14557,91.9,97,31,32.0
1,All Students,2019-20,10212,892,9320,91.3,90,34,37.8
1,All Students,2020-21,14866,1158,13708,92.2,87,22,25.3
1,All Students,2021-22,14445,1980,12465,86.3,88,50,56.8
1,All Students,2022-23,13668,1372,12296,90.0,80,34,42.5
2,All Students,2018-19,16033,1324,14709,91.7,94,30,31.9
2,All Students,2019-20,9839,697,9142,92.9,90,21,23.3
2,All Students,2020-21,14725,1327,13398,91.0,86,23,26.7
2,All Students,2021-22,14552,1987,12565,86.3,85,50,58.8
2,All Students,2022-23,14215,1403,12812,90.1,85,31,36.5
3,All Students,2018-19,19507,1374,18133,93.0,117,25,21.4
3,All Students,2019-20,9492,642,8850,93.2,85,15,17.6
3,All Students,2020-21,14786,1438,13348,90.3,87,27,31.0
3,All Students,2021-22,13044,1933,11111,85.2,77,50,64.9
3,All Students,2022-23,14368,1425,12943,90.1,86,35,40.7
4,All Students,2018-19,16985,995,15990,94.1,101,19,18.8
4,All Students,2019-20,12744,931,11813,92.7,117,32,27.4
4,All Students,2020-21,14726,1521,13205,89.7,85,30,35.3
4,All Students,2021-22,15069,1864,13205,87.6,88,40,45.5
4,All Students,2022-23,11889,1261,10628,89.4,70,36,51.4
5,All Students,2018-19,17344,1260,16084,92.7,100,28,28.0
5,All Students,2019-20,10994,660,10334,94.0,102,15,14.7
5,All Students,2020-21,19427,1370,18057,92.9,111,22,19.8
5,All Students,2021-22,14110,1759,12351,87.5,86,46,53.5
5,All Students,2022-23,13469,1170,12299,91.3,79,24,30.4
All Grades,All Students,2018-19,279488,19591,259897,93.0,1638,408,24.9
All Grades,All Students,2019-20,167899,11389,156510,93.2,1525,356,23.3
All Grades,All Students,2020-21,245577,21651,223926,91.2,1441,394,27.3
All Grades,All Students,2021-22,222317,22839,199478,89.7,1316,536,40.7
All Grades,All Students,2022-23,210604,18448,192156,91.2,1259,432,34.3
0K,All Students,2018-19,21815,1937,19878,91.1,134,50,37.3
0K,All Students,2019-20,12833,989,11844,92.3,122,35,28.7
0K,All Students,2020-21,23037,2202,20835,90.4,139,42,30.2
0K,All Students,2021-22,17915,2135,15780,88.1,109,49,45.0
0K,All Students,2022-23,16644,1948,14696,88.3,103,49,47.6
1,All Students,2018-19,26055,2091,23964,92.0,155,47,30.3
1,All Students,2019-20,14394,1204,13190,91.6,132,41,31.1
1,All Students,2020-21,21453,2166,19287,89.9,125,38,30.4
1,All Students,2021-22,25067,2656,22411,89.4,151,62,41.1
1,All Students,2022-23,19308,1941,17367,89.9,122,50,41.0
2,All Students,2018-19,26623,1970,24653,92.6,157,39,24.8
2,All Students,2019-20,17007,1273,15734,92.5,159,42,26.4
2,All Students,2020-21,21321,2358,18963,88.9,129,46,35.7
2,All Students,2021-22,21787,1845,19942,91.5,129,42,32.6
2,All Students,2022-23,25109,2217,22892,91.2,151,54,35.8
3,All Students,2018-19,31133,2050,29083,93.4,184,42,22.8
3,All Students,2019-20,17584,1167,16417,93.4,158,33,20.9
3,All Students,2020-21,26485,2633,23852,90.1,157,48,30.6
3,All Students,2021-22,22167,2543,19624,88.5,134,62,46.3
3,All Students,2022-23,21341,1760,19581,91.8,130,41,31.5
4,All Students,2018-19,36193,2227,33966,93.8,215,49,22.8
4,All Students,2019-20,19153,1239,17914,93.5,177,44,24.9
4,All Students,2020-21,26641,2780,23861,89.6,154,58,37.7
4,All Students,2021-22,27436,3356,24080,87.8,165,81,49.1
4,All Students,2022-23,23298,2049,21249,91.2,138,44,31.9
5,All Students,2018-19,36080,2508,33572,93.0,211,46,21.8
5,All Students,2019-20,23276,1360,21916,94.2,214,39,18.2
5,All Students,2020-21,29867,2321,27546,92.2,175,46,26.3
5,All Students,2021-22,26087,2529,23558,90.3,153,62,40.5
5,All Students,2022-23,28618,2621,25997,90.8,173,66,38.2
6,All Students,2018-19,38151,2230,35921,94.2,218,45,20.6
6,All Students,2019-20,21659,1372,20287,93.7,193,40,20.7
6,All Students,2020-21,32210,2186,30024,93.2,189,35,18.5
6,All Students,2021-22,27273,2341,24932,91.4,158,58,36.7
6,All Students,2022-23,24597,1822,22775,92.6,144,39,27.1
7,All Students,2018-19,32781,2040,30741,93.8,189,36,19.0
7,All Students,2019-20,22963,1441,21522,93.7,201,42,20.9
7,All Students,2020-21,30831,2614,28217,91.5,178,38,21.3
7,All Students,2021-22,27342,2622,24720,90.4,160,57,35.6
7,All Students,2022-23,25748,1910,23838,92.6,147,41,27.9
8,All Students,2018-19,30657,2538,28119,91.7,175,54,30.9
8,All Students,2019-20,19030,1344,17686,92.9,169,40,23.7
8,All Students,2020-21,33732,2391,31341,92.9,195,43,22.1
8,All Students,2021-22,27243,2812,24431,89.7,157,63,40.1
8,All Students,2022-23,25941,2180,23761,91.6,151,48,31.8
All Grades,All Students,2018-19,134782,13293,121489,90.1,807,339,42.0
All Grades,All Students,2019-20,83862,7930,75932,90.5,773,299,38.7
All Grades,All Students,2020-21,118382,10196,108186,91.4,704,220,31.3
All Grades,All Students,2021-22,111015,16727,94288,84.9,690,424,61.4
All Grades,All Students,2022-23,107568,13583,93985,87.4,655,357,54.5
PK in K-12 Schools,All Students,2018-19,9829,1113,8716,88.7,59,31,52.5
PK in K-12 Schools,All Students,2019-20,7383,898,6485,87.8,72,36,50.0
PK in K-12 Schools,All Students,2020-21,10211,s,s,s,s,s,s
PK in K-12 Schools,All Students,2021-22,9154,1890,7264,79.4,63,48,76.2
PK in K-12 Schools,All Students,2022-23,11062,s,s,s,s,s,s
0K,All Students,2018-19,17925,1977,15948,89.0,112,53,47.3
0K,All Students,2019-20,11388,1403,9985,87.7,108,56,51.9
0K,All Students,2020-21,14890,1858,13032,87.5,89,39,43.8
0K,All Students,2021-22,15991,2581,13410,83.9,104,73,70.2
0K,All Students,2022-23,15670,2258,13412,85.6,101,58,57.4
1,All Students,2018-19,21313,2112,19201,90.1,130,56,43.1
1,All Students,2019-20,10239,859,9380,91.6,94,30,31.9
1,All Students,2020-21,16356,2127,14229,87.0,100,46,46.0
1,All Students,2021-22,14435,2086,12349,85.5,89,50,56.2
1,All Students,2022-23,15218,1923,13295,87.4,92,55,59.8
2,All Students,2018-19,22530,2086,20444,90.7,133,55,41.4
2,All Students,2019-20,13320,1278,12042,90.4,123,51,41.5
2,All Students,2020-21,14849,1157,13692,92.2,87,26,29.9
2,All Students,2021-22,15416,2565,12851,83.4,95,61,64.2
2,All Students,2022-23,15165,1649,13516,89.1,90,47,52.2
3,All Students,2018-19,20252,2008,18244,90.1,120,53,44.2
3,All Students,2019-20,14812,1242,13570,91.6,134,46,34.3
3,All Students,2020-21,20151,1783,18368,91.2,119,36,30.3
3,All Students,2021-22,14384,1917,12467,86.7,86,45,52.3
3,All Students,2022-23,14444,1760,12684,87.8,90,48,53.3
4,All Students,2018-19,19165,1843,17322,90.4,109,35,32.1
4,All Students,2019-20,14478,1309,13169,91.0,131,46,35.1
4,All Students,2020-21,20868,802,20066,96.2,122,16,13.1
4,All Students,2021-22,20666,2966,17700,85.6,127,73,57.5
4,All Students,2022-23,14776,1495,13281,89.9,88,34,38.6
5,All Students,2018-19,23768,2154,21614,90.9,144,56,38.9
5,All Students,2019-20,12242,941,11301,92.3,111,34,30.6
5,All Students,2020-21,21035,1830,19205,91.3,126,42,33.3
5,All Students,2021-22,20969,2722,18247,87.0,126,74,58.7
5,All Students,2022-23,21111,2668,18443,87.4,125,65,52.0
6,All Students,2020-21,22,s,s,s,s,s,s
6,All Students,2022-23,122,s,s,s,s,s,s
All Grades,All Students,2018-19,104929,9775,95154,90.7,652,254,39.0
All Grades,All Students,2019-20,68685,5580,63105,91.9,633,190,30.0
All Grades,All Students,2020-21,92380,8443,83937,90.9,561,171,30.5
All Grades,All Students,2021-22,84024,10628,73396,87.4,521,282,54.1
All Grades,All Students,2022-23,92112,12061,80051,86.9,574,322,56.1
PK in K-12 Schools,All Students,2018-19,10874,1424,9450,86.9,71,41,57.7
PK in K-12 Schools,All Students,2019-20,10235,1056,9179,89.7,97,36,37.1
PK in K-12 Schools,All Students,2020-21,13030,754,12276,94.2,83,16,19.3
PK in K-12 Schools,All Students,2021-22,13651,1754,11897,87.2,90,49,54.4
PK in K-12 Schools,All Students,2022-23,16037,2386,13651,85.1,106,64,60.4
0K,All Students,2018-19,13640,1487,12153,89.1,88,42,47.7
0K,All Students,2019-20,8818,743,8075,91.6,82,26,31.7
0K,All Students,2020-21,11362,1213,10149,89.3,73,30,41.1
0K,All Students,2021-22,10958,1626,9332,85.2,72,47,65.3
0K,All Students,2022-23,13050,1829,11221,86.0,81,44,54.3
1,All Students,2018-19,13672,1542,12130,88.7,85,38,44.7
1,All Students,2019-20,9836,987,8849,90.0,92,40,43.5
1,All Students,2020-21,12393,1090,11303,91.2,75,23,30.7
1,All Students,2021-22,10955,1703,9252,84.5,70,41,58.6
1,All Students,2022-23,11817,1768,10049,85.0,74,48,64.9
2,All Students,2018-19,14196,1032,13164,92.7,91,31,34.1
2,All Students,2019-20,8617,806,7811,90.6,78,28,35.9
2,All Students,2020-21,13571,1602,11969,88.2,81,29,35.8
2,All Students,2021-22,11466,1128,10338,90.2,69,29,42.0
2,All Students,2022-23,10921,s,s,s,s,s,s
3,All Students,2018-19,16234,1457,14777,91.0,99,38,38.4
3,All Students,2019-20,9088,601,8487,93.4,83,18,21.7
3,All Students,2020-21,13125,1066,12059,91.9,76,20,26.3
3,All Students,2021-22,11810,1652,10158,86.0,71,45,63.4
3,All Students,2022-23,13244,1297,11947,90.2,79,33,41.8
4,All Students,2018-19,17694,1376,16318,92.2,110,32,29.1
4,All Students,2019-20,10790,770,10020,92.9,99,24,24.2
4,All Students,2020-21,13491,1310,12181,90.3,81,26,32.1
4,All Students,2021-22,12427,1469,10958,88.2,73,40,54.8
4,All Students,2022-23,14227,1782,12445,87.5,86,46,53.5
5,All Students,2018-19,18619,1457,17162,92.2,108,32,29.6
5,All Students,2019-20,11301,617,10684,94.5,102,18,17.6
5,All Students,2020-21,15408,1408,14000,90.9,92,27,29.3
5,All Students,2021-22,12757,1296,11461,89.8,76,31,40.8
5,All Students,2022-23,12647,1440,11207,88.6,80,45,56.3
6,All Students,2022-23,169,s,s,s,s,s,s
All Grades,All Students,2018-19,61528,6460,55068,89.5,381,170,44.6
All Grades,All Students,2019-20,44914,4982,39932,88.9,419,180,43.0
All Grades,All Students,2020-21,61523,4853,56670,92.1,377,88,23.3
All Grades,All Students,2021-22,63990,10026,53964,84.3,405,257,63.5
All Grades,All Students,2022-23,62274,8334,53940,86.6,384,207,53.9
PK in K-12 Schools,All Students,2018-19,14420,2043,12377,85.8,92,56,60.9
PK in K-12 Schools,All Students,2019-20,14737,2229,12508,84.9,135,75,55.6
PK in K-12 Schools,All Students,2020-21,15733,734,14999,95.3,99,17,17.2
PK in K-12 Schools,All Students,2021-22,21458,3884,17574,81.9,141,104,73.8
PK in K-12 Schools,All Students,2022-23,21041,3265,17776,84.5,130,78,60.0
0K,All Students,2018-19,9088,967,8121,89.4,56,29,51.8
0K,All Students,2019-20,4323,467,3856,89.2,43,18,41.9
0K,All Students,2020-21,7967,419,7548,94.7,52,9,17.3
0K,All Students,2021-22,7216,966,6250,86.6,45,26,57.8
0K,All Students,2022-23,6816,1060,5756,84.4,49,32,65.3
1,All Students,2018-19,7662,880,6782,88.5,49,24,49.0
1,All Students,2019-20,5395,496,4899,90.8,50,18,36.0
1,All Students,2020-21,6314,570,5744,91.0,39,12,30.8
1,All Students,2021-22,6064,890,5174,85.3,40,17,42.5
1,All Students,2022-23,6512,701,5811,89.2,41,22,53.7
2,All Students,2018-19,7686,664,7022,91.4,49,16,32.7
2,All Students,2019-20,5170,523,4647,89.9,50,25,50.0
2,All Students,2020-21,8526,955,7571,88.8,50,17,34.0
2,All Students,2021-22,6606,837,5769,87.3,41,20,48.8
2,All Students,2022-23,6179,791,5388,87.2,35,17,48.6
3,All Students,2018-19,7136,622,6514,91.3,45,16,35.6
3,All Students,2019-20,4937,472,4465,90.4,45,16,35.6
3,All Students,2020-21,7734,904,6830,88.3,47,17,36.2
3,All Students,2021-22,7563,1140,6423,84.9,50,33,66.0
3,All Students,2022-23,6389,751,5638,88.2,38,17,44.7
4,All Students,2018-19,7986,659,7327,91.7,47,16,34.0
4,All Students,2019-20,5027,429,4598,91.5,47,15,31.9
4,All Students,2020-21,7803,627,7176,92.0,46,7,15.2
4,All Students,2021-22,7189,1144,6045,84.1,42,29,69.0
4,All Students,2022-23,8454,994,7460,88.2,51,21,41.2
5,All Students,2018-19,7550,625,6925,91.7,43,13,30.2
5,All Students,2019-20,5325,366,4959,93.1,49,13,26.5
5,All Students,2020-21,7446,644,6802,91.4,44,9,20.5
5,All Students,2021-22,7894,1165,6729,85.2,46,28,60.9
5,All Students,2022-23,6038,s,s,s,s,s,s
6,All Students,2022-23,845,s,s,s,s,s,s
All Grades,All Students,2018-19,100912,10153,90759,89.9,628,276,43.9
All Grades,All Students,2019-20,62410,6249,56161,90.0,583,243,41.7
All Grades,All Students,2020-21,93191,8412,84779,91.0,558,186,33.3
All Grades,All Students,2021-22,78354,10540,67814,86.5,481,254,52.8
All Grades,All Students,2022-23,82828,9902,72926,88.0,512,256,50.0
PK in K-12 Schools,All Students,2018-19,6185,763,5422,87.7,41,21,51.2
PK in K-12 Schools,All Students,2019-20,3998,412,3586,89.7,39,15,38.5
PK in K-12 Schools,All Students,2020-21,7547,710,6837,90.6,47,18,38.3
PK in K-12 Schools,All Students,2021-22,8622,1194,7428,86.2,52,27,51.9
PK in K-12 Schools,All Students,2022-23,8834,1189,7645,86.5,55,33,60.0
0K,All Students,2018-19,13991,1733,12258,87.6,84,45,53.6
0K,All Students,2019-20,9055,1278,7777,85.9,87,52,59.8
0K,All Students,2020-21,11844,1071,10773,91.0,73,22,30.1
0K,All Students,2021-22,9734,1534,8200,84.2,62,41,66.1
0K,All Students,2022-23,13142,1840,11302,86.0,82,52,63.4
1,All Students,2018-19,14938,1592,13346,89.3,94,47,50.0
1,All Students,2019-20,8760,951,7809,89.1,80,39,48.8
1,All Students,2020-21,13090,1266,11824,90.3,77,30,39.0
1,All Students,2021-22,11125,1429,9696,87.2,70,37,52.9
1,All Students,2022-23,11670,1412,10258,87.9,70,36,51.4
2,All Students,2018-19,17200,1505,15695,91.3,105,42,40.0
2,All Students,2019-20,8738,870,7868,90.0,81,36,44.4
2,All Students,2020-21,12994,1362,11632,89.5,79,35,44.3
2,All Students,2021-22,12341,1724,10617,86.0,75,39,52.0
2,All Students,2022-23,12661,1298,11363,89.7,79,32,40.5
3,All Students,2018-19,17978,1666,16312,90.7,115,46,40.0
3,All Students,2019-20,10996,914,10082,91.7,103,37,35.9
3,All Students,2020-21,12083,1189,10894,90.2,72,21,29.2
3,All Students,2021-22,11598,1547,10051,86.7,71,37,52.1
3,All Students,2022-23,12738,1527,11211,88.0,81,38,46.9
4,All Students,2018-19,13552,1198,12354,91.2,82,32,39.0
4,All Students,2019-20,11913,1003,10910,91.6,110,36,32.7
4,All Students,2020-21,17412,1332,16080,92.4,102,27,26.5
4,All Students,2021-22,10045,1297,8748,87.1,60,27,45.0
4,All Students,2022-23,12944,1487,11457,88.5,79,39,49.4
5,All Students,2018-19,17068,1696,15372,90.1,107,43,40.2
5,All Students,2019-20,8950,821,8129,90.8,83,28,33.7
5,All Students,2020-21,18221,1482,16739,91.9,108,33,30.6
5,All Students,2021-22,14889,1815,13074,87.8,91,46,50.5
5,All Students,2022-23,10839,1149,9690,89.4,66,26,39.4
All Grades,All Students,2018-19,96750,5223,91527,94.6,552,74,13.4
All Grades,All Students,2019-20,62796,3016,59780,95.2,555,75,13.5
All Grades,All Students,2020-21,95587,2504,93083,97.4,554,36,6.5
All Grades,All Students,2021-22,94829,6793,88036,92.8,545,127,23.3
All Grades,All Students,2022-23,94661,6338,88323,93.3,548,121,22.1
6,All Students,2018-19,31920,1494,30426,95.3,183,18,9.8
6,All Students,2019-20,22037,1004,21033,95.4,195,23,11.8
6,All Students,2020-21,33905,702,33203,97.9,199,12,6.0
6,All Students,2021-22,32995,2268,30727,93.1,192,43,22.4
6,All Students,2022-23,34972,2411,32561,93.1,203,50,24.6
7,All Students,2018-19,33905,1889,32016,94.4,194,26,13.4
7,All Students,2019-20,19822,886,18936,95.5,176,23,13.1
7,All Students,2020-21,32094,921,31173,97.1,185,13,7.0
7,All Students,2021-22,31812,2006,29806,93.7,182,34,18.7
7,All Students,2022-23,29796,1885,27911,93.7,174,35,20.1
8,All Students,2018-19,30925,1840,29085,94.1,175,30,17.1
8,All Students,2019-20,20937,1126,19811,94.6,184,29,15.8
8,All Students,2020-21,29588,881,28707,97.0,170,11,6.5
8,All Students,2021-22,30020,s,s,s,s,s,s
8,All Students,2022-23,29893,2042,27851,93.2,171,36,21.1
9,All Students,2021-22,2,s,s,s,s,s,s
All Grades,All Students,2018-19,97247,11302,85945,88.4,589,303,51.4
All Grades,All Students,2019-20,66549,6890,59659,89.6,612,259,42.3
All Grades,All Students,2020-21,92014,9256,82758,89.9,552,177,32.1
All Grades,All Students,2021-22,86399,13639,72760,84.2,531,337,63.5
All Grades,All Students,2022-23,77288,11278,66010,85.4,479,295,61.6
PK in K-12 Schools,All Students,2018-19,6111,s,s,s,s,s,s
PK in K-12 Schools,All Students,2019-20,5727,s,s,s,s,s,s
PK in K-12 Schools,All Students,2020-21,7082,182,6900,97.4,45,3,6.7
PK in K-12 Schools,All Students,2021-22,7951,1091,6860,86.3,50,30,60.0
PK in K-12 Schools,All Students,2022-23,8557,1572,6985,81.6,53,40,75.5
0K,All Students,2018-19,15098,2403,12695,84.1,96,62,64.6
0K,All Students,2019-20,10390,1250,9140,88.0,95,49,51.6
0K,All Students,2020-21,10797,1442,9355,86.6,69,30,43.5
0K,All Students,2021-22,11518,2179,9339,81.1,75,55,73.3
0K,All Students,2022-23,8339,s,s,s,s,s,s
1,All Students,2018-19,14051,1787,12264,87.3,83,50,60.2
1,All Students,2019-20,9971,1040,8931,89.6,91,41,45.1
1,All Students,2020-21,16051,2598,13453,83.8,96,47,49.0
1,All Students,2021-22,10642,2014,8628,81.1,67,45,67.2
1,All Students,2022-23,12686,1954,10732,84.6,77,44,57.1
2,All Students,2018-19,17562,1928,15634,89.0,105,56,53.3
2,All Students,2019-20,8825,903,7922,89.8,84,37,44.0
2,All Students,2020-21,13711,1315,12396,90.4,82,32,39.0
2,All Students,2021-22,14076,2579,11497,81.7,87,61,70.1
2,All Students,2022-23,9712,1491,8221,84.6,60,40,66.7
3,All Students,2018-19,15505,1644,13861,89.4,93,46,49.5
3,All Students,2019-20,11047,987,10060,91.1,101,34,33.7
3,All Students,2020-21,12559,1000,11559,92.0,74,15,20.3
3,All Students,2021-22,14305,1836,12469,87.2,86,48,55.8
3,All Students,2022-23,11692,1649,10043,85.9,72,41,56.9
4,All Students,2018-19,14968,1494,13474,90.0,91,38,41.8
4,All Students,2019-20,10616,916,9700,91.4,98,33,33.7
4,All Students,2020-21,15689,1266,14423,91.9,90,23,25.6
4,All Students,2021-22,12335,1831,10504,85.2,73,43,58.9
4,All Students,2022-23,14001,1486,12515,89.4,85,41,48.2
5,All Students,2018-19,13782,1279,12503,90.7,82,32,39.0
5,All Students,2019-20,9971,913,9058,90.8,91,32,35.2
5,All Students,2020-21,16125,1453,14672,91.0,96,27,28.1
5,All Students,2021-22,15572,2109,13463,86.5,93,55,59.1
5,All Students,2022-23,12050,1534,10516,87.3,72,42,58.3
6,All Students,2018-19,170,s,s,s,s,s,s
6,All Students,2019-20,2,s,s,s,s,s,s
6,All Students,2022-23,251,s,s,s,s,s,s
All Grades,All Students,2018-19,142257,11527,130730,91.9,852,270,31.7
All Grades,All Students,2019-20,84348,6085,78263,92.8,776,199,25.6
All Grades,All Students,2020-21,110101,7321,102780,93.4,647,149,23.0
All Grades,All Students,2021-22,98891,12002,86889,87.9,608,293,48.2
All Grades,All Students,2022-23,95187,10228,84959,89.3,585,251,42.9
PK in K-12 Schools,All Students,2018-19,6362,836,5526,86.9,38,23,60.5
PK in K-12 Schools,All Students,2019-20,4100,s,s,s,s,s,s
PK in K-12 Schools,All Students,2020-21,3019,191,2828,93.7,18,4,22.2
PK in K-12 Schools,All Students,2021-22,3088,s,s,s,s,s,s
PK in K-12 Schools,All Students,2022-23,3160,486,2674,84.6,19,13,68.4
0K,All Students,2018-19,18686,1947,16739,89.6,110,46,41.8
0K,All Students,2019-20,9682,917,8765,90.5,94,33,35.1
0K,All Students,2020-21,11996,719,11277,94.0,72,13,18.1
0K,All Students,2021-22,12422,1914,10508,84.6,77,48,62.3
0K,All Students,2022-23,13761,1816,11945,86.8,85,49,57.6
1,All Students,2018-19,19952,1706,18246,91.4,117,39,33.3
1,All Students,2019-20,12151,998,11153,91.8,112,37,33.0
1,All Students,2020-21,15228,1116,14112,92.7,88,23,26.1
1,All Students,2021-22,13475,1776,11699,86.8,84,44,52.4
1,All Students,2022-23,14332,1611,12721,88.8,89,41,46.1
2,All Students,2018-19,23857,1732,22125,92.7,144,41,28.5
2,All Students,2019-20,12226,1053,11173,91.4,113,38,33.6
2,All Students,2020-21,17318,1039,16279,94.0,103,18,17.5
2,All Students,2021-22,14633,1585,13048,89.2,92,44,47.8
2,All Students,2022-23,14522,1429,13093,90.2,87,35,40.2
3,All Students,2018-19,24647,1771,22876,92.8,149,45,30.2
3,All Students,2019-20,14698,850,13848,94.2,134,21,15.7
3,All Students,2020-21,17798,1028,16770,94.2,104,23,22.1
3,All Students,2021-22,17386,2185,15201,87.4,107,55,51.4
3,All Students,2022-23,14056,1453,12603,89.7,86,32,37.2
4,All Students,2018-19,24940,1723,23217,93.1,150,37,24.7
4,All Students,2019-20,15540,951,14589,93.9,143,30,21.0
4,All Students,2020-21,21207,1508,19699,92.9,125,32,25.6
4,All Students,2021-22,16459,2050,14409,87.5,101,46,45.5
4,All Students,2022-23,17466,1601,15865,90.8,110,36,32.7
5,All Students,2018-19,23813,1812,22001,92.4,144,39,27.1
5,All Students,2019-20,15950,839,15111,94.7,144,23,16.0
5,All Students,2020-21,23535,1720,21815,92.7,137,36,26.3
5,All Students,2021-22,21415,2047,19368,90.4,128,47,36.7
5,All Students,2022-23,17890,1832,16058,89.8,109,45,41.3
6,All Students,2019-20,1,s,s,s,s,s,s
7,All Students,2021-22,13,s,s,s,s,s,s
All Grades,All Students,2018-19,74816,5989,68827,92.0,450,145,32.2
All Grades,All Students,2019-20,56240,4542,51698,91.9,510,154,30.2
All Grades,All Students,2020-21,87917,9398,78519,89.3,517,163,31.5
All Grades,All Students,2021-22,96196,10883,85313,88.7,578,257,44.5
All Grades,All Students,2022-23,98335,9895,88440,89.9,598,228,38.1
6,All Students,2018-19,27357,2018,25339,92.6,164,54,32.9
6,All Students,2019-20,20596,1437,19159,93.0,189,53,28.0
6,All Students,2020-21,29276,3053,26223,89.6,173,47,27.2
6,All Students,2021-22,33670,3500,30170,89.6,205,80,39.0
6,All Students,2022-23,31614,2628,28986,91.7,191,62,32.5
7,All Students,2018-19,24540,2057,22483,91.6,148,46,31.1
7,All Students,2019-20,17828,1409,16419,92.1,161,49,30.4
7,All Students,2020-21,31510,4056,27454,87.1,187,79,42.2
7,All Students,2021-22,30248,3318,26930,89.0,180,76,42.2
7,All Students,2022-23,35684,3861,31823,89.2,216,90,41.7
8,All Students,2018-19,22919,1914,21005,91.6,138,45,32.6
8,All Students,2019-20,17814,s,s,s,s,s,s
8,All Students,2020-21,27131,2289,24842,91.6,157,37,23.6
8,All Students,2021-22,32278,4065,28213,87.4,193,101,52.3
8,All Students,2022-23,31032,s,s,s,s,s,s
9,All Students,2019-20,2,s,s,s,s,s,s
9,All Students,2022-23,5,s,s,s,s,s,s
All Grades,All Students,2018-19,77549,7396,70153,90.5,464,182,39.2
All Grades,All Students,2019-20,45781,4081,41700,91.1,426,134,31.5
All Grades,All Students,2020-21,62624,6373,56251,89.8,381,140,36.7
All Grades,All Students,2021-22,55733,8434,47299,84.9,355,220,62.0
All Grades,All Students,2022-23,52519,6725,45794,87.2,330,185,56.1
PK in K-12 Schools,All Students,2018-19,5962,605,5357,89.9,38,16,42.1
PK in K-12 Schools,All Students,2019-20,5507,674,4833,87.8,52,20,38.5
PK in K-12 Schools,All Students,2020-21,6957,1043,5914,85.0,45,22,48.9
PK in K-12 Schools,All Students,2021-22,6806,1522,5284,77.6,47,34,72.3
PK in K-12 Schools,All Students,2022-23,6886,1099,5787,84.0,43,30,69.8
0K,All Students,2018-19,9954,1230,8724,87.6,63,32,50.8
0K,All Students,2019-20,5328,439,4889,91.8,49,14,28.6
0K,All Students,2020-21,7145,1056,6089,85.2,44,22,50.0
0K,All Students,2021-22,6849,1000,5849,85.4,44,28,63.6
0K,All Students,2022-23,4761,887,3874,81.4,33,27,81.8
1,All Students,2018-19,10456,1150,9306,89.0,63,27,42.9
1,All Students,2019-20,5837,547,5290,90.6,57,21,36.8
1,All Students,2020-21,7924,675,7249,91.5,48,14,29.2
1,All Students,2021-22,6790,925,5865,86.4,43,27,62.8
1,All Students,2022-23,7233,945,6288,86.9,47,26,55.3
2,All Students,2018-19,12556,1113,11443,91.1,74,27,36.5
2,All Students,2019-20,7356,699,6657,90.5,71,24,33.8
2,All Students,2020-21,8790,1051,7739,88.0,54,25,46.3
2,All Students,2021-22,7538,857,6681,88.6,47,20,42.6
2,All Students,2022-23,7452,895,6557,88.0,47,26,55.3
3,All Students,2018-19,10705,975,9730,90.9,64,26,40.6
3,All Students,2019-20,7419,527,6892,92.9,68,15,22.1
3,All Students,2020-21,10812,1081,9731,90.0,64,23,35.9
3,All Students,2021-22,8940,1191,7749,86.7,57,33,57.9
3,All Students,2022-23,8549,825,7724,90.3,53,22,41.5
4,All Students,2018-19,11827,1027,10800,91.3,70,24,34.3
4,All Students,2019-20,6885,574,6311,91.7,63,20,31.7
4,All Students,2020-21,10509,998,9511,90.5,64,25,39.1
4,All Students,2021-22,9796,1631,8165,83.4,62,40,64.5
4,All Students,2022-23,8785,1006,7779,88.5,54,25,46.3
5,All Students,2018-19,16089,1296,14793,91.9,92,30,32.6
5,All Students,2019-20,7449,621,6828,91.7,66,20,30.3
5,All Students,2020-21,10487,469,10018,95.5,62,9,14.5
5,All Students,2021-22,9014,1308,7706,85.5,55,38,69.1
5,All Students,2022-23,8853,1068,7785,87.9,53,29,54.7
All Grades,All Students,2018-19,85617,7392,78225,91.4,500,172,34.4
All Grades,All Students,2019-20,50993,4428,46565,91.3,472,174,36.9
All Grades,All Students,2020-21,71857,8314,63543,88.4,426,174,40.8
All Grades,All Students,2021-22,61444,7482,53962,87.8,384,177,46.1
All Grades,All Students,2022-23,60873,6322,54551,89.6,373,154,41.3
6,All Students,2018-19,31021,2719,28302,91.2,184,65,35.3
6,All Students,2019-20,14067,s,s,s,s,s,s
6,All Students,2020-21,21391,2536,18855,88.1,129,55,42.6
6,All Students,2021-22,21284,2570,18714,87.9,135,63,46.7
6,All Students,2022-23,18506,1809,16697,90.2,113,46,40.7
7,All Students,2018-19,25120,1881,23239,92.5,146,43,29.5
7,All Students,2019-20,20893,1789,19104,91.4,193,69,35.8
7,All Students,2020-21,19448,2324,17124,88.1,115,50,43.5
7,All Students,2021-22,20874,2422,18452,88.4,129,52,40.3
7,All Students,2022-23,20853,2324,18529,88.9,130,59,45.4
8,All Students,2018-19,29476,2792,26684,90.5,170,64,37.6
8,All Students,2019-20,16030,1266,14764,92.1,144,46,31.9
8,All Students,2020-21,31018,3454,27564,88.9,182,69,37.9
8,All Students,2021-22,19286,2490,16796,87.1,120,62,51.7
8,All Students,2022-23,21514,2189,19325,89.8,130,49,37.7
9,All Students,2019-20,3,s,s,s,s,s,s
All Grades,All Students,2018-19,118414,12122,106292,89.8,716,319,44.6
All Grades,All Students,2019-20,71573,7550,64023,89.5,662,284,42.9
All Grades,All Students,2020-21,101738,10795,90943,89.4,601,200,33.3
All Grades,All Students,2021-22,92916,14330,78586,84.6,568,345,60.7
All Grades,All Students,2022-23,89338,10231,79107,88.5,543,266,49.0
PK in K-12 Schools,All Students,2018-19,11480,1470,10010,87.2,69,42,60.9
PK in K-12 Schools,All Students,2019-20,7571,1102,6469,85.4,73,46,63.0
PK in K-12 Schools,All Students,2020-21,9812,747,9065,92.4,60,16,26.7
PK in K-12 Schools,All Students,2021-22,11611,2135,9476,81.6,74,58,78.4
PK in K-12 Schools,All Students,2022-23,12754,1725,11029,86.5,82,50,61.0
0K,All Students,2018-19,15772,2136,13636,86.5,99,61,61.6
0K,All Students,2019-20,10104,1196,8908,88.2,96,44,45.8
0K,All Students,2020-21,12242,1835,10407,85.0,75,34,45.3
0K,All Students,2021-22,11339,2160,9179,81.0,73,52,71.2
0K,All Students,2022-23,12295,1481,10814,88.0,73,33,45.2
1,All Students,2018-19,17609,1791,15818,89.8,109,45,41.3
1,All Students,2019-20,9257,1172,8085,87.3,90,50,55.6
1,All Students,2020-21,15462,2169,13293,86.0,92,36,39.1
1,All Students,2021-22,12472,1890,10582,84.8,75,49,65.3
1,All Students,2022-23,11182,1504,9678,86.5,68,40,58.8
2,All Students,2018-19,17150,1596,15554,90.7,104,39,37.5
2,All Students,2019-20,10260,819,9441,92.0,93,26,28.0
2,All Students,2020-21,12565,1522,11043,87.9,73,32,43.8
2,All Students,2021-22,13919,2051,11868,85.3,82,48,58.5
2,All Students,2022-23,11904,1356,10548,88.6,75,39,52.0
3,All Students,2018-19,19858,1776,18082,91.1,121,49,40.5
3,All Students,2019-20,10986,1066,9920,90.3,100,39,39.0
3,All Students,2020-21,16072,1722,14350,89.3,93,30,32.3
3,All Students,2021-22,12376,2046,10330,83.5,76,48,63.2
3,All Students,2022-23,12540,1505,11035,88.0,76,38,50.0
4,All Students,2018-19,18549,1693,16856,90.9,107,41,38.3
4,All Students,2019-20,12193,1242,10951,89.8,109,41,37.6
4,All Students,2020-21,16468,1553,14915,90.6,98,29,29.6
4,All Students,2021-22,15767,1980,13787,87.4,97,45,46.4
4,All Students,2022-23,12146,1255,10891,89.7,73,33,45.2
5,All Students,2018-19,17996,1660,16336,90.8,107,42,39.3
5,All Students,2019-20,11202,953,10249,91.5,101,38,37.6
5,All Students,2020-21,19117,1247,17870,93.5,110,23,20.9
5,All Students,2021-22,15432,2068,13364,86.6,91,45,49.5
5,All Students,2022-23,16517,1405,15112,91.5,96,33,34.4
All Grades,All Students,2018-19,106960,10864,96096,89.8,655,282,43.1
All Grades,All Students,2019-20,64326,6191,58135,90.4,606,240,39.6
All Grades,All Students,2020-21,83922,9206,74716,89.0,492,193,39.2
All Grades,All Students,2021-22,74018,10766,63252,85.5,471,276,58.6
All Grades,All Students,2022-23,68310,8386,59924,87.7,428,228,53.3
PK in K-12 Schools,All Students,2018-19,6981,908,6073,87.0,47,29,61.7
PK in K-12 Schools,All Students,2019-20,5397,695,4702,87.1,53,33,62.3
PK in K-12 Schools,All Students,2020-21,5323,606,4717,88.6,36,17,47.2
PK in K-12 Schools,All Students,2021-22,7374,1319,6055,82.1,53,41,77.4
PK in K-12 Schools,All Students,2022-23,8218,1234,6984,85.0,53,34,64.2
0K,All Students,2018-19,15685,1849,13836,88.2,98,47,48.0
0K,All Students,2019-20,8164,876,7288,89.3,80,34,42.5
0K,All Students,2020-21,11057,1448,9609,86.9,66,35,53.0
0K,All Students,2021-22,5979,s,s,s,s,s,s
0K,All Students,2022-23,7943,1097,6846,86.2,53,32,60.4
1,All Students,2018-19,15382,1469,13913,90.4,93,37,39.8
1,All Students,2019-20,9690,1014,8676,89.5,94,46,48.9
1,All Students,2020-21,12088,1433,10655,88.1,69,21,30.4
1,All Students,2021-22,11523,1909,9614,83.4,76,52,68.4
1,All Students,2022-23,6459,935,5524,85.5,40,26,65.0
2,All Students,2018-19,18070,1818,16252,89.9,110,46,41.8
2,All Students,2019-20,9679,913,8766,90.6,90,29,32.2
2,All Students,2020-21,12631,1815,10816,85.6,74,39,52.7
2,All Students,2021-22,11448,1380,10068,87.9,69,37,53.6
2,All Students,2022-23,11052,1331,9721,88.0,65,31,47.7
3,All Students,2018-19,15198,1485,13713,90.2,91,37,40.7
3,All Students,2019-20,9554,794,8760,91.7,89,29,32.6
3,All Students,2020-21,13934,1358,12576,90.3,81,29,35.8
3,All Students,2021-22,11451,1678,9773,85.3,75,42,56.0
3,All Students,2022-23,11687,1228,10459,89.5,76,36,47.4
4,All Students,2018-19,19210,1784,17426,90.7,115,47,40.9
4,All Students,2019-20,9819,847,8972,91.4,92,28,30.4
4,All Students,2020-21,14716,1379,13337,90.6,85,30,35.3
4,All Students,2021-22,12719,1836,10883,85.6,77,46,59.7
4,All Students,2022-23,10652,1157,9495,89.1,67,33,49.3
5,All Students,2018-19,16434,1551,14883,90.6,101,39,38.6
5,All Students,2019-20,12023,1052,10971,91.3,108,41,38.0
5,All Students,2020-21,14173,1167,13006,91.8,81,22,27.2
5,All Students,2021-22,13478,1782,11696,86.8,80,34,42.5
5,All Students,2022-23,12299,1404,10895,88.6,74,36,48.6
6,All Students,2021-22,46,s,s,s,s,s,s
All Grades,All Students,2018-19,68303,6858,61445,90.0,420,184,43.8
All Grades,All Students,2019-20,44780,4245,40535,90.5,421,155,36.8
All Grades,All Students,2020-21,59490,4126,55364,93.1,368,97,26.4
All Grades,All Students,2021-22,61491,7538,53953,87.7,385,195,50.6
All Grades,All Students,2022-23,56524,7199,49325,87.3,344,172,50.0
PK in K-12 Schools,All Students,2018-19,5907,953,4954,83.9,38,27,71.1
PK in K-12 Schools,All Students,2019-20,5411,813,4598,85.0,57,36,63.2
PK in K-12 Schools,All Students,2020-21,7303,s,s,s,s,s,s
PK in K-12 Schools,All Students,2021-22,6913,1042,5871,84.9,46,28,60.9
PK in K-12 Schools,All Students,2022-23,6735,1122,5613,83.3,42,26,61.9
0K,All Students,2018-19,9443,997,8446,89.4,60,26,43.3
0K,All Students,2019-20,6046,768,5278,87.3,58,31,53.4
0K,All Students,2020-21,8907,677,8230,92.4,54,14,25.9
0K,All Students,2021-22,8016,1056,6960,86.8,50,27,54.0
0K,All Students,2022-23,7044,1016,6028,85.6,45,26,57.8
1,All Students,2018-19,8740,1101,7639,87.4,52,30,57.7
1,All Students,2019-20,6143,537,5606,91.3,57,20,35.1
1,All Students,2020-21,7616,774,6842,89.8,46,20,43.5
1,All Students,2021-22,8341,1114,7227,86.6,51,26,51.0
1,All Students,2022-23,8962,1250,7712,86.1,54,27,50.0
2,All Students,2018-19,10715,992,9723,90.7,68,29,42.6
2,All Students,2019-20,5573,510,5063,90.8,52,19,36.5
2,All Students,2020-21,8301,683,7618,91.8,52,14,26.9
2,All Students,2021-22,7361,961,6400,86.9,48,27,56.3
2,All Students,2022-23,7652,852,6800,88.9,46,20,43.5
3,All Students,2018-19,10062,878,9184,91.3,63,24,38.1
3,All Students,2019-20,7340,672,6668,90.8,68,22,32.4
3,All Students,2020-21,7573,520,7053,93.1,47,14,29.8
3,All Students,2021-22,9910,998,8912,89.9,62,28,45.2
3,All Students,2022-23,7377,953,6424,87.1,45,24,53.3
4,All Students,2018-19,12837,1080,11757,91.6,76,27,35.5
4,All Students,2019-20,5782,351,5431,93.9,54,11,20.4
4,All Students,2020-21,11962,594,11368,95.0,72,12,16.7
4,All Students,2021-22,8491,1130,7361,86.7,52,29,55.8
4,All Students,2022-23,10194,988,9206,90.3,62,23,37.1
5,All Students,2018-19,10599,857,9742,91.9,63,21,33.3
5,All Students,2019-20,8485,594,7891,93.0,77,16,20.8
5,All Students,2020-21,7771,437,7334,94.4,45,8,17.8
5,All Students,2021-22,12459,1237,11222,90.1,76,30,39.5
5,All Students,2022-23,8560,1018,7542,88.1,50,26,52.0
6,All Students,2020-21,57,s,s,s,s,s,s
All Grades,All Students,2018-19,146410,11039,135371,92.5,878,250,28.5
All Grades,All Students,2019-20,88388,5955,82433,93.3,822,203,24.7
All Grades,All Students,2020-21,124412,12040,112372,90.3,749,237,31.6
All Grades,All Students,2021-22,124825,14676,110149,88.2,776,378,48.7
All Grades,All Students,2022-23,119501,12824,106677,89.3,772,357,46.2
PK in K-12 Schools,All Students,2020-21,2568,523,2045,79.6,15,8,53.3
PK in K-12 Schools,All Students,2021-22,5694,769,4925,86.5,37,20,54.1
PK in K-12 Schools,All Students,2022-23,8888,s,s,s,s,s,s
0K,All Students,2018-19,21214,1713,19501,91.9,133,43,32.3
0K,All Students,2019-20,14135,1064,13071,92.5,132,34,25.8
0K,All Students,2020-21,16301,1980,14321,87.9,104,39,37.5
0K,All Students,2021-22,17374,2746,14628,84.2,121,77,63.6
0K,All Students,2022-23,17860,2388,15472,86.6,116,66,56.9
1,All Students,2018-19,22580,1860,20720,91.8,137,47,34.3
1,All Students,2019-20,11895,800,11095,93.3,110,30,27.3
1,All Students,2020-21,20252,2879,17373,85.8,120,54,45.0
1,All Students,2021-22,18086,2194,15892,87.9,112,58,51.8
1,All Students,2022-23,17872,1967,15905,89.0,116,59,50.9
2,All Students,2018-19,26862,2191,24671,91.8,159,52,32.7
2,All Students,2019-20,14579,1107,13472,92.4,140,45,32.1
2,All Students,2020-21,18045,1482,16563,91.8,109,29,26.6
2,All Students,2021-22,19695,2220,17475,88.7,120,51,42.5
2,All Students,2022-23,17048,1897,15151,88.9,113,53,46.9
3,All Students,2018-19,23026,1710,21316,92.6,137,37,27.0
3,All Students,2019-20,17057,1142,15915,93.3,157,34,21.7
3,All Students,2020-21,21955,2115,19840,90.4,131,41,31.3
3,All Students,2021-22,19228,2054,17174,89.3,119,57,47.9
3,All Students,2022-23,18106,1730,16376,90.4,119,43,36.1
4,All Students,2018-19,26247,1790,24457,93.2,158,36,22.8
4,All Students,2019-20,14711,1005,13706,93.2,137,36,26.3
4,All Students,2020-21,24526,1746,22780,92.9,144,36,25.0
4,All Students,2021-22,22405,2465,19940,89.0,136,63,46.3
4,All Students,2022-23,18107,1733,16374,90.4,118,55,46.6
5,All Students,2018-19,26481,1775,24706,93.3,154,35,22.7
5,All Students,2019-20,16011,837,15174,94.8,146,24,16.4
5,All Students,2020-21,20765,1315,19450,93.7,126,30,23.8
5,All Students,2021-22,22343,2228,20115,90.0,131,52,39.7
5,All Students,2022-23,21282,2023,19259,90.5,133,52,39.1
6,All Students,2022-23,338,s,s,s,s,s,s
All Grades,All Students,2018-19,134672,10181,124491,92.4,810,227,28.0
All Grades,All Students,2019-20,78271,5940,72331,92.4,726,210,28.9
All Grades,All Students,2020-21,101833,7546,94287,92.6,614,155,25.2
All Grades,All Students,2021-22,90787,10970,79817,87.9,565,287,50.8
All Grades,All Students,2022-23,84111,9496,74615,88.7,518,239,46.1
PK in K-12 Schools,All Students,2018-19,9488,s,s,s,s,s,s
PK in K-12 Schools,All Students,2019-20,7700,s,s,s,s,s,s
PK in K-12 Schools,All Students,2020-21,9591,1002,8589,89.6,62,29,46.8
PK in K-12 Schools,All Students,2021-22,11302,1783,9519,84.2,73,46,63.0
PK in K-12 Schools,All Students,2022-23,10021,1362,8659,86.4,60,34,56.7
0K,All Students,2018-19,18373,1686,16687,90.8,111,42,37.8
0K,All Students,2019-20,10531,1052,9479,90.0,100,43,43.0
0K,All Students,2020-21,12046,2216,9830,81.6,78,47,60.3
0K,All Students,2021-22,11686,1578,10108,86.5,78,47,60.3
0K,All Students,2022-23,10107,1467,8640,85.5,68,42,61.8
1,All Students,2018-19,15478,1300,14178,91.6,94,30,31.9
1,All Students,2019-20,9993,648,9345,93.5,92,22,23.9
1,All Students,2020-21,14877,1269,13608,91.5,88,30,34.1
1,All Students,2021-22,11142,1523,9619,86.3,73,40,54.8
1,All Students,2022-23,9755,1092,8663,88.8,59,31,52.5
2,All Students,2018-19,19061,1418,17643,92.6,115,33,28.7
2,All Students,2019-20,9506,656,8850,93.1,88,21,23.9
2,All Students,2020-21,13608,747,12861,94.5,80,14,17.5
2,All Students,2021-22,15351,1634,13717,89.4,92,40,43.5
2,All Students,2022-23,11974,1419,10555,88.1,73,35,47.9
3,All Students,2018-19,24568,1837,22731,92.5,148,42,28.4
3,All Students,2019-20,10507,760,9747,92.8,98,26,26.5
3,All Students,2020-21,13735,803,12932,94.2,81,13,16.0
3,All Students,2021-22,14089,1549,12540,89.0,85,39,45.9
3,All Students,2022-23,14475,1420,13055,90.2,89,34,38.2
4,All Students,2018-19,23285,1592,21693,93.2,140,32,22.9
4,All Students,2019-20,15338,1070,14268,93.0,141,41,29.1
4,All Students,2020-21,15393,597,14796,96.1,92,6,6.5
4,All Students,2021-22,13081,1543,11538,88.2,79,40,50.6
4,All Students,2022-23,14217,1321,12896,90.7,85,31,36.5
5,All Students,2018-19,24079,1576,22503,93.5,143,29,20.3
5,All Students,2019-20,14694,887,13807,94.0,135,26,19.3
5,All Students,2020-21,22583,912,21671,96.0,133,16,12.0
5,All Students,2021-22,14136,1360,12776,90.4,85,35,41.2
5,All Students,2022-23,13562,1415,12147,89.6,84,32,38.1
6,All Students,2018-19,340,s,s,s,s,s,s
6,All Students,2019-20,2,s,s,s,s,s,s
All Grades,All Students,2018-19,108166,12038,96128,88.9,677,265,39.1
All Grades,All Students,2019-20,68056,6030,62026,91.1,632,187,29.6
All Grades,All Students,2020-21,109653,12017,97636,89.0,649,230,35.4
All Grades,All Students,2021-22,107535,15619,91916,85.5,653,365,55.9
All Grades,All Students,2022-23,104762,14957,89805,85.7,637,355,55.7
6,All Students,2018-19,16603,1206,15397,92.7,100,31,31.0
6,All Students,2019-20,11808,787,11021,93.3,105,22,21.0
6,All Students,2020-21,17601,1670,15931,90.5,101,36,35.6
6,All Students,2021-22,16409,1915,14494,88.3,97,39,40.2
6,All Students,2022-23,16772,1796,14976,89.3,100,41,41.0
7,All Students,2018-19,17716,1231,16485,93.1,103,23,22.3
7,All Students,2019-20,10107,697,9410,93.1,94,18,19.1
7,All Students,2020-21,17901,1925,15976,89.2,103,37,35.9
7,All Students,2021-22,17136,1874,15262,89.1,101,44,43.6
7,All Students,2022-23,15960,2234,13726,86.0,93,52,55.9
8,All Students,2018-19,16812,1402,15410,91.7,101,34,33.7
8,All Students,2019-20,10381,670,9711,93.5,95,20,21.1
8,All Students,2020-21,15177,1619,13558,89.3,88,32,36.4
8,All Students,2021-22,17050,2179,14871,87.2,99,49,49.5
8,All Students,2022-23,17106,1576,15530,90.8,102,41,40.2
9,All Students,2018-19,17797,2998,14799,83.2,118,56,47.5
9,All Students,2019-20,10523,1435,9088,86.4,101,41,40.6
9,All Students,2020-21,20363,3123,17240,84.7,120,50,41.7
9,All Students,2021-22,19391,3855,15536,80.1,124,85,68.5
9,All Students,2022-23,17269,3088,14181,82.1,110,67,60.9
10,All Students,2018-19,14989,1891,13098,87.4,101,46,45.5
10,All Students,2019-20,9314,1013,8301,89.1,86,34,39.5
10,All Students,2020-21,14416,1701,12715,88.2,87,31,35.6
10,All Students,2021-22,16658,2366,14292,85.8,104,58,55.8
10,All Students,2022-23,15889,2788,13101,82.5,100,70,70.0
11,All Students,2018-19,12319,1515,10804,87.7,76,32,42.1
11,All Students,2019-20,8870,768,8102,91.3,86,31,36.0
11,All Students,2020-21,12067,901,11166,92.5,74,20,27.0
11,All Students,2021-22,9644,1639,8005,83.0,60,41,68.3
11,All Students,2022-23,12182,1955,10227,84.0,75,47,62.7
12,All Students,2018-19,11930,1795,10135,85.0,78,43,55.1
12,All Students,2019-20,7053,660,6393,90.6,65,21,32.3
12,All Students,2020-21,12107,1060,11047,91.2,75,23,30.7
12,All Students,2021-22,11247,1791,9456,84.1,68,49,72.1
12,All Students,2022-23,9584,1520,8064,84.1,57,37,64.9
All Grades,All Students,2018-19,39038,8239,30799,78.9,261,154,59.0
All Grades,All Students,2019-20,25289,5186,20103,79.5,260,154,59.2
All Grades,All Students,2020-21,34635,7014,27621,79.7,201,89,44.3
All Grades,All Students,2021-22,32327,5736,26591,82.3,220,122,55.5
All Grades,All Students,2022-23,28254,4482,23772,84.1,199,98,49.2
9,All Students,2018-19,11287,2237,9050,80.2,77,50,64.9
9,All Students,2019-20,7697,1615,6082,79.0,84,50,59.5
9,All Students,2020-21,4529,589,3940,87.0,27,9,33.3
9,All Students,2021-22,8264,946,7318,88.6,60,23,38.3
9,All Students,2022-23,6671,1056,5615,84.2,54,28,51.9
10,All Students,2018-19,8634,2129,6505,75.3,62,37,59.7
10,All Students,2019-20,6599,1472,5127,77.7,70,46,65.7
10,All Students,2020-21,12612,3634,8978,71.2,71,42,59.2
10,All Students,2021-22,6498,845,5653,87.0,45,21,46.7
10,All Students,2022-23,8317,1224,7093,85.3,59,25,42.4
11,All Students,2018-19,11256,2106,9150,81.3,72,37,51.4
11,All Students,2019-20,5537,1209,4328,78.2,52,30,57.7
11,All Students,2020-21,8710,1441,7269,83.5,51,19,37.3
11,All Students,2021-22,10045,2199,7846,78.1,68,44,64.7
11,All Students,2022-23,5485,768,4717,86.0,37,16,43.2
12,All Students,2018-19,7861,1767,6094,77.5,50,30,60.0
12,All Students,2019-20,5456,890,4566,83.7,54,28,51.9
12,All Students,2020-21,8784,1350,7434,84.6,52,19,36.5
12,All Students,2021-22,7520,1746,5774,76.8,47,34,72.3
12,All Students,2022-23,7781,1434,6347,81.6,49,29,59.2
All Grades,All Students,2018-19,75601,12354,63247,83.7,478,247,51.7
All Grades,All Students,2019-20,47526,7981,39545,83.2,463,243,52.5
All Grades,All Students,2020-21,76045,13682,62363,82.0,451,234,51.9
All Grades,All Students,2021-22,70700,14428,56272,79.6,437,290,66.4
All Grades,All Students,2022-23,69569,12567,57002,81.9,440,247,56.1
9,All Students,2018-19,20512,3531,16981,82.8,128,57,44.5
9,All Students,2019-20,14562,2477,12085,83.0,141,66,46.8
9,All Students,2020-21,21502,4510,16992,79.0,128,70,54.7
9,All Students,2021-22,17856,3440,14416,80.7,113,71,62.8
9,All Students,2022-23,17652,2620,15032,85.2,113,49,43.4
10,All Students,2018-19,20315,3459,16856,83.0,132,64,48.5
10,All Students,2019-20,13041,2482,10559,81.0,133,79,59.4
10,All Students,2020-21,20910,3768,17142,82.0,121,61,50.4
10,All Students,2021-22,18849,3533,15316,81.3,119,79,66.4
10,All Students,2022-23,17843,3211,14632,82.0,113,64,56.6
11,All Students,2018-19,18608,2999,15609,83.9,114,66,57.9
11,All Students,2019-20,10727,1501,9226,86.0,102,48,47.1
11,All Students,2020-21,18162,3331,14831,81.7,107,62,57.9
11,All Students,2021-22,18543,4172,14371,77.5,111,72,64.9
11,All Students,2022-23,17718,3250,14468,81.7,112,68,60.7
12,All Students,2018-19,16166,2365,13801,85.4,104,60,57.7
12,All Students,2019-20,9196,1521,7675,83.5,87,50,57.5
12,All Students,2020-21,15471,2073,13398,86.6,95,41,43.2
12,All Students,2021-22,15452,3283,12169,78.8,94,68,72.3
12,All Students,2022-23,16356,3486,12870,78.7,102,66,64.7
All Grades,All Students,2018-19,43847,5253,38594,88.0,276,123,44.6
All Grades,All Students,2019-20,22859,2697,20162,88.2,224,93,41.5
All Grades,All Students,2020-21,32826,3547,29279,89.2,194,73,37.6
All Grades,All Students,2021-22,30621,4785,25836,84.4,190,108,56.8
All Grades,All Students,2022-23,34084,4424,29660,87.0,219,104,47.5
6,All Students,2018-19,11276,s,s,s,s,s,s
6,All Students,2019-20,7276,794,6482,89.1,69,30,43.5
6,All Students,2020-21,11312,1587,9725,86.0,68,39,57.4
6,All Students,2021-22,10105,1672,8433,83.5,64,41,64.1
6,All Students,2022-23,10149,1166,8983,88.5,64,29,45.3
7,All Students,2018-19,13513,1677,11836,87.6,89,40,44.9
7,All Students,2019-20,7108,s,s,s,s,s,s
7,All Students,2020-21,10548,945,9603,91.0,62,15,24.2
7,All Students,2021-22,11450,1956,9494,82.9,70,40,57.1
7,All Students,2022-23,12269,1690,10579,86.2,81,38,46.9
8,All Students,2018-19,19028,2336,16692,87.7,115,50,43.5
8,All Students,2019-20,8474,1145,7329,86.5,85,36,42.4
8,All Students,2020-21,10966,1015,9951,90.7,64,19,29.7
8,All Students,2021-22,9066,1157,7909,87.2,56,27,48.2
8,All Students,2022-23,11666,1568,10098,86.6,74,37,50.0
9,All Students,2018-19,30,s,s,s,s,s,s
9,All Students,2019-20,1,s,s,s,s,s,s
All Grades,All Students,2018-19,86510,8129,78381,90.6,521,165,31.7
All Grades,All Students,2019-20,55504,4724,50780,91.5,515,154,29.9
All Grades,All Students,2020-21,79291,2580,76711,96.7,463,39,8.4
All Grades,All Students,2021-22,70493,8379,62114,88.1,439,204,46.5
All Grades,All Students,2022-23,66990,7045,59945,89.5,401,143,35.7
6,All Students,2018-19,25192,2181,23011,91.3,154,47,30.5
6,All Students,2019-20,18980,1659,17321,91.3,178,48,27.0
6,All Students,2020-21,25044,536,24508,97.9,149,4,2.7
6,All Students,2021-22,18544,s,s,s,s,s,s
6,All Students,2022-23,20484,1764,18720,91.4,122,35,28.7
7,All Students,2018-19,30866,2921,27945,90.5,183,66,36.1
7,All Students,2019-20,16250,s,s,s,s,s,s
7,All Students,2020-21,28704,1592,27112,94.5,166,30,18.1
7,All Students,2021-22,24748,2916,21832,88.2,155,67,43.2
7,All Students,2022-23,20455,2676,17779,86.9,122,58,47.5
8,All Students,2018-19,30452,3027,27425,90.1,184,52,28.3
8,All Students,2019-20,20220,1922,18298,90.5,185,71,38.4
8,All Students,2020-21,25543,452,25091,98.2,148,5,3.4
8,All Students,2021-22,27102,3460,23642,87.2,163,83,50.9
8,All Students,2022-23,26051,2605,23446,90.0,157,50,31.8
9,All Students,2019-20,54,s,s,s,s,s,s
9,All Students,2021-22,99,s,s,s,s,s,s
All Grades,All Students,2018-19,90427,6444,83983,92.9,540,140,25.9
All Grades,All Students,2019-20,59244,3926,55318,93.4,534,109,20.4
All Grades,All Students,2020-21,90734,6304,84430,93.1,545,127,23.3
All Grades,All Students,2021-22,89687,9402,80285,89.5,537,247,46.0
All Grades,All Students,2022-23,93148,8817,84331,90.5,555,212,38.2
PK in K-12 Schools,All Students,2018-19,9421,1020,8401,89.2,56,25,44.6
PK in K-12 Schools,All Students,2019-20,5831,572,5259,90.2,52,18,34.6
PK in K-12 Schools,All Students,2020-21,8303,1336,6967,83.9,53,32,60.4
PK in K-12 Schools,All Students,2021-22,8840,1035,7805,88.3,54,31,57.4
PK in K-12 Schools,All Students,2022-23,8879,922,7957,89.6,53,26,49.1
0K,All Students,2018-19,13380,1243,12137,90.7,84,33,39.3
0K,All Students,2019-20,9085,783,8302,91.4,84,24,28.6
0K,All Students,2020-21,14331,1139,13192,92.1,89,25,28.1
0K,All Students,2021-22,13897,1697,12200,87.8,85,48,56.5
0K,All Students,2022-23,13443,1556,11887,88.4,83,40,48.2
1,All Students,2018-19,12345,922,11423,92.5,77,20,26.0
1,All Students,2019-20,9414,646,8768,93.1,86,23,26.7
1,All Students,2020-21,14485,1215,13270,91.6,87,22,25.3
1,All Students,2021-22,14915,1547,13368,89.6,90,42,46.7
1,All Students,2022-23,15942,1575,14367,90.1,94,41,43.6
2,All Students,2018-19,13673,859,12814,93.7,79,16,20.3
2,All Students,2019-20,7286,437,6849,94.0,65,12,18.5
2,All Students,2020-21,13723,829,12894,94.0,81,15,18.5
2,All Students,2021-22,13541,1377,12164,89.8,83,36,43.4
2,All Students,2022-23,14631,1222,13409,91.6,89,28,31.5
3,All Students,2018-19,14604,914,13690,93.7,85,17,20.0
3,All Students,2019-20,8850,507,8343,94.3,79,12,15.2
3,All Students,2020-21,11501,429,11072,96.3,68,6,8.8
3,All Students,2021-22,12790,1445,11345,88.7,75,34,45.3
3,All Students,2022-23,14323,1410,12913,90.2,84,30,35.7
4,All Students,2018-19,15627,848,14779,94.6,93,18,19.4
4,All Students,2019-20,9929,533,9396,94.6,90,13,14.4
4,All Students,2020-21,13047,569,12478,95.6,77,11,14.3
4,All Students,2021-22,12682,1049,11633,91.7,75,26,34.7
4,All Students,2022-23,13175,1201,11974,90.9,79,25,31.6
5,All Students,2018-19,11377,638,10739,94.4,66,11,16.7
5,All Students,2019-20,8849,448,8401,94.9,78,7,9.0
5,All Students,2020-21,15344,787,14557,94.9,90,16,17.8
5,All Students,2021-22,13022,1252,11770,90.4,75,30,40.0
5,All Students,2022-23,12755,931,11824,92.7,73,22,30.1
All Grades,All Students,2018-19,71010,11624,59386,83.6,460,238,51.7
All Grades,All Students,2019-20,45218,6573,38645,85.5,439,211,48.1
All Grades,All Students,2020-21,68172,9072,59100,86.7,401,138,34.4
All Grades,All Students,2021-22,64063,14214,49849,77.8,397,298,75.1
All Grades,All Students,2022-23,58435,11074,47361,81.0,384,226,58.9
9,All Students,2018-19,17876,2198,15678,87.7,119,49,41.2
9,All Students,2019-20,11383,1100,10283,90.3,111,42,37.8
9,All Students,2020-21,15598,2009,13589,87.1,92,33,35.9
9,All Students,2021-22,16305,2875,13430,82.4,102,71,69.6
9,All Students,2022-23,14768,2542,12226,82.8,99,50,50.5
10,All Students,2018-19,19531,3595,15936,81.6,136,68,50.0
10,All Students,2019-20,11974,1566,10408,86.9,117,47,40.2
10,All Students,2020-21,19269,2947,16322,84.7,115,48,41.7
10,All Students,2021-22,14406,3323,11083,76.9,89,69,77.5
10,All Students,2022-23,14750,2836,11914,80.8,100,63,63.0
11,All Students,2018-19,17997,3221,14776,82.1,110,58,52.7
11,All Students,2019-20,10541,1958,8583,81.4,103,56,54.4
11,All Students,2020-21,17285,1323,15962,92.3,100,23,23.0
11,All Students,2021-22,17643,4666,12977,73.6,110,87,79.1
11,All Students,2022-23,13590,2509,11081,81.5,91,54,59.3
12,All Students,2018-19,15606,2610,12996,83.3,95,63,66.3
12,All Students,2019-20,11320,1949,9371,82.8,108,66,61.1
12,All Students,2020-21,16020,2793,13227,82.6,94,34,36.2
12,All Students,2021-22,15709,3350,12359,78.7,96,71,74.0
12,All Students,2022-23,15327,3187,12140,79.2,94,59,62.8
All Grades,All Students,2018-19,76549,12952,63597,83.1,516,297,57.6
All Grades,All Students,2019-20,49025,7827,41198,84.0,480,240,50.0
All Grades,All Students,2020-21,71317,8163,63154,88.6,431,171,39.7
All Grades,All Students,2021-22,56035,10956,45079,80.4,359,231,64.3
All Grades,All Students,2022-23,51072,9512,41560,81.4,351,222,63.2
9,All Students,2018-19,22652,4123,18529,81.8,170,99,58.2
9,All Students,2019-20,14492,2546,11946,82.4,147,71,48.3
9,All Students,2020-21,20131,2338,17793,88.4,121,39,32.2
9,All Students,2021-22,14839,3921,10918,73.6,95,65,68.4
9,All Students,2022-23,15560,3639,11921,76.6,111,71,64.0
10,All Students,2018-19,23838,4330,19508,81.8,151,81,53.6
10,All Students,2019-20,12853,2418,10435,81.2,129,75,58.1
10,All Students,2020-21,18555,2127,16428,88.5,116,41,35.3
10,All Students,2021-22,13869,2555,11314,81.6,91,57,62.6
10,All Students,2022-23,11191,2047,9144,81.7,83,55,66.3
11,All Students,2018-19,14876,1863,13013,87.5,99,51,51.5
11,All Students,2019-20,11164,1406,9758,87.4,104,41,39.4
11,All Students,2020-21,15603,1644,13959,89.5,94,41,43.6
11,All Students,2021-22,13670,2024,11646,85.2,88,48,54.5
11,All Students,2022-23,11534,1900,9634,83.5,77,50,64.9
12,All Students,2018-19,15183,2636,12547,82.6,96,66,68.8
12,All Students,2019-20,10516,1457,9059,86.1,100,53,53.0
12,All Students,2020-21,17028,2054,14974,87.9,100,50,50.0
12,All Students,2021-22,13657,2456,11201,82.0,85,61,71.8
12,All Students,2022-23,12787,1926,10861,84.9,80,46,57.5
All Grades,All Students,2018-19,112161,11660,100501,89.6,684,310,45.3
All Grades,All Students,2019-20,66909,6428,60481,90.4,616,239,38.8
All Grades,All Students,2020-21,91154,10698,80456,88.3,546,219,40.1
All Grades,All Students,2021-22,96991,15390,81601,84.1,602,363,60.3
All Grades,All Students,2022-23,89742,11767,77975,86.9,553,301,54.4
PK in K-12 Schools,All Students,2018-19,8204,1080,7124,86.8,55,32,58.2
PK in K-12 Schools,All Students,2019-20,5181,651,4530,87.4,50,24,48.0
PK in K-12 Schools,All Students,2020-21,7658,1206,6452,84.3,50,31,62.0
PK in K-12 Schools,All Students,2021-22,10941,2109,8832,80.7,69,48,69.6
PK in K-12 Schools,All Students,2022-23,11712,2033,9679,82.6,75,52,69.3
0K,All Students,2018-19,14386,2059,12327,85.7,91,57,62.6
0K,All Students,2019-20,8662,868,7794,90.0,79,34,43.0
0K,All Students,2020-21,10670,1578,9092,85.2,65,34,52.3
0K,All Students,2021-22,12431,2436,9995,80.4,78,60,76.9
0K,All Students,2022-23,11503,1682,9821,85.4,74,45,60.8
1,All Students,2018-19,17052,1780,15272,89.6,104,43,41.3
1,All Students,2019-20,9843,1103,8740,88.8,95,43,45.3
1,All Students,2020-21,13771,1781,11990,87.1,84,37,44.0
1,All Students,2021-22,13466,2194,11272,83.7,86,56,65.1
1,All Students,2022-23,10863,s,s,s,s,s,s
2,All Students,2018-19,16840,1527,15313,90.9,103,41,39.8
2,All Students,2019-20,10995,1052,9943,90.4,100,37,37.0
2,All Students,2020-21,14914,1896,13018,87.3,90,36,40.0
2,All Students,2021-22,14211,2320,11891,83.7,88,54,61.4
2,All Students,2022-23,13304,1699,11605,87.2,80,44,55.0
3,All Students,2018-19,14027,1197,12830,91.5,85,37,43.5
3,All Students,2019-20,10263,875,9388,91.5,95,38,40.0
3,All Students,2020-21,14446,1258,13188,91.3,84,28,33.3
3,All Students,2021-22,16277,2438,13839,85.0,101,54,53.5
3,All Students,2022-23,13000,1412,11588,89.1,77,36,46.8
4,All Students,2018-19,19842,1912,17930,90.4,120,46,38.3
4,All Students,2019-20,8882,722,8160,91.9,81,25,30.9
4,All Students,2020-21,16009,1510,14499,90.6,94,25,26.6
4,All Students,2021-22,13821,1919,11902,86.1,84,42,50.0
4,All Students,2022-23,15774,1853,13921,88.3,94,41,43.6
5,All Students,2018-19,21810,2105,19705,90.3,126,54,42.9
5,All Students,2019-20,13083,1157,11926,91.2,116,38,32.8
5,All Students,2020-21,13686,1469,12217,89.3,79,28,35.4
5,All Students,2021-22,15844,1974,13870,87.5,96,49,51.0
5,All Students,2022-23,13471,1325,12146,90.2,82,35,42.7
6,All Students,2022-23,115,s,s,s,s,s,s
All Grades,All Students,2018-19,90084,6404,83680,92.9,525,139,26.5
All Grades,All Students,2019-20,56427,3830,52597,93.2,506,112,22.1
All Grades,All Students,2020-21,80441,7790,72651,90.3,465,143,30.8
All Grades,All Students,2021-22,76819,7735,69084,89.9,454,182,40.1
All Grades,All Students,2022-23,72484,6464,66020,91.1,429,126,29.4
6,All Students,2018-19,30529,2218,28311,92.7,177,50,28.2
6,All Students,2019-20,17846,s,s,s,s,s,s
6,All Students,2020-21,27589,2322,25267,91.6,161,45,28.0
6,All Students,2021-22,24928,s,s,s,s,s,s
6,All Students,2022-23,24872,2114,22758,91.5,145,40,27.6
7,All Students,2018-19,29518,2120,27398,92.8,171,46,26.9
7,All Students,2019-20,18816,1274,17542,93.2,171,40,23.4
7,All Students,2020-21,25043,3270,21773,86.9,144,64,44.4
7,All Students,2021-22,26884,2591,24293,90.4,158,59,37.3
7,All Students,2022-23,23126,2030,21096,91.2,137,38,27.7
8,All Students,2018-19,30037,2066,27971,93.1,177,43,24.3
8,All Students,2019-20,19745,1373,18372,93.0,176,41,23.3
8,All Students,2020-21,27809,2198,25611,92.1,160,34,21.3
8,All Students,2021-22,24960,2661,22299,89.3,149,63,42.3
8,All Students,2022-23,24486,2320,22166,90.5,147,48,32.7
9,All Students,2019-20,20,s,s,s,s,s,s
9,All Students,2021-22,47,s,s,s,s,s,s
All Grades,All Students,2018-19,59133,9730,49403,83.5,394,216,54.8
All Grades,All Students,2019-20,42570,6862,35708,83.9,417,211,50.6
All Grades,All Students,2020-21,63203,11438,51765,81.9,383,169,44.1
All Grades,All Students,2021-22,58898,12941,45957,78.0,393,260,66.2
All Grades,All Students,2022-23,61623,13069,48554,78.8,416,264,63.5
7,All Students,2020-21,81,s,s,s,s,s,s
8,All Students,2019-20,31,s,s,s,s,s,s
8,All Students,2021-22,3,s,s,s,s,s,s
9,All Students,2018-19,14965,2761,12204,81.6,101,59,58.4
9,All Students,2019-20,11970,1522,10448,87.3,119,56,47.1
9,All Students,2020-21,13941,2616,11325,81.2,87,37,42.5
9,All Students,2021-22,12153,s,s,s,s,s,s
9,All Students,2022-23,14882,3268,11614,78.0,101,63,62.4
10,All Students,2018-19,16399,2998,13401,81.7,112,61,54.5
10,All Students,2019-20,10296,2320,7976,77.5,102,60,58.8
10,All Students,2020-21,18566,3463,15103,81.3,113,51,45.1
10,All Students,2021-22,15855,3806,12049,76.0,106,72,67.9
10,All Students,2022-23,14160,2716,11444,80.8,100,58,58.0
11,All Students,2018-19,14204,1832,12372,87.1,96,45,46.9
11,All Students,2019-20,9829,s,s,s,s,s,s
11,All Students,2020-21,13451,s,s,s,s,s,s
11,All Students,2021-22,18333,3722,14611,79.7,117,73,62.4
11,All Students,2022-23,14935,3222,11713,78.4,99,61,61.6
12,All Students,2018-19,13565,2139,11426,84.2,85,51,60.0
12,All Students,2019-20,10444,1397,9047,86.6,98,48,49.0
12,All Students,2020-21,17164,3482,13682,79.7,102,51,50.0
12,All Students,2021-22,12554,2825,9729,77.5,82,63,76.8
12,All Students,2022-23,17646,3863,13783,78.1,116,82,70.7
All Grades,All Students,2018-19,69862,12191,57671,82.5,470,255,54.3
All Grades,All Students,2019-20,49852,6789,43063,86.4,471,199,42.3
All Grades,All Students,2020-21,76460,11049,65411,85.5,463,191,41.3
All Grades,All Students,2021-22,73040,8591,64449,88.2,447,175,39.1
All Grades,All Students,2022-23,70137,8769,61368,87.5,436,199,45.6
9,All Students,2018-19,19744,2873,16871,85.4,140,73,52.1
9,All Students,2019-20,14106,1453,12653,89.7,131,43,32.8
9,All Students,2020-21,23638,3222,20416,86.4,140,50,35.7
9,All Students,2021-22,19980,2244,17736,88.8,122,44,36.1
9,All Students,2022-23,18240,2169,16071,88.1,114,49,43.0
10,All Students,2018-19,19811,4452,15359,77.5,134,75,56.0
10,All Students,2019-20,14627,2505,12122,82.9,139,63,45.3
10,All Students,2020-21,21419,3201,18218,85.1,127,47,37.0
10,All Students,2021-22,20593,2672,17921,87.0,128,55,43.0
10,All Students,2022-23,17841,2226,15615,87.5,112,45,40.2
11,All Students,2018-19,19290,3393,15897,82.4,126,68,54.0
11,All Students,2019-20,10422,1649,8773,84.2,101,48,47.5
11,All Students,2020-21,18007,2432,15575,86.5,113,49,43.4
11,All Students,2021-22,17253,1805,15448,89.5,104,32,30.8
11,All Students,2022-23,18120,2438,15682,86.5,111,59,53.2
12,All Students,2018-19,11017,1473,9544,86.6,70,39,55.7
12,All Students,2019-20,10697,1182,9515,89.0,100,45,45.0
12,All Students,2020-21,13396,2194,11202,83.6,83,45,54.2
12,All Students,2021-22,15214,1870,13344,87.7,93,44,47.3
12,All Students,2022-23,15936,1936,14000,87.9,99,46,46.5
All Grades,All Students,2018-19,110535,13515,97020,87.8,692,313,45.2
All Grades,All Students,2019-20,65855,7212,58643,89.0,623,231,37.1
All Grades,All Students,2020-21,100759,14899,85860,85.2,589,228,38.7
All Grades,All Students,2021-22,95222,16357,78865,82.8,587,331,56.4
All Grades,All Students,2022-23,89386,14281,75105,84.0,576,317,55.0
6,All Students,2018-19,16640,1421,15219,91.5,98,37,37.8
6,All Students,2019-20,9755,689,9066,92.9,88,18,20.5
6,All Students,2020-21,15307,1400,13907,90.9,91,29,31.9
6,All Students,2021-22,13529,1584,11945,88.3,79,30,38.0
6,All Students,2022-23,11667,1268,10399,89.1,73,33,45.2
7,All Students,2018-19,18155,1552,16603,91.5,108,36,33.3
7,All Students,2019-20,9617,670,8947,93.0,88,19,21.6
7,All Students,2020-21,14439,1423,13016,90.1,84,22,26.2
7,All Students,2021-22,14518,2001,12517,86.2,87,48,55.2
7,All Students,2022-23,13721,1609,12112,88.3,83,36,43.4
8,All Students,2018-19,18382,1801,16581,90.2,111,43,38.7
8,All Students,2019-20,11296,880,10416,92.2,105,28,26.7
8,All Students,2020-21,15031,1407,13624,90.6,86,27,31.4
8,All Students,2021-22,13605,2185,11420,83.9,84,44,52.4
8,All Students,2022-23,13483,1797,11686,86.7,84,41,48.8
9,All Students,2018-19,16063,2848,13215,82.3,104,58,55.8
9,All Students,2019-20,11171,1728,9443,84.5,111,57,51.4
9,All Students,2020-21,16655,3521,13134,78.9,97,44,45.4
9,All Students,2021-22,19058,3649,15409,80.9,118,79,66.9
9,All Students,2022-23,12273,2114,10159,82.8,85,48,56.5
10,All Students,2018-19,15560,2292,13268,85.3,104,56,53.8
10,All Students,2019-20,7789,1033,6756,86.7,74,34,45.9
10,All Students,2020-21,16239,3609,12630,77.8,95,44,46.3
10,All Students,2021-22,12413,2626,9787,78.8,81,50,61.7
10,All Students,2022-23,17721,3956,13765,77.7,117,77,65.8
11,All Students,2018-19,12477,1480,10997,88.1,77,35,45.5
11,All Students,2019-20,8562,1192,7370,86.1,82,40,48.8
11,All Students,2020-21,11414,1872,9542,83.6,66,31,47.0
11,All Students,2021-22,12396,1964,10432,84.2,78,39,50.0
11,All Students,2022-23,9973,1665,8308,83.3,62,38,61.3
12,All Students,2018-19,13258,2121,11137,84.0,90,48,53.3
12,All Students,2019-20,7665,1020,6645,86.7,75,35,46.7
12,All Students,2020-21,11674,1667,10007,85.7,70,31,44.3
12,All Students,2021-22,9703,2348,7355,75.8,60,41,68.3
12,All Students,2022-23,10548,1872,8676,82.3,72,44,61.1
All Grades,All Students,2018-19,66978,5733,61245,91.4,389,125,32.1
All Grades,All Students,2019-20,42213,2455,39758,94.2,378,60,15.9
All Grades,All Students,2020-21,65348,3415,61933,94.8,382,54,14.1
All Grades,All Students,2021-22,63369,7218,56151,88.6,383,178,46.5
All Grades,All Students,2022-23,66555,6129,60426,90.8,396,138,34.8
6,All Students,2018-19,22847,1582,21265,93.1,132,34,25.8
6,All Students,2019-20,13533,773,12760,94.3,120,19,15.8
6,All Students,2020-21,22312,1313,20999,94.1,134,22,16.4
6,All Students,2021-22,18077,2305,15772,87.2,113,69,61.1
6,All Students,2022-23,22838,2192,20646,90.4,136,53,39.0
7,All Students,2018-19,21346,1694,19652,92.1,125,39,31.2
7,All Students,2019-20,14381,752,13629,94.8,131,20,15.3
7,All Students,2020-21,20939,s,s,s,s,s,s
7,All Students,2021-22,23154,2339,20815,89.9,139,54,38.8
7,All Students,2022-23,20310,1712,18598,91.6,122,38,31.1
8,All Students,2018-19,22785,2457,20328,89.2,132,52,39.4
8,All Students,2019-20,14299,930,13369,93.5,127,21,16.5
8,All Students,2020-21,21956,1256,20700,94.3,126,19,15.1
8,All Students,2021-22,22138,2574,19564,88.4,131,55,42.0
8,All Students,2022-23,23407,2225,21182,90.5,138,47,34.1
9,All Students,2020-21,141,s,s,s,s,s,s
All Grades,All Students,2018-19,40884,4012,36872,90.2,264,106,40.2
All Grades,All Students,2019-20,23569,2347,21222,90.0,223,86,38.6
All Grades,All Students,2020-21,32989,4366,28623,86.8,195,84,43.1
All Grades,All Students,2021-22,33200,5388,27812,83.8,211,121,57.3
All Grades,All Students,2022-23,30197,3511,26686,88.4,191,76,39.8
6,All Students,2018-19,12732,1244,11488,90.2,83,30,36.1
6,All Students,2019-20,6227,633,5594,89.8,61,26,42.6
6,All Students,2020-21,9888,952,8936,90.4,59,18,30.5
6,All Students,2021-22,13735,1897,11838,86.2,88,44,50.0
6,All Students,2022-23,7656,905,6751,88.2,49,17,34.7
7,All Students,2018-19,13361,1442,11919,89.2,89,46,51.7
7,All Students,2019-20,9090,809,8281,91.1,82,25,30.5
7,All Students,2020-21,9291,1538,7753,83.4,54,30,55.6
7,All Students,2021-22,10174,1385,8789,86.4,62,35,56.5
7,All Students,2022-23,12081,1299,10782,89.2,77,31,40.3
8,All Students,2018-19,14791,1326,13465,91.0,92,30,32.6
8,All Students,2019-20,8252,905,7347,89.0,80,35,43.8
8,All Students,2020-21,13810,1876,11934,86.4,82,36,43.9
8,All Students,2021-22,9291,2106,7185,77.3,61,42,68.9
8,All Students,2022-23,10460,1307,9153,87.5,65,28,43.1
All Grades,All Students,2018-19,75839,10543,65296,86.1,490,248,50.6
All Grades,All Students,2019-20,44378,6531,37847,85.3,436,213,48.9
All Grades,All Students,2020-21,69357,10338,59019,85.1,420,177,42.1
All Grades,All Students,2021-22,70136,12179,57957,82.6,439,264,60.1
All Grades,All Students,2022-23,70530,11516,59014,83.7,455,251,55.2
6,All Students,2018-19,12031,958,11073,92.0,72,21,29.2
6,All Students,2019-20,5915,584,5331,90.1,57,19,33.3
6,All Students,2020-21,12082,1147,10935,90.5,70,17,24.3
6,All Students,2021-22,9632,1120,8512,88.4,61,30,49.2
6,All Students,2022-23,7891,1032,6859,86.9,48,24,50.0
7,All Students,2018-19,10644,1419,9225,86.7,68,34,50.0
7,All Students,2019-20,6877,567,6310,91.8,64,21,32.8
7,All Students,2020-21,8662,700,7962,91.9,51,11,21.6
7,All Students,2021-22,10294,1298,8996,87.4,62,36,58.1
7,All Students,2022-23,10668,1382,9286,87.0,66,32,48.5
8,All Students,2018-19,15337,1726,13611,88.7,96,42,43.8
8,All Students,2019-20,6103,841,5262,86.2,57,26,45.6
8,All Students,2020-21,10224,1263,8961,87.6,59,20,33.9
8,All Students,2021-22,9118,1603,7515,82.4,54,33,61.1
8,All Students,2022-23,11145,1478,9667,86.7,68,33,48.5
9,All Students,2018-19,8761,1397,7364,84.1,65,40,61.5
9,All Students,2019-20,8552,1439,7113,83.2,91,47,51.6
9,All Students,2020-21,9438,1863,7575,80.3,60,32,53.3
9,All Students,2021-22,14656,2764,11892,81.1,94,51,54.3
9,All Students,2022-23,11870,2602,9268,78.1,83,53,63.9
10,All Students,2018-19,10165,1683,8482,83.4,69,42,60.9
10,All Students,2019-20,5200,1317,3883,74.7,53,37,69.8
10,All Students,2020-21,12624,2340,10284,81.5,81,48,59.3
10,All Students,2021-22,8390,1575,6815,81.2,55,34,61.8
10,All Students,2022-23,13522,2392,11130,82.3,88,52,59.1
11,All Students,2018-19,8914,1443,7471,83.8,56,31,55.4
11,All Students,2019-20,5518,818,4700,85.2,56,30,53.6
11,All Students,2020-21,7444,1637,5807,78.0,47,28,59.6
11,All Students,2021-22,10926,2078,8848,81.0,71,48,67.6
11,All Students,2022-23,6508,1352,5156,79.2,44,29,65.9
12,All Students,2018-19,9987,1917,8070,80.8,64,38,59.4
12,All Students,2019-20,6213,965,5248,84.5,58,33,56.9
12,All Students,2020-21,8883,1388,7495,84.4,52,21,40.4
12,All Students,2021-22,7120,1741,5379,75.5,42,32,76.2
12,All Students,2022-23,8926,1278,7648,85.7,58,28,48.3
All Grades,All Students,2018-19,61334,4976,56358,91.9,368,121,32.9
All Grades,All Students,2019-20,50879,4133,46746,91.9,466,138,29.6
All Grades,All Students,2020-21,78158,6328,71830,91.9,464,113,24.4
All Grades,All Students,2021-22,71536,8529,63007,88.1,438,206,47.0
All Grades,All Students,2022-23,75070,8894,66176,88.2,446,218,48.9
PK in K-12 Schools,All Students,2018-19,8634,828,7806,90.4,51,20,39.2
PK in K-12 Schools,All Students,2019-20,5996,514,5482,91.4,54,18,33.3
PK in K-12 Schools,All Students,2020-21,7466,665,6801,91.1,47,14,29.8
PK in K-12 Schools,All Students,2021-22,7878,1075,6803,86.4,50,29,58.0
PK in K-12 Schools,All Students,2022-23,6241,760,5481,87.8,37,21,56.8
0K,All Students,2018-19,13479,1171,12308,91.3,81,29,35.8
0K,All Students,2019-20,9518,1006,8512,89.4,94,42,44.7
0K,All Students,2020-21,11609,1023,10586,91.2,72,18,25.0
0K,All Students,2021-22,11339,1615,9724,85.8,72,39,54.2
0K,All Students,2022-23,12041,1829,10212,84.8,71,45,63.4
1,All Students,2018-19,13727,1163,12564,91.5,85,33,38.8
1,All Students,2019-20,9825,832,8993,91.5,88,26,29.5
1,All Students,2020-21,14325,1433,12892,90.0,85,26,30.6
1,All Students,2021-22,9754,1117,8637,88.5,58,25,43.1
1,All Students,2022-23,11682,1520,10162,87.0,70,38,54.3
2,All Students,2018-19,9832,743,9089,92.4,59,17,28.8
2,All Students,2019-20,9035,635,8400,93.0,82,22,26.8
2,All Students,2020-21,13966,1110,12856,92.1,81,20,24.7
2,All Students,2021-22,11833,1395,10438,88.2,73,36,49.3
2,All Students,2022-23,9655,1124,8531,88.4,57,26,45.6
3,All Students,2018-19,9727,760,8967,92.2,58,19,32.8
3,All Students,2019-20,6166,442,5724,92.8,56,11,19.6
3,All Students,2020-21,13400,1075,12325,92.0,77,21,27.3
3,All Students,2021-22,12369,1290,11079,89.6,76,26,34.2
3,All Students,2022-23,11346,1146,10200,89.9,66,26,39.4
4,All Students,2018-19,5935,311,5624,94.8,34,3,8.8
4,All Students,2019-20,6139,493,5646,92.0,54,14,25.9
4,All Students,2020-21,8434,567,7867,93.3,50,8,16.0
4,All Students,2021-22,11267,1495,9772,86.7,67,37,55.2
4,All Students,2022-23,12372,1308,11064,89.4,76,31,40.8
5,All Students,2019-20,4200,211,3989,95.0,39,5,12.8
5,All Students,2020-21,8958,455,8503,94.9,52,6,11.5
5,All Students,2021-22,7096,542,6554,92.4,42,14,33.3
5,All Students,2022-23,11733,1207,10526,89.7,69,31,44.9
All Grades,All Students,2018-19,128038,18601,109437,85.5,792,341,43.1
All Grades,All Students,2019-20,97991,14143,83848,85.6,919,406,44.2
All Grades,All Students,2020-21,172775,22208,150567,87.1,1026,387,37.7
All Grades,All Students,2021-22,171141,21846,149295,87.2,1097,489,44.6
All Grades,All Students,2022-23,167153,20580,146573,87.7,1103,416,37.7
8,All Students,2021-22,1,s,s,s,s,s,s
9,All Students,2018-19,57698,9661,48037,83.3,352,159,45.2
9,All Students,2019-20,44898,7875,37023,82.5,424,216,50.9
9,All Students,2020-21,63836,9605,54231,85.0,375,158,42.1
9,All Students,2021-22,50384,5789,44595,88.5,329,134,40.7
9,All Students,2022-23,51132,5244,45888,89.7,334,98,29.3
10,All Students,2018-19,29740,4644,25096,84.4,186,96,51.6
10,All Students,2019-20,22716,2964,19752,87.0,212,83,39.2
10,All Students,2020-21,53268,7244,46024,86.4,316,121,38.3
10,All Students,2021-22,49178,6947,42231,85.9,320,159,49.7
10,All Students,2022-23,46655,5941,40714,87.3,310,118,38.1
11,All Students,2018-19,20416,1745,18671,91.5,125,32,25.6
11,All Students,2019-20,15601,1641,13960,89.5,144,54,37.5
11,All Students,2020-21,34415,3526,30889,89.8,203,63,31.0
11,All Students,2021-22,41482,5533,35949,86.7,259,115,44.4
11,All Students,2022-23,39150,5504,33646,85.9,260,114,43.8
12,All Students,2018-19,20184,2551,17633,87.4,129,54,41.9
12,All Students,2019-20,14776,1663,13113,88.7,139,53,38.1
12,All Students,2020-21,21256,1833,19423,91.4,132,45,34.1
12,All Students,2021-22,30096,s,s,s,s,s,s
12,All Students,2022-23,30216,3891,26325,87.1,199,86,43.2
All Grades,All Students,2018-19,53518,4476,49042,91.6,332,96,28.9
All Grades,All Students,2019-20,33070,2733,30337,91.7,315,89,28.3
All Grades,All Students,2020-21,47974,2633,45341,94.5,288,37,12.8
All Grades,All Students,2021-22,48722,7127,41595,85.4,313,178,56.9
All Grades,All Students,2022-23,46727,5436,41291,88.4,282,125,44.3
5,All Students,2019-20,3,s,s,s,s,s,s
6,All Students,2018-19,16771,1505,15266,91.0,105,33,31.4
6,All Students,2019-20,10570,s,s,s,s,s,s
6,All Students,2020-21,17802,932,16870,94.8,106,12,11.3
6,All Students,2021-22,16027,2454,13573,84.7,103,60,58.3
6,All Students,2022-23,11679,1234,10445,89.4,72,28,38.9
7,All Students,2018-19,18360,1509,16851,91.8,114,36,31.6
7,All Students,2019-20,10829,1047,9782,90.3,105,35,33.3
7,All Students,2020-21,15329,795,14534,94.8,94,11,11.7
7,All Students,2021-22,17996,2499,15497,86.1,114,61,53.5
7,All Students,2022-23,17550,1914,15636,89.1,106,46,43.4
8,All Students,2018-19,18387,1462,16925,92.0,113,27,23.9
8,All Students,2019-20,11668,958,10710,91.8,112,33,29.5
8,All Students,2020-21,14843,906,13937,93.9,88,14,15.9
8,All Students,2021-22,14699,2174,12525,85.2,96,57,59.4
8,All Students,2022-23,17498,2288,15210,86.9,104,51,49.0
11,All Students,2018-19,21593,3721,17872,82.8,137,66,48.2
All Grades,All Students,2018-19,56206,8788,47418,84.4,374,212,56.7
All Grades,All Students,2019-20,37570,5918,31652,84.2,373,203,54.4
All Grades,All Students,2020-21,59571,9047,50524,84.8,370,139,37.6
All Grades,All Students,2021-22,55097,11107,43990,79.8,354,201,56.8
All Grades,All Students,2022-23,56091,7283,48808,87.0,372,140,37.6
9,All Students,2018-19,13917,1637,12280,88.2,99,40,40.4
9,All Students,2019-20,10102,1379,8723,86.3,108,57,52.8
9,All Students,2020-21,14937,1149,13788,92.3,95,21,22.1
9,All Students,2021-22,12830,1863,10967,85.5,89,43,48.3
9,All Students,2022-23,15895,1791,14104,88.7,110,37,33.6
10,All Students,2018-19,15708,2790,12918,82.2,103,60,58.3
10,All Students,2019-20,8782,1180,7602,86.6,90,43,47.8
10,All Students,2020-21,14301,2422,11879,83.1,88,32,36.4
10,All Students,2021-22,15299,2180,13119,85.8,94,39,41.5
10,All Students,2022-23,12802,1376,11426,89.3,85,29,34.1
11,All Students,2018-19,12428,1415,11013,88.6,83,41,49.4
11,All Students,2019-20,8533,1579,6954,81.5,81,47,58.0
11,All Students,2020-21,14807,2790,12017,81.2,91,42,46.2
11,All Students,2021-22,10647,2298,8349,78.4,64,29,45.3
11,All Students,2022-23,16051,2120,13931,86.8,104,34,32.7
12,All Students,2018-19,14153,2946,11207,79.2,89,71,79.8
12,All Students,2019-20,10153,1780,8373,82.5,94,56,59.6
12,All Students,2020-21,15526,2686,12840,82.7,96,44,45.8
12,All Students,2021-22,16321,4766,11555,70.8,107,90,84.1
12,All Students,2022-23,11343,1996,9347,82.4,73,40,54.8
All Grades,All Students,2018-19,69283,5429,63854,92.2,401,109,27.2
All Grades,All Students,2019-20,43154,3339,39815,92.3,396,106,26.8
All Grades,All Students,2020-21,62937,7209,55728,88.5,370,136,36.8
All Grades,All Students,2021-22,61593,9140,52453,85.2,371,218,58.8
All Grades,All Students,2022-23,54117,7631,46486,85.9,339,178,52.5
6,All Students,2018-19,23504,1492,22012,93.7,138,27,19.6
6,All Students,2019-20,13178,1036,12142,92.1,126,34,27.0
6,All Students,2020-21,20407,2064,18343,89.9,120,38,31.7
6,All Students,2021-22,20899,3036,17863,85.5,127,73,57.5
6,All Students,2022-23,15124,1965,13159,87.0,96,48,50.0
7,All Students,2018-19,22348,1686,20662,92.5,128,37,28.9
7,All Students,2019-20,15058,1017,14041,93.2,136,32,23.5
7,All Students,2020-21,19355,2368,16987,87.8,115,48,41.7
7,All Students,2021-22,20240,3165,17075,84.4,121,74,61.2
7,All Students,2022-23,18635,2614,16021,86.0,119,66,55.5
8,All Students,2018-19,23431,2251,21180,90.4,135,45,33.3
8,All Students,2019-20,14918,1286,13632,91.4,134,40,29.9
8,All Students,2020-21,23175,2777,20398,88.0,135,50,37.0
8,All Students,2021-22,20454,2939,17515,85.6,123,71,57.7
8,All Students,2022-23,20358,3052,17306,85.0,124,64,51.6
All Grades,All Students,2018-19,82616,16384,66232,80.2,547,307,56.1
All Grades,All Students,2019-20,50943,11086,39857,78.2,500,305,61.0
All Grades,All Students,2020-21,64419,11652,52767,81.9,394,157,39.8
All Grades,All Students,2021-22,49732,9567,40165,80.8,351,183,52.1
All Grades,All Students,2022-23,52579,7245,45334,86.2,370,107,28.9
9,All Students,2018-19,17213,3526,13687,79.5,115,56,48.7
9,All Students,2019-20,12213,2960,9253,75.8,125,71,56.8
9,All Students,2020-21,11120,1414,9706,87.3,65,14,21.5
9,All Students,2021-22,11935,2604,9331,78.2,91,40,44.0
9,All Students,2022-23,18346,3036,15310,83.5,130,38,29.2
10,All Students,2018-19,21744,4569,17175,79.0,145,88,60.7
10,All Students,2019-20,10444,2527,7917,75.8,100,61,61.0
10,All Students,2020-21,19638,4397,15241,77.6,121,64,52.9
10,All Students,2021-22,12651,2587,10064,79.6,90,46,51.1
10,All Students,2022-23,11003,1750,9253,84.1,81,25,30.9
11,All Students,2019-20,12311,2282,10029,81.5,119,81,68.1
11,All Students,2020-21,14438,2799,11639,80.6,91,45,49.5
11,All Students,2021-22,13650,2270,11380,83.4,94,53,56.4
11,All Students,2022-23,11902,1535,10367,87.1,84,26,31.0
12,All Students,2018-19,22066,4568,17498,79.3,150,97,64.7
12,All Students,2019-20,15975,3317,12658,79.2,156,92,59.0
12,All Students,2020-21,19223,3042,16181,84.2,117,34,29.1
12,All Students,2021-22,11496,2106,9390,81.7,76,44,57.9
12,All Students,2022-23,11328,924,10404,91.8,75,18,24.0
All Grades,All Students,2018-19,61449,6566,54883,89.3,374,159,42.5
All Grades,All Students,2019-20,39295,3985,35310,89.9,372,151,40.6
All Grades,All Students,2020-21,59926,4944,54982,91.7,357,86,24.1
All Grades,All Students,2021-22,61222,8565,52657,86.0,387,220,56.8
All Grades,All Students,2022-23,53797,6561,47236,87.8,336,160,47.6
6,All Students,2018-19,18943,1999,16944,89.4,115,51,44.3
6,All Students,2019-20,11445,1056,10389,90.8,109,41,37.6
6,All Students,2020-21,19914,761,19153,96.2,119,15,12.6
6,All Students,2021-22,16006,2486,13520,84.5,100,64,64.0
6,All Students,2022-23,10876,1377,9499,87.3,72,34,47.2
7,All Students,2018-19,20200,2050,18150,89.9,124,52,41.9
7,All Students,2019-20,13576,1358,12218,90.0,131,50,38.2
7,All Students,2020-21,18533,1333,17200,92.8,110,22,20.0
7,All Students,2021-22,24265,3112,21153,87.2,155,85,54.8
7,All Students,2022-23,16274,1882,14392,88.4,101,44,43.6
8,All Students,2018-19,22306,2517,19789,88.7,135,56,41.5
8,All Students,2019-20,14274,1571,12703,89.0,132,60,45.5
8,All Students,2020-21,21479,2850,18629,86.7,128,49,38.3
8,All Students,2021-22,20951,2967,17984,85.8,132,71,53.8
8,All Students,2022-23,26647,3302,23345,87.6,163,82,50.3
All Grades,All Students,2018-19,54598,9613,44985,82.4,369,207,56.1
All Grades,All Students,2019-20,35681,4150,31531,88.4,349,144,41.3
All Grades,All Students,2020-21,60284,6125,54159,89.8,362,147,40.6
All Grades,All Students,2021-22,58302,8674,49628,85.1,375,192,51.2
All Grades,All Students,2022-23,57094,9276,47818,83.8,372,198,53.2
9,All Students,2018-19,15779,2090,13689,86.8,103,43,41.7
9,All Students,2019-20,9449,911,8538,90.4,96,32,33.3
9,All Students,2020-21,14855,1227,13628,91.7,89,31,34.8
9,All Students,2021-22,16820,2216,14604,86.8,111,44,39.6
9,All Students,2022-23,15424,2200,13224,85.7,103,47,45.6
10,All Students,2018-19,19097,3724,15373,80.5,131,80,61.1
10,All Students,2019-20,10406,1131,9275,89.1,99,41,41.4
10,All Students,2020-21,14358,1504,12854,89.5,85,34,40.0
10,All Students,2021-22,13505,2103,11402,84.4,89,46,51.7
10,All Students,2022-23,16893,2650,14243,84.3,108,52,48.1
11,All Students,2018-19,9127,1727,7400,81.1,65,40,61.5
11,All Students,2019-20,9864,1389,8475,85.9,95,41,43.2
11,All Students,2020-21,16151,1613,14538,90.0,94,41,43.6
11,All Students,2021-22,13404,1954,11450,85.4,83,48,57.8
11,All Students,2022-23,12664,2116,10548,83.3,84,46,54.8
12,All Students,2018-19,10595,2072,8523,80.4,70,44,62.9
12,All Students,2019-20,5962,719,5243,87.9,59,30,50.8
12,All Students,2020-21,14914,1776,13138,88.1,94,41,43.6
12,All Students,2021-22,14573,2401,12172,83.5,92,54,58.7
12,All Students,2022-23,12113,2310,9803,80.9,77,53,68.8
All Grades,All Students,2018-19,91331,16409,74922,82.0,591,292,49.4
All Grades,All Students,2019-20,55890,9067,46823,83.8,538,233,43.3
All Grades,All Students,2020-21,77682,13984,63698,82.0,461,229,49.7
All Grades,All Students,2021-22,76286,15321,60965,79.9,485,293,60.4
All Grades,All Students,2022-23,67188,12590,54598,81.3,441,267,60.5
8,All Students,2020-21,5,s,s,s,s,s,s
9,All Students,2018-19,29252,6189,23063,78.8,189,91,48.1
9,All Students,2019-20,18292,4436,13856,75.7,175,93,53.1
9,All Students,2020-21,19498,4558,14940,76.6,112,52,46.4
9,All Students,2021-22,23276,4876,18400,79.1,153,99,64.7
9,All Students,2022-23,17608,3506,14102,80.1,120,73,60.8
10,All Students,2018-19,25664,4984,20680,80.6,170,80,47.1
10,All Students,2019-20,15043,2121,12922,85.9,147,60,40.8
10,All Students,2020-21,20108,3708,16400,81.6,122,66,54.1
10,All Students,2021-22,15684,3653,12031,76.7,98,62,63.3
10,All Students,2022-23,19532,3741,15791,80.8,124,75,60.5
11,All Students,2018-19,17373,2094,15279,87.9,112,53,47.3
11,All Students,2019-20,10933,1340,9593,87.7,107,40,37.4
11,All Students,2020-21,21774,3197,18577,85.3,126,59,46.8
11,All Students,2021-22,17016,3474,13542,79.6,111,66,59.5
11,All Students,2022-23,14358,2712,11646,81.1,97,63,64.9
12,All Students,2018-19,19042,3142,15900,83.5,120,68,56.7
12,All Students,2019-20,11622,1170,10452,89.9,109,40,36.7
12,All Students,2020-21,16297,s,s,s,s,s,s
12,All Students,2021-22,20310,3318,16992,83.7,123,66,53.7
12,All Students,2022-23,15690,2631,13059,83.2,100,56,56.0
All Grades,All Students,2018-19,50460,14968,35492,70.3,349,250,71.6
All Grades,All Students,2019-20,26822,7566,19256,71.8,267,198,74.2
All Grades,All Students,2020-21,27954,3979,23975,85.8,172,67,39.0
9,All Students,2018-19,14492,4425,10067,69.5,110,83,75.5
9,All Students,2019-20,9660,3015,6645,68.8,99,72,72.7
9,All Students,2020-21,9616,2003,7613,79.2,55,31,56.4
10,All Students,2018-19,14569,5107,9462,64.9,93,71,76.3
10,All Students,2019-20,8066,2325,5741,71.2,78,63,80.8
10,All Students,2020-21,5693,1103,4590,80.6,36,21,58.3
11,All Students,2018-19,9559,2421,7138,74.7,70,47,67.1
11,All Students,2019-20,6239,1228,5011,80.3,62,42,67.7
11,All Students,2020-21,7772,498,7274,93.6,47,6,12.8
12,All Students,2018-19,11840,3015,8825,74.5,76,49,64.5
12,All Students,2019-20,2857,998,1859,65.1,28,21,75.0
12,All Students,2020-21,4873,375,4498,92.3,34,9,26.5
All Grades,All Students,2018-19,63337,10473,52864,83.5,422,250,59.2
All Grades,All Students,2019-20,40738,6145,34593,84.9,404,197,48.8
All Grades,All Students,2020-21,63945,7894,56051,87.7,385,118,30.6
All Grades,All Students,2021-22,63393,13713,49680,78.4,401,273,68.1
All Grades,All Students,2022-23,62801,11825,50976,81.2,391,225,57.5
8,All Students,2022-23,16,s,s,s,s,s,s
9,All Students,2018-19,15265,2443,12822,84.0,104,60,57.7
9,All Students,2019-20,8834,1242,7592,85.9,94,45,47.9
9,All Students,2020-21,17945,1167,16778,93.5,107,21,19.6
9,All Students,2021-22,20863,3289,17574,84.2,135,75,55.6
9,All Students,2022-23,17575,2467,15108,86.0,110,50,45.5
10,All Students,2018-19,17787,2929,14858,83.5,117,63,53.8
10,All Students,2019-20,10753,1863,8890,82.7,105,58,55.2
10,All Students,2020-21,13934,2022,11912,85.5,87,34,39.1
10,All Students,2021-22,16980,3276,13704,80.7,105,65,61.9
10,All Students,2022-23,19936,3851,16085,80.7,123,70,56.9
11,All Students,2018-19,14968,2707,12261,81.9,98,60,61.2
11,All Students,2019-20,11683,1593,10090,86.4,116,49,42.2
11,All Students,2020-21,15372,2839,12533,81.5,94,41,43.6
11,All Students,2021-22,13128,3641,9487,72.3,83,66,79.5
11,All Students,2022-23,14453,2596,11857,82.0,89,56,62.9
12,All Students,2018-19,15317,2394,12923,84.4,103,67,65.0
12,All Students,2019-20,9468,1447,8021,84.7,89,45,50.6
12,All Students,2020-21,16694,1866,14828,88.8,97,22,22.7
12,All Students,2021-22,12422,3507,8915,71.8,78,67,85.9
12,All Students,2022-23,10821,s,s,s,s,s,s
All Grades,All Students,2018-19,120092,9354,110738,92.2,716,210,29.3
All Grades,All Students,2019-20,72874,5551,67323,92.4,668,203,30.4
All Grades,All Students,2020-21,97182,4395,92787,95.5,568,75,13.2
All Grades,All Students,2021-22,93871,12072,81799,87.1,577,281,48.7
All Grades,All Students,2022-23,102584,10839,91745,89.4,631,261,41.4
6,All Students,2018-19,34459,s,s,s,s,s,s
6,All Students,2019-20,20872,1572,19300,92.5,193,56,29.0
6,All Students,2020-21,30922,1133,29789,96.3,184,17,9.2
6,All Students,2021-22,30512,s,s,s,s,s,s
6,All Students,2022-23,36027,3709,32318,89.7,221,94,42.5
7,All Students,2018-19,43334,3469,39865,92.0,259,82,31.7
7,All Students,2019-20,24115,1784,22331,92.6,222,69,31.1
7,All Students,2020-21,31661,1380,30281,95.6,182,25,13.7
7,All Students,2021-22,31285,3612,27673,88.5,190,80,42.1
7,All Students,2022-23,33652,3526,30126,89.5,207,87,42.0
8,All Students,2018-19,42278,3572,38706,91.6,251,82,32.7
8,All Students,2019-20,27887,2195,25692,92.1,253,78,30.8
8,All Students,2020-21,34599,1882,32717,94.6,202,33,16.3
8,All Students,2021-22,32070,4759,27311,85.2,200,107,53.5
8,All Students,2022-23,32905,3604,29301,89.0,203,80,39.4
9,All Students,2018-19,21,s,s,s,s,s,s
9,All Students,2021-22,4,s,s,s,s,s,s
All Grades,All Students,2018-19,33617,3630,29987,89.2,203,87,42.9
All Grades,All Students,2019-20,30576,2981,27595,90.3,287,111,38.7
All Grades,All Students,2020-21,55039,5324,49715,90.3,333,106,31.8
All Grades,All Students,2021-22,64911,9604,55307,85.2,392,247,63.0
All Grades,All Students,2022-23,74891,8278,66613,88.9,462,227,49.1
PK in K-12 Schools,All Students,2018-19,12023,1354,10669,88.7,70,32,45.7
PK in K-12 Schools,All Students,2019-20,9296,937,8359,89.9,86,31,36.0
PK in K-12 Schools,All Students,2020-21,10666,1339,9327,87.4,66,25,37.9
PK in K-12 Schools,All Students,2021-22,11148,1886,9262,83.1,68,50,73.5
PK in K-12 Schools,All Students,2022-23,8556,1234,7322,85.6,53,33,62.3
0K,All Students,2018-19,11938,1227,10711,89.7,74,27,36.5
0K,All Students,2019-20,8922,898,8024,89.9,84,33,39.3
0K,All Students,2020-21,13997,1738,12259,87.6,84,36,42.9
0K,All Students,2021-22,10673,1522,9151,85.7,66,42,63.6
0K,All Students,2022-23,12801,1733,11068,86.5,80,51,63.8
1,All Students,2018-19,9656,1049,8607,89.1,59,28,47.5
1,All Students,2019-20,6527,604,5923,90.7,61,26,42.6
1,All Students,2020-21,12789,1118,11671,91.3,78,22,28.2
1,All Students,2021-22,16212,2574,13638,84.1,96,66,68.8
1,All Students,2022-23,10764,1167,9597,89.2,64,31,48.4
2,All Students,2019-20,5831,542,5289,90.7,56,21,37.5
2,All Students,2020-21,9058,525,8533,94.2,54,11,20.4
2,All Students,2021-22,10588,1462,9126,86.2,62,38,61.3
2,All Students,2022-23,14992,1541,13451,89.7,94,44,46.8
3,All Students,2020-21,8529,604,7925,92.9,51,12,23.5
3,All Students,2021-22,8132,1150,6982,85.9,51,29,56.9
3,All Students,2022-23,10459,938,9521,91.0,64,26,40.6
4,All Students,2021-22,8158,1010,7148,87.6,49,22,44.9
4,All Students,2022-23,8574,865,7709,89.9,54,23,42.6
5,All Students,2022-23,8745,800,7945,90.9,53,19,35.8
All Grades,All Students,2018-19,96680,11946,84734,87.6,636,329,51.7
All Grades,All Students,2019-20,53625,4843,48782,91.0,523,200,38.2
All Grades,All Students,2020-21,73483,8680,64803,88.2,454,196,43.2
All Grades,All Students,2021-22,59784,6395,53389,89.3,394,188,47.7
All Grades,All Students,2022-23,60293,6724,53569,88.8,383,171,44.6
PK in K-12 Schools,All Students,2018-19,5336,s,s,s,s,s,s
PK in K-12 Schools,All Students,2019-20,3816,484,3332,87.3,39,23,59.0
PK in K-12 Schools,All Students,2020-21,4596,s,s,s,s,s,s
PK in K-12 Schools,All Students,2021-22,2631,s,s,s,s,s,s
PK in K-12 Schools,All Students,2022-23,4585,584,4001,87.3,30,17,56.7
0K,All Students,2018-19,8713,1373,7340,84.2,59,41,69.5
0K,All Students,2019-20,5338,695,4643,87.0,53,27,50.9
0K,All Students,2020-21,5308,895,4413,83.1,34,18,52.9
0K,All Students,2021-22,5248,719,4529,86.3,37,21,56.8
0K,All Students,2022-23,3482,423,3059,87.9,25,12,48.0
1,All Students,2018-19,10299,1146,9153,88.9,68,33,48.5
1,All Students,2019-20,4558,418,4140,90.8,46,19,41.3
1,All Students,2020-21,6952,763,6189,89.0,44,18,40.9
1,All Students,2021-22,4514,688,3826,84.8,30,19,63.3
1,All Students,2022-23,5200,722,4478,86.1,33,18,54.5
2,All Students,2018-19,10269,1141,9128,88.9,68,36,52.9
2,All Students,2019-20,6126,492,5634,92.0,59,20,33.9
2,All Students,2020-21,7200,772,6428,89.3,44,18,40.9
2,All Students,2021-22,5248,626,4622,88.1,35,19,54.3
2,All Students,2022-23,4782,700,4082,85.4,30,17,56.7
3,All Students,2018-19,9773,1033,8740,89.4,66,34,51.5
3,All Students,2019-20,4803,331,4472,93.1,48,14,29.2
3,All Students,2020-21,9142,950,8192,89.6,55,21,38.2
3,All Students,2021-22,6581,684,5897,89.6,43,20,46.5
3,All Students,2022-23,4797,460,4337,90.4,32,12,37.5
4,All Students,2018-19,11791,1160,10631,90.2,77,31,40.3
4,All Students,2019-20,5818,463,5355,92.0,55,18,32.7
4,All Students,2020-21,7308,966,6342,86.8,45,19,42.2
4,All Students,2021-22,7466,656,6810,91.2,49,17,34.7
4,All Students,2022-23,6961,840,6121,87.9,46,23,50.0
5,All Students,2018-19,9886,1208,8678,87.8,65,35,53.8
5,All Students,2019-20,7672,654,7018,91.5,76,30,39.5
5,All Students,2020-21,7924,928,6996,88.3,49,23,46.9
5,All Students,2021-22,6406,581,5825,90.9,43,17,39.5
5,All Students,2022-23,8170,674,7496,91.8,49,14,28.6
6,All Students,2018-19,6997,657,6340,90.6,46,21,45.7
6,All Students,2019-20,4573,336,4237,92.7,44,16,36.4
6,All Students,2020-21,11110,1574,9536,85.8,66,35,53.0
6,All Students,2021-22,8706,813,7893,90.7,57,25,43.9
6,All Students,2022-23,6046,649,5397,89.3,36,15,41.7
7,All Students,2018-19,11095,1453,9642,86.9,69,34,49.3
7,All Students,2019-20,4718,338,4380,92.8,44,14,31.8
7,All Students,2020-21,6631,707,5924,89.3,41,17,41.5
7,All Students,2021-22,7678,837,6841,89.1,45,22,48.9
7,All Students,2022-23,8703,803,7900,90.8,56,20,35.7
8,All Students,2018-19,12406,1878,10528,84.9,77,37,48.1
8,All Students,2019-20,6203,632,5571,89.8,59,19,32.2
8,All Students,2020-21,7300,532,6768,92.7,42,11,26.2
8,All Students,2021-22,5303,402,4901,92.4,34,13,38.2
8,All Students,2022-23,7567,869,6698,88.5,46,23,50.0
9,All Students,2018-19,115,s,s,s,s,s,s
9,All Students,2020-21,12,s,s,s,s,s,s
9,All Students,2021-22,3,s,s,s,s,s,s
All Grades,All Students,2018-19,98108,10255,87853,89.5,594,230,38.7
All Grades,All Students,2019-20,63914,6964,56950,89.1,600,248,41.3
All Grades,All Students,2020-21,88742,13612,75130,84.7,545,264,48.4
All Grades,All Students,2021-22,79189,11235,67954,85.8,501,281,56.1
All Grades,All Students,2022-23,78396,8729,69667,88.9,499,226,45.3
PK in K-12 Schools,All Students,2019-20,6670,1158,5512,82.6,67,39,58.2
PK in K-12 Schools,All Students,2020-21,9974,1535,8439,84.6,65,32,49.2
PK in K-12 Schools,All Students,2021-22,9783,1629,8154,83.3,63,44,69.8
PK in K-12 Schools,All Students,2022-23,10779,1589,9190,85.3,79,50,63.3
0K,All Students,2018-19,13509,2059,11450,84.8,83,46,55.4
0K,All Students,2019-20,7857,1060,6797,86.5,76,38,50.0
0K,All Students,2020-21,10968,1794,9174,83.6,70,37,52.9
0K,All Students,2021-22,10305,1582,8723,84.6,64,41,64.1
0K,All Students,2022-23,10598,1347,9251,87.3,68,32,47.1
1,All Students,2018-19,15748,1874,13874,88.1,94,41,43.6
1,All Students,2019-20,7521,1013,6508,86.5,72,39,54.2
1,All Students,2020-21,12340,1908,10432,84.5,77,40,51.9
1,All Students,2021-22,10771,1517,9254,85.9,68,35,51.5
1,All Students,2022-23,10798,1475,9323,86.3,67,40,59.7
2,All Students,2018-19,16423,1757,14666,89.3,101,43,42.6
2,All Students,2019-20,10007,938,9069,90.6,93,33,35.5
2,All Students,2020-21,10736,2033,8703,81.1,65,39,60.0
2,All Students,2021-22,10472,1316,9156,87.4,71,38,53.5
2,All Students,2022-23,10787,943,9844,91.3,66,19,28.8
3,All Students,2018-19,17804,1639,16165,90.8,108,36,33.3
3,All Students,2019-20,10250,884,9366,91.4,94,27,28.7
3,All Students,2020-21,14802,2139,12663,85.5,89,43,48.3
3,All Students,2021-22,11388,1742,9646,84.7,74,39,52.7
3,All Students,2022-23,10668,924,9744,91.3,66,20,30.3
4,All Students,2018-19,17308,1322,15986,92.4,104,26,25.0
4,All Students,2019-20,10723,1110,9613,89.6,99,43,43.4
4,All Students,2020-21,15649,2055,13594,86.9,95,34,35.8
4,All Students,2021-22,13514,1898,11616,86.0,83,47,56.6
4,All Students,2022-23,12491,1292,11199,89.7,76,32,42.1
5,All Students,2018-19,17316,1604,15712,90.7,104,38,36.5
5,All Students,2019-20,10886,801,10085,92.6,99,29,29.3
5,All Students,2020-21,14273,2148,12125,85.0,84,39,46.4
5,All Students,2021-22,12956,1551,11405,88.0,78,37,47.4
5,All Students,2022-23,12275,1159,11116,90.6,77,33,42.9
All Grades,All Students,2018-19,75253,5343,69910,92.9,450,86,19.1
All Grades,All Students,2019-20,45205,3837,41368,91.5,425,109,25.6
All Grades,All Students,2020-21,61070,7064,54006,88.4,365,135,37.0
All Grades,All Students,2021-22,55574,7303,48271,86.9,335,161,48.1
All Grades,All Students,2022-23,49210,5800,43410,88.2,309,136,44.0
6,All Students,2018-19,23513,s,s,s,s,s,s
6,All Students,2019-20,13927,s,s,s,s,s,s
6,All Students,2020-21,17403,2313,15090,86.7,104,45,43.3
6,All Students,2021-22,17839,1759,16080,90.1,110,37,33.6
6,All Students,2022-23,12100,1195,10905,90.1,78,32,41.0
7,All Students,2018-19,23714,1716,21998,92.8,147,34,23.1
7,All Students,2019-20,15602,1469,14133,90.6,145,41,28.3
7,All Students,2020-21,21399,2116,19283,90.1,129,37,28.7
7,All Students,2021-22,17338,s,s,s,s,s,s
7,All Students,2022-23,19010,1931,17079,89.8,120,44,36.7
8,All Students,2018-19,27973,1788,26185,93.6,163,19,11.7
8,All Students,2019-20,15663,1194,14469,92.4,146,33,22.6
8,All Students,2020-21,22268,2635,19633,88.2,132,53,40.2
8,All Students,2021-22,20303,2386,17917,88.2,121,61,50.4
8,All Students,2022-23,18100,2674,15426,85.2,111,60,54.1
9,All Students,2018-19,53,s,s,s,s,s,s
9,All Students,2021-22,94,s,s,s,s,s,s
10,All Students,2019-20,13,s,s,s,s,s,s
All Grades,All Students,2018-19,130087,12759,117328,90.2,800,323,40.4
All Grades,All Students,2019-20,81051,7184,73867,91.1,750,253,33.7
All Grades,All Students,2020-21,110055,16031,94024,85.4,679,289,42.6
All Grades,All Students,2021-22,106490,15332,91158,85.6,649,355,54.7
All Grades,All Students,2022-23,106497,14003,92494,86.9,661,355,53.7
PK in K-12 Schools,All Students,2018-19,9266,s,s,s,s,s,s
PK in K-12 Schools,All Students,2019-20,5843,573,5270,90.2,55,22,40.0
PK in K-12 Schools,All Students,2020-21,7928,933,6995,88.2,58,23,39.7
PK in K-12 Schools,All Students,2021-22,8537,1296,7241,84.8,51,28,54.9
PK in K-12 Schools,All Students,2022-23,8865,1389,7476,84.3,51,32,62.7
0K,All Students,2018-19,19710,2233,17477,88.7,125,58,46.4
0K,All Students,2019-20,12714,1468,11246,88.5,119,56,47.1
0K,All Students,2020-21,15006,2144,12862,85.7,99,46,46.5
0K,All Students,2021-22,16106,2588,13518,83.9,103,62,60.2
0K,All Students,2022-23,16108,2542,13566,84.2,103,61,59.2
1,All Students,2018-19,21722,2543,19179,88.3,131,67,51.1
1,All Students,2019-20,13290,1379,11911,89.6,122,51,41.8
1,All Students,2020-21,17962,3840,14122,78.6,108,55,50.9
1,All Students,2021-22,15117,2566,12551,83.0,92,61,66.3
1,All Students,2022-23,16252,2136,14116,86.9,107,57,53.3
2,All Students,2018-19,18466,1867,16599,89.9,110,48,43.6
2,All Students,2019-20,11683,946,10737,91.9,111,36,32.4
2,All Students,2020-21,19330,2939,16391,84.8,117,52,44.4
2,All Students,2021-22,16860,2581,14279,84.7,105,61,58.1
2,All Students,2022-23,15984,2165,13819,86.5,98,58,59.2
3,All Students,2018-19,17073,1302,15771,92.4,105,26,24.8
3,All Students,2019-20,11832,1069,10763,91.0,108,38,35.2
3,All Students,2020-21,17473,2592,14881,85.2,105,44,41.9
3,All Students,2021-22,18624,2589,16035,86.1,112,61,54.5
3,All Students,2022-23,16296,2066,14230,87.3,103,60,58.3
4,All Students,2018-19,23658,1888,21770,92.0,148,44,29.7
4,All Students,2019-20,10826,724,10102,93.3,103,22,21.4
4,All Students,2020-21,17610,2219,15391,87.4,105,40,38.1
4,All Students,2021-22,14886,1816,13070,87.8,89,39,43.8
4,All Students,2022-23,18889,2414,16475,87.2,112,57,50.9
5,All Students,2018-19,20142,1708,18434,91.5,122,44,36.1
5,All Students,2019-20,14863,1025,13838,93.1,132,28,21.2
5,All Students,2020-21,14746,1364,13382,90.8,87,29,33.3
5,All Students,2021-22,16360,1896,14464,88.4,97,43,44.3
5,All Students,2022-23,14103,1291,12812,90.8,87,30,34.5
7,All Students,2018-19,50,s,s,s,s,s,s
All Grades,All Students,2018-19,108491,8074,100417,92.6,654,174,26.6
All Grades,All Students,2019-20,60838,4352,56486,92.8,573,150,26.2
All Grades,All Students,2020-21,84966,11689,73277,86.2,513,237,46.2
All Grades,All Students,2021-22,80415,10159,70256,87.4,502,252,50.2
All Grades,All Students,2022-23,71677,7699,63978,89.3,439,188,42.8
0K,All Students,2018-19,12324,1165,11159,90.5,77,30,39.0
0K,All Students,2019-20,6711,455,6256,93.2,68,17,25.0
0K,All Students,2020-21,11360,1946,9414,82.9,70,40,57.1
0K,All Students,2021-22,11510,1678,9832,85.4,71,48,67.6
0K,All Students,2022-23,9565,s,s,s,s,s,s
1,All Students,2018-19,20420,1592,18828,92.2,124,36,29.0
1,All Students,2019-20,8267,737,7530,91.1,78,28,35.9
1,All Students,2020-21,11231,s,s,s,s,s,s
1,All Students,2021-22,12445,1682,10763,86.5,79,39,49.4
1,All Students,2022-23,11336,1348,9988,88.1,71,41,57.7
2,All Students,2018-19,19226,1289,17937,93.3,119,29,24.4
2,All Students,2019-20,12179,859,11320,92.9,116,31,26.7
2,All Students,2020-21,12745,1459,11286,88.6,74,28,37.8
2,All Students,2021-22,10056,1156,8900,88.5,64,34,53.1
2,All Students,2022-23,11208,1274,9934,88.6,71,30,42.3
3,All Students,2018-19,17655,1047,16608,94.1,105,19,18.1
3,All Students,2019-20,12658,785,11873,93.8,117,28,23.9
3,All Students,2020-21,16845,2029,14816,88.0,100,44,44.0
3,All Students,2021-22,12659,1375,11284,89.1,79,30,38.0
3,All Students,2022-23,10926,904,10022,91.7,65,23,35.4
4,All Students,2018-19,18357,1380,16977,92.5,108,29,26.9
4,All Students,2019-20,10337,666,9671,93.6,97,21,21.6
4,All Students,2020-21,18416,2558,15858,86.1,110,46,41.8
4,All Students,2021-22,16235,2120,14115,86.9,102,49,48.0
4,All Students,2022-23,12482,1278,11204,89.8,75,24,32.0
5,All Students,2018-19,20509,1601,18908,92.2,121,31,25.6
5,All Students,2019-20,10686,850,9836,92.0,97,25,25.8
5,All Students,2020-21,14358,2057,12301,85.7,86,41,47.7
5,All Students,2021-22,17510,2148,15362,87.7,107,52,48.6
5,All Students,2022-23,16129,1596,14533,90.1,97,37,38.1
6,All Students,2020-21,11,s,s,s,s,s,s
6,All Students,2022-23,31,s,s,s,s,s,s
All Grades,All Students,2018-19,71428,5042,66386,92.9,434,110,25.3
All Grades,All Students,2019-20,42892,2721,40171,93.7,417,90,21.6
All Grades,All Students,2020-21,59387,6048,53339,89.8,362,123,34.0
All Grades,All Students,2021-22,56260,4327,51933,92.3,352,95,27.0
All Grades,All Students,2022-23,57599,3764,53835,93.5,365,76,20.8
PK in K-12 Schools,All Students,2018-19,6356,641,5715,89.9,39,15,38.5
PK in K-12 Schools,All Students,2019-20,3645,s,s,s,s,s,s
PK in K-12 Schools,All Students,2020-21,5159,855,4304,83.4,36,22,61.1
PK in K-12 Schools,All Students,2021-22,5117,562,4555,89.0,35,13,37.1
PK in K-12 Schools,All Students,2022-23,5626,677,4949,88.0,40,19,47.5
0K,All Students,2018-19,9783,700,9083,92.8,64,21,32.8
0K,All Students,2019-20,6825,425,6400,93.8,66,17,25.8
0K,All Students,2020-21,7626,1218,6408,84.0,47,24,51.1
0K,All Students,2021-22,9114,828,8286,90.9,58,21,36.2
0K,All Students,2022-23,10039,802,9237,92.0,67,19,28.4
1,All Students,2018-19,12328,918,11410,92.6,75,20,26.7
1,All Students,2019-20,5873,368,5505,93.7,58,11,19.0
1,All Students,2020-21,10659,1224,9435,88.5,65,24,36.9
1,All Students,2021-22,8259,688,7571,91.7,52,15,28.8
1,All Students,2022-23,9052,648,8404,92.8,57,14,24.6
2,All Students,2018-19,13026,1007,12019,92.3,77,17,22.1
2,All Students,2019-20,7663,510,7153,93.3,70,13,18.6
2,All Students,2020-21,8228,657,7571,92.0,49,14,28.6
2,All Students,2021-22,8952,582,8370,93.5,54,13,24.1
2,All Students,2022-23,7838,519,7319,93.4,48,9,18.8
3,All Students,2018-19,9667,457,9210,95.3,59,10,16.9
3,All Students,2019-20,7238,532,6706,92.6,70,20,28.6
3,All Students,2020-21,10014,1019,8995,89.8,61,21,34.4
3,All Students,2021-22,6658,436,6222,93.5,43,9,20.9
3,All Students,2022-23,8480,451,8029,94.7,53,6,11.3
4,All Students,2018-19,9269,591,8678,93.6,56,14,25.0
4,All Students,2019-20,5647,275,5372,95.1,54,8,14.8
4,All Students,2020-21,9880,624,9256,93.7,59,10,16.9
4,All Students,2021-22,10123,784,9339,92.3,61,15,24.6
4,All Students,2022-23,6442,277,6165,95.7,39,4,10.3
5,All Students,2018-19,10999,728,10271,93.4,64,13,20.3
5,All Students,2019-20,5989,291,5698,95.1,57,6,10.5
5,All Students,2020-21,7821,451,7370,94.2,45,8,17.8
5,All Students,2021-22,8037,447,7590,94.4,49,9,18.4
5,All Students,2022-23,10122,390,9732,96.1,61,5,8.2
8,All Students,2019-20,12,s,s,s,s,s,s
All Grades,All Students,2018-19,182952,19116,163836,89.6,1152,489,42.4
All Grades,All Students,2019-20,104116,9817,94299,90.6,999,374,37.4
All Grades,All Students,2020-21,149797,9949,139848,93.4,926,224,24.2
All Grades,All Students,2021-22,128494,18656,109838,85.5,805,471,58.5
All Grades,All Students,2022-23,114446,15710,98736,86.3,742,414,55.8
PK in K-12 Schools,All Students,2018-19,9144,1066,8078,88.3,58,30,51.7
PK in K-12 Schools,All Students,2019-20,9126,1041,8085,88.6,90,41,45.6
PK in K-12 Schools,All Students,2020-21,18744,738,18006,96.1,121,10,8.3
PK in K-12 Schools,All Students,2021-22,19278,3358,15920,82.6,125,91,72.8
PK in K-12 Schools,All Students,2022-23,15907,2760,13147,82.6,106,75,70.8
0K,All Students,2018-19,27348,3833,23515,86.0,180,100,55.6
0K,All Students,2019-20,12577,1441,11136,88.5,121,62,51.2
0K,All Students,2020-21,14701,724,13977,95.1,97,15,15.5
0K,All Students,2021-22,15245,2348,12897,84.6,100,66,66.0
0K,All Students,2022-23,16146,2608,13538,83.8,102,65,63.7
1,All Students,2018-19,23112,2829,20283,87.8,153,84,54.9
1,All Students,2019-20,13829,1582,12247,88.6,136,57,41.9
1,All Students,2020-21,19209,1494,17715,92.2,117,36,30.8
1,All Students,2021-22,16154,2456,13698,84.8,100,58,58.0
1,All Students,2022-23,15786,2398,13388,84.8,108,65,60.2
2,All Students,2018-19,31077,3298,27779,89.4,193,77,39.9
2,All Students,2019-20,13952,1321,12631,90.5,134,49,36.6
2,All Students,2020-21,19462,1553,17909,92.0,119,35,29.4
2,All Students,2021-22,16135,2351,13784,85.4,100,56,56.0
2,All Students,2022-23,14030,1781,12249,87.3,90,46,51.1
3,All Students,2018-19,27260,2559,24701,90.6,168,61,36.3
3,All Students,2019-20,17494,1583,15911,91.0,166,64,38.6
3,All Students,2020-21,21566,1077,20489,95.0,130,22,16.9
3,All Students,2021-22,18753,2597,16156,86.2,118,64,54.2
3,All Students,2022-23,15860,2067,13793,87.0,100,53,53.0
4,All Students,2018-19,31430,2852,28578,90.9,194,73,37.6
4,All Students,2019-20,19381,1451,17930,92.5,187,54,28.9
4,All Students,2020-21,27839,2337,25502,91.6,170,57,33.5
4,All Students,2021-22,21377,2702,18675,87.4,134,69,51.5
4,All Students,2022-23,17156,1957,15199,88.6,116,57,49.1
5,All Students,2018-19,33581,2679,30902,92.0,206,64,31.1
5,All Students,2019-20,17757,1398,16359,92.1,165,47,28.5
5,All Students,2020-21,28276,2026,26250,92.8,172,49,28.5
5,All Students,2021-22,21552,2844,18708,86.8,128,67,52.3
5,All Students,2022-23,19561,2139,17422,89.1,120,53,44.2
All Grades,All Students,2018-19,105584,10105,95479,90.4,649,244,37.6
All Grades,All Students,2019-20,70022,6947,63075,90.1,662,243,36.7
All Grades,All Students,2020-21,94442,10745,83697,88.6,560,224,40.0
All Grades,All Students,2021-22,89994,12755,77239,85.8,555,332,59.8
All Grades,All Students,2022-23,85783,10935,74848,87.3,531,278,52.4
PK in K-12 Schools,All Students,2018-19,12449,1387,11062,88.9,75,29,38.7
PK in K-12 Schools,All Students,2019-20,11434,1276,10158,88.8,104,47,45.2
PK in K-12 Schools,All Students,2020-21,12728,1459,11269,88.5,78,39,50.0
PK in K-12 Schools,All Students,2021-22,13232,2079,11153,84.3,90,66,73.3
PK in K-12 Schools,All Students,2022-23,11659,1944,9715,83.3,74,53,71.6
0K,All Students,2018-19,12497,1207,11290,90.3,78,28,35.9
0K,All Students,2019-20,10975,1375,9600,87.5,108,49,45.4
0K,All Students,2020-21,13223,2149,11074,83.7,80,40,50.0
0K,All Students,2021-22,10448,1646,8802,84.2,62,40,64.5
0K,All Students,2022-23,11037,1393,9644,87.4,76,40,52.6
1,All Students,2018-19,17303,2220,15083,87.2,106,53,50.0
1,All Students,2019-20,8445,843,7602,90.0,84,29,34.5
1,All Students,2020-21,14574,1728,12846,88.1,88,36,40.9
1,All Students,2021-22,14047,1801,12246,87.2,88,46,52.3
1,All Students,2022-23,10883,1495,9388,86.3,65,39,60.0
2,All Students,2018-19,14559,1372,13187,90.6,94,41,43.6
2,All Students,2019-20,10802,1265,9537,88.3,102,42,41.2
2,All Students,2020-21,11731,1003,10728,91.5,68,20,29.4
2,All Students,2021-22,13305,1795,11510,86.5,81,49,60.5
2,All Students,2022-23,13968,1590,12378,88.6,86,38,44.2
3,All Students,2018-19,15496,1328,14168,91.4,99,33,33.3
3,All Students,2019-20,9194,748,8446,91.9,88,26,29.5
3,All Students,2020-21,14486,1642,12844,88.7,86,30,34.9
3,All Students,2021-22,11089,1234,9855,88.9,69,33,47.8
3,All Students,2022-23,12686,1540,11146,87.9,76,37,48.7
4,All Students,2018-19,16636,1435,15201,91.4,97,32,33.0
4,All Students,2019-20,9396,741,8655,92.1,86,24,27.9
4,All Students,2020-21,14186,1525,12661,89.2,82,35,42.7
4,All Students,2021-22,13345,2226,11119,83.3,81,50,61.7
4,All Students,2022-23,11361,1205,10156,89.4,69,29,42.0
5,All Students,2018-19,16644,1156,15488,93.1,100,28,28.0
5,All Students,2019-20,9776,699,9077,92.8,90,26,28.9
5,All Students,2020-21,13514,1239,12275,90.8,78,24,30.8
5,All Students,2021-22,14528,1974,12554,86.4,84,48,57.1
5,All Students,2022-23,14189,1768,12421,87.5,85,42,49.4
All Grades,All Students,2018-19,75698,8747,66951,88.4,462,220,47.6
All Grades,All Students,2019-20,45325,4836,40489,89.3,429,185,43.1
All Grades,All Students,2020-21,61392,6871,54521,88.8,381,139,36.5
All Grades,All Students,2021-22,59661,9743,49918,83.7,374,235,62.8
All Grades,All Students,2022-23,55480,7449,48031,86.6,395,224,56.7
PK in K-12 Schools,All Students,2018-19,4803,988,3815,79.4,32,26,81.3
PK in K-12 Schools,All Students,2019-20,5460,903,4557,83.5,53,38,71.7
PK in K-12 Schools,All Students,2020-21,5577,267,5310,95.2,36,8,22.2
PK in K-12 Schools,All Students,2021-22,6575,1493,5082,77.3,42,33,78.6
PK in K-12 Schools,All Students,2022-23,8787,1602,7185,81.8,72,53,73.6
0K,All Students,2018-19,12466,1599,10867,87.2,79,46,58.2
0K,All Students,2019-20,5460,606,4854,88.9,56,24,42.9
0K,All Students,2020-21,7048,929,6119,86.8,47,19,40.4
0K,All Students,2021-22,6171,s,s,s,s,s,s
0K,All Students,2022-23,7593,1057,6536,86.1,59,37,62.7
1,All Students,2018-19,9211,1137,8074,87.7,56,32,57.1
1,All Students,2019-20,7380,780,6600,89.4,71,28,39.4
1,All Students,2020-21,7938,1122,6816,85.9,50,21,42.0
1,All Students,2021-22,7790,1353,6437,82.6,50,31,62.0
1,All Students,2022-23,6777,1066,5711,84.3,47,26,55.3
2,All Students,2018-19,11013,1251,9762,88.6,69,33,47.8
2,All Students,2019-20,5462,502,4960,90.8,51,19,37.3
2,All Students,2020-21,10400,828,9572,92.0,63,16,25.4
2,All Students,2021-22,8441,1429,7012,83.1,52,32,61.5
2,All Students,2022-23,7358,958,6400,87.0,53,26,49.1
3,All Students,2018-19,13090,1351,11739,89.7,79,27,34.2
3,All Students,2019-20,6881,574,6307,91.7,68,21,30.9
3,All Students,2020-21,8297,980,7317,88.2,52,18,34.6
3,All Students,2021-22,10962,1689,9273,84.6,71,46,64.8
3,All Students,2022-23,7897,954,6943,87.9,53,27,50.9
4,All Students,2018-19,12464,1333,11131,89.3,74,32,43.2
4,All Students,2019-20,7381,762,6619,89.7,65,29,44.6
4,All Students,2020-21,11087,1302,9785,88.3,68,28,41.2
4,All Students,2021-22,8288,1191,7097,85.6,52,33,63.5
4,All Students,2022-23,9380,1019,8361,89.1,62,35,56.5
5,All Students,2018-19,12651,1088,11563,91.4,73,24,32.9
5,All Students,2019-20,7301,709,6592,90.3,66,27,40.9
5,All Students,2020-21,11045,1443,9602,86.9,65,29,44.6
5,All Students,2021-22,11395,1480,9915,87.0,69,35,50.7
5,All Students,2022-23,7688,793,6895,89.7,49,20,40.8
6,All Students,2021-22,39,s,s,s,s,s,s
All Grades,All Students,2018-19,95704,9591,86113,90.0,601,241,40.1
All Grades,All Students,2019-20,61411,5951,55460,90.3,580,223,38.4
All Grades,All Students,2020-21,87383,7835,79548,91.0,537,149,27.7
All Grades,All Students,2021-22,79656,10577,69079,86.7,492,271,55.1
All Grades,All Students,2022-23,74436,8097,66339,89.1,453,195,43.0
PK in K-12 Schools,All Students,2018-19,9277,1123,8154,87.9,58,26,44.8
PK in K-12 Schools,All Students,2019-20,9029,1189,7840,86.8,89,50,56.2
PK in K-12 Schools,All Students,2020-21,11966,1346,10620,88.8,77,27,35.1
PK in K-12 Schools,All Students,2021-22,14251,1966,12285,86.2,87,55,63.2
PK in K-12 Schools,All Students,2022-23,11990,1439,10551,88.0,78,42,53.8
0K,All Students,2018-19,14353,1711,12642,88.1,96,49,51.0
0K,All Students,2019-20,9053,1034,8019,88.6,85,38,44.7
0K,All Students,2020-21,11831,1603,10228,86.5,74,35,47.3
0K,All Students,2021-22,9790,s,s,s,s,s,s
0K,All Students,2022-23,9949,1059,8890,89.4,61,26,42.6
1,All Students,2018-19,15169,1739,13430,88.5,98,46,46.9
1,All Students,2019-20,9412,1008,8404,89.3,90,44,48.9
1,All Students,2020-21,12456,1383,11073,88.9,77,29,37.7
1,All Students,2021-22,9990,1427,8563,85.7,63,34,54.0
1,All Students,2022-23,11622,1481,10141,87.3,69,32,46.4
2,All Students,2018-19,12725,1438,11287,88.7,76,39,51.3
2,All Students,2019-20,7865,736,7129,90.6,72,24,33.3
2,All Students,2020-21,12499,1266,11233,89.9,77,25,32.5
2,All Students,2021-22,12438,1735,10703,86.1,78,43,55.1
2,All Students,2022-23,10810,1183,9627,89.1,64,28,43.8
3,All Students,2018-19,17455,1400,16055,92.0,107,34,31.8
3,All Students,2019-20,7739,693,7046,91.0,75,25,33.3
3,All Students,2020-21,11569,750,10819,93.5,69,12,17.4
3,All Students,2021-22,10512,1449,9063,86.2,64,32,50.0
3,All Students,2022-23,10593,1054,9539,90.1,63,24,38.1
4,All Students,2018-19,12775,1110,11665,91.3,80,29,36.3
4,All Students,2019-20,10055,724,9331,92.8,94,23,24.5
4,All Students,2020-21,11994,906,11088,92.4,74,14,18.9
4,All Students,2021-22,11061,1294,9767,88.3,66,34,51.5
4,All Students,2022-23,9460,948,8512,90.0,58,21,36.2
5,All Students,2018-19,13950,1070,12880,92.3,86,18,20.9
5,All Students,2019-20,8258,567,7691,93.1,75,19,25.3
5,All Students,2020-21,15068,581,14487,96.1,89,7,7.9
5,All Students,2021-22,11445,1332,10113,88.4,71,37,52.1
5,All Students,2022-23,10012,933,9079,90.7,60,22,36.7
6,All Students,2021-22,169,s,s,s,s,s,s
All Grades,All Students,2018-19,197882,20367,177515,89.7,1218,489,40.1
All Grades,All Students,2019-20,118600,10575,108025,91.1,1089,364,33.4
All Grades,All Students,2020-21,160349,13368,146981,91.7,953,267,28.0
All Grades,All Students,2021-22,147424,15374,132050,89.6,913,370,40.5
All Grades,All Students,2022-23,142893,13747,129146,90.4,873,329,37.7
PK in K-12 Schools,All Students,2019-20,3750,s,s,s,s,s,s
PK in K-12 Schools,All Students,2020-21,7195,513,6682,92.9,44,11,25.0
PK in K-12 Schools,All Students,2021-22,11443,1202,10241,89.5,72,30,41.7
PK in K-12 Schools,All Students,2022-23,13680,1503,12177,89.0,83,37,44.6
0K,All Students,2018-19,25215,3334,21881,86.8,159,90,56.6
0K,All Students,2019-20,15410,1817,13593,88.2,145,72,49.7
0K,All Students,2020-21,15118,697,14421,95.4,95,8,8.4
0K,All Students,2021-22,15565,1855,13710,88.1,100,49,49.0
0K,All Students,2022-23,18026,1959,16067,89.1,113,54,47.8
1,All Students,2018-19,32570,3656,28914,88.8,207,95,45.9
1,All Students,2019-20,15427,1547,13880,90.0,147,59,40.1
1,All Students,2020-21,23595,2713,20882,88.5,137,53,38.7
1,All Students,2021-22,17343,1992,15351,88.5,115,61,53.0
1,All Students,2022-23,17986,1961,16025,89.1,113,49,43.4
2,All Students,2018-19,33805,3302,30503,90.2,204,84,41.2
2,All Students,2019-20,20081,1766,18315,91.2,185,55,29.7
2,All Students,2020-21,22658,2296,20362,89.9,134,46,34.3
2,All Students,2021-22,23245,2728,20517,88.3,141,64,45.4
2,All Students,2022-23,19603,1945,17658,90.1,120,46,38.3
3,All Students,2018-19,35855,3513,32342,90.2,218,75,34.4
3,All Students,2019-20,21661,1827,19834,91.6,197,58,29.4
3,All Students,2020-21,30574,3075,27499,89.9,182,71,39.0
3,All Students,2021-22,25088,2582,22506,89.7,152,58,38.2
3,All Students,2022-23,23797,2098,21699,91.2,141,44,31.2
4,All Students,2018-19,35046,3213,31833,90.8,214,74,34.6
4,All Students,2019-20,21182,1636,19546,92.3,192,54,28.1
4,All Students,2020-21,30672,1511,29161,95.1,182,26,14.3
4,All Students,2021-22,26225,2282,23943,91.3,161,54,33.5
4,All Students,2022-23,23789,2070,21719,91.3,142,49,34.5
5,All Students,2018-19,35391,3349,32042,90.5,216,71,32.9
5,All Students,2019-20,21086,1518,19568,92.8,190,51,26.8
5,All Students,2020-21,30537,2563,27974,91.6,179,52,29.1
5,All Students,2021-22,28515,2733,25782,90.4,172,54,31.4
5,All Students,2022-23,26012,2211,23801,91.5,161,50,31.1
6,All Students,2019-20,3,s,s,s,s,s,s
All Grades,All Students,2018-19,101433,11469,89964,88.7,628,294,46.8
All Grades,All Students,2019-20,65013,7572,57441,88.4,617,295,47.8
All Grades,All Students,2020-21,70301,11003,59298,84.3,431,229,53.1
All Grades,All Students,2021-22,57455,7234,50221,87.4,365,189,51.8
All Grades,All Students,2022-23,60337,7681,52656,87.3,388,217,55.9
PK in K-12 Schools,All Students,2018-19,6742,1074,5668,84.1,45,26,57.8
PK in K-12 Schools,All Students,2019-20,8305,1605,6700,80.7,82,64,78.0
PK in K-12 Schools,All Students,2020-21,5356,1131,4225,78.9,33,20,60.6
PK in K-12 Schools,All Students,2021-22,6423,702,5721,89.1,41,19,46.3
PK in K-12 Schools,All Students,2022-23,8663,1429,7234,83.5,55,39,70.9
0K,All Students,2018-19,12596,1724,10872,86.3,79,51,64.6
0K,All Students,2019-20,7320,1012,6308,86.2,77,41,53.2
0K,All Students,2020-21,5458,952,4506,82.6,36,23,63.9
0K,All Students,2021-22,6806,1104,5702,83.8,45,28,62.2
0K,All Students,2022-23,7652,1364,6288,82.2,52,39,75.0
1,All Students,2018-19,14179,1848,12331,87.0,90,50,55.6
1,All Students,2019-20,8970,923,8047,89.7,83,32,38.6
1,All Students,2020-21,9422,1789,7633,81.0,62,37,59.7
1,All Students,2021-22,6481,667,5814,89.7,45,21,46.7
1,All Students,2022-23,6697,940,5757,86.0,44,28,63.6
2,All Students,2018-19,13656,1525,12131,88.8,84,40,47.6
2,All Students,2019-20,8739,975,7764,88.8,83,42,50.6
2,All Students,2020-21,11526,1806,9720,84.3,71,34,47.9
2,All Students,2021-22,7882,1031,6851,86.9,49,26,53.1
2,All Students,2022-23,6940,734,6206,89.4,44,22,50.0
3,All Students,2018-19,19305,2136,17169,88.9,117,51,43.6
3,All Students,2019-20,9180,903,8277,90.2,88,31,35.2
3,All Students,2020-21,11415,1583,9832,86.1,69,37,53.6
3,All Students,2021-22,10531,1268,9263,88.0,65,32,49.2
3,All Students,2022-23,7698,861,6837,88.8,50,25,50.0
4,All Students,2018-19,16737,1537,15200,90.8,102,38,37.3
4,All Students,2019-20,11218,1073,10145,90.4,103,46,44.7
4,All Students,2020-21,11333,1749,9584,84.6,67,38,56.7
4,All Students,2021-22,9825,1184,8641,87.9,62,30,48.4
4,All Students,2022-23,11358,1192,10166,89.5,71,33,46.5
5,All Students,2018-19,18218,1625,16593,91.1,111,38,34.2
5,All Students,2019-20,11281,1081,10200,90.4,101,39,38.6
5,All Students,2020-21,15791,1993,13798,87.4,93,40,43.0
5,All Students,2021-22,8482,1000,7482,88.2,49,24,49.0
5,All Students,2022-23,10426,969,9457,90.7,66,25,37.9
All Grades,All Students,2018-19,25941,2247,23694,91.3,176,64,36.4
All Grades,All Students,2019-20,14257,1143,13114,92.0,138,43,31.2
All Grades,All Students,2020-21,17044,1730,15314,89.8,101,37,36.6
All Grades,All Students,2021-22,15928,1754,14174,89.0,103,46,44.7
All Grades,All Students,2022-23,17770,1541,16229,91.3,113,35,31.0
0K,All Students,2018-19,7973,831,7142,89.6,56,28,50.0
0K,All Students,2019-20,3529,339,3190,90.4,35,16,45.7
0K,All Students,2020-21,3110,325,2785,89.5,19,10,52.6
0K,All Students,2021-22,5013,727,4286,85.5,35,22,62.9
0K,All Students,2022-23,4854,468,4386,90.4,33,13,39.4
1,All Students,2018-19,7410,645,6765,91.3,50,17,34.0
1,All Students,2019-20,4135,320,3815,92.3,40,12,30.0
1,All Students,2020-21,3532,525,3007,85.1,21,10,47.6
1,All Students,2021-22,2784,280,2504,89.9,19,8,42.1
1,All Students,2022-23,3985,349,3636,91.2,23,7,30.4
2,All Students,2018-19,6390,510,5880,92.0,41,12,29.3
2,All Students,2019-20,3569,276,3293,92.3,33,9,27.3
2,All Students,2020-21,6125,585,5540,90.4,35,11,31.4
2,All Students,2021-22,3308,398,2910,88.0,21,9,42.9
2,All Students,2022-23,2323,285,2038,87.7,18,8,44.4
3,All Students,2018-19,4168,261,3907,93.7,29,7,24.1
3,All Students,2019-20,3024,208,2816,93.1,30,6,20.0
3,All Students,2020-21,4277,295,3982,93.1,26,6,23.1
3,All Students,2021-22,4823,349,4474,92.8,28,7,25.0
3,All Students,2022-23,2971,174,2797,94.1,18,3,16.7
4,All Students,2022-23,3637,265,3372,92.7,21,4,19.0
All Grades,All Students,2018-19,109734,12164,97570,88.9,661,295,44.6
All Grades,All Students,2019-20,65680,6861,58819,89.6,610,256,42.0
All Grades,All Students,2020-21,92374,10001,82373,89.2,541,194,35.9
All Grades,All Students,2021-22,85556,12282,73274,85.6,524,321,61.3
All Grades,All Students,2022-23,80074,10379,69695,87.0,484,265,54.8
PK in K-12 Schools,All Students,2018-19,8862,1289,7573,85.5,58,33,56.9
PK in K-12 Schools,All Students,2019-20,8977,1398,7579,84.4,87,57,65.5
PK in K-12 Schools,All Students,2020-21,12179,1712,10467,85.9,75,42,56.0
PK in K-12 Schools,All Students,2021-22,15406,2509,12897,83.7,93,65,69.9
PK in K-12 Schools,All Students,2022-23,12803,2152,10651,83.2,82,59,72.0
0K,All Students,2018-19,13646,1781,11865,86.9,82,44,53.7
0K,All Students,2019-20,8604,936,7668,89.1,80,36,45.0
0K,All Students,2020-21,13058,1288,11770,90.1,76,21,27.6
0K,All Students,2021-22,12542,1585,10957,87.4,78,44,56.4
0K,All Students,2022-23,11184,1477,9707,86.8,66,37,56.1
1,All Students,2018-19,21147,2280,18867,89.2,127,50,39.4
1,All Students,2019-20,8773,936,7837,89.3,81,38,46.9
1,All Students,2020-21,11874,999,10875,91.6,68,18,26.5
1,All Students,2021-22,12602,1855,10747,85.3,76,52,68.4
1,All Students,2022-23,11953,1397,10556,88.3,71,40,56.3
2,All Students,2018-19,17960,2234,15726,87.6,108,47,43.5
2,All Students,2019-20,10886,1061,9825,90.3,102,40,39.2
2,All Students,2020-21,11559,1299,10260,88.8,69,26,37.7
2,All Students,2021-22,9622,1510,8112,84.3,62,38,61.3
2,All Students,2022-23,13122,1862,11260,85.8,78,46,59.0
3,All Students,2018-19,18410,1779,16631,90.3,110,50,45.5
3,All Students,2019-20,9395,1015,8380,89.2,85,35,41.2
3,All Students,2020-21,15893,1417,14476,91.1,91,28,30.8
3,All Students,2021-22,10438,1459,8979,86.0,65,40,61.5
3,All Students,2022-23,7986,963,7023,87.9,50,22,44.0
4,All Students,2018-19,14109,1402,12707,90.1,86,38,44.2
4,All Students,2019-20,10630,841,9789,92.1,100,29,29.0
4,All Students,2020-21,13609,1669,11940,87.7,79,27,34.2
4,All Students,2021-22,13257,1690,11567,87.3,81,43,53.1
4,All Students,2022-23,10616,1195,9421,88.7,65,30,46.2
5,All Students,2018-19,15600,1399,14201,91.0,90,33,36.7
5,All Students,2019-20,8415,674,7741,92.0,75,21,28.0
5,All Students,2020-21,14202,1617,12585,88.6,83,32,38.6
5,All Students,2021-22,11689,1674,10015,85.7,69,39,56.5
5,All Students,2022-23,12410,1333,11077,89.3,72,31,43.1
All Grades,All Students,2018-19,73837,6059,67778,91.8,460,144,31.3
All Grades,All Students,2019-20,46213,3455,42758,92.5,435,108,24.8
All Grades,All Students,2020-21,62489,7880,54609,87.4,380,170,44.7
All Grades,All Students,2021-22,61141,8097,53044,86.8,389,208,53.5
All Grades,All Students,2022-23,57503,6827,50676,88.1,386,204,52.8
PK in K-12 Schools,All Students,2018-19,4834,s,s,s,s,s,s
PK in K-12 Schools,All Students,2019-20,3539,379,3160,89.3,36,15,41.7
PK in K-12 Schools,All Students,2020-21,4362,s,s,s,s,s,s
PK in K-12 Schools,All Students,2021-22,6709,1147,5562,82.9,45,32,71.1
PK in K-12 Schools,All Students,2022-23,7129,1033,6096,85.5,50,33,66.0
0K,All Students,2018-19,12392,1535,10857,87.6,79,39,49.4
0K,All Students,2019-20,7890,804,7086,89.8,76,28,36.8
0K,All Students,2020-21,8735,1025,7710,88.3,54,22,40.7
0K,All Students,2021-22,8875,1202,7673,86.5,57,37,64.9
0K,All Students,2022-23,5717,945,4772,83.5,40,26,65.0
1,All Students,2018-19,9756,730,9026,92.5,62,16,25.8
1,All Students,2019-20,7098,581,6517,91.8,70,20,28.6
1,All Students,2020-21,10043,1528,8515,84.8,64,34,53.1
1,All Students,2021-22,9511,1229,8282,87.1,63,34,54.0
1,All Students,2022-23,8715,1042,7673,88.0,62,36,58.1
2,All Students,2018-19,10207,837,9370,91.8,65,19,29.2
2,All Students,2019-20,5884,372,5512,93.7,54,10,18.5
2,All Students,2020-21,10117,1480,8637,85.4,62,33,53.2
2,All Students,2021-22,9894,1234,8660,87.5,62,34,54.8
2,All Students,2022-23,8316,895,7421,89.2,56,29,51.8
3,All Students,2018-19,12408,846,11562,93.2,76,19,25.0
3,All Students,2019-20,6226,429,5797,93.1,59,12,20.3
3,All Students,2020-21,8630,1158,7472,86.6,52,26,50.0
3,All Students,2021-22,8657,1070,7587,87.6,55,28,50.9
3,All Students,2022-23,8678,890,7788,89.7,57,27,47.4
4,All Students,2018-19,11634,712,10922,93.9,68,15,22.1
4,All Students,2019-20,7797,475,7322,93.9,71,13,18.3
4,All Students,2020-21,8959,1475,7484,83.5,53,26,49.1
4,All Students,2021-22,9329,1199,8130,87.1,57,24,42.1
4,All Students,2022-23,9042,958,8084,89.4,57,26,45.6
5,All Students,2018-19,12436,805,11631,93.5,74,15,20.3
5,All Students,2019-20,7779,415,7364,94.7,69,10,14.5
5,All Students,2020-21,11632,942,10690,91.9,67,23,34.3
5,All Students,2021-22,8166,1016,7150,87.6,50,19,38.0
5,All Students,2022-23,9906,1064,8842,89.3,64,27,42.2
6,All Students,2018-19,170,s,s,s,s,s,s
7,All Students,2020-21,11,s,s,s,s,s,s
All Grades,All Students,2018-19,126374,10865,115509,91.4,798,279,35.0
All Grades,All Students,2019-20,77245,6900,70345,91.1,736,257,34.9
All Grades,All Students,2020-21,103759,9550,94209,90.8,626,198,31.6
All Grades,All Students,2021-22,95130,11071,84059,88.4,593,279,47.0
All Grades,All Students,2022-23,89003,9501,79502,89.3,561,249,44.4
PK in K-12 Schools,All Students,2019-20,6233,808,5425,87.0,64,41,64.1
PK in K-12 Schools,All Students,2020-21,8188,709,7479,91.3,49,12,24.5
PK in K-12 Schools,All Students,2021-22,8892,1288,7604,85.5,52,30,57.7
PK in K-12 Schools,All Students,2022-23,10654,1368,9286,87.2,71,43,60.6
0K,All Students,2018-19,18294,2156,16138,88.2,119,71,59.7
0K,All Students,2019-20,8845,954,7891,89.2,83,32,38.6
0K,All Students,2020-21,9896,1206,8690,87.8,66,35,53.0
0K,All Students,2021-22,15475,1878,13597,87.9,98,54,55.1
0K,All Students,2022-23,10287,1376,8911,86.6,67,36,53.7
1,All Students,2018-19,20168,1914,18254,90.5,129,47,36.4
1,All Students,2019-20,11647,1202,10445,89.7,112,52,46.4
1,All Students,2020-21,12405,1069,11336,91.4,76,22,28.9
1,All Students,2021-22,9982,1297,8685,87.0,66,38,57.6
1,All Students,2022-23,13880,1739,12141,87.5,89,49,55.1
2,All Students,2018-19,20106,1705,18401,91.5,123,36,29.3
2,All Students,2019-20,11789,954,10835,91.9,114,33,28.9
2,All Students,2020-21,17436,1836,15600,89.5,104,35,33.7
2,All Students,2021-22,12074,1409,10665,88.3,78,37,47.4
2,All Students,2022-23,8445,857,7588,89.9,54,19,35.2
3,All Students,2018-19,24330,1908,22422,92.2,154,47,30.5
3,All Students,2019-20,11593,910,10683,92.2,110,31,28.2
3,All Students,2020-21,17382,1615,15767,90.7,105,31,29.5
3,All Students,2021-22,16326,1943,14383,88.1,100,48,48.0
3,All Students,2022-23,12577,1168,11409,90.7,76,30,39.5
4,All Students,2018-19,20741,1651,19090,92.0,134,46,34.3
4,All Students,2019-20,14218,1182,13036,91.7,132,40,30.3
4,All Students,2020-21,17393,1432,15961,91.8,103,29,28.2
4,All Students,2021-22,16160,1655,14505,89.8,101,42,41.6
4,All Students,2022-23,16699,1702,14997,89.8,104,44,42.3
5,All Students,2018-19,22735,1531,21204,93.3,139,32,23.0
5,All Students,2019-20,12920,890,12030,93.1,121,28,23.1
5,All Students,2020-21,21059,1683,19376,92.0,123,34,27.6
5,All Students,2021-22,16221,1601,14620,90.1,98,30,30.6
5,All Students,2022-23,16461,1291,15170,92.2,100,28,28.0
All Grades,All Students,2018-19,86643,7603,79040,91.2,530,149,28.1
All Grades,All Students,2019-20,50783,4637,46146,90.9,472,156,33.1
All Grades,All Students,2020-21,71118,2373,68745,96.7,424,31,7.3
All Grades,All Students,2021-22,69658,8629,61029,87.6,423,206,48.7
All Grades,All Students,2022-23,64390,8286,56104,87.1,394,185,47.0
6,All Students,2018-19,26744,s,s,s,s,s,s
6,All Students,2019-20,18430,1468,16962,92.0,170,50,29.4
6,All Students,2020-21,19586,579,19007,97.0,116,12,10.3
6,All Students,2021-22,21363,2647,18716,87.6,131,62,47.3
6,All Students,2022-23,19232,2467,16765,87.2,117,60,51.3
7,All Students,2018-19,27338,2838,24500,89.6,166,51,30.7
7,All Students,2019-20,16659,1655,15004,90.1,154,54,35.1
7,All Students,2020-21,27304,798,26506,97.1,163,7,4.3
7,All Students,2021-22,21728,2639,19089,87.9,132,65,49.2
7,All Students,2022-23,22171,3010,19161,86.4,133,61,45.9
8,All Students,2018-19,32552,2460,30092,92.4,198,47,23.7
8,All Students,2019-20,15690,s,s,s,s,s,s
8,All Students,2020-21,24213,981,23232,95.9,145,12,8.3
8,All Students,2021-22,26567,3343,23224,87.4,160,79,49.4
8,All Students,2022-23,22987,2809,20178,87.8,144,64,44.4
9,All Students,2018-19,9,s,s,s,s,s,s
9,All Students,2019-20,4,s,s,s,s,s,s
9,All Students,2020-21,1,s,s,s,s,s,s
10,All Students,2020-21,14,s,s,s,s,s,s
All Grades,All Students,2018-19,103866,10571,93295,89.8,656,272,41.5
All Grades,All Students,2019-20,66361,6246,60115,90.6,618,231,37.4
All Grades,All Students,2020-21,95674,7250,88424,92.4,590,168,28.5
All Grades,All Students,2021-22,91984,12242,79742,86.7,593,333,56.2
All Grades,All Students,2022-23,91293,10596,80697,88.4,608,289,47.5
PK in K-12 Schools,All Students,2018-19,11718,2062,9656,82.4,79,53,67.1
PK in K-12 Schools,All Students,2019-20,7245,1036,6209,85.7,68,45,66.2
PK in K-12 Schools,All Students,2020-21,10460,553,9907,94.7,69,12,17.4
PK in K-12 Schools,All Students,2021-22,10301,1552,8749,84.9,70,47,67.1
PK in K-12 Schools,All Students,2022-23,11321,s,s,s,s,s,s
0K,All Students,2018-19,15718,1882,13836,88.0,105,56,53.3
0K,All Students,2019-20,10833,1222,9611,88.7,102,45,44.1
0K,All Students,2020-21,10377,390,9987,96.2,66,5,7.6
0K,All Students,2021-22,11362,2029,9333,82.1,77,51,66.2
0K,All Students,2022-23,13820,1795,12025,87.0,95,49,51.6
1,All Students,2018-19,15258,1338,13920,91.2,96,37,38.5
1,All Students,2019-20,10102,958,9144,90.5,95,33,34.7
1,All Students,2020-21,15909,1335,14574,91.6,97,34,35.1
1,All Students,2021-22,13150,1771,11379,86.5,88,55,62.5
1,All Students,2022-23,13066,1692,11374,87.1,88,50,56.8
2,All Students,2018-19,17585,1714,15871,90.3,111,41,36.9
2,All Students,2019-20,8925,699,8226,92.2,82,26,31.7
2,All Students,2020-21,15172,1367,13805,91.0,93,31,33.3
2,All Students,2021-22,16041,2105,13936,86.9,100,60,60.0
2,All Students,2022-23,13591,1574,12017,88.4,92,44,47.8
3,All Students,2018-19,13454,1184,12270,91.2,81,29,35.8
3,All Students,2019-20,10434,920,9514,91.2,98,34,34.7
3,All Students,2020-21,13206,1029,12177,92.2,80,26,32.5
3,All Students,2021-22,14516,1617,12899,88.9,90,40,44.4
3,All Students,2022-23,14696,1477,13219,89.9,96,37,38.5
4,All Students,2018-19,14945,1154,13791,92.3,94,30,31.9
4,All Students,2019-20,9590,711,8879,92.6,90,23,25.6
4,All Students,2020-21,15836,1285,14551,91.9,94,31,33.0
4,All Students,2021-22,11944,1397,10547,88.3,77,37,48.1
4,All Students,2022-23,13349,1284,12065,90.4,89,37,41.6
5,All Students,2018-19,15188,1237,13951,91.9,90,26,28.9
5,All Students,2019-20,9232,700,8532,92.4,83,25,30.1
5,All Students,2020-21,14714,1291,13423,91.2,91,29,31.9
5,All Students,2021-22,14670,1771,12899,87.9,91,43,47.3
5,All Students,2022-23,11448,1010,10438,91.2,74,29,39.2
6,All Students,2022-23,2,s,s,s,s,s,s
All Grades,All Students,2018-19,62522,3839,58683,93.9,358,62,17.3
All Grades,All Students,2019-20,38862,1663,37199,95.7,344,39,11.3
All Grades,All Students,2020-21,61374,3478,57896,94.3,357,64,17.9
All Grades,All Students,2021-22,56620,5219,51401,90.8,336,111,33.0
All Grades,All Students,2022-23,54108,5409,48699,90.0,321,112,34.9
6,All Students,2018-19,21724,1005,20719,95.4,125,10,8.0
6,All Students,2019-20,13566,499,13067,96.3,118,12,10.2
6,All Students,2020-21,22169,1213,20956,94.5,129,23,17.8
6,All Students,2021-22,19189,1800,17389,90.6,115,41,35.7
6,All Students,2022-23,18257,1790,16467,90.2,110,33,30.0
7,All Students,2018-19,20300,s,s,s,s,s,s
7,All Students,2019-20,12989,565,12424,95.7,115,10,8.7
7,All Students,2020-21,20268,1020,19248,95.0,117,16,13.7
7,All Students,2021-22,18223,1620,16603,91.1,109,33,30.3
7,All Students,2022-23,18740,1799,16941,90.4,111,36,32.4
8,All Students,2018-19,20409,1482,18927,92.7,116,30,25.9
8,All Students,2019-20,12307,599,11708,95.1,111,17,15.3
8,All Students,2020-21,18937,1245,17692,93.4,111,25,22.5
8,All Students,2021-22,19208,1799,17409,90.6,112,37,33.0
8,All Students,2022-23,17110,s,s,s,s,s,s
9,All Students,2018-19,89,s,s,s,s,s,s
9,All Students,2022-23,1,s,s,s,s,s,s
All Grades,All Students,2018-19,66513,7405,59108,88.9,413,200,48.4
All Grades,All Students,2019-20,43928,4476,39452,89.8,416,165,39.7
All Grades,All Students,2020-21,58395,9398,48997,83.9,380,217,57.1
All Grades,All Students,2021-22,62537,10058,52479,83.9,384,248,64.6
All Grades,All Students,2022-23,67693,9949,57744,85.3,425,242,56.9
PK in K-12 Schools,All Students,2018-19,3174,307,2867,90.3,19,9,47.4
PK in K-12 Schools,All Students,2019-20,5220,669,4551,87.2,49,26,53.1
PK in K-12 Schools,All Students,2020-21,5994,1548,4446,74.2,47,37,78.7
PK in K-12 Schools,All Students,2021-22,9753,1871,7882,80.8,65,50,76.9
PK in K-12 Schools,All Students,2022-23,10814,2033,8781,81.2,67,47,70.1
0K,All Students,2018-19,9190,1324,7866,85.6,60,38,63.3
0K,All Students,2019-20,6453,759,5694,88.2,63,28,44.4
0K,All Students,2020-21,8579,1699,6880,80.2,62,44,71.0
0K,All Students,2021-22,7102,1386,5716,80.5,44,34,77.3
0K,All Students,2022-23,9082,1657,7425,81.8,61,43,70.5
1,All Students,2018-19,11886,1295,10591,89.1,72,32,44.4
1,All Students,2019-20,5377,545,4832,89.9,53,22,41.5
1,All Students,2020-21,8647,1450,7197,83.2,55,35,63.6
1,All Students,2021-22,10544,1684,8860,84.0,64,42,65.6
1,All Students,2022-23,9852,1722,8130,82.5,61,40,65.6
2,All Students,2018-19,7919,1132,6787,85.7,49,32,65.3
2,All Students,2019-20,7417,630,6787,91.5,68,22,32.4
2,All Students,2020-21,8654,1308,7346,84.9,57,29,50.9
2,All Students,2021-22,8629,1150,7479,86.7,52,26,50.0
2,All Students,2022-23,10121,1414,8707,86.0,64,34,53.1
3,All Students,2018-19,11710,1107,10603,90.5,70,28,40.0
3,All Students,2019-20,5390,545,4845,89.9,52,20,38.5
3,All Students,2020-21,9488,1278,8210,86.5,57,27,47.4
3,All Students,2021-22,9087,1491,7596,83.6,56,33,58.9
3,All Students,2022-23,8992,854,8138,90.5,57,23,40.4
4,All Students,2018-19,11298,1159,10139,89.7,74,30,40.5
4,All Students,2019-20,6699,609,6090,90.9,63,24,38.1
4,All Students,2020-21,7514,1015,6499,86.5,46,22,47.8
4,All Students,2021-22,9555,1216,8339,87.3,56,29,51.8
4,All Students,2022-23,9556,1296,8260,86.4,59,32,54.2
5,All Students,2018-19,11336,1081,10255,90.5,69,31,44.9
5,All Students,2019-20,7372,719,6653,90.2,68,23,33.8
5,All Students,2020-21,9519,1100,8419,88.4,56,23,41.1
5,All Students,2021-22,7867,1260,6607,84.0,47,34,72.3
5,All Students,2022-23,9276,973,8303,89.5,56,23,41.1
All Grades,All Students,2018-19,83107,5487,77620,93.4,501,127,25.3
All Grades,All Students,2019-20,49225,2922,46303,94.1,458,101,22.1
All Grades,All Students,2020-21,64396,4097,60299,93.6,383,87,22.7
All Grades,All Students,2021-22,51048,5049,45999,90.1,313,126,40.3
All Grades,All Students,2022-23,51246,4906,46340,90.4,336,130,38.7
PK in K-12 Schools,All Students,2018-19,3143,275,2868,91.3,18,7,38.9
PK in K-12 Schools,All Students,2019-20,2031,s,s,s,s,s,s
PK in K-12 Schools,All Students,2020-21,3095,185,2910,94.0,18,3,16.7
PK in K-12 Schools,All Students,2021-22,3077,333,2744,89.2,21,12,57.1
PK in K-12 Schools,All Students,2022-23,2960,361,2599,87.8,18,11,61.1
0K,All Students,2018-19,11349,861,10488,92.4,70,23,32.9
0K,All Students,2019-20,5970,542,5428,90.9,59,27,45.8
0K,All Students,2020-21,7139,576,6563,91.9,46,17,37.0
0K,All Students,2021-22,6573,807,5766,87.7,41,25,61.0
0K,All Students,2022-23,8491,1107,7384,87.0,60,33,55.0
1,All Students,2018-19,12695,837,11858,93.4,82,20,24.4
1,All Students,2019-20,7286,441,6845,93.9,66,17,25.8
1,All Students,2020-21,8290,648,7642,92.2,49,17,34.7
1,All Students,2021-22,6855,814,6041,88.1,40,19,47.5
1,All Students,2022-23,6945,874,6071,87.4,47,24,51.1
2,All Students,2018-19,12767,873,11894,93.2,76,19,25.0
2,All Students,2019-20,9369,557,8812,94.1,88,17,19.3
2,All Students,2020-21,10018,995,9023,90.1,60,20,33.3
2,All Students,2021-22,7141,711,6430,90.0,47,19,40.4
2,All Students,2022-23,6014,521,5493,91.3,37,12,32.4
3,All Students,2018-19,15133,872,14261,94.2,89,16,18.0
3,All Students,2019-20,6968,348,6620,95.0,62,10,16.1
3,All Students,2020-21,12743,704,12039,94.5,75,14,18.7
3,All Students,2021-22,8301,646,7655,92.2,51,12,23.5
3,All Students,2022-23,8661,651,8010,92.5,59,18,30.5
4,All Students,2018-19,14497,928,13569,93.6,87,20,23.0
4,All Students,2019-20,9907,471,9436,95.2,89,8,9.0
4,All Students,2020-21,9639,573,9066,94.1,56,10,17.9
4,All Students,2021-22,11165,995,10170,91.1,67,22,32.8
4,All Students,2022-23,8137,563,7574,93.1,52,11,21.2
5,All Students,2018-19,13523,841,12682,93.8,79,22,27.8
5,All Students,2019-20,7683,412,7271,94.6,75,14,18.7
5,All Students,2020-21,13472,416,13056,96.9,79,6,7.6
5,All Students,2021-22,7936,743,7193,90.6,46,17,37.0
5,All Students,2022-23,10038,829,9209,91.7,63,21,33.3
6,All Students,2019-20,11,s,s,s,s,s,s
All Grades,All Students,2018-19,41625,3428,38197,91.8,250,79,31.6
All Grades,All Students,2019-20,24972,2110,22862,91.6,228,80,35.1
All Grades,All Students,2020-21,38351,4309,34042,88.8,229,92,40.2
All Grades,All Students,2021-22,33979,3944,30035,88.4,205,89,43.4
All Grades,All Students,2022-23,28255,2680,25575,90.5,180,77,42.8
PK in K-12 Schools,All Students,2019-20,1664,177,1487,89.4,15,9,60.0
PK in K-12 Schools,All Students,2020-21,5540,727,4813,86.9,34,16,47.1
PK in K-12 Schools,All Students,2021-22,5795,667,5128,88.5,36,17,47.2
PK in K-12 Schools,All Students,2022-23,5214,529,4685,89.9,36,18,50.0
0K,All Students,2018-19,13746,1329,12417,90.3,82,30,36.6
0K,All Students,2019-20,8295,867,7428,89.5,78,35,44.9
0K,All Students,2020-21,12333,1350,10983,89.1,73,29,39.7
0K,All Students,2021-22,9780,1148,8632,88.3,62,28,45.2
0K,All Students,2022-23,7988,767,7221,90.4,50,21,42.0
1,All Students,2018-19,14954,1146,13808,92.3,91,26,28.6
1,All Students,2019-20,7126,522,6604,92.7,63,18,28.6
1,All Students,2020-21,11086,1518,9568,86.3,65,28,43.1
1,All Students,2021-22,9516,1067,8449,88.8,56,24,42.9
1,All Students,2022-23,6953,749,6204,89.2,45,21,46.7
2,All Students,2018-19,12925,953,11972,92.6,77,23,29.9
2,All Students,2019-20,7887,544,7343,93.1,72,18,25.0
2,All Students,2020-21,9392,714,8678,92.4,57,19,33.3
2,All Students,2021-22,8888,1062,7826,88.1,51,20,39.2
2,All Students,2022-23,8100,635,7465,92.2,49,17,34.7
All Grades,All Students,2018-19,126976,10944,116032,91.4,798,299,37.5
All Grades,All Students,2019-20,77347,6587,70760,91.5,720,229,31.8
All Grades,All Students,2020-21,105373,8854,96519,91.6,642,186,29.0
All Grades,All Students,2021-22,93972,9647,84325,89.7,593,223,37.6
All Grades,All Students,2022-23,86316,8468,77848,90.2,541,212,39.2
PK in K-12 Schools,All Students,2018-19,9191,s,s,s,s,s,s
PK in K-12 Schools,All Students,2019-20,5439,486,4953,91.1,50,16,32.0
PK in K-12 Schools,All Students,2020-21,9379,661,8718,93.0,61,14,23.0
PK in K-12 Schools,All Students,2021-22,8662,718,7944,91.7,60,22,36.7
PK in K-12 Schools,All Students,2022-23,9999,1135,8864,88.6,63,31,49.2
0K,All Students,2018-19,18003,2131,15872,88.2,122,60,49.2
0K,All Students,2019-20,10093,1113,8980,89.0,97,45,46.4
0K,All Students,2020-21,11029,699,10330,93.7,71,15,21.1
0K,All Students,2021-22,11176,1417,9759,87.3,70,28,40.0
0K,All Students,2022-23,9249,883,8366,90.5,62,21,33.9
1,All Students,2018-19,18615,1717,16898,90.8,117,47,40.2
1,All Students,2019-20,10274,911,9363,91.1,94,30,31.9
1,All Students,2020-21,14840,899,13941,93.9,89,18,20.2
1,All Students,2021-22,11575,1262,10313,89.1,73,26,35.6
1,All Students,2022-23,12704,1276,11428,90.0,80,34,42.5
2,All Students,2018-19,19275,1600,17675,91.7,117,44,37.6
2,All Students,2019-20,12084,1130,10954,90.6,111,37,33.3
2,All Students,2020-21,15265,1697,13568,88.9,94,38,40.4
2,All Students,2021-22,13594,1446,12148,89.4,85,36,42.4
2,All Students,2022-23,12183,1266,10917,89.6,74,30,40.5
3,All Students,2018-19,21563,1617,19946,92.5,133,44,33.1
3,All Students,2019-20,12717,885,11832,93.0,121,28,23.1
3,All Students,2020-21,17759,1353,16406,92.4,104,26,25.0
3,All Students,2021-22,15237,1577,13660,89.7,96,37,38.5
3,All Students,2022-23,12095,1126,10969,90.7,79,30,38.0
4,All Students,2018-19,23217,1664,21553,92.8,144,37,25.7
4,All Students,2019-20,12732,921,11811,92.8,120,38,31.7
4,All Students,2020-21,18141,1378,16763,92.4,109,26,23.9
4,All Students,2021-22,16368,1781,14587,89.1,102,45,44.1
4,All Students,2022-23,14599,1315,13284,91.0,90,33,36.7
5,All Students,2018-19,17095,1247,15848,92.7,104,33,31.7
5,All Students,2019-20,14008,1141,12867,91.9,127,35,27.6
5,All Students,2020-21,18960,2167,16793,88.6,114,49,43.0
5,All Students,2021-22,17360,1446,15914,91.7,107,29,27.1
5,All Students,2022-23,15487,1467,14020,90.5,93,33,35.5
7,All Students,2018-19,17,s,s,s,s,s,s
All Grades,All Students,2018-19,112715,7967,104748,92.9,685,164,23.9
All Grades,All Students,2019-20,71746,4719,67027,93.4,657,129,19.6
All Grades,All Students,2020-21,108078,7777,100301,92.8,634,124,19.6
All Grades,All Students,2021-22,96784,9285,87499,90.4,588,212,36.1
All Grades,All Students,2022-23,98509,8730,89779,91.1,592,210,35.5
PK in K-12 Schools,All Students,2018-19,6398,451,5947,93.0,38,10,26.3
PK in K-12 Schools,All Students,2019-20,4133,398,3735,90.4,36,10,27.8
PK in K-12 Schools,All Students,2020-21,6064,637,5427,89.5,35,9,25.7
PK in K-12 Schools,All Students,2021-22,6059,685,5374,88.7,40,19,47.5
PK in K-12 Schools,All Students,2022-23,6249,708,5541,88.7,37,20,54.1
0K,All Students,2018-19,11835,1093,10742,90.8,78,24,30.8
0K,All Students,2019-20,9183,691,8492,92.5,86,22,25.6
0K,All Students,2020-21,13459,1627,11832,87.9,79,31,39.2
0K,All Students,2021-22,12455,1560,10895,87.5,78,38,48.7
0K,All Students,2022-23,13846,1752,12094,87.3,84,44,52.4
1,All Students,2018-19,14914,1214,13700,91.9,92,26,28.3
1,All Students,2019-20,8225,595,7630,92.8,77,17,22.1
1,All Students,2020-21,14020,1129,12891,91.9,83,23,27.7
1,All Students,2021-22,13348,1753,11595,86.9,83,41,49.4
1,All Students,2022-23,12798,1263,11535,90.1,81,35,43.2
2,All Students,2018-19,14183,1044,13139,92.6,90,26,28.9
2,All Students,2019-20,10472,716,9756,93.2,94,20,21.3
2,All Students,2020-21,11795,1208,10587,89.8,70,20,28.6
2,All Students,2021-22,14598,1225,13373,91.6,84,26,31.0
2,All Students,2022-23,13733,1431,12302,89.6,82,32,39.0
3,All Students,2018-19,22656,1431,21225,93.7,135,25,18.5
3,All Students,2019-20,12950,736,12214,94.3,118,22,18.6
3,All Students,2020-21,21355,1257,20098,94.1,126,19,15.1
3,All Students,2021-22,11861,957,10904,91.9,74,20,27.0
3,All Students,2022-23,18375,1333,17042,92.7,110,32,29.1
4,All Students,2018-19,20161,1373,18788,93.2,122,29,23.8
4,All Students,2019-20,14315,793,13522,94.5,132,19,14.4
4,All Students,2020-21,20181,1040,19141,94.8,118,13,11.0
4,All Students,2021-22,20295,1525,18770,92.5,121,31,25.6
4,All Students,2022-23,12426,807,11619,93.5,74,17,23.0
5,All Students,2018-19,22568,1361,21207,94.0,130,24,18.5
5,All Students,2019-20,12468,790,11678,93.7,114,19,16.7
5,All Students,2020-21,21204,879,20325,95.9,123,9,7.3
5,All Students,2021-22,18168,1580,16588,91.3,108,37,34.3
5,All Students,2022-23,21082,1436,19646,93.2,124,30,24.2
All Grades,All Students,2018-19,58378,4941,53437,91.5,339,100,29.5
All Grades,All Students,2019-20,38848,2486,36362,93.6,350,70,20.0
All Grades,All Students,2020-21,55443,7233,48210,87.0,322,145,45.0
All Grades,All Students,2021-22,49105,7142,41963,85.5,291,160,55.0
All Grades,All Students,2022-23,41373,5634,35739,86.4,246,116,47.2
6,All Students,2018-19,19019,1596,17423,91.6,110,34,30.9
6,All Students,2019-20,12715,864,11851,93.2,115,26,22.6
6,All Students,2020-21,18509,2212,16297,88.0,109,45,41.3
6,All Students,2021-22,15258,1911,13347,87.5,91,45,49.5
6,All Students,2022-23,13724,1782,11942,87.0,83,36,43.4
7,All Students,2018-19,22847,1826,21021,92.0,134,37,27.6
7,All Students,2019-20,12193,820,11373,93.3,110,24,21.8
7,All Students,2020-21,18559,1975,16584,89.4,108,39,36.1
7,All Students,2021-22,16172,2761,13411,82.9,97,60,61.9
7,All Students,2022-23,13343,1695,11648,87.3,79,30,38.0
8,All Students,2018-19,16512,1519,14993,90.8,95,29,30.5
8,All Students,2019-20,13940,802,13138,94.2,125,20,16.0
8,All Students,2020-21,18375,3046,15329,83.4,105,61,58.1
8,All Students,2021-22,17675,2470,15205,86.0,103,55,53.4
8,All Students,2022-23,14306,2157,12149,84.9,84,50,59.5
All Grades,All Students,2018-19,183528,12614,170914,93.1,1049,245,23.4
All Grades,All Students,2019-20,118836,8025,110811,93.2,1054,252,23.9
All Grades,All Students,2020-21,173613,14843,158770,91.5,1015,293,28.9
All Grades,All Students,2021-22,156590,16341,140249,89.6,912,374,41.0
All Grades,All Students,2022-23,151587,15859,135728,89.5,876,363,41.4
PK in K-12 Schools,All Students,2022-23,2,s,s,s,s,s,s
0K,All Students,2018-19,20823,1678,19145,91.9,121,44,36.4
0K,All Students,2019-20,12921,997,11924,92.3,115,32,27.8
0K,All Students,2020-21,16523,1934,14589,88.3,102,42,41.2
0K,All Students,2021-22,16134,1787,14347,88.9,96,48,50.0
0K,All Students,2022-23,15791,2404,13387,84.8,94,57,60.6
1,All Students,2018-19,20375,1380,18995,93.2,116,26,22.4
1,All Students,2019-20,13619,1084,12535,92.0,123,46,37.4
1,All Students,2020-21,18325,1659,16666,90.9,111,35,31.5
1,All Students,2021-22,14579,1456,13123,90.0,84,32,38.1
1,All Students,2022-23,17714,1798,15916,89.8,104,48,46.2
2,All Students,2018-19,20955,1310,19645,93.7,118,24,20.3
2,All Students,2019-20,13395,930,12465,93.1,120,28,23.3
2,All Students,2020-21,20129,2669,17460,86.7,118,53,44.9
2,All Students,2021-22,16147,1843,14304,88.6,93,45,48.4
2,All Students,2022-23,14691,s,s,s,s,s,s
3,All Students,2018-19,22581,1486,21095,93.4,128,27,21.1
3,All Students,2019-20,13704,979,12725,92.9,121,29,24.0
3,All Students,2020-21,19340,1602,17738,91.7,113,27,23.9
3,All Students,2021-22,18236,1879,16357,89.7,106,42,39.6
3,All Students,2022-23,15428,1560,13868,89.9,90,40,44.4
4,All Students,2018-19,19011,s,s,s,s,s,s
4,All Students,2019-20,13652,848,12804,93.8,120,26,21.7
4,All Students,2020-21,20059,1544,18515,92.3,116,28,24.1
4,All Students,2021-22,16227,1534,14693,90.5,96,33,34.4
4,All Students,2022-23,18070,2018,16052,88.8,103,40,38.8
5,All Students,2018-19,19270,1596,17674,91.7,111,36,32.4
5,All Students,2019-20,13389,815,12574,93.9,119,23,19.3
5,All Students,2020-21,20475,2303,18172,88.8,117,49,41.9
5,All Students,2021-22,18895,1862,17033,90.1,110,44,40.0
5,All Students,2022-23,15150,1158,13992,92.4,87,22,25.3
6,All Students,2018-19,20005,1290,18715,93.6,117,23,19.7
6,All Students,2019-20,13147,850,12297,93.5,117,28,23.9
6,All Students,2020-21,20044,959,19085,95.2,116,20,17.2
6,All Students,2021-22,19180,1906,17274,90.1,113,41,36.3
6,All Students,2022-23,20418,2075,18343,89.8,116,49,42.2
7,All Students,2018-19,20671,1261,19410,93.9,119,23,19.3
7,All Students,2019-20,12204,842,11362,93.1,107,24,22.4
7,All Students,2020-21,20168,858,19310,95.7,116,17,14.7
7,All Students,2021-22,18187,1963,16224,89.2,107,46,43.0
7,All Students,2022-23,17972,1749,16223,90.3,103,38,36.9
8,All Students,2018-19,19827,1244,18583,93.7,111,19,17.1
8,All Students,2019-20,12805,680,12125,94.7,112,16,14.3
8,All Students,2020-21,18550,1315,17235,92.9,106,22,20.8
8,All Students,2021-22,19005,2111,16894,88.9,107,43,40.2
8,All Students,2022-23,16351,1773,14578,89.2,93,39,41.9
9,All Students,2018-19,10,s,s,s,s,s,s
All Grades,All Students,2018-19,62642,7132,55510,88.6,393,152,38.7
All Grades,All Students,2019-20,37933,4112,33821,89.2,360,129,35.8
All Grades,All Students,2020-21,49516,1449,48067,97.1,294,24,8.2
All Grades,All Students,2021-22,43968,3637,40331,91.7,275,77,28.0
All Grades,All Students,2022-23,44164,4360,39804,90.1,281,107,38.1
6,All Students,2018-19,20072,s,s,s,s,s,s
6,All Students,2019-20,11342,1424,9918,87.4,105,44,41.9
6,All Students,2020-21,13110,353,12757,97.3,78,6,7.7
6,All Students,2021-22,13115,s,s,s,s,s,s
6,All Students,2022-23,14758,1705,13053,88.4,97,44,45.4
7,All Students,2018-19,21428,2520,18908,88.2,134,55,41.0
7,All Students,2019-20,12841,1021,11820,92.0,123,37,30.1
7,All Students,2020-21,16563,623,15940,96.2,99,12,12.1
7,All Students,2021-22,13370,1121,12249,91.6,84,25,29.8
7,All Students,2022-23,15576,1431,14145,90.8,99,34,34.3
8,All Students,2018-19,21011,2333,18678,88.9,131,50,38.2
8,All Students,2019-20,13750,1667,12083,87.9,132,48,36.4
8,All Students,2020-21,19843,473,19370,97.6,117,6,5.1
8,All Students,2021-22,17466,1386,16080,92.1,109,28,25.7
8,All Students,2022-23,13796,s,s,s,s,s,s
9,All Students,2018-19,131,s,s,s,s,s,s
9,All Students,2021-22,17,s,s,s,s,s,s
9,All Students,2022-23,34,s,s,s,s,s,s
All Grades,All Students,2018-19,62521,9535,52986,84.7,408,164,40.2
All Grades,All Students,2019-20,38637,5501,33136,85.8,372,153,41.1
All Grades,All Students,2020-21,63713,7085,56628,88.9,384,128,33.3
All Grades,All Students,2021-22,65007,8702,56305,86.6,410,153,37.3
All Grades,All Students,2022-23,64217,7873,56344,87.7,417,162,38.8
9,All Students,2018-19,16965,2347,14618,86.2,113,46,40.7
9,All Students,2019-20,11136,1145,9991,89.7,109,38,34.9
9,All Students,2020-21,19919,1969,17950,90.1,115,33,28.7
9,All Students,2021-22,19279,1882,17397,90.2,118,34,28.8
9,All Students,2022-23,20896,2358,18538,88.7,134,43,32.1
10,All Students,2018-19,16367,2501,13866,84.7,108,43,39.8
10,All Students,2019-20,10000,1574,8426,84.3,97,44,45.4
10,All Students,2020-21,16491,1898,14593,88.5,97,31,32.0
10,All Students,2021-22,19350,1970,17380,89.8,121,39,32.2
10,All Students,2022-23,18218,2184,16034,88.0,118,49,41.5
11,All Students,2018-19,14763,2243,12520,84.8,94,33,35.1
11,All Students,2019-20,8874,1502,7372,83.1,83,35,42.2
11,All Students,2020-21,15753,2065,13688,86.9,90,39,43.3
11,All Students,2021-22,13884,2402,11482,82.7,85,35,41.2
11,All Students,2022-23,15620,2061,13559,86.8,101,41,40.6
12,All Students,2018-19,14426,2444,11982,83.1,93,42,45.2
12,All Students,2019-20,8627,1280,7347,85.2,83,36,43.4
12,All Students,2020-21,11550,1153,10397,90.0,82,25,30.5
12,All Students,2021-22,12494,2448,10046,80.4,86,45,52.3
12,All Students,2022-23,9483,1270,8213,86.6,64,29,45.3
All Grades,All Students,2018-19,42902,5028,37874,88.3,268,118,44.0
All Grades,All Students,2019-20,28117,3300,24817,88.3,261,111,42.5
All Grades,All Students,2020-21,35504,2088,33416,94.1,210,35,16.7
All Grades,All Students,2021-22,31856,3704,28152,88.4,192,91,47.4
All Grades,All Students,2022-23,30579,3668,26911,88.0,194,90,46.4
6,All Students,2018-19,14120,1501,12619,89.4,89,38,42.7
6,All Students,2019-20,8507,752,7755,91.2,79,25,31.6
6,All Students,2020-21,9345,450,8895,95.2,56,6,10.7
6,All Students,2021-22,11315,1357,9958,88.0,67,37,55.2
6,All Students,2022-23,11022,1263,9759,88.5,69,28,40.6
7,All Students,2018-19,14852,1652,13200,88.9,91,40,44.0
7,All Students,2019-20,9698,1179,8519,87.8,93,43,46.2
7,All Students,2020-21,11975,725,11250,93.9,71,14,19.7
7,All Students,2021-22,9282,1234,8048,86.7,57,32,56.1
7,All Students,2022-23,9581,1166,8415,87.8,60,32,53.3
8,All Students,2018-19,13818,s,s,s,s,s,s
8,All Students,2019-20,9912,1369,8543,86.2,89,43,48.3
8,All Students,2020-21,14184,913,13271,93.6,83,15,18.1
8,All Students,2021-22,11259,1113,10146,90.1,68,22,32.4
8,All Students,2022-23,9976,1239,8737,87.6,65,30,46.2
10,All Students,2018-19,112,s,s,s,s,s,s
All Grades,All Students,2018-19,88590,7756,80834,91.2,560,131,23.4
All Grades,All Students,2019-20,54772,4387,50385,92.0,521,133,25.5
All Grades,All Students,2020-21,84209,13908,70301,83.5,493,227,46.0
All Grades,All Students,2021-22,80157,10906,69251,86.4,494,203,41.1
All Grades,All Students,2022-23,73104,6266,66838,91.4,467,107,22.9
6,All Students,2018-19,13088,658,12430,95.0,80,11,13.8
6,All Students,2019-20,7490,471,7019,93.7,70,14,20.0
6,All Students,2020-21,10729,1459,9270,86.4,63,31,49.2
6,All Students,2021-22,9731,997,8734,89.8,61,19,31.1
6,All Students,2022-23,6070,453,5617,92.5,37,9,24.3
7,All Students,2018-19,14858,737,14121,95.0,89,11,12.4
7,All Students,2019-20,6863,343,6520,95.0,64,8,12.5
7,All Students,2020-21,10951,1829,9122,83.3,63,28,44.4
7,All Students,2021-22,10293,1190,9103,88.4,62,26,41.9
7,All Students,2022-23,9146,578,8568,93.7,57,13,22.8
8,All Students,2018-19,13120,1400,11720,89.3,78,22,28.2
8,All Students,2019-20,8712,690,8022,92.1,81,21,25.9
8,All Students,2020-21,10149,836,9313,91.8,57,15,26.3
8,All Students,2021-22,11226,1640,9586,85.4,66,27,40.9
8,All Students,2022-23,11022,1076,9946,90.2,69,18,26.1
9,All Students,2018-19,14256,1852,12404,87.0,91,24,26.4
9,All Students,2019-20,10107,1020,9087,89.9,100,29,29.0
9,All Students,2020-21,14437,2891,11546,80.0,84,37,44.0
9,All Students,2021-22,12299,1679,10620,86.3,78,29,37.2
9,All Students,2022-23,13152,1039,12113,92.1,86,19,22.1
10,All Students,2018-19,13279,1261,12018,90.5,89,26,29.2
10,All Students,2019-20,8625,790,7835,90.8,83,25,30.1
10,All Students,2020-21,16087,2767,13320,82.8,96,43,44.8
10,All Students,2021-22,12442,2328,10114,81.3,79,39,49.4
10,All Students,2022-23,12043,1016,11027,91.6,77,14,18.2
11,All Students,2018-19,10093,895,9198,91.1,67,16,23.9
11,All Students,2019-20,5526,367,5159,93.4,52,14,26.9
11,All Students,2020-21,11668,2046,9622,82.5,69,32,46.4
11,All Students,2021-22,13077,1816,11261,86.1,81,39,48.1
11,All Students,2022-23,10548,1276,9272,87.9,71,18,25.4
12,All Students,2018-19,9896,953,8943,90.4,66,21,31.8
12,All Students,2019-20,7449,706,6743,90.5,71,22,31.0
12,All Students,2020-21,10188,2080,8108,79.6,61,41,67.2
12,All Students,2021-22,11089,1256,9833,88.7,67,24,35.8
12,All Students,2022-23,11123,828,10295,92.6,70,16,22.9
All Grades,All Students,2018-19,90626,8355,82271,90.8,551,176,31.9
All Grades,All Students,2019-20,52621,4759,47862,91.0,482,150,31.1
All Grades,All Students,2020-21,66010,6334,59676,90.4,387,118,30.5
All Grades,All Students,2021-22,57325,5788,51537,89.9,346,143,41.3
All Grades,All Students,2022-23,55940,4468,51472,92.0,349,98,28.1
6,All Students,2018-19,29605,2439,27166,91.8,183,52,28.4
6,All Students,2019-20,14249,1353,12896,90.5,138,56,40.6
6,All Students,2020-21,16326,1243,15083,92.4,98,22,22.4
6,All Students,2021-22,18268,1785,16483,90.2,113,44,38.9
6,All Students,2022-23,16456,1389,15067,91.6,106,32,30.2
7,All Students,2018-19,31601,3090,28511,90.2,190,67,35.3
7,All Students,2019-20,18345,1316,17029,92.8,166,35,21.1
7,All Students,2020-21,21715,2535,19180,88.3,126,52,41.3
7,All Students,2021-22,18158,1911,16247,89.5,108,49,45.4
7,All Students,2022-23,19348,1393,17955,92.8,123,32,26.0
8,All Students,2018-19,29420,2826,26594,90.4,178,57,32.0
8,All Students,2019-20,20027,2090,17937,89.6,178,59,33.1
8,All Students,2020-21,27969,2556,25413,90.9,163,44,27.0
8,All Students,2021-22,20899,2092,18807,90.0,125,50,40.0
8,All Students,2022-23,20136,1686,18450,91.6,120,34,28.3
All Grades,All Students,2018-19,58703,4059,54644,93.1,344,83,24.1
All Grades,All Students,2019-20,36293,2213,34080,93.9,329,66,20.1
All Grades,All Students,2020-21,49711,3108,46603,93.7,295,69,23.4
All Grades,All Students,2021-22,41175,2907,38268,92.9,246,62,25.2
All Grades,All Students,2022-23,45119,4033,41086,91.1,280,92,32.9
PK in K-12 Schools,All Students,2018-19,6305,575,5730,90.9,37,11,29.7
PK in K-12 Schools,All Students,2019-20,3745,251,3494,93.3,36,9,25.0
PK in K-12 Schools,All Students,2020-21,4681,297,4384,93.7,30,7,23.3
PK in K-12 Schools,All Students,2021-22,4452,406,4046,90.9,26,8,30.8
PK in K-12 Schools,All Students,2022-23,5701,850,4851,85.1,36,21,58.3
0K,All Students,2018-19,8512,978,7534,88.5,49,24,49.0
0K,All Students,2019-20,5548,445,5103,92.0,49,11,22.4
0K,All Students,2020-21,8135,584,7551,92.8,47,13,27.7
0K,All Students,2021-22,4562,327,4235,92.8,30,8,26.7
0K,All Students,2022-23,8402,757,7645,91.0,49,17,34.7
1,All Students,2018-19,8706,671,8035,92.3,51,13,25.5
1,All Students,2019-20,5140,427,4713,91.7,48,16,33.3
1,All Students,2020-21,8097,783,7314,90.3,49,19,38.8
1,All Students,2021-22,8459,524,7935,93.8,48,11,22.9
1,All Students,2022-23,4704,482,4222,89.8,29,10,34.5
2,All Students,2018-19,8348,417,7931,95.0,51,10,19.6
2,All Students,2019-20,5856,305,5551,94.8,53,7,13.2
2,All Students,2020-21,6192,532,5660,91.4,38,16,42.1
2,All Students,2021-22,6725,613,6112,90.9,44,16,36.4
2,All Students,2022-23,7015,511,6504,92.7,44,9,20.5
3,All Students,2018-19,8709,505,8204,94.2,50,9,18.0
3,All Students,2019-20,5230,260,4970,95.0,47,9,19.1
3,All Students,2020-21,7354,359,6995,95.1,43,6,14.0
3,All Students,2021-22,4480,356,4124,92.1,27,8,29.6
3,All Students,2022-23,7958,683,7275,91.4,50,18,36.0
4,All Students,2018-19,9070,503,8567,94.5,54,9,16.7
4,All Students,2019-20,5184,241,4943,95.4,47,10,21.3
4,All Students,2020-21,7721,301,7420,96.1,45,5,11.1
4,All Students,2021-22,6196,386,5810,93.8,35,6,17.1
4,All Students,2022-23,5085,391,4694,92.3,33,10,30.3
5,All Students,2018-19,9053,410,8643,95.5,52,7,13.5
5,All Students,2019-20,5590,284,5306,94.9,50,5,10.0
5,All Students,2020-21,7531,252,7279,96.7,43,3,7.0
5,All Students,2021-22,6301,295,6006,95.3,36,5,13.9
5,All Students,2022-23,6254,359,5895,94.3,39,7,17.9
All Grades,All Students,2018-19,102258,12453,89805,87.8,605,220,36.4
All Grades,All Students,2019-20,67005,7600,59405,88.7,609,205,33.7
All Grades,All Students,2020-21,106566,11435,95131,89.3,622,219,35.2
All Grades,All Students,2021-22,100257,21613,78644,78.4,596,434,72.8
All Grades,All Students,2022-23,97608,18543,79065,81.0,596,380,63.8
6,All Students,2018-19,15235,1164,14071,92.4,87,25,28.7
6,All Students,2019-20,9782,762,9020,92.2,87,24,27.6
6,All Students,2020-21,15563,1024,14539,93.4,92,21,22.8
6,All Students,2021-22,13282,2484,10798,81.3,81,59,72.8
6,All Students,2022-23,15074,2052,13022,86.4,89,44,49.4
7,All Students,2018-19,15802,1566,14236,90.1,92,24,26.1
7,All Students,2019-20,9712,773,8939,92.0,86,19,22.1
7,All Students,2020-21,14650,1588,13062,89.2,84,32,38.1
7,All Students,2021-22,15901,2873,13028,81.9,94,65,69.1
7,All Students,2022-23,12776,1833,10943,85.7,77,39,50.6
8,All Students,2018-19,16596,1802,14794,89.1,93,30,32.3
8,All Students,2019-20,9770,855,8915,91.2,86,23,26.7
8,All Students,2020-21,14065,1065,13000,92.4,82,24,29.3
8,All Students,2021-22,12826,2737,10089,78.7,76,54,71.1
8,All Students,2022-23,14616,2752,11864,81.2,83,55,66.3
9,All Students,2018-19,13917,1298,12619,90.7,84,30,35.7
9,All Students,2019-20,10077,949,9128,90.6,94,32,34.0
9,All Students,2020-21,16527,2087,14440,87.4,96,31,32.3
9,All Students,2021-22,15370,2777,12593,81.9,92,64,69.6
9,All Students,2022-23,12793,2390,10403,81.3,80,51,63.8
10,All Students,2018-19,13844,1675,12169,87.9,86,32,37.2
10,All Students,2019-20,9160,1228,7932,86.6,84,32,38.1
10,All Students,2020-21,15799,2319,13480,85.3,93,45,48.4
10,All Students,2021-22,15071,3417,11654,77.3,91,67,73.6
10,All Students,2022-23,15450,3326,12124,78.5,97,75,77.3
11,All Students,2018-19,14303,2160,12143,84.9,90,39,43.3
11,All Students,2019-20,9223,1119,8104,87.9,87,30,34.5
11,All Students,2020-21,14238,1511,12727,89.4,83,32,38.6
11,All Students,2021-22,14018,3101,10917,77.9,83,62,74.7
11,All Students,2022-23,13730,3066,10664,77.7,86,50,58.1
12,All Students,2018-19,12561,2788,9773,77.8,73,40,54.8
12,All Students,2019-20,9281,1914,7367,79.4,84,44,52.4
12,All Students,2020-21,15724,1841,13883,88.3,92,34,37.0
12,All Students,2021-22,13789,4224,9565,69.4,79,63,79.7
12,All Students,2022-23,13169,3124,10045,76.3,84,66,78.6
All Grades,All Students,2018-19,70013,7937,62076,88.7,444,174,39.2
All Grades,All Students,2019-20,43497,4696,38801,89.2,414,160,38.6
All Grades,All Students,2020-21,67822,8981,58841,86.8,397,146,36.8
All Grades,All Students,2021-22,62001,4851,57150,92.2,389,93,23.9
All Grades,All Students,2022-23,59673,6584,53089,89.0,385,146,37.9
9,All Students,2018-19,20524,2444,18080,88.1,134,43,32.1
9,All Students,2019-20,11843,1303,10540,89.0,115,42,36.5
9,All Students,2020-21,17658,2650,15008,85.0,104,39,37.5
9,All Students,2021-22,19550,1407,18143,92.8,124,28,22.6
9,All Students,2022-23,17658,2371,15287,86.6,118,50,42.4
10,All Students,2018-19,19281,2470,16811,87.2,121,54,44.6
10,All Students,2019-20,11460,1302,10158,88.6,110,42,38.2
10,All Students,2020-21,17817,2533,15284,85.8,106,43,40.6
10,All Students,2021-22,14895,1208,13687,91.9,96,21,21.9
10,All Students,2022-23,17557,1819,15738,89.6,114,42,36.8
11,All Students,2018-19,14238,1080,13158,92.4,90,29,32.2
11,All Students,2019-20,10687,1050,9637,90.2,101,38,37.6
11,All Students,2020-21,15575,1553,14022,90.0,89,22,24.7
11,All Students,2021-22,13843,1586,12257,88.5,87,33,37.9
11,All Students,2022-23,11976,986,10990,91.8,77,23,29.9
12,All Students,2018-19,15970,1943,14027,87.8,99,48,48.5
12,All Students,2019-20,9507,1041,8466,89.1,88,38,43.2
12,All Students,2020-21,16705,2243,14462,86.6,97,42,43.3
12,All Students,2021-22,13713,650,13063,95.3,82,11,13.4
12,All Students,2022-23,12482,1408,11074,88.7,76,31,40.8
All Grades,All Students,2018-19,61665,9862,51803,84.0,372,173,46.5
All Grades,All Students,2019-20,38392,5325,33067,86.1,364,154,42.3
All Grades,All Students,2020-21,59662,10150,49512,83.0,350,155,44.3
All Grades,All Students,2021-22,54815,11532,43283,79.0,343,239,69.7
All Grades,All Students,2022-23,54497,9427,45070,82.7,342,197,57.6
9,All Students,2018-19,14897,2911,11986,80.5,89,39,43.8
9,All Students,2019-20,9734,1461,8273,85.0,93,38,40.9
9,All Students,2020-21,17109,2342,14767,86.3,99,35,35.4
9,All Students,2021-22,18506,4238,14268,77.1,116,77,66.4
9,All Students,2022-23,16027,2921,13106,81.8,102,50,49.0
10,All Students,2018-19,15667,2154,13513,86.3,96,43,44.8
10,All Students,2019-20,9855,1349,8506,86.3,94,40,42.6
10,All Students,2020-21,14966,3067,11899,79.5,86,42,48.8
10,All Students,2021-22,13159,2107,11052,84.0,85,54,63.5
10,All Students,2022-23,14137,2344,11793,83.4,90,54,60.0
11,All Students,2018-19,15145,2315,12830,84.7,91,42,46.2
11,All Students,2019-20,9221,1043,8178,88.7,89,36,40.4
11,All Students,2020-21,13565,2560,11005,81.1,79,40,50.6
11,All Students,2021-22,11888,2282,9606,80.8,74,51,68.9
11,All Students,2022-23,14050,2413,11637,82.8,87,51,58.6
12,All Students,2018-19,15956,2482,13474,84.4,96,49,51.0
12,All Students,2019-20,9582,1472,8110,84.6,88,40,45.5
12,All Students,2020-21,14010,2174,11836,84.5,85,37,43.5
12,All Students,2021-22,11262,2905,8357,74.2,68,57,83.8
12,All Students,2022-23,10283,1749,8534,83.0,63,42,66.7
All Grades,All Students,2018-19,74887,6464,68423,91.4,473,132,27.9
All Grades,All Students,2019-20,48540,3577,44963,92.6,461,118,25.6
All Grades,All Students,2020-21,70606,11761,58845,83.3,442,243,55.0
All Grades,All Students,2021-22,67223,10373,56850,84.6,412,219,53.2
All Grades,All Students,2022-23,64630,8654,55976,86.6,401,177,44.1
9,All Students,2018-19,20472,1764,18708,91.4,130,30,23.1
9,All Students,2019-20,13483,999,12484,92.6,129,34,26.4
9,All Students,2020-21,18829,3459,15370,81.6,120,66,55.0
9,All Students,2021-22,16175,2125,14050,86.9,102,51,50.0
9,All Students,2022-23,20797,3203,17594,84.6,129,60,46.5
10,All Students,2018-19,19924,1457,18467,92.7,129,29,22.5
10,All Students,2019-20,11980,950,11030,92.1,118,35,29.7
10,All Students,2020-21,19211,3148,16063,83.6,121,66,54.5
10,All Students,2021-22,18194,3144,15050,82.7,112,62,55.4
10,All Students,2022-23,15622,2086,13536,86.6,100,43,43.0
11,All Students,2018-19,17762,1430,16332,91.9,111,28,25.2
11,All Students,2019-20,11839,666,11173,94.4,109,20,18.3
11,All Students,2020-21,16202,2721,13481,83.2,100,61,61.0
11,All Students,2021-22,18020,2380,15640,86.8,110,49,44.5
11,All Students,2022-23,13907,1677,12230,87.9,85,44,51.8
12,All Students,2018-19,16729,1813,14916,89.2,103,45,43.7
12,All Students,2019-20,11238,962,10276,91.4,105,29,27.6
12,All Students,2020-21,16364,2433,13931,85.1,101,50,49.5
12,All Students,2021-22,14834,2724,12110,81.6,88,57,64.8
12,All Students,2022-23,14304,1688,12616,88.2,87,30,34.5
All Grades,All Students,2018-19,58792,9711,49081,83.5,371,186,50.1
All Grades,All Students,2019-20,38852,6361,32491,83.6,367,171,46.6
All Grades,All Students,2020-21,58067,7956,50111,86.3,339,134,39.5
All Grades,All Students,2021-22,46430,9224,37206,80.1,285,181,63.5
All Grades,All Students,2022-23,42325,7280,35045,82.8,283,161,56.9
9,All Students,2018-19,17924,2924,15000,83.7,110,53,48.2
9,All Students,2019-20,13194,2655,10539,79.9,125,63,50.4
9,All Students,2020-21,15436,3257,12179,78.9,89,45,50.6
9,All Students,2021-22,11026,1939,9087,82.4,68,39,57.4
9,All Students,2022-23,12752,2081,10671,83.7,92,50,54.3
10,All Students,2018-19,17930,3779,14151,78.9,118,65,55.1
10,All Students,2019-20,11489,1904,9585,83.4,108,49,45.4
10,All Students,2020-21,19286,2850,16436,85.2,112,53,47.3
10,All Students,2021-22,12665,2794,9871,77.9,80,54,67.5
10,All Students,2022-23,13883,2461,11422,82.3,90,48,53.3
11,All Students,2018-19,10311,1348,8963,86.9,66,30,45.5
11,All Students,2019-20,7433,869,6564,88.3,72,31,43.1
11,All Students,2020-21,10945,970,9975,91.1,63,15,23.8
11,All Students,2021-22,9875,1976,7899,80.0,60,40,66.7
11,All Students,2022-23,5595,760,4835,86.4,35,20,57.1
12,All Students,2018-19,12627,1660,10967,86.9,77,38,49.4
12,All Students,2019-20,6736,933,5803,86.1,62,28,45.2
12,All Students,2020-21,12400,879,11521,92.9,75,21,28.0
12,All Students,2021-22,12864,2515,10349,80.4,77,48,62.3
12,All Students,2022-23,10095,1978,8117,80.4,66,43,65.2
All Grades,All Students,2018-19,127430,19191,108239,84.9,782,490,62.7
All Grades,All Students,2019-20,72524,9321,63203,87.1,686,356,51.9
All Grades,All Students,2020-21,90545,14680,75865,83.8,543,239,44.0
All Grades,All Students,2021-22,77508,13061,64447,83.1,475,306,64.4
All Grades,All Students,2022-23,70423,8450,61973,88.0,435,213,49.0
PK in K-12 Schools,All Students,2018-19,11090,s,s,s,s,s,s
PK in K-12 Schools,All Students,2019-20,6842,1226,5616,82.1,69,47,68.1
PK in K-12 Schools,All Students,2020-21,5005,555,4450,88.9,32,12,37.5
PK in K-12 Schools,All Students,2021-22,5534,1052,4482,81.0,38,24,63.2
PK in K-12 Schools,All Students,2022-23,2944,429,2515,85.4,22,14,63.6
0K,All Students,2018-19,17313,2836,14477,83.6,106,71,67.0
0K,All Students,2019-20,10229,1579,8650,84.6,99,63,63.6
0K,All Students,2020-21,9278,1433,7845,84.6,57,29,50.9
0K,All Students,2021-22,9418,1830,7588,80.6,57,44,77.2
0K,All Students,2022-23,10872,1540,9332,85.8,70,38,54.3
1,All Students,2018-19,20449,3495,16954,82.9,129,89,69.0
1,All Students,2019-20,10057,1339,8718,86.7,95,51,53.7
1,All Students,2020-21,15151,3209,11942,78.8,91,55,60.4
1,All Students,2021-22,9602,1425,8177,85.2,60,35,58.3
1,All Students,2022-23,9315,1245,8070,86.6,59,33,55.9
2,All Students,2018-19,19853,2812,17041,85.8,121,75,62.0
2,All Students,2019-20,10699,1403,9296,86.9,101,57,56.4
2,All Students,2020-21,13839,2616,11223,81.1,82,35,42.7
2,All Students,2021-22,13780,2514,11266,81.8,84,59,70.2
2,All Students,2022-23,9899,1150,8749,88.4,61,30,49.2
3,All Students,2018-19,20519,3177,17342,84.5,129,80,62.0
3,All Students,2019-20,11946,1322,10624,88.9,111,44,39.6
3,All Students,2020-21,14602,2290,12312,84.3,88,38,43.2
3,All Students,2021-22,12550,1901,10649,84.9,76,47,61.8
3,All Students,2022-23,12388,1352,11036,89.1,73,35,47.9
4,All Students,2018-19,19563,2269,17294,88.4,119,63,52.9
4,All Students,2019-20,11722,1432,10290,87.8,111,61,55.0
4,All Students,2020-21,16465,2291,14174,86.1,99,35,35.4
4,All Students,2021-22,12663,1833,10830,85.5,75,39,52.0
4,All Students,2022-23,13237,1514,11723,88.6,81,37,45.7
5,All Students,2018-19,18639,2296,16343,87.7,109,59,54.1
5,All Students,2019-20,11029,1020,10009,90.8,100,33,33.0
5,All Students,2020-21,16205,2286,13919,85.9,94,35,37.2
5,All Students,2021-22,13961,2506,11455,82.0,85,58,68.2
5,All Students,2022-23,11768,1220,10548,89.6,69,26,37.7
6,All Students,2018-19,4,s,s,s,s,s,s
All Grades,All Students,2018-19,89245,6611,82634,92.6,537,144,26.8
All Grades,All Students,2019-20,53810,3362,50448,93.8,498,110,22.1
All Grades,All Students,2020-21,77764,7348,70416,90.6,464,166,35.8
All Grades,All Students,2021-22,72726,9641,63085,86.7,448,252,56.3
All Grades,All Students,2022-23,69668,7683,61985,89.0,428,189,44.2
0K,All Students,2018-19,13046,1228,11818,90.6,80,36,45.0
0K,All Students,2019-20,6773,615,6158,90.9,66,24,36.4
0K,All Students,2020-21,10090,1005,9085,90.0,64,26,40.6
0K,All Students,2021-22,9193,1311,7882,85.7,56,33,58.9
0K,All Students,2022-23,8250,977,7273,88.2,52,23,44.2
1,All Students,2018-19,15315,1222,14093,92.0,92,26,28.3
1,All Students,2019-20,8682,542,8140,93.8,78,14,17.9
1,All Students,2020-21,10398,1121,9277,89.2,63,28,44.4
1,All Students,2021-22,10094,1329,8765,86.8,67,37,55.2
1,All Students,2022-23,10400,1383,9017,86.7,66,37,56.1
2,All Students,2018-19,14224,1053,13171,92.6,86,22,25.6
2,All Students,2019-20,9120,584,8536,93.6,88,19,21.6
2,All Students,2020-21,12740,1041,11699,91.8,76,21,27.6
2,All Students,2021-22,11600,1657,9943,85.7,71,44,62.0
2,All Students,2022-23,9634,1003,8631,89.6,59,22,37.3
3,All Students,2018-19,16456,1238,15218,92.5,99,26,26.3
3,All Students,2019-20,10149,588,9561,94.2,91,17,18.7
3,All Students,2020-21,14863,1294,13569,91.3,87,27,31.0
3,All Students,2021-22,13423,1801,11622,86.6,83,44,53.0
3,All Students,2022-23,13208,1499,11709,88.7,78,35,44.9
4,All Students,2018-19,14430,919,13511,93.6,87,19,21.8
4,All Students,2019-20,9308,606,8702,93.5,84,22,26.2
4,All Students,2020-21,15381,1664,13717,89.2,90,35,38.9
4,All Students,2021-22,14350,1835,12515,87.2,87,47,54.0
4,All Students,2022-23,13453,1349,12104,90.0,85,36,42.4
5,All Students,2018-19,15774,951,14823,94.0,93,15,16.1
5,All Students,2019-20,9778,427,9351,95.6,91,14,15.4
5,All Students,2020-21,14292,1223,13069,91.4,84,29,34.5
5,All Students,2021-22,14066,1708,12358,87.9,84,47,56.0
5,All Students,2022-23,14723,1472,13251,90.0,88,36,40.9
All Grades,All Students,2018-19,66487,9686,56801,85.4,412,166,40.3
All Grades,All Students,2019-20,47008,7332,39676,84.4,432,179,41.4
All Grades,All Students,2020-21,80221,13620,66601,83.0,464,202,43.5
All Grades,All Students,2021-22,73235,14135,59100,80.7,446,265,59.4
All Grades,All Students,2022-23,67921,11312,56609,83.3,432,244,56.5
9,All Students,2018-19,20162,2273,17889,88.7,130,47,36.2
9,All Students,2019-20,14090,1527,12563,89.2,134,40,29.9
9,All Students,2020-21,21887,2686,19201,87.7,126,42,33.3
9,All Students,2021-22,19529,3431,16098,82.4,121,63,52.1
9,All Students,2022-23,17629,2306,15323,86.9,113,48,42.5
10,All Students,2018-19,19059,2291,16768,88.0,114,35,30.7
10,All Students,2019-20,12272,1818,10454,85.2,116,54,46.6
10,All Students,2020-21,20823,3824,16999,81.6,120,57,47.5
10,All Students,2021-22,19966,3288,16678,83.5,123,68,55.3
10,All Students,2022-23,16105,2959,13146,81.6,103,60,58.3
11,All Students,2018-19,14163,2344,11819,83.4,89,44,49.4
11,All Students,2019-20,12401,2014,10387,83.8,108,39,36.1
11,All Students,2020-21,18362,3603,14759,80.4,108,49,45.4
11,All Students,2021-22,18205,3881,14324,78.7,106,68,64.2
11,All Students,2022-23,17635,2708,14927,84.6,111,63,56.8
12,All Students,2018-19,13103,2778,10325,78.8,79,40,50.6
12,All Students,2019-20,8245,1973,6272,76.1,74,46,62.2
12,All Students,2020-21,19149,3507,15642,81.7,110,54,49.1
12,All Students,2021-22,15535,3535,12000,77.2,96,66,68.8
12,All Students,2022-23,16552,3339,13213,79.8,105,73,69.5
All Grades,All Students,2018-19,56450,3891,52559,93.1,335,73,21.8
All Grades,All Students,2019-20,35910,2372,33538,93.4,323,72,22.3
All Grades,All Students,2020-21,57024,3173,53851,94.4,330,52,15.8
All Grades,All Students,2021-22,54997,7360,47637,86.6,330,164,49.7
All Grades,All Students,2022-23,58310,5731,52579,90.2,340,114,33.5
6,All Students,2018-19,19743,1417,18326,92.8,124,27,21.8
6,All Students,2019-20,12221,732,11489,94.0,111,24,21.6
6,All Students,2020-21,19792,863,18929,95.6,116,16,13.8
6,All Students,2021-22,18724,2532,16192,86.5,114,62,54.4
6,All Students,2022-23,20954,2147,18807,89.8,122,46,37.7
7,All Students,2018-19,18539,1311,17228,92.9,107,26,24.3
7,All Students,2019-20,12291,838,11453,93.2,111,21,18.9
7,All Students,2020-21,18547,1205,17342,93.5,107,20,18.7
7,All Students,2021-22,19236,2024,17212,89.5,113,44,38.9
7,All Students,2022-23,18301,1829,16472,90.0,108,35,32.4
8,All Students,2018-19,18168,1163,17005,93.6,104,20,19.2
8,All Students,2019-20,11398,802,10596,93.0,101,27,26.7
8,All Students,2020-21,18685,1105,17580,94.1,107,16,15.0
8,All Students,2021-22,17037,2804,14233,83.5,103,58,56.3
8,All Students,2022-23,19055,1755,17300,90.8,110,33,30.0
All Grades,All Students,2018-19,73711,6128,67583,91.7,448,157,35.0
All Grades,All Students,2019-20,42118,3245,38873,92.3,400,112,28.0
All Grades,All Students,2020-21,55846,3388,52458,93.9,334,70,21.0
All Grades,All Students,2021-22,48066,5299,42767,89.0,294,124,42.2
6,All Students,2022-23,10823,976,9847,91.0,72,25,34.7
All Grades,All Students,2022-23,49247,5452,43795,88.9,309,140,45.3
0K,All Students,2018-19,9273,964,8309,89.6,60,28,46.7
0K,All Students,2019-20,4050,269,3781,93.4,38,9,23.7
0K,All Students,2020-21,7058,457,6601,93.5,45,8,17.8
0K,All Students,2021-22,6723,835,5888,87.6,40,19,47.5
0K,All Students,2022-23,8139,1122,7017,86.2,52,27,51.9
1,All Students,2018-19,9325,847,8478,90.9,58,23,39.7
1,All Students,2019-20,6285,554,5731,91.2,58,18,31.0
1,All Students,2020-21,6229,326,5903,94.8,38,7,18.4
1,All Students,2021-22,7055,935,6120,86.7,45,24,53.3
1,All Students,2022-23,6710,808,5902,88.0,41,20,48.8
2,All Students,2018-19,10423,893,9530,91.4,65,26,40.0
2,All Students,2019-20,5393,418,4975,92.2,53,15,28.3
2,All Students,2020-21,8711,622,8089,92.9,52,14,26.9
2,All Students,2021-22,5650,467,5183,91.7,36,13,36.1
2,All Students,2022-23,8708,1034,7674,88.1,56,27,48.2
3,All Students,2018-19,15068,1231,13837,91.8,88,26,29.5
3,All Students,2019-20,7403,538,6865,92.7,70,21,30.0
3,All Students,2020-21,8652,535,8117,93.8,51,9,17.6
3,All Students,2021-22,10360,1088,9272,89.5,63,26,41.3
3,All Students,2022-23,6915,744,6171,89.2,44,17,38.6
4,All Students,2018-19,15194,1114,14080,92.7,92,27,29.3
4,All Students,2019-20,9996,907,9089,90.9,92,30,32.6
4,All Students,2020-21,10696,613,10083,94.3,63,14,22.2
4,All Students,2021-22,7205,692,6513,90.4,44,17,38.6
4,All Students,2022-23,10846,1006,9840,90.7,65,27,41.5
5,All Students,2018-19,14428,1079,13349,92.5,85,27,31.8
5,All Students,2019-20,8991,559,8432,93.8,89,19,21.3
5,All Students,2020-21,14500,835,13665,94.2,85,18,21.2
5,All Students,2021-22,11073,1282,9791,88.4,66,25,37.9
5,All Students,2022-23,7929,738,7191,90.7,51,22,43.1
All Grades,All Students,2018-19,52646,4467,48179,91.5,331,97,29.3
All Grades,All Students,2019-20,31033,2682,28351,91.4,286,87,30.4
All Grades,All Students,2020-21,41881,4632,37249,88.9,249,92,36.9
All Grades,All Students,2021-22,36982,4487,32495,87.9,231,105,45.5
All Grades,All Students,2022-23,32754,2972,29782,90.9,222,89,40.1
6,All Students,2018-19,14321,1142,13179,92.0,90,26,28.9
6,All Students,2019-20,10103,988,9115,90.2,96,35,36.5
6,All Students,2020-21,11879,1135,10744,90.4,73,27,37.0
6,All Students,2021-22,11279,1604,9675,85.8,68,33,48.5
6,All Students,2022-23,6872,581,6291,91.5,47,17,36.2
7,All Students,2018-19,17831,1495,16336,91.6,114,34,29.8
7,All Students,2019-20,9507,737,8770,92.2,85,23,27.1
7,All Students,2020-21,15482,1810,13672,88.3,92,36,39.1
7,All Students,2021-22,12123,1221,10902,89.9,77,35,45.5
7,All Students,2022-23,11324,1123,10201,90.1,77,36,46.8
8,All Students,2018-19,20494,1830,18664,91.1,127,37,29.1
8,All Students,2019-20,11423,957,10466,91.6,105,29,27.6
8,All Students,2020-21,14520,1687,12833,88.4,84,29,34.5
8,All Students,2021-22,13580,1662,11918,87.8,86,37,43.0
8,All Students,2022-23,14558,1268,13290,91.3,98,36,36.7
All Grades,All Students,2018-19,71940,8465,63475,88.2,449,197,43.9
All Grades,All Students,2019-20,44572,4322,40250,90.3,411,138,33.6
All Grades,All Students,2020-21,57814,7691,50123,86.7,338,128,37.9
All Grades,All Students,2021-22,55058,6535,48523,88.1,332,148,44.6
All Grades,All Students,2022-23,42922,3650,39272,91.5,275,87,31.6
5,All Students,2018-19,2,s,s,s,s,s,s
6,All Students,2018-19,20998,2001,18997,90.5,131,57,43.5
6,All Students,2019-20,14576,1089,13487,92.5,134,32,23.9
6,All Students,2020-21,14881,1193,13688,92.0,86,23,26.7
6,All Students,2021-22,18407,2080,16327,88.7,111,51,45.9
7,All Students,2018-19,22819,2613,20206,88.5,145,62,42.8
7,All Students,2019-20,13165,s,s,s,s,s,s
7,All Students,2020-21,21833,2584,19249,88.2,129,48,37.2
7,All Students,2021-22,14642,1592,13050,89.1,88,37,42.0
7,All Students,2022-23,16790,1357,15433,91.9,112,34,30.4
8,All Students,2018-19,28003,3826,24177,86.3,172,77,44.8
8,All Students,2019-20,16739,2008,14731,88.0,151,63,41.7
8,All Students,2020-21,21100,3914,17186,81.5,123,57,46.3
8,All Students,2021-22,21915,2816,19099,87.2,132,60,45.5
8,All Students,2022-23,15309,1317,13992,91.4,91,28,30.8
9,All Students,2018-19,118,s,s,s,s,s,s
9,All Students,2019-20,92,s,s,s,s,s,s
9,All Students,2021-22,68,s,s,s,s,s,s
10,All Students,2021-22,26,s,s,s,s,s,s
All Grades,All Students,2018-19,83012,6661,76351,92.0,512,102,19.9
All Grades,All Students,2019-20,50869,3694,47175,92.7,465,86,18.5
All Grades,All Students,2020-21,82259,14002,68257,83.0,496,218,44.0
All Grades,All Students,2021-22,72699,10803,61896,85.1,478,226,47.3
All Grades,All Students,2022-23,65188,7394,57794,88.7,450,185,41.1
6,All Students,2018-19,12715,657,12058,94.8,76,9,11.8
6,All Students,2019-20,5839,332,5507,94.3,55,7,12.7
6,All Students,2020-21,11426,1259,10167,89.0,66,25,37.9
6,All Students,2021-22,8143,973,7170,88.1,49,23,46.9
6,All Students,2022-23,7601,768,6833,89.9,45,17,37.8
7,All Students,2018-19,11124,483,10641,95.7,68,4,5.9
7,All Students,2019-20,7655,443,7212,94.2,70,8,11.4
7,All Students,2020-21,8925,1449,7476,83.8,50,22,44.0
7,All Students,2021-22,9179,1225,7954,86.7,55,25,45.5
7,All Students,2022-23,7471,890,6581,88.1,43,19,44.2
8,All Students,2018-19,16786,1376,15410,91.8,98,23,23.5
8,All Students,2019-20,6517,419,6098,93.6,60,11,18.3
8,All Students,2020-21,10571,2102,8469,80.1,61,36,59.0
8,All Students,2021-22,8110,1108,7002,86.3,48,27,56.3
8,All Students,2022-23,7814,962,6852,87.7,48,19,39.6
9,All Students,2018-19,13434,714,12720,94.7,83,15,18.1
9,All Students,2019-20,9663,772,8891,92.0,87,19,21.8
9,All Students,2020-21,16113,1527,14586,90.5,91,24,26.4
9,All Students,2021-22,13321,1619,11702,87.8,81,38,46.9
9,All Students,2022-23,12761,1282,11479,90.0,79,28,35.4
10,All Students,2018-19,11426,576,10850,95.0,69,12,17.4
10,All Students,2019-20,8385,486,7899,94.2,77,11,14.3
10,All Students,2020-21,15750,3452,12298,78.1,88,46,52.3
10,All Students,2021-22,14542,2036,12506,86.0,88,37,42.0
10,All Students,2022-23,11369,1070,10299,90.6,72,24,33.3
11,All Students,2018-19,8409,519,7890,93.8,51,10,19.6
11,All Students,2019-20,7267,446,6821,93.9,66,16,24.2
11,All Students,2020-21,13125,2221,10904,83.1,73,25,34.2
11,All Students,2021-22,14338,2773,11565,80.7,86,56,65.1
11,All Students,2022-23,13077,1526,11551,88.3,83,34,41.0
12,All Students,2018-19,9118,2336,6782,74.4,67,29,43.3
12,All Students,2019-20,5543,796,4747,85.6,50,14,28.0
12,All Students,2020-21,6349,1992,4357,68.6,67,40,59.7
12,All Students,2021-22,5066,1069,3997,78.9,71,20,28.2
12,All Students,2022-23,5095,896,4199,82.4,80,44,55.0
All Grades,All Students,2018-19,124896,13979,110917,88.8,739,295,39.9
All Grades,All Students,2019-20,79069,7407,71662,90.6,726,239,32.9
All Grades,All Students,2020-21,122172,19633,102539,83.9,709,278,39.2
All Grades,All Students,2021-22,112438,13899,98539,87.6,667,304,45.6
All Grades,All Students,2022-23,113368,13901,99467,87.7,691,298,43.1
6,All Students,2018-19,17688,1145,16543,93.5,101,22,21.8
6,All Students,2019-20,11437,681,10756,94.0,104,21,20.2
6,All Students,2020-21,15668,1816,13852,88.4,93,34,36.6
6,All Students,2021-22,16844,1584,15260,90.6,99,41,41.4
6,All Students,2022-23,19247,1993,17254,89.6,112,40,35.7
7,All Students,2018-19,18775,1364,17411,92.7,106,26,24.5
7,All Students,2019-20,11374,649,10725,94.3,101,22,21.8
7,All Students,2020-21,16775,2494,14281,85.1,98,43,43.9
7,All Students,2021-22,16401,1577,14824,90.4,94,35,37.2
7,All Students,2022-23,17670,1917,15753,89.2,105,49,46.7
8,All Students,2018-19,17270,1436,15834,91.7,101,29,28.7
8,All Students,2019-20,11566,755,10811,93.5,103,24,23.3
8,All Students,2020-21,17049,1795,15254,89.5,98,34,34.7
8,All Students,2021-22,15816,1799,14017,88.6,92,40,43.5
8,All Students,2022-23,15416,2081,13335,86.5,91,46,50.5
9,All Students,2018-19,18436,2170,16266,88.2,112,41,36.6
9,All Students,2019-20,12465,1408,11057,88.7,118,35,29.7
9,All Students,2020-21,18882,2938,15944,84.4,109,37,33.9
9,All Students,2021-22,15392,1164,14228,92.4,93,21,22.6
9,All Students,2022-23,15487,1588,13899,89.7,98,38,38.8
10,All Students,2018-19,17539,1832,15707,89.6,105,33,31.4
10,All Students,2019-20,11427,1145,10282,90.0,106,42,39.6
10,All Students,2020-21,19264,4104,15160,78.7,111,47,42.3
10,All Students,2021-22,16389,2371,14018,85.5,98,48,49.0
10,All Students,2022-23,14861,1315,13546,91.2,95,25,26.3
11,All Students,2018-19,17083,2534,14549,85.2,103,57,55.3
11,All Students,2019-20,10640,1154,9486,89.2,99,37,37.4
11,All Students,2020-21,17624,3437,14187,80.5,103,44,42.7
11,All Students,2021-22,16275,2389,13886,85.3,98,49,50.0
11,All Students,2022-23,15317,2230,13087,85.4,95,45,47.4
12,All Students,2018-19,18105,3498,14607,80.7,111,87,78.4
12,All Students,2019-20,10160,1615,8545,84.1,95,58,61.1
12,All Students,2020-21,16910,3049,13861,82.0,97,39,40.2
12,All Students,2021-22,15321,3015,12306,80.3,93,70,75.3
12,All Students,2022-23,15370,2777,12593,81.9,95,55,57.9
All Grades,All Students,2018-19,55815,4717,51098,91.5,358,105,29.3
All Grades,All Students,2019-20,36986,2707,34279,92.7,346,82,23.7
All Grades,All Students,2020-21,55056,5252,49804,90.5,325,112,34.5
All Grades,All Students,2021-22,39830,4072,35758,89.8,246,88,35.8
All Grades,All Students,2022-23,28833,2791,26042,90.3,182,67,36.8
6,All Students,2018-19,20878,1507,19371,92.8,131,37,28.2
6,All Students,2019-20,11921,918,11003,92.3,114,25,21.9
6,All Students,2020-21,15997,s,s,s,s,s,s
6,All Students,2021-22,8725,829,7896,90.5,55,19,34.5
6,All Students,2022-23,7037,541,6496,92.3,45,14,31.1
7,All Students,2018-19,17080,1443,15637,91.6,113,35,31.0
7,All Students,2019-20,14155,989,13166,93.0,132,30,22.7
7,All Students,2020-21,18270,1566,16704,91.4,108,33,30.6
7,All Students,2021-22,13732,1728,12004,87.4,87,37,42.5
7,All Students,2022-23,8997,791,8206,91.2,59,19,32.2
8,All Students,2018-19,17857,1767,16090,90.1,114,33,28.9
8,All Students,2019-20,10865,s,s,s,s,s,s
8,All Students,2020-21,20786,1887,18899,90.9,123,38,30.9
8,All Students,2021-22,17373,1515,15858,91.3,104,32,30.8
8,All Students,2022-23,12799,1459,11340,88.6,78,34,43.6
9,All Students,2020-21,3,s,s,s,s,s,s
12,All Students,2019-20,45,s,s,s,s,s,s
All Grades,All Students,2018-19,44050,6704,37346,84.8,291,140,48.1
All Grades,All Students,2019-20,30037,4017,26020,86.6,299,133,44.5
All Grades,All Students,2020-21,56751,8304,48447,85.4,338,151,44.7
All Grades,All Students,2021-22,54649,11039,43610,79.8,366,190,51.9
All Grades,All Students,2022-23,53458,9176,44282,82.8,357,164,45.9
9,All Students,2018-19,16499,2836,13663,82.8,100,48,48.0
9,All Students,2019-20,11723,1582,10141,86.5,114,42,36.8
9,All Students,2020-21,20094,3283,16811,83.7,118,54,45.8
9,All Students,2021-22,15971,3887,12084,75.7,113,72,63.7
9,All Students,2022-23,16948,3762,13186,77.8,114,56,49.1
10,All Students,2018-19,13047,2273,10774,82.6,95,55,57.9
10,All Students,2019-20,9045,1326,7719,85.3,94,53,56.4
10,All Students,2020-21,17602,3156,14446,82.1,106,57,53.8
10,All Students,2021-22,17803,4398,13405,75.3,122,65,53.3
10,All Students,2022-23,14943,3084,11859,79.4,106,58,54.7
11,All Students,2018-19,6468,687,5781,89.4,45,18,40.0
11,All Students,2019-20,5780,689,5091,88.1,57,25,43.9
11,All Students,2020-21,10683,1068,9615,90.0,64,24,37.5
11,All Students,2021-22,12106,1519,10587,87.5,76,30,39.5
11,All Students,2022-23,10753,1232,9521,88.5,69,25,36.2
12,All Students,2018-19,8036,908,7128,88.7,51,19,37.3
12,All Students,2019-20,3489,420,3069,88.0,34,13,38.2
12,All Students,2020-21,8372,797,7575,90.5,50,16,32.0
12,All Students,2021-22,8769,1235,7534,85.9,55,23,41.8
12,All Students,2022-23,10814,1098,9716,89.8,68,25,36.8
All Grades,All Students,2018-19,85425,7091,78334,91.7,533,154,28.9
All Grades,All Students,2019-20,48937,4882,44055,90.0,446,151,33.9
All Grades,All Students,2020-21,55438,4366,51072,92.1,324,77,23.8
All Grades,All Students,2021-22,39068,4733,34335,87.9,245,105,42.9
All Grades,All Students,2022-23,31216,2593,28623,91.7,208,69,33.2
6,All Students,2018-19,22713,2184,20529,90.4,145,41,28.3
6,All Students,2019-20,13200,1299,11901,90.2,120,36,30.0
6,All Students,2020-21,13024,1043,11981,92.0,77,24,31.2
6,All Students,2021-22,8566,1155,7411,86.5,53,26,49.1
6,All Students,2022-23,9474,875,8599,90.8,65,23,35.4
7,All Students,2018-19,32913,2906,30007,91.2,203,63,31.0
7,All Students,2019-20,14446,1567,12879,89.2,131,45,34.4
7,All Students,2020-21,20468,1372,19096,93.3,119,21,17.6
7,All Students,2021-22,10399,1385,9014,86.7,71,33,46.5
7,All Students,2022-23,9656,817,8839,91.5,63,26,41.3
8,All Students,2018-19,29799,2001,27798,93.3,185,50,27.0
8,All Students,2019-20,21291,2016,19275,90.5,195,70,35.9
8,All Students,2020-21,21946,1951,19995,91.1,128,32,25.0
8,All Students,2021-22,20103,2193,17910,89.1,121,46,38.0
8,All Students,2022-23,12086,901,11185,92.5,80,20,25.0
All Grades,All Students,2018-19,67015,4111,62904,93.9,386,73,18.9
All Grades,All Students,2019-20,43683,2515,41168,94.2,383,71,18.5
All Grades,All Students,2020-21,67312,3193,64119,95.3,391,55,14.1
All Grades,All Students,2021-22,66486,5283,61203,92.1,396,119,30.1
All Grades,All Students,2022-23,66997,5366,61631,92.0,405,115,28.4
6,All Students,2018-19,21920,1242,20678,94.3,126,20,15.9
6,All Students,2019-20,16286,886,15400,94.6,143,24,16.8
6,All Students,2020-21,23419,1174,22245,95.0,138,21,15.2
6,All Students,2021-22,22749,1967,20782,91.4,137,46,33.6
6,All Students,2022-23,23993,1951,22042,91.9,144,42,29.2
7,All Students,2018-19,22987,1502,21485,93.5,132,32,24.2
7,All Students,2019-20,13335,619,12716,95.4,117,15,12.8
7,All Students,2020-21,23970,851,23119,96.4,138,12,8.7
7,All Students,2021-22,21914,1644,20270,92.5,130,37,28.5
7,All Students,2022-23,21676,1849,19827,91.5,131,36,27.5
8,All Students,2018-19,22108,1367,20741,93.8,128,21,16.4
8,All Students,2019-20,14062,1010,13052,92.8,123,32,26.0
8,All Students,2020-21,19923,1168,18755,94.1,115,22,19.1
8,All Students,2021-22,21819,s,s,s,s,s,s
8,All Students,2022-23,21328,1566,19762,92.7,130,37,28.5
9,All Students,2021-22,4,s,s,s,s,s,s
All Grades,All Students,2018-19,53663,6103,47560,88.6,339,123,36.3
All Grades,All Students,2019-20,37050,3114,33936,91.6,364,118,32.4
All Grades,All Students,2020-21,63956,4364,59592,93.2,377,87,23.1
All Grades,All Students,2021-22,61373,8197,53176,86.6,378,160,42.3
All Grades,All Students,2022-23,58533,6257,52276,89.3,382,154,40.3
9,All Students,2018-19,16732,1294,15438,92.3,113,25,22.1
9,All Students,2019-20,11362,840,10522,92.6,117,30,25.6
9,All Students,2020-21,16813,1197,15616,92.9,102,26,25.5
9,All Students,2021-22,17761,1703,16058,90.4,112,37,33.0
9,All Students,2022-23,15502,960,14542,93.8,114,29,25.4
10,All Students,2018-19,13990,1383,12607,90.1,88,34,38.6
10,All Students,2019-20,10498,773,9725,92.6,106,29,27.4
10,All Students,2020-21,17424,1114,16310,93.6,103,21,20.4
10,All Students,2021-22,15023,1670,13353,88.9,92,28,30.4
10,All Students,2022-23,17306,1686,15620,90.3,108,45,41.7
11,All Students,2018-19,11568,1049,10519,90.9,70,22,31.4
11,All Students,2019-20,8405,864,7541,89.7,79,36,45.6
11,All Students,2020-21,16069,1135,14934,92.9,94,25,26.6
11,All Students,2021-22,14030,2330,11700,83.4,87,45,51.7
11,All Students,2022-23,12862,1419,11443,89.0,81,29,35.8
12,All Students,2018-19,11373,2377,8996,79.1,68,42,61.8
12,All Students,2019-20,6785,637,6148,90.6,62,23,37.1
12,All Students,2020-21,13650,918,12732,93.3,78,15,19.2
12,All Students,2021-22,14559,2494,12065,82.9,87,50,57.5
12,All Students,2022-23,12863,2192,10671,83.0,79,51,64.6
All Grades,All Students,2018-19,70316,14164,56152,79.9,430,234,54.4
All Grades,All Students,2019-20,42742,7824,34918,81.7,393,158,40.2
All Grades,All Students,2020-21,58500,14609,43891,75.0,336,159,47.3
All Grades,All Students,2021-22,55331,15937,39394,71.2,340,259,76.2
All Grades,All Students,2022-23,57545,12388,45157,78.5,387,221,57.1
9,All Students,2018-19,15998,2295,13703,85.7,111,50,45.0
9,All Students,2019-20,8057,1241,6816,84.6,87,26,29.9
9,All Students,2020-21,6691,1792,4899,73.2,41,18,43.9
9,All Students,2021-22,13669,2985,10684,78.2,98,61,62.2
9,All Students,2022-23,15906,2278,13628,85.7,122,50,41.0
10,All Students,2018-19,20360,2820,17540,86.1,129,64,49.6
10,All Students,2019-20,11916,1407,10509,88.2,111,31,27.9
10,All Students,2020-21,15797,3689,12108,76.6,90,43,47.8
10,All Students,2021-22,7824,1914,5910,75.5,48,32,66.7
10,All Students,2022-23,16375,3139,13236,80.8,109,59,54.1
11,All Students,2018-19,16681,2942,13739,82.4,100,45,45.0
11,All Students,2019-20,10898,1863,9035,82.9,95,43,45.3
11,All Students,2020-21,18393,3166,15227,82.8,106,36,34.0
11,All Students,2021-22,14581,3895,10686,73.3,87,69,79.3
11,All Students,2022-23,10447,1944,8503,81.4,69,41,59.4
12,All Students,2018-19,17277,6107,11170,64.7,90,75,83.3
12,All Students,2019-20,11871,3313,8558,72.1,100,58,58.0
12,All Students,2020-21,17619,5962,11657,66.2,99,62,62.6
12,All Students,2021-22,19257,7143,12114,62.9,107,97,90.7
12,All Students,2022-23,14817,5027,9790,66.1,87,71,81.6
All Grades,All Students,2018-19,45243,11835,33408,73.8,313,204,65.2
All Grades,All Students,2019-20,26224,6378,19846,75.7,255,169,66.3
All Grades,All Students,2020-21,30844,4772,26072,84.5,196,90,45.9
All Grades,All Students,2021-22,19571,3372,16199,82.8,137,85,62.0
All Grades,All Students,2022-23,16571,3077,13494,81.4,121,64,52.9
9,All Students,2018-19,10505,3047,7458,71.0,76,48,63.2
9,All Students,2019-20,6116,1564,4552,74.4,61,41,67.2
9,All Students,2020-21,5414,1187,4227,78.1,37,22,59.5
9,All Students,2021-22,4239,966,3273,77.2,32,18,56.3
9,All Students,2022-23,3468,525,2943,84.9,26,13,50.0
10,All Students,2018-19,12103,2844,9259,76.5,86,49,57.0
10,All Students,2019-20,6670,2244,4426,66.4,66,51,77.3
10,All Students,2020-21,7846,1487,6359,81.0,49,30,61.2
10,All Students,2021-22,4465,868,3597,80.6,34,24,70.6
10,All Students,2022-23,4430,957,3473,78.4,33,14,42.4
11,All Students,2018-19,10373,2799,7574,73.0,73,54,74.0
11,All Students,2019-20,7341,1249,6092,83.0,69,35,50.7
11,All Students,2020-21,6278,671,5607,89.3,41,17,41.5
11,All Students,2021-22,4952,682,4270,86.2,35,22,62.9
11,All Students,2022-23,3701,677,3024,81.7,27,15,55.6
12,All Students,2018-19,12262,3145,9117,74.4,78,53,67.9
12,All Students,2019-20,6097,1321,4776,78.3,59,42,71.2
12,All Students,2020-21,11306,1427,9879,87.4,69,21,30.4
12,All Students,2021-22,5915,856,5059,85.5,36,21,58.3
12,All Students,2022-23,4972,918,4054,81.5,35,22,62.9
All Grades,All Students,2018-19,43667,7445,36222,83.0,296,128,43.2
All Grades,All Students,2019-20,33136,6055,27081,81.7,330,141,42.7
All Grades,All Students,2020-21,54901,8288,46613,84.9,359,157,43.7
All Grades,All Students,2021-22,52120,11598,40522,77.7,359,219,61.0
All Grades,All Students,2022-23,48785,8603,40182,82.4,346,183,52.9
9,All Students,2018-19,18971,4420,14551,76.7,127,63,49.6
9,All Students,2019-20,16094,4266,11828,73.5,160,88,55.0
9,All Students,2020-21,23079,4963,18116,78.5,146,80,54.8
9,All Students,2021-22,18690,5364,13326,71.3,130,86,66.2
9,All Students,2022-23,15811,4203,11608,73.4,119,80,67.2
10,All Students,2018-19,11069,1620,9449,85.4,79,35,44.3
10,All Students,2019-20,7628,1092,6536,85.7,78,27,34.6
10,All Students,2020-21,15416,1538,13878,90.0,101,37,36.6
10,All Students,2021-22,16993,3140,13853,81.5,106,59,55.7
10,All Students,2022-23,14169,2206,11963,84.4,99,46,46.5
11,All Students,2018-19,6687,608,6079,90.9,45,14,31.1
11,All Students,2019-20,4994,245,4749,95.1,48,7,14.6
11,All Students,2020-21,10506,1016,9490,90.3,62,19,30.6
11,All Students,2021-22,10702,1924,8778,82.0,70,39,55.7
11,All Students,2022-23,10246,1229,9017,88.0,71,34,47.9
12,All Students,2018-19,6940,797,6143,88.5,45,16,35.6
12,All Students,2019-20,4420,452,3968,89.8,44,19,43.2
12,All Students,2020-21,5900,771,5129,86.9,50,21,42.0
12,All Students,2021-22,5735,1170,4565,79.6,53,35,66.0
12,All Students,2022-23,8559,965,7594,88.7,57,23,40.4
All Grades,All Students,2018-19,69959,4957,65002,92.9,430,92,21.4
All Grades,All Students,2019-20,47529,2967,44562,93.8,442,91,20.6
All Grades,All Students,2020-21,84862,6875,77987,91.9,498,126,25.3
All Grades,All Students,2021-22,80200,8656,71544,89.2,491,182,37.1
All Grades,All Students,2022-23,74506,7118,67388,90.4,456,147,32.2
6,All Students,2018-19,8878,553,8325,93.8,53,13,24.5
6,All Students,2019-20,6228,289,5939,95.4,57,8,14.0
6,All Students,2020-21,14142,957,13185,93.2,82,20,24.4
6,All Students,2021-22,9916,1045,8871,89.5,58,20,34.5
6,All Students,2022-23,10009,1020,8989,89.8,59,19,32.2
7,All Students,2018-19,9829,720,9109,92.7,56,8,14.3
7,All Students,2019-20,4798,300,4498,93.7,44,9,20.5
7,All Students,2020-21,8957,670,8287,92.5,52,11,21.2
7,All Students,2021-22,11013,1091,9922,90.1,65,23,35.4
7,All Students,2022-23,9450,777,8673,91.8,54,13,24.1
8,All Students,2018-19,8012,454,7558,94.3,46,8,17.4
8,All Students,2019-20,5532,307,5225,94.5,51,11,21.6
8,All Students,2020-21,7165,757,6408,89.4,41,14,34.1
8,All Students,2021-22,8306,741,7565,91.1,50,17,34.0
8,All Students,2022-23,9885,840,9045,91.5,57,20,35.1
9,All Students,2018-19,12193,967,11226,92.1,77,15,19.5
9,All Students,2019-20,10320,672,9648,93.5,95,16,16.8
9,All Students,2020-21,18051,1492,16559,91.7,104,26,25.0
9,All Students,2021-22,13820,2039,11781,85.2,89,42,47.2
9,All Students,2022-23,11681,1249,10432,89.3,74,29,39.2
10,All Students,2018-19,12088,714,11374,94.1,75,10,13.3
10,All Students,2019-20,7678,503,7175,93.4,71,18,25.4
10,All Students,2020-21,16141,1275,14866,92.1,93,20,21.5
10,All Students,2021-22,13170,1498,11672,88.6,79,27,34.2
10,All Students,2022-23,9890,1248,8642,87.4,66,25,37.9
11,All Students,2018-19,10352,767,9585,92.6,64,20,31.3
11,All Students,2019-20,6447,290,6157,95.5,61,7,11.5
11,All Students,2020-21,11864,1202,10662,89.9,68,25,36.8
11,All Students,2021-22,13435,1153,12282,91.4,82,23,28.0
11,All Students,2022-23,11790,1098,10692,90.7,73,23,31.5
12,All Students,2018-19,8607,782,7825,90.9,59,18,30.5
12,All Students,2019-20,6526,606,5920,90.7,63,22,34.9
12,All Students,2020-21,8542,522,8020,93.9,58,10,17.2
12,All Students,2021-22,10540,1089,9451,89.7,68,30,44.1
12,All Students,2022-23,11801,886,10915,92.5,73,18,24.7
All Grades,All Students,2018-19,98567,8525,90042,91.4,604,218,36.1
All Grades,All Students,2019-20,61583,4943,56640,92.0,555,177,31.9
All Grades,All Students,2020-21,86178,11155,75023,87.1,518,226,43.6
All Grades,All Students,2021-22,73214,8883,64331,87.9,445,220,49.4
All Grades,All Students,2022-23,75631,7651,67980,89.9,466,183,39.3
PK in K-12 Schools,All Students,2018-19,6299,657,5642,89.6,40,19,47.5
PK in K-12 Schools,All Students,2019-20,3774,313,3461,91.7,34,11,32.4
PK in K-12 Schools,All Students,2020-21,5658,783,4875,86.2,35,17,48.6
PK in K-12 Schools,All Students,2021-22,5830,744,5086,87.2,35,18,51.4
PK in K-12 Schools,All Students,2022-23,5830,597,5233,89.8,36,13,36.1
0K,All Students,2018-19,16770,1686,15084,89.9,105,44,41.9
0K,All Students,2019-20,9394,999,8395,89.4,84,36,42.9
0K,All Students,2020-21,10127,1593,8534,84.3,65,33,50.8
0K,All Students,2021-22,11131,1750,9381,84.3,71,43,60.6
0K,All Students,2022-23,14022,1772,12250,87.4,86,44,51.2
1,All Students,2018-19,16989,1262,15727,92.6,102,27,26.5
1,All Students,2019-20,10702,955,9747,91.1,94,37,39.4
1,All Students,2020-21,13417,2206,11211,83.6,78,40,51.3
1,All Students,2021-22,7460,831,6629,88.9,47,23,48.9
1,All Students,2022-23,10640,1355,9285,87.3,66,31,47.0
2,All Students,2018-19,15134,1502,13632,90.1,94,42,44.7
2,All Students,2019-20,9693,761,8932,92.1,90,27,30.0
2,All Students,2020-21,15241,1676,13565,89.0,91,33,36.3
2,All Students,2021-22,11837,1544,10293,87.0,72,39,54.2
2,All Students,2022-23,7703,761,6942,90.1,47,18,38.3
3,All Students,2018-19,14720,1068,13652,92.7,91,24,26.4
3,All Students,2019-20,9282,686,8596,92.6,84,29,34.5
3,All Students,2020-21,13409,1325,12084,90.1,79,27,34.2
3,All Students,2021-22,12784,1407,11377,89.0,77,38,49.4
3,All Students,2022-23,10504,1123,9381,89.3,68,28,41.2
4,All Students,2018-19,14809,1177,13632,92.1,87,27,31.0
4,All Students,2019-20,9513,627,8886,93.4,86,21,24.4
4,All Students,2020-21,13707,1522,12185,88.9,81,36,44.4
4,All Students,2021-22,12038,941,11097,92.2,72,22,30.6
4,All Students,2022-23,13915,1185,12730,91.5,85,28,32.9
5,All Students,2018-19,13846,1173,12673,91.5,85,35,41.2
5,All Students,2019-20,9225,602,8623,93.5,83,16,19.3
5,All Students,2020-21,14619,2050,12569,86.0,89,40,44.9
5,All Students,2021-22,12134,1666,10468,86.3,71,37,52.1
5,All Students,2022-23,13017,858,12159,93.4,78,21,26.9
All Grades,All Students,2018-19,79975,6311,73664,92.1,483,147,30.4
All Grades,All Students,2019-20,49261,3678,45583,92.5,449,112,24.9
All Grades,All Students,2020-21,72031,6446,65585,91.1,434,135,31.1
All Grades,All Students,2021-22,65322,7784,57538,88.1,396,178,44.9
All Grades,All Students,2022-23,64179,7323,56856,88.6,398,180,45.2
PK in K-12 Schools,All Students,2018-19,5782,603,5179,89.6,35,17,48.6
PK in K-12 Schools,All Students,2019-20,3208,356,2852,88.9,32,11,34.4
PK in K-12 Schools,All Students,2020-21,4364,417,3947,90.4,28,10,35.7
PK in K-12 Schools,All Students,2021-22,3819,452,3367,88.2,28,15,53.6
PK in K-12 Schools,All Students,2022-23,5783,559,5224,90.3,38,16,42.1
0K,All Students,2018-19,11572,1287,10285,88.9,74,34,45.9
0K,All Students,2019-20,7920,839,7081,89.4,71,28,39.4
0K,All Students,2020-21,10842,1504,9338,86.1,68,27,39.7
0K,All Students,2021-22,10269,1619,8650,84.2,60,36,60.0
0K,All Students,2022-23,10379,1672,8707,83.9,67,45,67.2
1,All Students,2018-19,13348,1347,12001,89.9,83,33,39.8
1,All Students,2019-20,8426,685,7741,91.9,77,17,22.1
1,All Students,2020-21,11180,1206,9974,89.2,68,28,41.2
1,All Students,2021-22,9382,1191,8191,87.3,57,28,49.1
1,All Students,2022-23,9530,1051,8479,89.0,59,26,44.1
2,All Students,2018-19,12566,872,11694,93.1,78,22,28.2
2,All Students,2019-20,7366,631,6735,91.4,66,22,33.3
2,All Students,2020-21,12248,1107,11141,91.0,74,25,33.8
2,All Students,2021-22,7994,990,7004,87.6,51,23,45.1
2,All Students,2022-23,8377,982,7395,88.3,52,23,44.2
3,All Students,2018-19,10592,647,9945,93.9,62,13,21.0
3,All Students,2019-20,7372,365,7007,95.0,66,11,16.7
3,All Students,2020-21,10980,846,10134,92.3,64,17,26.6
3,All Students,2021-22,11905,1162,10743,90.2,69,24,34.8
3,All Students,2022-23,8289,909,7380,89.0,51,19,37.3
4,All Students,2018-19,12087,636,11451,94.7,71,13,18.3
4,All Students,2019-20,7327,452,6875,93.8,68,13,19.1
4,All Students,2020-21,11310,574,10736,94.9,67,10,14.9
4,All Students,2021-22,11191,1448,9743,87.1,68,32,47.1
4,All Students,2022-23,11514,954,10560,91.7,70,26,37.1
5,All Students,2018-19,14028,919,13109,93.4,80,15,18.8
5,All Students,2019-20,7642,350,7292,95.4,69,10,14.5
5,All Students,2020-21,11107,792,10315,92.9,65,18,27.7
5,All Students,2021-22,10762,922,9840,91.4,63,20,31.7
5,All Students,2022-23,10307,1196,9111,88.4,61,25,41.0
All Grades,All Students,2018-19,80372,6235,74137,92.2,467,121,25.9
All Grades,All Students,2019-20,48631,2838,45793,94.2,430,80,18.6
All Grades,All Students,2020-21,70056,6031,64025,91.4,408,103,25.2
All Grades,All Students,2021-22,65181,6582,58599,89.9,381,152,39.9
All Grades,All Students,2022-23,65808,6273,59535,90.5,399,138,34.6
6,All Students,2018-19,24304,1489,22815,93.9,142,31,21.8
6,All Students,2019-20,15433,828,14605,94.6,136,27,19.9
6,All Students,2020-21,22439,2250,20189,90.0,131,38,29.0
6,All Students,2021-22,22452,2318,20134,89.7,131,50,38.2
6,All Students,2022-23,24356,2058,22298,91.6,149,50,33.6
7,All Students,2018-19,27054,1756,25298,93.5,157,28,17.8
7,All Students,2019-20,15721,924,14797,94.1,140,24,17.1
7,All Students,2020-21,23705,1872,21833,92.1,137,35,25.5
7,All Students,2021-22,20582,2138,18444,89.6,121,51,42.1
7,All Students,2022-23,20260,1889,18371,90.7,123,41,33.3
8,All Students,2018-19,29014,2990,26024,89.7,168,62,36.9
8,All Students,2019-20,17477,1086,16391,93.8,154,29,18.8
8,All Students,2020-21,23912,1909,22003,92.0,140,30,21.4
8,All Students,2021-22,22147,2126,20021,90.4,129,51,39.5
8,All Students,2022-23,21192,2326,18866,89.0,127,47,37.0
All Grades,All Students,2018-19,87817,8558,79259,90.3,541,212,39.2
All Grades,All Students,2019-20,59767,5458,54309,90.9,547,202,36.9
All Grades,All Students,2020-21,87698,12467,75231,85.8,531,265,49.9
All Grades,All Students,2021-22,82407,10902,71505,86.8,514,275,53.5
All Grades,All Students,2022-23,73122,7837,65285,89.3,454,199,43.8
PK in K-12 Schools,All Students,2018-19,6294,796,5498,87.4,41,19,46.3
PK in K-12 Schools,All Students,2019-20,5769,701,5068,87.8,54,33,61.1
PK in K-12 Schools,All Students,2020-21,9191,2041,7150,77.8,62,45,72.6
PK in K-12 Schools,All Students,2021-22,11262,1941,9321,82.8,73,51,69.9
PK in K-12 Schools,All Students,2022-23,11163,1392,9771,87.5,70,34,48.6
0K,All Students,2018-19,14374,1661,12713,88.4,91,45,49.5
0K,All Students,2019-20,9589,1129,8460,88.2,87,47,54.0
0K,All Students,2020-21,12755,1767,10988,86.1,79,43,54.4
0K,All Students,2021-22,11885,1597,10288,86.6,76,43,56.6
0K,All Students,2022-23,9787,1274,8513,87.0,62,34,54.8
1,All Students,2018-19,8984,949,8035,89.4,53,24,45.3
1,All Students,2019-20,9530,992,8538,89.6,84,31,36.9
1,All Students,2020-21,14257,2450,11807,82.8,86,51,59.3
1,All Students,2021-22,11979,1782,10197,85.1,75,48,64.0
1,All Students,2022-23,11313,1106,10207,90.2,70,31,44.3
2,All Students,2018-19,14104,1479,12625,89.5,87,38,43.7
2,All Students,2019-20,5927,474,5453,92.0,57,16,28.1
2,All Students,2020-21,14034,1895,12139,86.5,82,38,46.3
2,All Students,2021-22,13085,1814,11271,86.1,80,43,53.8
2,All Students,2022-23,10890,1196,9694,89.0,68,35,51.5
3,All Students,2018-19,14618,1330,13288,90.9,92,34,37.0
3,All Students,2019-20,10115,708,9407,93.0,93,24,25.8
3,All Students,2020-21,8619,786,7833,90.9,53,19,35.8
3,All Students,2021-22,13427,1518,11909,88.7,82,37,45.1
3,All Students,2022-23,10890,1132,9758,89.6,69,27,39.1
4,All Students,2018-19,14793,1301,13492,91.2,88,28,31.8
4,All Students,2019-20,9921,760,9161,92.3,92,26,28.3
4,All Students,2020-21,14675,1417,13258,90.3,86,32,37.2
4,All Students,2021-22,7077,902,6175,87.3,46,24,52.2
4,All Students,2022-23,11607,1024,10583,91.2,69,24,34.8
5,All Students,2018-19,14650,1042,13608,92.9,89,24,27.0
5,All Students,2019-20,8916,694,8222,92.2,80,25,31.3
5,All Students,2020-21,14167,2111,12056,85.1,83,37,44.6
5,All Students,2021-22,13692,1348,12344,90.2,82,29,35.4
5,All Students,2022-23,7472,713,6759,90.5,46,14,30.4
All Grades,All Students,2018-19,128454,10344,118110,91.9,774,199,25.7
All Grades,All Students,2019-20,81501,6064,75437,92.6,751,174,23.2
All Grades,All Students,2020-21,131382,13512,117870,89.7,750,187,24.9
All Grades,All Students,2021-22,123528,15892,107636,87.1,745,307,41.2
All Grades,All Students,2022-23,121603,14227,107376,88.3,750,276,36.8
6,All Students,2018-19,16560,648,15912,96.1,95,8,8.4
6,All Students,2019-20,10478,352,10126,96.6,92,7,7.6
6,All Students,2020-21,16300,578,15722,96.5,94,9,9.6
6,All Students,2021-22,14582,1455,13127,90.0,85,28,32.9
6,All Students,2022-23,16161,1499,14662,90.7,97,34,35.1
7,All Students,2018-19,15487,562,14925,96.4,91,7,7.7
7,All Students,2019-20,10569,446,10123,95.8,94,10,10.6
7,All Students,2020-21,15533,855,14678,94.5,90,16,17.8
7,All Students,2021-22,15154,1280,13874,91.6,90,30,33.3
7,All Students,2022-23,14211,1240,12971,91.3,83,22,26.5
8,All Students,2018-19,16153,915,15238,94.3,94,16,17.0
8,All Students,2019-20,10032,461,9571,95.4,89,9,10.1
8,All Students,2020-21,15928,805,15123,94.9,91,17,18.7
8,All Students,2021-22,14761,1165,13596,92.1,87,24,27.6
8,All Students,2022-23,15255,1202,14053,92.1,91,23,25.3
9,All Students,2018-19,20713,1839,18874,91.1,130,34,26.2
9,All Students,2019-20,14411,1276,13135,91.1,138,35,25.4
9,All Students,2020-21,23771,4276,19495,82.0,132,51,38.6
9,All Students,2021-22,21799,3751,18048,82.8,135,67,49.6
9,All Students,2022-23,19767,3133,16634,84.2,124,50,40.3
10,All Students,2018-19,21399,2273,19126,89.4,133,43,32.3
10,All Students,2019-20,13693,1525,12168,88.9,133,45,33.8
10,All Students,2020-21,23736,3195,20541,86.5,134,34,25.4
10,All Students,2021-22,21363,3286,18077,84.6,133,54,40.6
10,All Students,2022-23,22699,3216,19483,85.8,143,64,44.8
11,All Students,2018-19,18644,1287,17357,93.1,115,28,24.3
11,All Students,2019-20,10346,832,9514,92.0,96,26,27.1
11,All Students,2020-21,18630,2004,16626,89.2,108,29,26.9
11,All Students,2021-22,18636,2260,16376,87.9,113,47,41.6
11,All Students,2022-23,16295,1766,14529,89.2,104,34,32.7
12,All Students,2018-19,19498,2820,16678,85.5,116,63,54.3
12,All Students,2019-20,11972,1172,10800,90.2,109,42,38.5
12,All Students,2020-21,17484,1799,15685,89.7,101,31,30.7
12,All Students,2021-22,17233,2695,14538,84.4,102,57,55.9
12,All Students,2022-23,17215,2171,15044,87.4,108,49,45.4
All Grades,All Students,2018-19,65610,15290,50320,76.7,425,259,60.9
All Grades,All Students,2019-20,36186,8080,28106,77.7,339,194,57.2
All Grades,All Students,2020-21,51996,10097,41899,80.6,308,156,50.6
All Grades,All Students,2021-22,42802,8940,33862,79.1,268,164,61.2
All Grades,All Students,2022-23,36430,6927,29503,81.0,238,141,59.2
9,All Students,2018-19,15299,3310,11989,78.4,103,63,61.2
9,All Students,2019-20,8840,1676,7164,81.0,84,41,48.8
9,All Students,2020-21,12955,1299,11656,90.0,78,26,33.3
9,All Students,2021-22,9220,1311,7909,85.8,62,29,46.8
9,All Students,2022-23,5835,910,4925,84.4,46,32,69.6
10,All Students,2018-19,18472,4735,13737,74.4,118,80,67.8
10,All Students,2019-20,8493,2275,6218,73.2,80,53,66.3
10,All Students,2020-21,13049,2473,10576,81.0,75,43,57.3
10,All Students,2021-22,11990,2235,9755,81.4,74,44,59.5
10,All Students,2022-23,9683,1502,8181,84.5,62,31,50.0
11,All Students,2018-19,16116,3819,12297,76.3,103,57,55.3
11,All Students,2019-20,9036,2237,6799,75.2,84,57,67.9
11,All Students,2020-21,12611,3287,9324,73.9,78,45,57.7
11,All Students,2021-22,12214,2761,9453,77.4,76,48,63.2
11,All Students,2022-23,9859,1980,7879,79.9,63,41,65.1
12,All Students,2018-19,15723,3426,12297,78.2,101,59,58.4
12,All Students,2019-20,9817,1892,7925,80.7,91,43,47.3
12,All Students,2020-21,13381,3038,10343,77.3,77,42,54.5
12,All Students,2021-22,9378,2633,6745,71.9,56,43,76.8
12,All Students,2022-23,11053,2535,8518,77.1,67,37,55.2
All Grades,All Students,2018-19,89631,18522,71109,79.3,604,369,61.1
All Grades,All Students,2019-20,50137,8788,41349,82.5,500,296,59.2
All Grades,All Students,2020-21,68845,6781,62064,90.2,411,90,21.9
All Grades,All Students,2021-22,58373,8702,49671,85.1,363,187,51.5
All Grades,All Students,2022-23,53629,9106,44523,83.0,360,192,53.3
9,All Students,2018-19,22568,4391,18177,80.5,157,85,54.1
9,All Students,2019-20,13305,2282,11023,82.8,137,84,61.3
9,All Students,2020-21,13652,1393,12259,89.8,84,17,20.2
9,All Students,2021-22,13295,2029,11266,84.7,87,48,55.2
9,All Students,2022-23,12538,1540,10998,87.7,89,31,34.8
10,All Students,2018-19,25144,5171,19973,79.4,172,108,62.8
10,All Students,2019-20,13148,2352,10796,82.1,131,74,56.5
10,All Students,2020-21,20576,1129,19447,94.5,121,19,15.7
10,All Students,2021-22,12723,2446,10277,80.8,80,47,58.8
10,All Students,2022-23,13790,2765,11025,79.9,89,55,61.8
11,All Students,2018-19,22581,5619,16962,75.1,144,101,70.1
11,All Students,2019-20,13218,2156,11062,83.7,129,72,55.8
11,All Students,2020-21,15882,297,15585,98.1,96,4,4.2
11,All Students,2021-22,17575,2806,14769,84.0,108,61,56.5
11,All Students,2022-23,12037,1857,10180,84.6,86,46,53.5
12,All Students,2018-19,19338,3341,15997,82.7,131,75,57.3
12,All Students,2019-20,10466,1998,8468,80.9,103,66,64.1
12,All Students,2020-21,18730,3958,14772,78.9,110,50,45.5
12,All Students,2021-22,14780,1421,13359,90.4,88,31,35.2
12,All Students,2022-23,15264,2944,12320,80.7,96,60,62.5
All Grades,All Students,2018-19,37625,8770,28855,76.7,267,160,59.9
All Grades,All Students,2019-20,25277,5676,19601,77.5,244,141,57.8
All Grades,All Students,2020-21,36079,5091,30988,85.9,210,71,33.8
All Grades,All Students,2021-22,27800,3444,24356,87.6,182,72,39.6
All Grades,All Students,2022-23,20452,2370,18082,88.4,141,42,29.8
9,All Students,2018-19,11758,2874,8884,75.6,84,40,47.6
9,All Students,2019-20,8226,2530,5696,69.2,83,50,60.2
9,All Students,2020-21,8639,1493,7146,82.7,50,20,40.0
9,All Students,2021-22,7934,1353,6581,82.9,54,27,50.0
9,All Students,2022-23,5609,842,4767,85.0,41,15,36.6
10,All Students,2018-19,11480,2805,8675,75.6,89,60,67.4
10,All Students,2019-20,7706,1778,5928,76.9,75,46,61.3
10,All Students,2020-21,10377,2058,8319,80.2,62,30,48.4
10,All Students,2021-22,7421,979,6442,86.8,49,21,42.9
10,All Students,2022-23,5491,705,4786,87.2,39,12,30.8
11,All Students,2018-19,6336,1185,5151,81.3,42,21,50.0
11,All Students,2019-20,4740,618,4122,87.0,44,21,47.7
11,All Students,2020-21,7706,496,7210,93.6,44,5,11.4
11,All Students,2021-22,4826,481,4345,90.0,30,8,26.7
11,All Students,2022-23,4161,573,3588,86.2,27,8,29.6
12,All Students,2018-19,8051,1906,6145,76.3,52,39,75.0
12,All Students,2019-20,4605,750,3855,83.7,42,24,57.1
12,All Students,2020-21,9357,1044,8313,88.8,54,16,29.6
12,All Students,2021-22,7619,631,6988,91.7,49,16,32.7
12,All Students,2022-23,5191,250,4941,95.2,34,7,20.6
All Grades,All Students,2018-19,75546,4257,71289,94.4,435,75,17.2
All Grades,All Students,2019-20,49206,2589,46617,94.7,436,65,14.9
All Grades,All Students,2020-21,73475,5693,67782,92.3,433,106,24.5
All Grades,All Students,2021-22,73055,7274,65781,90.0,429,176,41.0
All Grades,All Students,2022-23,73618,6439,67179,91.3,434,134,30.9
PK in K-12 Schools,All Students,2018-19,9235,663,8572,92.8,55,16,29.1
PK in K-12 Schools,All Students,2019-20,5991,385,5606,93.6,54,11,20.4
PK in K-12 Schools,All Students,2020-21,9369,983,8386,89.5,56,17,30.4
PK in K-12 Schools,All Students,2021-22,9163,1100,8063,88.0,55,31,56.4
PK in K-12 Schools,All Students,2022-23,9424,988,8436,89.5,56,21,37.5
0K,All Students,2018-19,9639,581,9058,94.0,55,12,21.8
0K,All Students,2019-20,6143,389,5754,93.7,54,11,20.4
0K,All Students,2020-21,8675,631,8044,92.7,52,12,23.1
0K,All Students,2021-22,8873,1038,7835,88.3,53,30,56.6
0K,All Students,2022-23,8813,931,7882,89.4,51,19,37.3
1,All Students,2018-19,11141,659,10482,94.1,64,10,15.6
1,All Students,2019-20,7587,462,7125,93.9,67,12,17.9
1,All Students,2020-21,10198,883,9315,91.3,61,17,27.9
1,All Students,2021-22,9755,1008,8747,89.7,58,23,39.7
1,All Students,2022-23,11090,961,10129,91.3,66,23,34.8
2,All Students,2018-19,10865,514,10351,95.3,62,10,16.1
2,All Students,2019-20,7347,371,6976,95.0,65,9,13.8
2,All Students,2020-21,11508,1065,10443,90.7,67,18,26.9
2,All Students,2021-22,11477,1153,10324,90.0,66,23,34.8
2,All Students,2022-23,10112,910,9202,91.0,59,16,27.1
3,All Students,2018-19,12135,668,11467,94.5,69,10,14.5
3,All Students,2019-20,7314,288,7026,96.1,64,8,12.5
3,All Students,2020-21,11525,494,11031,95.7,67,8,11.9
3,All Students,2021-22,11596,868,10728,92.5,68,19,27.9
3,All Students,2022-23,11891,927,10964,92.2,73,17,23.3
4,All Students,2018-19,11657,637,11020,94.5,68,9,13.2
4,All Students,2019-20,7507,375,7132,95.0,66,9,13.6
4,All Students,2020-21,10956,766,10190,93.0,66,17,25.8
4,All Students,2021-22,10744,1042,9702,90.3,64,27,42.2
4,All Students,2022-23,11810,896,10914,92.4,68,19,27.9
5,All Students,2018-19,10874,535,10339,95.1,62,8,12.9
5,All Students,2019-20,7317,319,6998,95.6,66,5,7.6
5,All Students,2020-21,11244,871,10373,92.3,64,17,26.6
5,All Students,2021-22,11447,1065,10382,90.7,65,23,35.4
5,All Students,2022-23,10478,826,9652,92.1,61,19,31.1
All Grades,All Students,2018-19,58808,8539,50269,85.5,381,145,38.1
All Grades,All Students,2019-20,40276,4776,35500,88.1,377,134,35.5
All Grades,All Students,2020-21,57697,12259,45438,78.8,356,198,55.6
All Grades,All Students,2021-22,58287,11147,47140,80.9,385,214,55.6
All Grades,All Students,2022-23,57914,9232,48682,84.1,392,175,44.6
9,All Students,2018-19,18743,2033,16710,89.2,127,41,32.3
9,All Students,2019-20,10885,1228,9657,88.7,106,39,36.8
9,All Students,2020-21,11176,2575,8601,77.0,80,46,57.5
9,All Students,2021-22,15345,1841,13504,88.0,123,43,35.0
9,All Students,2022-23,15324,1884,13440,87.7,125,46,36.8
10,All Students,2018-19,11511,1008,10503,91.2,75,25,33.3
10,All Students,2019-20,11795,961,10834,91.9,108,25,23.1
10,All Students,2020-21,14586,2913,11673,80.0,89,55,61.8
10,All Students,2021-22,10970,1708,9262,84.4,72,42,58.3
10,All Students,2022-23,17917,2342,15575,86.9,115,37,32.2
11,All Students,2018-19,14213,1895,12318,86.7,87,29,33.3
11,All Students,2019-20,8592,988,7604,88.5,79,27,34.2
11,All Students,2020-21,19677,3896,15781,80.2,116,54,46.6
11,All Students,2021-22,14960,2983,11977,80.1,90,54,60.0
11,All Students,2022-23,11748,2173,9575,81.5,74,38,51.4
12,All Students,2018-19,14341,3603,10738,74.9,92,50,54.3
12,All Students,2019-20,9004,1599,7405,82.2,84,43,51.2
12,All Students,2020-21,12258,2875,9383,76.5,71,43,60.6
12,All Students,2021-22,17012,4615,12397,72.9,100,75,75.0
12,All Students,2022-23,12925,2833,10092,78.1,78,54,69.2
All Grades,All Students,2018-19,91733,7732,84001,91.6,542,154,28.4
All Grades,All Students,2019-20,59390,4656,54734,92.2,542,117,21.6
All Grades,All Students,2020-21,96372,18426,77946,80.9,561,344,61.3
All Grades,All Students,2021-22,92457,10691,81766,88.4,547,234,42.8
All Grades,All Students,2022-23,89113,9621,79492,89.2,536,204,38.1
6,All Students,2018-19,14873,961,13912,93.5,86,18,20.9
6,All Students,2019-20,9641,740,8901,92.3,87,17,19.5
6,All Students,2020-21,17695,4678,13017,73.6,105,84,80.0
6,All Students,2021-22,12402,1148,11254,90.7,72,28,38.9
6,All Students,2022-23,13230,1409,11821,89.3,77,28,36.4
7,All Students,2018-19,15921,934,14987,94.1,90,16,17.8
7,All Students,2019-20,8620,584,8036,93.2,77,17,22.1
7,All Students,2020-21,14107,2637,11470,81.3,81,54,66.7
7,All Students,2021-22,13757,1431,12326,89.6,80,29,36.3
7,All Students,2022-23,12005,1150,10855,90.4,72,27,37.5
8,All Students,2018-19,13417,913,12504,93.2,76,14,18.4
8,All Students,2019-20,9529,537,8992,94.4,85,11,12.9
8,All Students,2020-21,12876,1911,10965,85.2,74,35,47.3
8,All Students,2021-22,13603,1046,12557,92.3,78,24,30.8
8,All Students,2022-23,11366,935,10431,91.8,66,19,28.8
9,All Students,2018-19,15254,1644,13610,89.2,95,36,37.9
9,All Students,2019-20,9330,827,8503,91.1,84,18,21.4
9,All Students,2020-21,14411,2716,11695,81.2,85,49,57.6
9,All Students,2021-22,15241,1567,13674,89.7,95,36,37.9
9,All Students,2022-23,14711,1570,13141,89.3,91,35,38.5
10,All Students,2018-19,11206,1295,9911,88.4,68,19,27.9
10,All Students,2019-20,8556,829,7727,90.3,83,23,27.7
10,All Students,2020-21,15661,2911,12750,81.4,90,50,55.6
10,All Students,2021-22,12971,1740,11231,86.6,78,36,46.2
10,All Students,2022-23,13887,1601,12286,88.5,84,31,36.9
11,All Students,2018-19,10799,738,10061,93.2,65,18,27.7
11,All Students,2019-20,6624,582,6042,91.2,61,15,24.6
11,All Students,2020-21,11704,2084,9620,82.2,69,41,59.4
11,All Students,2021-22,13995,1896,12099,86.5,82,41,50.0
11,All Students,2022-23,11606,1189,10417,89.8,72,25,34.7
12,All Students,2018-19,10263,1247,9016,87.8,62,33,53.2
12,All Students,2019-20,7090,557,6533,92.1,65,16,24.6
12,All Students,2020-21,9918,1489,8429,85.0,57,31,54.4
12,All Students,2021-22,10488,1863,8625,82.2,62,40,64.5
12,All Students,2022-23,12308,1767,10541,85.6,74,39,52.7
All Grades,All Students,2022-23,18927,3896,15031,79.4,131,101,77.1
PK in K-12 Schools,All Students,2022-23,18927,3896,15031,79.4,131,101,77.1
All Grades,All Students,2018-19,8613,467,8146,94.6,55,10,18.2
All Grades,All Students,2019-20,10977,608,10369,94.5,107,18,16.8
All Grades,All Students,2020-21,24020,757,23263,96.8,146,8,5.5
All Grades,All Students,2021-22,25893,1522,24371,94.1,165,33,20.0
All Grades,All Students,2022-23,29374,1510,27864,94.9,186,27,14.5
6,All Students,2018-19,8613,467,8146,94.6,55,10,18.2
6,All Students,2019-20,4218,174,4044,95.9,42,3,7.1
6,All Students,2020-21,5094,158,4936,96.9,32,3,9.4
6,All Students,2021-22,9294,618,8676,93.4,57,17,29.8
6,All Students,2022-23,8399,483,7916,94.2,55,10,18.2
7,All Students,2019-20,6759,434,6325,93.6,65,15,23.1
7,All Students,2020-21,8007,221,7786,97.2,51,2,3.9
7,All Students,2021-22,7720,411,7309,94.7,50,7,14.0
7,All Students,2022-23,9859,497,9362,95.0,61,10,16.4
8,All Students,2020-21,10919,378,10541,96.5,63,3,4.8
8,All Students,2021-22,8879,493,8386,94.4,58,9,15.5
8,All Students,2022-23,11116,530,10586,95.2,70,7,10.0
All Grades,All Students,2018-19,36803,3631,33172,90.1,235,77,32.8
All Grades,All Students,2019-20,28902,2770,26132,90.4,266,91,34.2
All Grades,All Students,2020-21,41891,3985,37906,90.5,247,57,23.1
All Grades,All Students,2021-22,34665,2827,31838,91.8,215,68,31.6
All Grades,All Students,2022-23,33626,3196,30430,90.5,215,86,40.0
6,All Students,2018-19,14130,1463,12667,89.6,87,25,28.7
6,All Students,2019-20,9584,895,8689,90.7,86,28,32.6
6,All Students,2020-21,12171,s,s,s,s,s,s
6,All Students,2021-22,7830,605,7225,92.3,48,15,31.3
6,All Students,2022-23,11217,994,10223,91.1,71,26,36.6
7,All Students,2018-19,13423,1293,12130,90.4,82,31,37.8
7,All Students,2019-20,10135,944,9191,90.7,95,30,31.6
7,All Students,2020-21,14200,1538,12662,89.2,84,20,23.8
7,All Students,2021-22,12172,989,11183,91.9,74,26,35.1
7,All Students,2022-23,9602,1016,8586,89.4,64,29,45.3
8,All Students,2018-19,9250,875,8375,90.5,66,21,31.8
8,All Students,2019-20,9183,931,8252,89.9,85,33,38.8
8,All Students,2020-21,15342,1595,13747,89.6,89,25,28.1
8,All Students,2021-22,14663,1233,13430,91.6,93,27,29.0
8,All Students,2022-23,12807,1186,11621,90.7,80,31,38.8
9,All Students,2020-21,178,s,s,s,s,s,s
All Grades,All Students,2018-19,56663,4634,52029,91.8,332,103,31.0
All Grades,All Students,2019-20,37818,3095,34723,91.8,343,101,29.4
All Grades,All Students,2020-21,58418,3855,54563,93.4,345,79,22.9
All Grades,All Students,2021-22,55413,6333,49080,88.6,329,156,47.4
All Grades,All Students,2022-23,55247,5671,49576,89.7,330,131,39.7
PK in K-12 Schools,All Students,2018-19,4451,427,4024,90.4,27,10,37.0
PK in K-12 Schools,All Students,2019-20,4016,642,3374,84.0,42,27,64.3
PK in K-12 Schools,All Students,2020-21,5102,503,4599,90.1,34,14,41.2
2,All Students,2018-19,15097,518,14579,96.6,93,5,5.4
PK in K-12 Schools,All Students,2021-22,7101,984,6117,86.1,49,33,67.3
PK in K-12 Schools,All Students,2022-23,7761,1028,6733,86.8,49,29,59.2
0K,All Students,2018-19,6684,768,5916,88.5,40,20,50.0
0K,All Students,2019-20,4463,311,4152,93.0,39,8,20.5
0K,All Students,2020-21,6614,656,5958,90.1,40,10,25.0
0K,All Students,2021-22,4889,606,4283,87.6,28,16,57.1
0K,All Students,2022-23,4463,557,3906,87.5,28,12,42.9
1,All Students,2018-19,5063,371,4692,92.7,30,9,30.0
1,All Students,2019-20,3680,359,3321,90.2,32,14,43.8
1,All Students,2020-21,6299,387,5912,93.9,37,9,24.3
1,All Students,2021-22,5551,639,4912,88.5,32,14,43.8
1,All Students,2022-23,4608,549,4059,88.1,26,12,46.2
2,All Students,2018-19,5665,463,5202,91.8,33,10,30.3
2,All Students,2019-20,3566,256,3310,92.8,32,7,21.9
2,All Students,2020-21,5568,383,5185,93.1,32,9,28.1
2,All Students,2021-22,5707,557,5150,90.2,32,9,28.1
2,All Students,2022-23,4365,369,3996,91.5,27,8,29.6
3,All Students,2018-19,4926,449,4477,90.9,29,10,34.5
3,All Students,2019-20,3228,253,2975,92.2,30,9,30.0
3,All Students,2020-21,4996,237,4759,95.3,30,5,16.7
3,All Students,2021-22,5300,578,4722,89.1,32,17,53.1
3,All Students,2022-23,4998,380,4618,92.4,30,9,30.0
4,All Students,2018-19,5518,344,5174,93.8,31,7,22.6
4,All Students,2019-20,3330,256,3074,92.3,29,9,31.0
4,All Students,2020-21,4621,175,4446,96.2,27,1,3.7
4,All Students,2021-22,4613,449,4164,90.3,26,10,38.5
4,All Students,2022-23,5445,510,4935,90.6,31,14,45.2
5,All Students,2018-19,6368,453,5915,92.9,37,9,24.3
5,All Students,2019-20,3381,187,3194,94.5,31,4,12.9
5,All Students,2020-21,5220,265,4955,94.9,30,6,20.0
5,All Students,2021-22,4243,s,s,s,s,s,s
5,All Students,2022-23,4428,376,4052,91.5,26,9,34.6
6,All Students,2018-19,7498,580,6918,92.3,43,12,27.9
6,All Students,2019-20,4334,327,4007,92.5,40,11,27.5
6,All Students,2020-21,6806,467,6339,93.1,39,10,25.6
6,All Students,2021-22,6474,828,5646,87.2,38,18,47.4
6,All Students,2022-23,7587,614,6973,91.9,45,13,28.9
7,All Students,2018-19,5103,366,4737,92.8,30,7,23.3
7,All Students,2019-20,4600,286,4314,93.8,40,6,15.0
7,All Students,2020-21,6093,367,5726,94.0,35,7,20.0
7,All Students,2021-22,6146,820,5326,86.7,37,20,54.1
7,All Students,2022-23,5917,604,5313,89.8,34,13,38.2
8,All Students,2018-19,5387,413,4974,92.3,32,9,28.1
8,All Students,2019-20,3220,218,3002,93.2,28,6,21.4
8,All Students,2020-21,7099,415,6684,94.2,41,8,19.5
8,All Students,2021-22,5382,481,4901,91.1,31,9,29.0
8,All Students,2022-23,5675,684,4991,87.9,34,12,35.3
9,All Students,2021-22,7,s,s,s,s,s,s
All Grades,All Students,2018-19,123029,5192,117837,95.8,729,75,10.3
All Grades,All Students,2019-20,69483,2962,66521,95.7,628,68,10.8
All Grades,All Students,2020-21,85377,6011,79366,93.0,510,127,24.9
All Grades,All Students,2021-22,74710,5528,69182,92.6,442,120,27.1
All Grades,All Students,2022-23,70937,4710,66227,93.4,423,98,23.2
0K,All Students,2018-19,14127,747,13380,94.7,84,13,15.5
0K,All Students,2019-20,7115,448,6667,93.7,67,13,19.4
0K,All Students,2020-21,10398,1175,9223,88.7,64,28,43.8
0K,All Students,2021-22,10751,1062,9689,90.1,65,26,40.0
0K,All Students,2022-23,11058,1025,10033,90.7,66,26,39.4
1,All Students,2018-19,14753,629,14124,95.7,90,11,12.2
1,All Students,2019-20,9562,435,9127,95.5,87,10,11.5
1,All Students,2020-21,12849,1133,11716,91.2,78,24,30.8
1,All Students,2021-22,10876,929,9947,91.5,64,22,34.4
1,All Students,2022-23,11572,858,10714,92.6,72,19,26.4
2,All Students,2019-20,9798,428,9370,95.6,88,9,10.2
2,All Students,2020-21,15056,1160,13896,92.3,89,22,24.7
2,All Students,2021-22,11304,910,10394,91.9,67,23,34.3
2,All Students,2022-23,9812,687,9125,93.0,58,15,25.9
3,All Students,2018-19,18190,641,17549,96.5,109,9,8.3
3,All Students,2019-20,9938,372,9566,96.3,92,11,12.0
3,All Students,2020-21,14966,897,14069,94.0,88,20,22.7
3,All Students,2021-22,13534,915,12619,93.2,80,16,20.0
3,All Students,2022-23,12098,646,11452,94.7,71,15,21.1
4,All Students,2018-19,33723,1513,32210,95.5,196,21,10.7
4,All Students,2019-20,12033,447,11586,96.3,108,12,11.1
4,All Students,2020-21,15127,652,14475,95.7,90,14,15.6
4,All Students,2021-22,13904,791,13113,94.3,84,18,21.4
4,All Students,2022-23,13088,710,12378,94.6,77,11,14.3
5,All Students,2018-19,27139,1144,25995,95.8,157,16,10.2
5,All Students,2019-20,21037,832,20205,96.0,186,13,7.0
5,All Students,2020-21,16981,994,15987,94.1,101,19,18.8
5,All Students,2021-22,14341,921,13420,93.6,82,15,18.3
5,All Students,2022-23,13309,784,12525,94.1,79,12,15.2
All Grades,All Students,2018-19,166746,14232,152514,91.5,1004,341,34.0
All Grades,All Students,2019-20,102938,8469,94469,91.8,947,291,30.7
All Grades,All Students,2020-21,146284,18572,127712,87.3,868,330,38.0
All Grades,All Students,2021-22,127569,16606,110963,87.0,787,405,51.5
All Grades,All Students,2022-23,120923,13091,107832,89.2,727,304,41.8
PK in K-12 Schools,All Students,2019-20,1987,245,1742,87.7,18,9,50.0
PK in K-12 Schools,All Students,2020-21,2822,s,s,s,s,s,s
PK in K-12 Schools,All Students,2021-22,2954,s,s,s,s,s,s
PK in K-12 Schools,All Students,2022-23,5738,s,s,s,s,s,s
0K,All Students,2018-19,25020,2626,22394,89.5,153,61,39.9
0K,All Students,2019-20,16827,1715,15112,89.8,157,75,47.8
0K,All Students,2020-21,22152,3661,18491,83.5,134,63,47.0
0K,All Students,2021-22,18494,2878,15616,84.4,119,75,63.0
0K,All Students,2022-23,13485,1806,11679,86.6,81,41,50.6
1,All Students,2018-19,25910,2423,23487,90.6,157,57,36.3
1,All Students,2019-20,16103,1450,14653,91.0,147,52,35.4
1,All Students,2020-21,24556,3273,21283,86.7,143,59,41.3
1,All Students,2021-22,21433,3292,18141,84.6,130,70,53.8
1,All Students,2022-23,18419,2213,16206,88.0,109,50,45.9
2,All Students,2018-19,26614,2116,24498,92.0,159,48,30.2
2,All Students,2019-20,16589,1270,15319,92.3,155,43,27.7
2,All Students,2020-21,22281,3394,18887,84.8,131,56,42.7
2,All Students,2021-22,22127,2783,19344,87.4,135,76,56.3
2,All Students,2022-23,20588,2399,18189,88.3,122,61,50.0
3,All Students,2018-19,24476,s,s,s,s,s,s
3,All Students,2019-20,16605,1152,15453,93.1,153,31,20.3
3,All Students,2020-21,24675,2515,22160,89.8,149,47,31.5
3,All Students,2021-22,19101,2349,16752,87.7,118,55,46.6
3,All Students,2022-23,21584,2118,19466,90.2,130,49,37.7
4,All Students,2018-19,29814,2204,27610,92.6,178,55,30.9
4,All Students,2019-20,16463,1316,15147,92.0,149,41,27.5
4,All Students,2020-21,25718,3189,22529,87.6,151,55,36.4
4,All Students,2021-22,22320,2428,19892,89.1,136,57,41.9
4,All Students,2022-23,18600,1750,16850,90.6,113,40,35.4
5,All Students,2018-19,34904,2736,32168,92.2,207,64,30.9
5,All Students,2019-20,18364,1321,17043,92.8,168,40,23.8
5,All Students,2020-21,23966,2102,21864,91.2,142,42,29.6
5,All Students,2021-22,21139,2502,18637,88.2,130,63,48.5
5,All Students,2022-23,22342,1839,20503,91.8,134,36,26.9
6,All Students,2018-19,8,s,s,s,s,s,s
6,All Students,2020-21,114,s,s,s,s,s,s
6,All Students,2021-22,1,s,s,s,s,s,s
6,All Students,2022-23,167,s,s,s,s,s,s
All Grades,All Students,2018-19,147411,14397,133014,90.2,889,357,40.2
All Grades,All Students,2019-20,93192,8561,84631,90.8,866,297,34.3
All Grades,All Students,2020-21,131655,13716,117939,89.6,795,330,41.5
All Grades,All Students,2021-22,116999,16622,100377,85.8,719,418,58.1
All Grades,All Students,2022-23,103821,11754,92067,88.7,646,280,43.3
PK in K-12 Schools,All Students,2018-19,12160,s,s,s,s,s,s
PK in K-12 Schools,All Students,2019-20,8177,995,7182,87.8,76,33,43.4
PK in K-12 Schools,All Students,2020-21,7111,568,6543,92.0,48,14,29.2
PK in K-12 Schools,All Students,2021-22,9303,1527,7776,83.6,63,41,65.1
PK in K-12 Schools,All Students,2022-23,8846,s,s,s,s,s,s
0K,All Students,2018-19,17547,2332,15215,86.7,111,63,56.8
0K,All Students,2019-20,10692,1263,9429,88.2,100,45,45.0
0K,All Students,2020-21,16134,1570,14564,90.3,95,36,37.9
0K,All Students,2021-22,12012,2308,9704,80.8,77,59,76.6
0K,All Students,2022-23,12340,1866,10474,84.9,78,47,60.3
1,All Students,2018-19,21018,2309,18709,89.0,131,63,48.1
1,All Students,2019-20,11189,1310,9879,88.3,107,50,46.7
1,All Students,2020-21,15831,1843,13988,88.4,93,43,46.2
1,All Students,2021-22,16534,2383,14151,85.6,102,60,58.8
1,All Students,2022-23,11491,1557,9934,86.5,73,36,49.3
2,All Students,2018-19,21383,1844,19539,91.4,125,41,32.8
2,All Students,2019-20,13028,1058,11970,91.9,122,40,32.8
2,All Students,2020-21,16075,1889,14186,88.2,102,49,48.0
2,All Students,2021-22,14640,2280,12360,84.4,89,54,60.7
2,All Students,2022-23,16305,1568,14737,90.4,100,38,38.0
3,All Students,2018-19,25434,2134,23300,91.6,148,52,35.1
3,All Students,2019-20,18203,1474,16729,91.9,166,46,27.7
3,All Students,2020-21,25774,2541,23233,90.1,155,59,38.1
3,All Students,2021-22,18962,2581,16381,86.4,113,64,56.6
3,All Students,2022-23,17826,2009,15817,88.7,109,45,41.3
4,All Students,2018-19,25566,2387,23179,90.7,152,53,34.9
4,All Students,2019-20,16339,1240,15099,92.4,151,44,29.1
4,All Students,2020-21,26519,2608,23911,90.2,158,67,42.4
4,All Students,2021-22,22096,2563,19533,88.4,136,65,47.8
4,All Students,2022-23,17124,1839,15285,89.3,104,39,37.5
5,All Students,2018-19,24301,1886,22415,92.2,143,41,28.7
5,All Students,2019-20,15564,1221,14343,92.2,144,39,27.1
5,All Students,2020-21,24211,2697,21514,88.9,144,62,43.1
5,All Students,2021-22,23452,2980,20472,87.3,139,75,54.0
5,All Students,2022-23,19876,1714,18162,91.4,119,40,33.6
6,All Students,2018-19,2,s,s,s,s,s,s
6,All Students,2022-23,13,s,s,s,s,s,s
All Grades,All Students,2018-19,84497,5317,79180,93.7,487,94,19.3
All Grades,All Students,2019-20,55598,3173,52425,94.3,493,74,15.0
All Grades,All Students,2020-21,80953,8675,72278,89.3,467,146,31.3
All Grades,All Students,2021-22,71315,7004,64311,90.2,417,153,36.7
All Grades,All Students,2022-23,72216,5782,66434,92.0,424,121,28.5
0K,All Students,2018-19,8032,681,7351,91.5,46,15,32.6
0K,All Students,2019-20,4813,301,4512,93.7,42,4,9.5
0K,All Students,2020-21,6802,699,6103,89.7,40,10,25.0
0K,All Students,2021-22,5983,544,5439,90.9,35,14,40.0
0K,All Students,2022-23,5717,458,5259,92.0,34,6,17.6
1,All Students,2018-19,8289,507,7782,93.9,49,13,26.5
1,All Students,2019-20,5179,351,4828,93.2,46,13,28.3
1,All Students,2020-21,7175,584,6591,91.9,41,10,24.4
1,All Students,2021-22,6845,743,6102,89.1,40,14,35.0
1,All Students,2022-23,5562,438,5124,92.1,34,10,29.4
2,All Students,2018-19,9256,503,8753,94.6,52,7,13.5
2,All Students,2019-20,5941,288,5653,95.2,54,7,13.0
2,All Students,2020-21,7524,894,6630,88.1,43,12,27.9
2,All Students,2021-22,6362,615,5747,90.3,40,17,42.5
2,All Students,2022-23,7209,499,6710,93.1,41,6,14.6
3,All Students,2018-19,8856,658,8198,92.6,51,10,19.6
3,All Students,2019-20,5734,300,5434,94.8,50,7,14.0
3,All Students,2020-21,8855,466,8389,94.7,51,8,15.7
3,All Students,2021-22,6355,651,5704,89.8,38,15,39.5
3,All Students,2022-23,5677,511,5166,91.0,34,11,32.4
4,All Students,2018-19,8146,414,7732,94.9,46,6,13.0
4,All Students,2019-20,6494,352,6142,94.6,58,10,17.2
4,All Students,2020-21,7995,731,7264,90.9,47,14,29.8
4,All Students,2021-22,8367,766,7601,90.8,48,17,35.4
4,All Students,2022-23,7278,598,6680,91.8,44,13,29.5
5,All Students,2018-19,11036,523,10513,95.3,62,9,14.5
5,All Students,2019-20,5503,276,5227,95.0,48,6,12.5
5,All Students,2020-21,9275,976,8299,89.5,53,15,28.3
5,All Students,2021-22,6912,684,6228,90.1,41,15,36.6
5,All Students,2022-23,8484,642,7842,92.4,48,13,27.1
6,All Students,2018-19,10504,721,9783,93.1,61,11,18.0
6,All Students,2019-20,7696,450,7246,94.2,69,11,15.9
6,All Students,2020-21,11375,1669,9706,85.3,65,26,40.0
6,All Students,2021-22,10693,969,9724,90.9,61,19,31.1
6,All Students,2022-23,11630,927,10703,92.0,66,21,31.8
7,All Students,2018-19,10639,632,10007,94.1,63,12,19.0
7,All Students,2019-20,7598,477,7121,93.7,67,9,13.4
7,All Students,2020-21,10877,1510,9367,86.1,63,27,42.9
7,All Students,2021-22,10043,1013,9030,89.9,58,21,36.2
7,All Students,2022-23,10262,863,9399,91.6,61,21,34.4
8,All Students,2018-19,9739,678,9061,93.0,57,11,19.3
8,All Students,2019-20,6640,378,6262,94.3,59,7,11.9
8,All Students,2020-21,11025,1133,9892,89.7,63,23,36.5
8,All Students,2021-22,9755,1019,8736,89.6,56,21,37.5
8,All Students,2022-23,10397,846,9551,91.9,62,20,32.3
All Grades,All Students,2018-19,174368,16063,158305,90.8,1037,394,38.0
All Grades,All Students,2019-20,103676,7971,95705,92.3,940,272,28.9
All Grades,All Students,2020-21,148153,15401,132752,89.6,877,349,39.8
All Grades,All Students,2021-22,140891,17969,122922,87.2,855,453,53.0
All Grades,All Students,2022-23,137938,16398,121540,88.1,834,407,48.8
PK in K-12 Schools,All Students,2018-19,3142,419,2723,86.7,18,12,66.7
PK in K-12 Schools,All Students,2019-20,2020,214,1806,89.4,18,7,38.9
PK in K-12 Schools,All Students,2020-21,2679,435,2244,83.8,18,9,50.0
PK in K-12 Schools,All Students,2021-22,2895,s,s,s,s,s,s
PK in K-12 Schools,All Students,2022-23,3014,572,2442,81.0,21,13,61.9
0K,All Students,2018-19,14527,1680,12847,88.4,92,46,50.0
0K,All Students,2019-20,7729,779,6950,89.9,74,34,45.9
0K,All Students,2020-21,13432,1388,12044,89.7,83,34,41.0
0K,All Students,2021-22,12341,2000,10341,83.8,75,54,72.0
0K,All Students,2022-23,11418,1779,9639,84.4,71,45,63.4
1,All Students,2018-19,15058,1406,13652,90.7,89,31,34.8
1,All Students,2019-20,8328,676,7652,91.9,75,26,34.7
1,All Students,2020-21,11728,1404,10324,88.0,73,34,46.6
1,All Students,2021-22,14437,2262,12175,84.3,89,56,62.9
1,All Students,2022-23,12088,1639,10449,86.4,75,46,61.3
2,All Students,2018-19,15905,1484,14421,90.7,94,37,39.4
2,All Students,2019-20,9948,778,9170,92.2,91,28,30.8
2,All Students,2020-21,12076,1017,11059,91.6,72,19,26.4
2,All Students,2021-22,11789,1419,10370,88.0,74,38,51.4
2,All Students,2022-23,14536,1770,12766,87.8,86,42,48.8
3,All Students,2018-19,19726,1465,18261,92.6,116,36,31.0
3,All Students,2019-20,9775,818,8957,91.6,89,31,34.8
3,All Students,2020-21,14756,1203,13553,91.8,87,24,27.6
3,All Students,2021-22,12050,1372,10678,88.6,77,40,51.9
3,All Students,2022-23,11380,1191,10189,89.5,68,27,39.7
4,All Students,2018-19,22174,1744,20430,92.1,136,43,31.6
4,All Students,2019-20,11909,740,11169,93.8,106,19,17.9
4,All Students,2020-21,13593,555,13038,95.9,79,8,10.1
4,All Students,2021-22,13982,1656,12326,88.2,86,43,50.0
4,All Students,2022-23,12703,1291,11412,89.8,78,35,44.9
5,All Students,2018-19,18794,1509,17285,92.0,112,34,30.4
5,All Students,2019-20,12577,841,11736,93.3,117,29,24.8
5,All Students,2020-21,16711,1398,15313,91.6,99,34,34.3
5,All Students,2021-22,13502,1617,11885,88.0,82,40,48.8
5,All Students,2022-23,14542,1491,13051,89.7,88,42,47.7
6,All Students,2018-19,22155,2084,20071,90.6,130,51,39.2
6,All Students,2019-20,13807,999,12808,92.8,124,31,25.0
6,All Students,2020-21,21334,2000,19334,90.6,123,43,35.0
6,All Students,2021-22,21919,2392,19527,89.1,130,49,37.7
6,All Students,2022-23,19195,2253,16942,88.3,113,52,46.0
7,All Students,2018-19,22228,2153,20075,90.3,132,55,41.7
7,All Students,2019-20,14391,1243,13148,91.4,129,41,31.8
7,All Students,2020-21,20099,3125,16974,84.5,117,78,66.7
7,All Students,2021-22,19754,2225,17529,88.7,118,51,43.2
7,All Students,2022-23,20590,2278,18312,88.9,122,52,42.6
8,All Students,2018-19,20659,2119,18540,89.7,118,49,41.5
8,All Students,2019-20,13192,883,12309,93.3,117,26,22.2
8,All Students,2020-21,21745,2876,18869,86.8,126,66,52.4
8,All Students,2021-22,18209,2524,15685,86.1,105,67,63.8
8,All Students,2022-23,18472,2134,16338,88.4,112,53,47.3
9,All Students,2021-22,13,s,s,s,s,s,s
All Grades,All Students,2018-19,78764,8225,70539,89.6,487,194,39.8
All Grades,All Students,2019-20,50281,4772,45509,90.5,474,177,37.3
All Grades,All Students,2020-21,69834,11922,57912,82.9,426,240,56.3
All Grades,All Students,2021-22,65907,9195,56712,86.0,409,232,56.7
All Grades,All Students,2022-23,67853,7930,59923,88.3,447,215,48.1
PK in K-12 Schools,All Students,2018-19,9367,1157,8210,87.6,59,31,52.5
PK in K-12 Schools,All Students,2019-20,6482,828,5654,87.2,65,30,46.2
PK in K-12 Schools,All Students,2020-21,7955,1645,6310,79.3,53,32,60.4
PK in K-12 Schools,All Students,2021-22,8061,1323,6738,83.6,54,37,68.5
PK in K-12 Schools,All Students,2022-23,8580,1258,7322,85.3,60,37,61.7
0K,All Students,2018-19,8837,1382,7455,84.4,58,34,58.6
0K,All Students,2019-20,7234,761,6473,89.5,68,30,44.1
0K,All Students,2020-21,10241,1849,8392,81.9,64,38,59.4
0K,All Students,2021-22,9148,1439,7709,84.3,60,38,63.3
0K,All Students,2022-23,9147,1125,8022,87.7,55,30,54.5
1,All Students,2018-19,14136,1451,12685,89.7,83,39,47.0
1,All Students,2019-20,7050,886,6164,87.4,69,38,55.1
1,All Students,2020-21,10957,2002,8955,81.7,64,41,64.1
1,All Students,2021-22,10386,1280,9106,87.7,61,33,54.1
1,All Students,2022-23,10588,1260,9328,88.1,74,36,48.6
2,All Students,2018-19,11055,1098,9957,90.1,72,24,33.3
2,All Students,2019-20,8940,760,8180,91.5,80,26,32.5
2,All Students,2020-21,9858,2153,7705,78.2,62,42,67.7
2,All Students,2021-22,9672,1161,8511,88.0,59,31,52.5
2,All Students,2022-23,10252,1123,9129,89.0,68,33,48.5
3,All Students,2018-19,9614,780,8834,91.9,61,19,31.1
3,All Students,2019-20,6842,566,6276,91.7,66,24,36.4
3,All Students,2020-21,13240,2162,11078,83.7,81,45,55.6
3,All Students,2021-22,9565,1630,7935,83.0,62,39,62.9
3,All Students,2022-23,8826,926,7900,89.5,60,21,35.0
4,All Students,2018-19,10909,930,9979,91.5,67,18,26.9
4,All Students,2019-20,6399,411,5988,93.6,60,15,25.0
4,All Students,2020-21,9350,1349,8001,85.6,55,27,49.1
4,All Students,2021-22,11578,1507,10071,87.0,69,36,52.2
4,All Students,2022-23,10959,1439,9520,86.9,72,37,51.4
5,All Students,2018-19,14846,1427,13419,90.4,87,29,33.3
5,All Students,2019-20,7334,560,6774,92.4,67,14,20.9
5,All Students,2020-21,8233,762,7471,90.7,47,15,31.9
5,All Students,2021-22,7497,855,6642,88.6,44,18,40.9
5,All Students,2022-23,9501,799,8702,91.6,58,21,36.2
All Grades,All Students,2018-19,148726,7179,141547,95.2,863,93,10.8
All Grades,All Students,2019-20,96485,5026,91459,94.8,852,106,12.4
All Grades,All Students,2020-21,137898,5330,132568,96.1,813,79,9.7
All Grades,All Students,2021-22,126583,9859,116724,92.2,741,180,24.3
All Grades,All Students,2022-23,129911,8493,121418,93.5,753,144,19.1
0K,All Students,2018-19,26151,1692,24459,93.5,152,28,18.4
0K,All Students,2019-20,17429,1214,16215,93.0,155,30,19.4
0K,All Students,2020-21,24381,1129,23252,95.4,143,18,12.6
0K,All Students,2021-22,21676,1884,19792,91.3,129,37,28.7
0K,All Students,2022-23,26132,2069,24063,92.1,153,43,28.1
1,All Students,2018-19,27650,1278,26372,95.4,161,15,9.3
1,All Students,2019-20,17213,980,16233,94.3,152,23,15.1
1,All Students,2020-21,23409,1257,22152,94.6,139,20,14.4
1,All Students,2021-22,22698,1695,21003,92.5,133,26,19.5
1,All Students,2022-23,22345,1573,20772,93.0,130,25,19.2
2,All Students,2018-19,21418,904,20514,95.8,124,12,9.7
2,All Students,2019-20,17719,882,16837,95.0,157,12,7.6
2,All Students,2020-21,24214,776,23438,96.8,142,11,7.7
2,All Students,2021-22,19809,1580,18229,92.0,116,30,25.9
2,All Students,2022-23,20877,1272,19605,93.9,120,22,18.3
3,All Students,2018-19,26440,1220,25220,95.4,152,15,9.9
3,All Students,2019-20,13318,579,12739,95.7,118,15,12.7
3,All Students,2020-21,24852,676,24176,97.3,147,10,6.8
3,All Students,2021-22,21365,1668,19697,92.2,125,33,26.4
3,All Students,2022-23,18529,1101,17428,94.1,108,16,14.8
4,All Students,2018-19,24526,1114,23412,95.5,145,15,10.3
4,All Students,2019-20,15839,637,15202,96.0,138,12,8.7
4,All Students,2020-21,18080,550,17530,97.0,107,8,7.5
4,All Students,2021-22,22732,1650,21082,92.7,132,28,21.2
4,All Students,2022-23,19196,1102,18094,94.3,111,17,15.3
5,All Students,2018-19,22541,971,21570,95.7,129,8,6.2
5,All Students,2019-20,14967,734,14233,95.1,132,14,10.6
5,All Students,2020-21,22962,942,22020,95.9,135,12,8.9
5,All Students,2021-22,18303,1382,16921,92.4,106,26,24.5
5,All Students,2022-23,22832,1376,21456,94.0,131,21,16.0
All Grades,All Students,2018-19,136485,12919,123566,90.5,836,357,42.7
All Grades,All Students,2019-20,83433,6878,76555,91.8,766,247,32.2
All Grades,All Students,2020-21,118315,15686,102629,86.7,704,299,42.5
All Grades,All Students,2021-22,109220,15418,93802,85.9,673,405,60.2
All Grades,All Students,2022-23,99512,11908,87604,88.0,610,296,48.5
PK in K-12 Schools,All Students,2018-19,6321,760,5561,88.0,36,22,61.1
PK in K-12 Schools,All Students,2019-20,4068,379,3689,90.7,36,12,33.3
PK in K-12 Schools,All Students,2020-21,5871,s,s,s,s,s,s
PK in K-12 Schools,All Students,2021-22,6291,858,5433,86.4,38,24,63.2
PK in K-12 Schools,All Students,2022-23,6218,1004,5214,83.9,36,21,58.3
0K,All Students,2018-19,19267,2245,17022,88.3,126,68,54.0
0K,All Students,2019-20,12060,1323,10737,89.0,111,59,53.2
0K,All Students,2020-21,15503,2290,13213,85.2,92,45,48.9
0K,All Students,2021-22,16338,2702,13636,83.5,109,80,73.4
0K,All Students,2022-23,13958,1895,12063,86.4,89,48,53.9
1,All Students,2018-19,18668,1823,16845,90.2,115,51,44.3
1,All Students,2019-20,11671,1023,10648,91.2,110,39,35.5
1,All Students,2020-21,19196,3440,15756,82.1,113,62,54.9
1,All Students,2021-22,14433,2222,12211,84.6,87,56,64.4
1,All Students,2022-23,16062,2367,13695,85.3,100,63,63.0
2,All Students,2018-19,21919,1941,19978,91.1,136,55,40.4
2,All Students,2019-20,13912,1106,12806,92.1,127,35,27.6
2,All Students,2020-21,17133,2300,14833,86.6,104,41,39.4
2,All Students,2021-22,17003,2673,14330,84.3,105,65,61.9
2,All Students,2022-23,14613,1576,13037,89.2,86,34,39.5
3,All Students,2018-19,23307,2393,20914,89.7,145,71,49.0
3,All Students,2019-20,13436,939,12497,93.0,124,31,25.0
3,All Students,2020-21,20431,1997,18434,90.2,123,40,32.5
3,All Students,2021-22,15318,2028,13290,86.8,97,53,54.6
3,All Students,2022-23,14731,1750,12981,88.1,86,41,47.7
4,All Students,2018-19,24048,1903,22145,92.1,143,45,31.5
4,All Students,2019-20,14052,1117,12935,92.1,132,40,30.3
4,All Students,2020-21,19706,2420,17286,87.7,117,46,39.3
4,All Students,2021-22,19217,2298,16919,88.0,117,61,52.1
4,All Students,2022-23,16218,1797,14421,88.9,103,52,50.5
5,All Students,2018-19,22955,1854,21101,91.9,135,45,33.3
5,All Students,2019-20,14234,991,13243,93.0,126,31,24.6
5,All Students,2020-21,20474,2756,17718,86.5,120,51,42.5
5,All Students,2021-22,20620,2637,17983,87.2,120,66,55.0
5,All Students,2022-23,17712,1519,16193,91.4,110,37,33.6
6,All Students,2020-21,1,s,s,s,s,s,s
All Grades,All Students,2018-19,158478,15467,143011,90.2,937,378,40.3
All Grades,All Students,2019-20,96615,8250,88365,91.5,888,275,31.0
All Grades,All Students,2020-21,129989,18155,111834,86.0,772,339,43.9
All Grades,All Students,2021-22,133959,16460,117499,87.7,822,399,48.5
All Grades,All Students,2022-23,136215,15243,120972,88.8,841,344,40.9
PK in K-12 Schools,All Students,2018-19,9472,1437,8035,84.8,55,41,74.5
PK in K-12 Schools,All Students,2019-20,8070,829,7241,89.7,77,32,41.6
PK in K-12 Schools,All Students,2020-21,8515,1115,7400,86.9,51,23,45.1
PK in K-12 Schools,All Students,2021-22,11639,1685,9954,85.5,78,46,59.0
PK in K-12 Schools,All Students,2022-23,12368,2009,10359,83.8,77,50,64.9
0K,All Students,2018-19,22768,2696,20072,88.2,138,72,52.2
0K,All Students,2019-20,12306,1103,11203,91.0,114,45,39.5
0K,All Students,2020-21,16267,2202,14065,86.5,101,45,44.6
0K,All Students,2021-22,18517,2579,15938,86.1,112,68,60.7
0K,All Students,2022-23,17352,2202,15150,87.3,108,53,49.1
1,All Students,2018-19,25106,2555,22551,89.8,149,59,39.6
1,All Students,2019-20,14329,1347,12982,90.6,131,43,32.8
1,All Students,2020-21,17763,2799,14964,84.2,107,56,52.3
1,All Students,2021-22,17783,2246,15537,87.4,113,55,48.7
1,All Students,2022-23,18839,2313,16526,87.7,118,53,44.9
2,All Students,2018-19,24979,2098,22881,91.6,150,54,36.0
2,All Students,2019-20,14849,1294,13555,91.3,137,44,32.1
2,All Students,2020-21,21273,4003,17270,81.2,126,64,50.8
2,All Students,2021-22,21369,2680,18689,87.5,130,64,49.2
2,All Students,2022-23,20213,2363,17850,88.3,128,57,44.5
3,All Students,2018-19,23812,2087,21725,91.2,141,45,31.9
3,All Students,2019-20,15853,1112,14741,93.0,145,32,22.1
3,All Students,2020-21,21458,2961,18497,86.2,125,57,45.6
3,All Students,2021-22,21380,2835,18545,86.7,130,65,50.0
3,All Students,2022-23,24772,2408,22364,90.3,149,47,31.5
4,All Students,2018-19,26032,2081,23951,92.0,152,46,30.3
4,All Students,2019-20,14974,1260,13714,91.6,136,40,29.4
4,All Students,2020-21,23374,1939,21435,91.7,137,38,27.7
4,All Students,2021-22,20390,2402,17988,88.2,125,55,44.0
4,All Students,2022-23,22147,2101,20046,90.5,135,45,33.3
5,All Students,2018-19,26309,2513,23796,90.4,152,61,40.1
5,All Students,2019-20,16234,1305,14929,92.0,148,39,26.4
5,All Students,2020-21,21339,3136,18203,85.3,125,56,44.8
5,All Students,2021-22,22881,2033,20848,91.1,134,46,34.3
5,All Students,2022-23,20524,1847,18677,91.0,126,39,31.0
All Grades,All Students,2018-19,113436,11521,101915,89.8,682,281,41.2
All Grades,All Students,2019-20,71649,6173,65476,91.4,646,198,30.7
All Grades,All Students,2020-21,100791,13450,87341,86.7,581,230,39.6
All Grades,All Students,2021-22,88199,12414,75785,85.9,527,297,56.4
All Grades,All Students,2022-23,81238,9546,71692,88.2,485,226,46.6
0K,All Students,2018-19,12707,1606,11101,87.4,84,50,59.5
0K,All Students,2019-20,6002,718,5284,88.0,56,29,51.8
0K,All Students,2020-21,8317,1456,6861,82.5,49,20,40.8
0K,All Students,2021-22,8106,1388,6718,82.9,51,37,72.5
0K,All Students,2022-23,7728,1167,6561,84.9,46,30,65.2
1,All Students,2018-19,12617,1255,11362,90.1,76,33,43.4
1,All Students,2019-20,7771,703,7068,91.0,69,22,31.9
1,All Students,2020-21,9879,1253,8626,87.3,57,21,36.8
1,All Students,2021-22,8526,1494,7032,82.5,50,33,66.0
1,All Students,2022-23,8144,1064,7080,86.9,49,25,51.0
2,All Students,2018-19,10401,1027,9374,90.1,62,22,35.5
2,All Students,2019-20,8027,677,7350,91.6,72,18,25.0
2,All Students,2020-21,11172,1542,9630,86.2,64,29,45.3
2,All Students,2021-22,9843,1260,8583,87.2,59,32,54.2
2,All Students,2022-23,9008,1134,7874,87.4,55,31,56.4
3,All Students,2018-19,12714,1132,11582,91.1,75,26,34.7
3,All Students,2019-20,6195,473,5722,92.4,57,15,26.3
3,All Students,2020-21,11101,1519,9582,86.3,64,26,40.6
3,All Students,2021-22,10171,1656,8515,83.7,60,34,56.7
3,All Students,2022-23,9930,1057,8873,89.4,60,23,38.3
4,All Students,2018-19,15935,1626,14309,89.8,93,38,40.9
4,All Students,2019-20,8297,655,7642,92.1,75,23,30.7
4,All Students,2020-21,10262,1036,9226,89.9,59,16,27.1
4,All Students,2021-22,10417,1406,9011,86.5,65,33,50.8
4,All Students,2022-23,10432,1334,9098,87.2,61,30,49.2
5,All Students,2018-19,17140,1716,15424,90.0,99,38,38.4
5,All Students,2019-20,10486,759,9727,92.8,95,21,22.1
5,All Students,2020-21,12509,1535,10974,87.7,72,30,41.7
5,All Students,2021-22,10056,1260,8796,87.5,60,35,58.3
5,All Students,2022-23,9965,1194,8771,88.0,61,30,49.2
6,All Students,2018-19,13748,1315,12433,90.4,82,27,32.9
6,All Students,2019-20,9082,872,8210,90.4,83,32,38.6
6,All Students,2020-21,12930,1905,11025,85.3,75,37,49.3
6,All Students,2021-22,8469,1131,7338,86.6,49,26,53.1
6,All Students,2022-23,8963,1005,7958,88.8,51,24,47.1
7,All Students,2018-19,10279,920,9359,91.0,63,22,34.9
7,All Students,2019-20,8646,675,7971,92.2,76,19,25.0
7,All Students,2020-21,12725,2150,10575,83.1,73,33,45.2
7,All Students,2021-22,11116,1314,9802,88.2,67,30,44.8
7,All Students,2022-23,7493,655,6838,91.3,44,14,31.8
8,All Students,2018-19,7895,924,6971,88.3,48,25,52.1
8,All Students,2019-20,7143,641,6502,91.0,63,19,30.2
8,All Students,2020-21,11896,1054,10842,91.1,68,18,26.5
8,All Students,2021-22,11495,1505,9990,86.9,66,37,56.1
8,All Students,2022-23,9575,936,8639,90.2,58,19,32.8
All Grades,All Students,2018-19,127123,12216,114907,90.4,755,257,34.0
All Grades,All Students,2019-20,81553,6435,75118,92.1,750,203,27.1
All Grades,All Students,2020-21,121195,20002,101193,83.5,714,354,49.6
All Grades,All Students,2021-22,99199,16247,82952,83.6,588,355,60.4
All Grades,All Students,2022-23,83494,10405,73089,87.5,505,233,46.1
5,All Students,2020-21,6,s,s,s,s,s,s
6,All Students,2018-19,45728,3944,41784,91.4,272,85,31.3
6,All Students,2019-20,26339,1973,24366,92.5,243,59,24.3
6,All Students,2020-21,37182,s,s,s,s,s,s
6,All Students,2021-22,23109,s,s,s,s,s,s
6,All Students,2022-23,25527,2440,23087,90.4,153,52,34.0
7,All Students,2018-19,39700,3222,36478,91.9,234,71,30.3
7,All Students,2019-20,29147,2589,26558,91.1,272,83,30.5
7,All Students,2020-21,39717,6934,32783,82.5,232,119,51.3
7,All Students,2021-22,37146,6072,31074,83.7,220,126,57.3
7,All Students,2022-23,23038,2916,20122,87.3,143,65,45.5
8,All Students,2018-19,41695,5050,36645,87.9,249,101,40.6
8,All Students,2019-20,25962,s,s,s,s,s,s
8,All Students,2020-21,44290,7705,36585,82.6,258,128,49.6
8,All Students,2021-22,38942,6533,32409,83.2,225,145,64.4
8,All Students,2022-23,34929,5049,29880,85.5,209,116,55.5
9,All Students,2019-20,105,s,s,s,s,s,s
9,All Students,2021-22,2,s,s,s,s,s,s
All Grades,All Students,2018-19,152201,13966,138235,90.8,929,345,37.1
All Grades,All Students,2019-20,94919,7599,87320,92.0,868,258,29.7
All Grades,All Students,2020-21,127414,13777,113637,89.2,761,302,39.7
All Grades,All Students,2021-22,120740,11560,109180,90.4,723,279,38.6
All Grades,All Students,2022-23,116156,10169,105987,91.2,706,243,34.4
PK in K-12 Schools,All Students,2021-22,2649,262,2387,90.1,15,6,40.0
PK in K-12 Schools,All Students,2022-23,5837,555,5282,90.5,33,11,33.3
0K,All Students,2018-19,23190,2396,20794,89.7,146,57,39.0
0K,All Students,2019-20,14699,1214,13485,91.7,139,41,29.5
0K,All Students,2020-21,16929,1771,15158,89.5,105,47,44.8
0K,All Students,2021-22,17609,2105,15504,88.0,108,59,54.6
0K,All Students,2022-23,16698,1690,15008,89.9,105,50,47.6
1,All Students,2018-19,26524,2530,23994,90.5,163,64,39.3
1,All Students,2019-20,14260,1192,13068,91.6,129,38,29.5
1,All Students,2020-21,20362,2610,17752,87.2,120,57,47.5
1,All Students,2021-22,17854,1808,16046,89.9,109,50,45.9
1,All Students,2022-23,18290,1635,16655,91.1,111,43,38.7
2,All Students,2018-19,25606,2107,23499,91.8,157,57,36.3
2,All Students,2019-20,16935,1502,15433,91.1,157,56,35.7
2,All Students,2020-21,19780,2210,17570,88.8,119,46,38.7
2,All Students,2021-22,18763,1976,16787,89.5,112,44,39.3
2,All Students,2022-23,17617,1649,15968,90.6,107,44,41.1
3,All Students,2018-19,26485,2286,24199,91.4,160,52,32.5
3,All Students,2019-20,17123,1132,15991,93.4,155,39,25.2
3,All Students,2020-21,24345,2394,21951,90.2,145,51,35.2
3,All Students,2021-22,17455,1499,15956,91.4,102,31,30.4
3,All Students,2022-23,18241,1476,16765,91.9,111,28,25.2
4,All Students,2018-19,26855,2549,24306,90.5,164,64,39.0
4,All Students,2019-20,15146,1311,13835,91.3,136,45,33.1
4,All Students,2020-21,24356,2942,21414,87.9,145,55,37.9
4,All Students,2021-22,22163,2102,20061,90.5,134,47,35.1
4,All Students,2022-23,17905,1430,16475,92.0,110,33,30.0
5,All Students,2018-19,23541,2098,21443,91.1,139,51,36.7
5,All Students,2019-20,16756,1248,15508,92.6,152,39,25.7
5,All Students,2020-21,21642,1850,19792,91.5,127,46,36.2
5,All Students,2021-22,24247,1808,22439,92.5,143,42,29.4
5,All Students,2022-23,21568,1734,19834,92.0,129,34,26.4
All Grades,All Students,2018-19,36153,2756,33397,92.4,215,66,30.7
All Grades,All Students,2019-20,23475,1743,21732,92.6,213,63,29.6
All Grades,All Students,2020-21,33315,3816,29499,88.5,200,70,35.0
All Grades,All Students,2021-22,30725,4200,26525,86.3,197,109,55.3
All Grades,All Students,2022-23,26921,2997,23924,88.9,168,85,50.6
PK in K-12 Schools,All Students,2018-19,3165,295,2870,90.7,18,9,50.0
PK in K-12 Schools,All Students,2019-20,4048,430,3618,89.4,39,20,51.3
PK in K-12 Schools,All Students,2020-21,4524,598,3926,86.8,30,14,46.7
PK in K-12 Schools,All Students,2021-22,8645,1549,7096,82.1,61,38,62.3
PK in K-12 Schools,All Students,2022-23,7716,989,6727,87.2,50,30,60.0
0K,All Students,2018-19,5362,556,4806,89.6,32,13,40.6
0K,All Students,2019-20,3638,325,3313,91.1,32,10,31.3
0K,All Students,2020-21,5742,990,4752,82.8,35,17,48.6
0K,All Students,2021-22,4038,632,3406,84.3,29,19,65.5
0K,All Students,2022-23,4705,648,4057,86.2,31,21,67.7
1,All Students,2018-19,4934,341,4593,93.1,31,8,25.8
1,All Students,2019-20,2791,196,2595,93.0,25,5,20.0
1,All Students,2020-21,5189,775,4414,85.1,30,14,46.7
1,All Students,2021-22,5068,649,4419,87.2,29,15,51.7
1,All Students,2022-23,2807,323,2484,88.5,18,8,44.4
2,All Students,2018-19,6358,508,5850,92.0,36,11,30.6
2,All Students,2019-20,2703,143,2560,94.7,24,5,20.8
2,All Students,2020-21,4055,438,3617,89.2,25,7,28.0
2,All Students,2021-22,3214,451,2763,86.0,18,12,66.7
2,All Students,2022-23,3639,395,3244,89.1,21,11,52.4
3,All Students,2018-19,6262,390,5872,93.8,38,10,26.3
3,All Students,2019-20,3488,252,3236,92.8,31,8,25.8
3,All Students,2020-21,3960,421,3539,89.4,23,9,39.1
3,All Students,2021-22,3117,258,2859,91.7,20,7,35.0
3,All Students,2022-23,2774,277,2497,90.0,17,7,41.2
4,All Students,2018-19,5619,440,5179,92.2,34,10,29.4
4,All Students,2019-20,3605,208,3397,94.2,33,9,27.3
4,All Students,2020-21,5010,322,4688,93.6,29,4,13.8
4,All Students,2021-22,3063,278,2785,90.9,19,7,36.8
4,All Students,2022-23,2802,189,2613,93.3,17,4,23.5
5,All Students,2018-19,4453,226,4227,94.9,26,5,19.2
5,All Students,2019-20,3202,189,3013,94.1,29,6,20.7
5,All Students,2020-21,4835,272,4563,94.4,28,5,17.9
5,All Students,2021-22,3580,383,3197,89.3,21,11,52.4
5,All Students,2022-23,2478,176,2302,92.9,14,4,28.6
All Grades,All Students,2018-19,84305,5575,78730,93.4,510,122,23.9
All Grades,All Students,2019-20,51941,3402,48539,93.5,474,101,21.3
All Grades,All Students,2020-21,74787,5443,69344,92.7,448,102,22.8
All Grades,All Students,2021-22,65512,6112,59400,90.7,404,154,38.1
All Grades,All Students,2022-23,64073,6125,57948,90.4,394,149,37.8
PK in K-12 Schools,All Students,2018-19,8776,764,8012,91.3,55,21,38.2
PK in K-12 Schools,All Students,2019-20,6125,496,5629,91.9,55,12,21.8
PK in K-12 Schools,All Students,2020-21,8203,619,7584,92.5,50,16,32.0
PK in K-12 Schools,All Students,2021-22,6886,819,6067,88.1,43,24,55.8
PK in K-12 Schools,All Students,2022-23,6258,731,5527,88.3,43,21,48.8
0K,All Students,2018-19,14068,1037,13031,92.6,85,22,25.9
0K,All Students,2019-20,7311,666,6645,90.9,68,26,38.2
0K,All Students,2020-21,12268,1039,11229,91.5,75,17,22.7
0K,All Students,2021-22,8492,757,7735,91.1,57,23,40.4
0K,All Students,2022-23,9022,1028,7994,88.6,59,30,50.8
1,All Students,2018-19,11905,825,11080,93.1,73,19,26.0
1,All Students,2019-20,8095,562,7533,93.1,75,18,24.0
1,All Students,2020-21,10077,892,9185,91.1,60,17,28.3
1,All Students,2021-22,10317,1096,9221,89.4,65,28,43.1
1,All Students,2022-23,8349,905,7444,89.2,52,21,40.4
2,All Students,2018-19,11800,684,11116,94.2,71,11,15.5
2,All Students,2019-20,7395,488,6907,93.4,68,16,23.5
2,All Students,2020-21,11277,715,10562,93.7,68,14,20.6
2,All Students,2021-22,9161,811,8350,91.1,58,22,37.9
2,All Students,2022-23,10699,972,9727,90.9,63,22,34.9
3,All Students,2018-19,13369,867,12502,93.5,81,19,23.5
3,All Students,2019-20,7137,327,6810,95.4,66,4,6.1
3,All Students,2020-21,10789,791,9998,92.7,65,12,18.5
3,All Students,2021-22,10458,892,9566,91.5,62,21,33.9
3,All Students,2022-23,8602,663,7939,92.3,51,14,27.5
4,All Students,2018-19,12337,756,11581,93.9,72,18,25.0
4,All Students,2019-20,8229,471,7758,94.3,75,12,16.0
4,All Students,2020-21,10007,712,9295,92.9,59,12,20.3
4,All Students,2021-22,10946,1114,9832,89.8,65,26,40.0
4,All Students,2022-23,10279,773,9506,92.5,61,19,31.1
5,All Students,2018-19,12050,642,11408,94.7,73,12,16.4
5,All Students,2019-20,7649,392,7257,94.9,67,13,19.4
5,All Students,2020-21,12166,675,11491,94.5,71,14,19.7
5,All Students,2021-22,9252,623,8629,93.3,54,10,18.5
5,All Students,2022-23,10864,1053,9811,90.3,65,22,33.8
All Grades,All Students,2018-19,117910,8459,109451,92.8,703,179,25.5
All Grades,All Students,2019-20,77859,5844,72015,92.5,705,190,27.0
All Grades,All Students,2020-21,118296,9022,109274,92.4,691,164,23.7
All Grades,All Students,2021-22,109768,11595,98173,89.4,657,273,41.6
All Grades,All Students,2022-23,107026,11356,95670,89.4,642,256,39.9
0K,All Students,2018-19,14894,1345,13549,91.0,92,32,34.8
0K,All Students,2019-20,12571,1172,11399,90.7,118,46,39.0
0K,All Students,2020-21,19575,2304,17271,88.2,116,40,34.5
0K,All Students,2021-22,21980,2766,19214,87.4,127,69,54.3
0K,All Students,2022-23,16795,2128,14667,87.3,102,50,49.0
1,All Students,2018-19,21406,1664,19742,92.2,127,31,24.4
1,All Students,2019-20,10103,s,s,s,s,s,s
1,All Students,2020-21,18109,1503,16606,91.7,106,29,27.4
1,All Students,2021-22,17866,2155,15711,87.9,109,49,45.0
1,All Students,2022-23,20900,2543,18357,87.8,124,59,47.6
2,All Students,2018-19,22423,1512,20911,93.3,132,33,25.0
2,All Students,2019-20,14164,997,13167,93.0,126,29,23.0
2,All Students,2020-21,16093,1291,14802,92.0,95,26,27.4
2,All Students,2021-22,16482,1431,15051,91.3,101,35,34.7
2,All Students,2022-23,18319,1940,16379,89.4,111,44,39.6
3,All Students,2018-19,20350,1510,18840,92.6,119,31,26.1
3,All Students,2019-20,14008,868,13140,93.8,125,30,24.0
3,All Students,2020-21,21814,1374,20440,93.7,126,26,20.6
3,All Students,2021-22,15267,1700,13567,88.9,90,40,44.4
3,All Students,2022-23,15622,1329,14293,91.5,94,28,29.8
4,All Students,2018-19,20591,1355,19236,93.4,125,31,24.8
4,All Students,2019-20,13609,978,12631,92.8,124,27,21.8
4,All Students,2020-21,21073,1299,19774,93.8,123,21,17.1
4,All Students,2021-22,19773,1867,17906,90.6,121,41,33.9
4,All Students,2022-23,15435,1578,13857,89.8,94,35,37.2
5,All Students,2018-19,18246,1073,17173,94.1,108,21,19.4
5,All Students,2019-20,13397,905,12492,93.2,121,31,25.6
5,All Students,2020-21,21632,1251,20381,94.2,125,22,17.6
5,All Students,2021-22,18400,1676,16724,90.9,109,39,35.8
5,All Students,2022-23,19955,1838,18117,90.8,117,40,34.2
6,All Students,2019-20,7,s,s,s,s,s,s
All Grades,All Students,2018-19,92582,9491,83091,89.7,575,233,40.5
All Grades,All Students,2019-20,60903,6482,54421,89.4,565,216,38.2
All Grades,All Students,2020-21,83171,15225,67946,81.7,500,271,54.2
All Grades,All Students,2021-22,78184,13953,64231,82.2,493,347,70.4
All Grades,All Students,2022-23,80090,10798,69292,86.5,512,282,55.1
PK in K-12 Schools,All Students,2018-19,8476,942,7534,88.9,54,28,51.9
PK in K-12 Schools,All Students,2019-20,6126,979,5147,84.0,54,31,57.4
PK in K-12 Schools,All Students,2020-21,5624,892,4732,84.1,38,26,68.4
PK in K-12 Schools,All Students,2021-22,6907,s,s,s,s,s,s
PK in K-12 Schools,All Students,2022-23,7558,1162,6396,84.6,56,38,67.9
0K,All Students,2018-19,11489,1647,9842,85.7,75,42,56.0
0K,All Students,2019-20,6347,707,5640,88.9,61,23,37.7
0K,All Students,2020-21,10718,3002,7716,72.0,65,43,66.2
0K,All Students,2021-22,9247,1827,7420,80.2,61,43,70.5
0K,All Students,2022-23,11020,1725,9295,84.3,72,41,56.9
1,All Students,2018-19,13326,1498,11828,88.8,82,37,45.1
1,All Students,2019-20,8746,1184,7562,86.5,84,46,54.8
1,All Students,2020-21,10412,2384,8028,77.1,65,47,72.3
1,All Students,2021-22,10192,1991,8201,80.5,69,53,76.8
1,All Students,2022-23,10706,1494,9212,86.0,71,41,57.7
2,All Students,2018-19,12918,1309,11609,89.9,78,30,38.5
2,All Students,2019-20,9385,975,8410,89.6,91,35,38.5
2,All Students,2020-21,12843,2629,10214,79.5,76,43,56.6
2,All Students,2021-22,11039,2041,8998,81.5,68,43,63.2
2,All Students,2022-23,11945,1666,10279,86.1,74,42,56.8
3,All Students,2018-19,16229,1532,14697,90.6,104,37,35.6
3,All Students,2019-20,9405,912,8493,90.3,87,28,32.2
3,All Students,2020-21,14216,2310,11906,83.8,85,41,48.2
3,All Students,2021-22,13237,2287,10950,82.7,81,54,66.7
3,All Students,2022-23,10432,1263,9169,87.9,65,30,46.2
4,All Students,2018-19,15799,1156,14643,92.7,94,25,26.6
4,All Students,2019-20,10673,935,9738,91.2,97,29,29.9
4,All Students,2020-21,13882,2236,11646,83.9,80,39,48.8
4,All Students,2021-22,15184,2508,12676,83.5,93,66,71.0
4,All Students,2022-23,12913,1618,11295,87.5,79,41,51.9
5,All Students,2018-19,14345,1407,12938,90.2,88,34,38.6
5,All Students,2019-20,10221,790,9431,92.3,91,24,26.4
5,All Students,2020-21,15476,1772,13704,88.6,91,32,35.2
5,All Students,2021-22,12376,1818,10558,85.3,73,47,64.4
5,All Students,2022-23,15516,1870,13646,87.9,95,49,51.6
6,All Students,2021-22,2,s,s,s,s,s,s
All Grades,All Students,2018-19,75974,6021,69953,92.1,457,149,32.6
All Grades,All Students,2019-20,58863,4673,54190,92.1,531,166,31.3
All Grades,All Students,2020-21,87555,10050,77505,88.5,517,223,43.1
All Grades,All Students,2021-22,89109,11416,77693,87.2,532,266,50.0
All Grades,All Students,2022-23,83588,9480,74108,88.7,520,242,46.5
PK in K-12 Schools,All Students,2018-19,6067,673,5394,88.9,37,21,56.8
PK in K-12 Schools,All Students,2019-20,4026,375,3651,90.7,37,16,43.2
PK in K-12 Schools,All Students,2020-21,5901,585,5316,90.1,35,13,37.1
PK in K-12 Schools,All Students,2021-22,5275,923,4352,82.5,36,24,66.7
PK in K-12 Schools,All Students,2022-23,6341,s,s,s,s,s,s
0K,All Students,2018-19,15032,1264,13768,91.6,93,34,36.6
0K,All Students,2019-20,8408,846,7562,89.9,77,34,44.2
0K,All Students,2020-21,15062,2133,12929,85.8,91,50,54.9
0K,All Students,2021-22,15869,2323,13546,85.4,95,48,50.5
0K,All Students,2022-23,11833,1517,10316,87.2,77,47,61.0
1,All Students,2018-19,12822,1013,11809,92.1,76,27,35.5
1,All Students,2019-20,10091,964,9127,90.4,90,38,42.2
1,All Students,2020-21,14519,2392,12127,83.5,86,55,64.0
1,All Students,2021-22,13871,2097,11774,84.9,82,48,58.5
1,All Students,2022-23,16671,2164,14507,87.0,107,58,54.2
2,All Students,2018-19,18738,1468,17270,92.2,110,35,31.8
2,All Students,2019-20,8707,601,8106,93.1,79,17,21.5
2,All Students,2020-21,12701,1259,11442,90.1,75,29,38.7
2,All Students,2021-22,13616,1698,11918,87.5,79,40,50.6
2,All Students,2022-23,12411,1554,10857,87.5,79,35,44.3
3,All Students,2018-19,11002,893,10109,91.9,67,22,32.8
3,All Students,2019-20,11536,856,10680,92.6,104,30,28.8
3,All Students,2020-21,11725,1274,10451,89.1,69,28,40.6
3,All Students,2021-22,12587,1463,11124,88.4,75,38,50.7
3,All Students,2022-23,11403,1089,10314,90.4,70,28,40.0
4,All Students,2018-19,12313,710,11603,94.2,74,10,13.5
4,All Students,2019-20,8416,623,7793,92.6,76,21,27.6
4,All Students,2020-21,16158,1331,14827,91.8,94,25,26.6
4,All Students,2021-22,12643,1317,11326,89.6,76,29,38.2
4,All Students,2022-23,13054,1132,11922,91.3,80,24,30.0
5,All Students,2019-20,7679,408,7271,94.7,68,10,14.7
5,All Students,2020-21,11489,1076,10413,90.6,67,23,34.3
5,All Students,2021-22,15248,1595,13653,89.5,89,39,43.8
5,All Students,2022-23,11874,1020,10854,91.4,71,27,38.0
6,All Students,2022-23,1,s,s,s,s,s,s
All Grades,All Students,2018-19,116968,8438,108530,92.8,724,189,26.1
All Grades,All Students,2019-20,74045,5906,68139,92.0,693,180,26.0
All Grades,All Students,2020-21,105088,11917,93171,88.7,620,249,40.2
All Grades,All Students,2021-22,101084,9547,91537,90.6,621,227,36.6
All Grades,All Students,2022-23,108437,13242,95195,87.8,671,306,45.6
6,All Students,2018-19,36409,s,s,s,s,s,s
6,All Students,2019-20,22382,1784,20598,92.0,213,66,31.0
6,All Students,2020-21,31584,s,s,s,s,s,s
6,All Students,2021-22,33271,3125,30146,90.6,204,75,36.8
6,All Students,2022-23,36379,3890,32489,89.3,225,91,40.4
7,All Students,2018-19,39925,2923,37002,92.7,250,68,27.2
7,All Students,2019-20,24927,1921,23006,92.3,229,50,21.8
7,All Students,2020-21,35612,4264,31348,88.0,213,87,40.8
7,All Students,2021-22,32785,2744,30041,91.6,201,65,32.3
7,All Students,2022-23,36486,4372,32114,88.0,226,106,46.9
8,All Students,2018-19,40594,2839,37755,93.0,245,57,23.3
8,All Students,2019-20,26736,2201,24535,91.8,251,64,25.5
8,All Students,2020-21,37889,4554,33335,88.0,221,97,43.9
8,All Students,2021-22,35028,3678,31350,89.5,216,87,40.3
8,All Students,2022-23,35572,4980,30592,86.0,220,109,49.5
9,All Students,2018-19,40,s,s,s,s,s,s
9,All Students,2020-21,3,s,s,s,s,s,s
All Grades,All Students,2018-19,133936,8796,125140,93.4,784,164,20.9
All Grades,All Students,2019-20,87854,5560,82294,93.7,788,149,18.9
All Grades,All Students,2020-21,125436,4449,120987,96.5,743,56,7.5
All Grades,All Students,2021-22,120778,9050,111728,92.5,709,173,24.4
All Grades,All Students,2022-23,119480,7870,111610,93.4,705,154,21.8
0K,All Students,2018-19,24606,1892,22714,92.3,149,39,26.2
0K,All Students,2019-20,17325,1220,16105,93.0,156,35,22.4
0K,All Students,2020-21,24747,1236,23511,95.0,148,23,15.5
0K,All Students,2021-22,19982,1662,18320,91.7,118,33,28.0
0K,All Students,2022-23,21731,1592,20139,92.7,129,34,26.4
1,All Students,2018-19,24043,1619,22424,93.3,139,30,21.6
1,All Students,2019-20,15075,1083,13992,92.8,133,27,20.3
1,All Students,2020-21,23949,619,23330,97.4,142,7,4.9
1,All Students,2021-22,21737,1627,20110,92.5,129,24,18.6
1,All Students,2022-23,18632,1266,17366,93.2,109,27,24.8
2,All Students,2018-19,20758,1260,19498,93.9,122,23,18.9
2,All Students,2019-20,13963,903,13060,93.5,125,27,21.6
2,All Students,2020-21,19527,566,18961,97.1,116,3,2.6
2,All Students,2021-22,22226,1285,20941,94.2,128,18,14.1
2,All Students,2022-23,20282,1193,19089,94.1,119,21,17.6
3,All Students,2018-19,20551,1189,19362,94.2,120,19,15.8
3,All Students,2019-20,12939,688,12251,94.7,115,17,14.8
3,All Students,2020-21,19908,587,19321,97.1,116,5,4.3
3,All Students,2021-22,19464,1637,17827,91.6,114,34,29.8
3,All Students,2022-23,21042,1159,19883,94.5,123,16,13.0
4,All Students,2018-19,21982,1527,20455,93.1,127,31,24.4
4,All Students,2019-20,14376,806,13570,94.4,131,19,14.5
4,All Students,2020-21,17543,572,16971,96.7,105,5,4.8
4,All Students,2021-22,19862,1533,18329,92.3,114,36,31.6
4,All Students,2022-23,18837,1353,17484,92.8,115,31,27.0
5,All Students,2018-19,21996,1309,20687,94.0,127,22,17.3
5,All Students,2019-20,14176,860,13316,93.9,128,24,18.8
5,All Students,2020-21,19762,869,18893,95.6,116,13,11.2
5,All Students,2021-22,17507,1306,16201,92.5,106,28,26.4
5,All Students,2022-23,18956,1307,17649,93.1,110,25,22.7
All Grades,All Students,2018-19,166613,13503,153110,91.9,1038,317,30.5
All Grades,All Students,2019-20,97827,7353,90474,92.5,932,260,27.9
All Grades,All Students,2020-21,134115,16435,117680,87.7,811,338,41.7
All Grades,All Students,2021-22,126974,13585,113389,89.3,795,325,40.9
All Grades,All Students,2022-23,117055,11520,105535,90.2,746,276,37.0
PK in K-12 Schools,All Students,2018-19,13978,1744,12234,87.5,97,46,47.4
PK in K-12 Schools,All Students,2019-20,7483,786,6697,89.5,79,39,49.4
PK in K-12 Schools,All Students,2020-21,6737,555,6182,91.8,46,15,32.6
PK in K-12 Schools,All Students,2021-22,9764,1363,8401,86.0,67,35,52.2
PK in K-12 Schools,All Students,2022-23,5637,996,4641,82.3,47,28,59.6
0K,All Students,2018-19,26479,2238,24241,91.5,166,55,33.1
0K,All Students,2019-20,12747,1073,11674,91.6,124,39,31.5
0K,All Students,2020-21,17447,3324,14123,80.9,109,72,66.1
0K,All Students,2021-22,16685,1910,14775,88.6,111,55,49.5
0K,All Students,2022-23,18847,2442,16405,87.0,120,60,50.0
1,All Students,2018-19,23340,2363,20977,89.9,146,60,41.1
1,All Students,2019-20,15449,1218,14231,92.1,144,37,25.7
1,All Students,2020-21,18955,1952,17003,89.7,115,41,35.7
1,All Students,2021-22,17064,2147,14917,87.4,110,52,47.3
1,All Students,2022-23,15657,1539,14118,90.2,101,40,39.6
2,All Students,2018-19,27256,2154,25102,92.1,172,50,29.1
2,All Students,2019-20,14123,1093,13030,92.3,136,39,28.7
2,All Students,2020-21,21218,2638,18580,87.6,127,56,44.1
2,All Students,2021-22,16569,1577,14992,90.5,106,37,34.9
2,All Students,2022-23,17090,1804,15286,89.4,109,47,43.1
3,All Students,2018-19,24797,1789,23008,92.8,154,39,25.3
3,All Students,2019-20,18507,1255,17252,93.2,176,45,25.6
3,All Students,2020-21,23134,2482,20652,89.3,139,48,34.5
3,All Students,2021-22,22308,2161,20147,90.3,136,53,39.0
3,All Students,2022-23,19155,1464,17691,92.4,117,28,23.9
4,All Students,2018-19,25413,1749,23664,93.1,151,33,21.9
4,All Students,2019-20,14740,970,13770,93.4,136,29,21.3
4,All Students,2020-21,25945,2846,23099,89.0,154,58,37.7
4,All Students,2021-22,21887,2273,19614,89.6,129,51,39.5
4,All Students,2022-23,20442,1741,18701,91.5,126,41,32.5
5,All Students,2018-19,25350,1466,23884,94.2,152,34,22.4
5,All Students,2019-20,14778,958,13820,93.5,137,32,23.4
5,All Students,2020-21,20679,2638,18041,87.2,121,48,39.7
5,All Students,2021-22,22697,2154,20543,90.5,136,42,30.9
5,All Students,2022-23,20227,1534,18693,92.4,126,32,25.4
All Grades,All Students,2018-19,289583,21059,268524,92.7,1708,447,26.2
All Grades,All Students,2019-20,188093,14038,174055,92.5,1690,460,27.2
All Grades,All Students,2020-21,267150,25922,241228,90.3,1565,464,29.6
All Grades,All Students,2021-22,238448,28812,209636,87.9,1418,675,47.6
All Grades,All Students,2022-23,224624,22695,201929,89.9,1340,521,38.9
PK in K-12 Schools,All Students,2018-19,6299,637,5662,89.9,36,17,47.2
PK in K-12 Schools,All Students,2019-20,4023,409,3614,89.8,36,13,36.1
PK in K-12 Schools,All Students,2020-21,6015,1062,4953,82.3,36,21,58.3
PK in K-12 Schools,All Students,2021-22,6134,961,5173,84.3,37,28,75.7
PK in K-12 Schools,All Students,2022-23,6164,741,5423,88.0,38,18,47.4
0K,All Students,2018-19,38063,4007,34056,89.5,227,94,41.4
0K,All Students,2019-20,24388,2427,21961,90.0,222,85,38.3
0K,All Students,2020-21,34226,5093,29133,85.1,202,81,40.1
0K,All Students,2021-22,24575,3450,21125,86.0,148,90,60.8
0K,All Students,2022-23,28310,3736,24574,86.8,173,87,50.3
1,All Students,2018-19,43238,3403,39835,92.1,262,78,29.8
1,All Students,2019-20,24314,2239,22075,90.8,224,89,39.7
1,All Students,2020-21,34277,4260,30017,87.6,200,81,40.5
1,All Students,2021-22,33539,4646,28893,86.1,202,112,55.4
1,All Students,2022-23,25163,2919,22244,88.4,159,80,50.3
2,All Students,2018-19,40810,2705,38105,93.4,240,51,21.3
2,All Students,2019-20,27626,1952,25674,92.9,248,60,24.2
2,All Students,2020-21,35565,3919,31646,89.0,207,70,33.8
2,All Students,2021-22,31413,4083,27330,87.0,189,92,48.7
2,All Students,2022-23,32893,3128,29765,90.5,191,75,39.3
3,All Students,2018-19,40864,2520,38344,93.8,240,51,21.3
3,All Students,2019-20,27248,1642,25606,94.0,245,50,20.4
3,All Students,2020-21,39750,3055,36695,92.3,233,67,28.8
3,All Students,2021-22,32490,3729,28761,88.5,191,83,43.5
3,All Students,2022-23,30468,2722,27746,91.1,180,61,33.9
4,All Students,2018-19,44989,3038,41951,93.2,263,67,25.5
4,All Students,2019-20,27251,1613,25638,94.1,243,44,18.1
4,All Students,2020-21,40411,2902,37509,92.8,238,47,19.7
4,All Students,2021-22,40486,4056,36430,90.0,240,93,38.8
4,All Students,2022-23,32009,3122,28887,90.2,190,68,35.8
5,All Students,2018-19,42511,2761,39750,93.5,250,56,22.4
5,All Students,2019-20,29322,1961,27361,93.3,263,62,23.6
5,All Students,2020-21,39867,2567,37300,93.6,232,41,17.7
5,All Students,2021-22,36805,3934,32871,89.3,217,95,43.8
5,All Students,2022-23,38679,3128,35551,91.9,222,58,26.1
6,All Students,2018-19,32809,1988,30821,93.9,190,33,17.4
6,All Students,2019-20,23921,1795,22126,92.5,209,57,27.3
6,All Students,2020-21,37039,3064,33975,91.7,217,56,25.8
6,All Students,2021-22,33006,3953,29053,88.0,194,82,42.3
6,All Students,2022-23,30938,3199,27739,89.7,187,74,39.6
All Grades,All Students,2018-19,116784,10039,106745,91.4,710,257,36.2
All Grades,All Students,2019-20,68512,5714,62798,91.7,643,201,31.3
All Grades,All Students,2020-21,92268,8632,83636,90.6,546,172,31.5
All Grades,All Students,2021-22,78205,10493,67712,86.6,482,269,55.8
All Grades,All Students,2022-23,69762,7388,62374,89.4,432,194,44.9
0K,All Students,2018-19,15299,1673,13626,89.1,95,43,45.3
0K,All Students,2019-20,10758,1228,9530,88.6,101,49,48.5
0K,All Students,2020-21,10332,1815,8517,82.4,60,34,56.7
0K,All Students,2021-22,11864,2226,9638,81.2,75,62,82.7
0K,All Students,2022-23,9999,1166,8833,88.3,63,33,52.4
1,All Students,2018-19,20027,2043,17984,89.8,124,60,48.4
1,All Students,2019-20,10695,1058,9637,90.1,102,37,36.3
1,All Students,2020-21,16113,1479,14634,90.8,96,30,31.3
1,All Students,2021-22,10234,1391,8843,86.4,66,40,60.6
1,All Students,2022-23,10772,1439,9333,86.6,65,43,66.2
2,All Students,2018-19,19809,1784,18025,91.0,122,51,41.8
2,All Students,2019-20,11861,898,10963,92.4,117,32,27.4
2,All Students,2020-21,14716,1325,13391,91.0,88,25,28.4
2,All Students,2021-22,12559,1675,10884,86.7,79,42,53.2
2,All Students,2022-23,9639,s,s,s,s,s,s
3,All Students,2018-19,20447,1528,18919,92.5,123,35,28.5
3,All Students,2019-20,11797,958,10839,91.9,107,37,34.6
3,All Students,2020-21,17412,1824,15588,89.5,103,38,36.9
3,All Students,2021-22,12444,1414,11030,88.6,77,33,42.9
3,All Students,2022-23,12594,1292,11302,89.7,78,30,38.5
4,All Students,2018-19,19631,1432,18199,92.7,118,31,26.3
4,All Students,2019-20,11813,824,10989,93.0,113,24,21.2
4,All Students,2020-21,16409,1138,15271,93.1,97,28,28.9
4,All Students,2021-22,15344,1965,13379,87.2,94,48,51.1
4,All Students,2022-23,11743,903,10840,92.3,72,17,23.6
5,All Students,2018-19,21571,1579,19992,92.7,128,37,28.9
5,All Students,2019-20,11588,748,10840,93.5,103,22,21.4
5,All Students,2020-21,17286,1051,16235,93.9,102,17,16.7
5,All Students,2021-22,15760,1822,13938,88.4,91,44,48.4
5,All Students,2022-23,15012,1621,13391,89.2,92,39,42.4
6,All Students,2022-23,3,s,s,s,s,s,s
All Grades,All Students,2018-19,215224,20240,194984,90.6,1304,539,41.3
All Grades,All Students,2019-20,132129,11374,120755,91.4,1203,419,34.8
All Grades,All Students,2020-21,185084,17217,167867,90.7,1090,371,34.0
All Grades,All Students,2021-22,163999,22151,141848,86.5,984,560,56.9
All Grades,All Students,2022-23,152719,17446,135273,88.6,934,455,48.7
PK in K-12 Schools,All Students,2020-21,4,s,s,s,s,s,s
0K,All Students,2018-19,35903,4215,31688,88.3,219,116,53.0
0K,All Students,2019-20,20072,s,s,s,s,s,s
0K,All Students,2020-21,25587,s,s,s,s,s,s
0K,All Students,2021-22,23533,s,s,s,s,s,s
0K,All Students,2022-23,22488,3578,18910,84.1,140,98,70.0
1,All Students,2018-19,38024,4026,33998,89.4,236,112,47.5
1,All Students,2019-20,24201,2358,21843,90.3,223,91,40.8
1,All Students,2020-21,27639,2682,24957,90.3,163,58,35.6
1,All Students,2021-22,23884,3673,20211,84.6,146,90,61.6
1,All Students,2022-23,22475,2750,19725,87.8,139,79,56.8
2,All Students,2018-19,37105,3176,33929,91.4,222,86,38.7
2,All Students,2019-20,22343,2011,20332,91.0,201,82,40.8
2,All Students,2020-21,35525,2826,32699,92.0,210,68,32.4
2,All Students,2021-22,26943,3528,23415,86.9,163,92,56.4
2,All Students,2022-23,22647,2817,19830,87.6,141,68,48.2
3,All Students,2018-19,36006,3129,32877,91.3,220,79,35.9
3,All Students,2019-20,22004,1655,20349,92.5,202,56,27.7
3,All Students,2020-21,32035,2879,29156,91.0,186,58,31.2
3,All Students,2021-22,31615,4201,27414,86.7,187,105,56.1
3,All Students,2022-23,25956,2654,23302,89.8,158,67,42.4
4,All Students,2018-19,34316,2856,31460,91.7,210,75,35.7
4,All Students,2019-20,22078,1512,20566,93.2,201,45,22.4
4,All Students,2020-21,31731,2602,29129,91.8,185,59,31.9
4,All Students,2021-22,28421,3630,24791,87.2,165,89,53.9
4,All Students,2022-23,30646,2868,27778,90.6,185,72,38.9
5,All Students,2018-19,33870,2838,31032,91.6,197,71,36.0
5,All Students,2019-20,21402,1552,19850,92.7,193,54,28.0
5,All Students,2020-21,32548,2406,30142,92.6,191,52,27.2
5,All Students,2021-22,29602,3628,25974,87.7,175,91,52.0
5,All Students,2022-23,28507,2779,25728,90.3,171,71,41.5
6,All Students,2021-22,1,s,s,s,s,s,s
7,All Students,2019-20,29,s,s,s,s,s,s
All Grades,All Students,2018-19,220168,19584,200584,91.1,1305,437,33.5
All Grades,All Students,2019-20,131147,11572,119575,91.2,1192,381,32.0
All Grades,All Students,2020-21,181283,22440,158843,87.6,1067,440,41.2
All Grades,All Students,2021-22,171495,20967,150528,87.8,1025,499,48.7
All Grades,All Students,2022-23,164531,16548,147983,89.9,989,365,36.9
0K,All Students,2018-19,18194,2213,15981,87.8,114,56,49.1
0K,All Students,2019-20,11807,s,s,s,s,s,s
0K,All Students,2020-21,13266,1240,12026,90.7,79,30,38.0
0K,All Students,2021-22,16727,2497,14230,85.1,103,69,67.0
0K,All Students,2022-23,12538,1618,10920,87.1,78,44,56.4
1,All Students,2018-19,21851,2221,19630,89.8,138,50,36.2
1,All Students,2019-20,13016,1352,11664,89.6,118,46,39.0
1,All Students,2020-21,17608,2018,15590,88.5,107,44,41.1
1,All Students,2021-22,15643,1867,13776,88.1,94,41,43.6
1,All Students,2022-23,17124,1867,15257,89.1,101,46,45.5
2,All Students,2018-19,22344,1907,20437,91.5,133,44,33.1
2,All Students,2019-20,12918,1121,11797,91.3,119,39,32.8
2,All Students,2020-21,18708,2181,16527,88.3,110,43,39.1
2,All Students,2021-22,15019,s,s,s,s,s,s
2,All Students,2022-23,16729,1577,15152,90.6,98,34,34.7
3,All Students,2018-19,24783,2065,22718,91.7,145,42,29.0
3,All Students,2019-20,12277,1039,11238,91.5,111,36,32.4
3,All Students,2020-21,18542,1595,16947,91.4,109,40,36.7
3,All Students,2021-22,19364,2676,16688,86.2,115,59,51.3
3,All Students,2022-23,14501,1248,13253,91.4,89,30,33.7
4,All Students,2018-19,21434,1671,19763,92.2,128,37,28.9
4,All Students,2019-20,15248,1101,14147,92.8,138,37,26.8
4,All Students,2020-21,19440,1407,18033,92.8,115,27,23.5
4,All Students,2021-22,16784,1749,15035,89.6,101,45,44.6
4,All Students,2022-23,19403,1971,17432,89.8,116,38,32.8
5,All Students,2018-19,26247,1821,24426,93.1,151,30,19.9
5,All Students,2019-20,12262,778,11484,93.7,112,25,22.3
5,All Students,2020-21,22182,1600,20582,92.8,130,30,23.1
5,All Students,2021-22,17600,2017,15583,88.5,106,43,40.6
5,All Students,2022-23,17229,1380,15849,92.0,101,27,26.7
6,All Students,2018-19,27060,2187,24873,91.9,159,53,33.3
6,All Students,2019-20,16713,1323,15390,92.1,151,43,28.5
6,All Students,2020-21,22010,3052,18958,86.1,131,65,49.6
6,All Students,2021-22,25529,2798,22731,89.0,154,71,46.1
6,All Students,2022-23,21433,2083,19350,90.3,137,45,32.8
7,All Students,2018-19,29838,2662,27176,91.1,174,62,35.6
7,All Students,2019-20,17236,1341,15895,92.2,158,47,29.7
7,All Students,2020-21,23704,4122,19582,82.6,137,74,54.0
7,All Students,2021-22,20625,2351,18274,88.6,121,59,48.8
7,All Students,2022-23,23858,2439,21419,89.8,141,50,35.5
8,All Students,2018-19,28417,2837,25580,90.0,163,63,38.7
8,All Students,2019-20,19606,2063,17543,89.5,175,61,34.9
8,All Students,2020-21,25823,5225,20598,79.8,149,87,58.4
8,All Students,2021-22,24122,3333,20789,86.2,140,71,50.7
8,All Students,2022-23,21716,2365,19351,89.1,128,51,39.8
9,All Students,2019-20,64,s,s,s,s,s,s
9,All Students,2021-22,82,s,s,s,s,s,s
All Grades,All Students,2018-19,196649,17307,179342,91.2,1153,341,29.6
All Grades,All Students,2019-20,119704,9153,110551,92.4,1086,291,26.8
All Grades,All Students,2020-21,166547,21850,144697,86.9,985,432,43.9
All Grades,All Students,2021-22,136231,19350,116881,85.8,819,419,51.2
All Grades,All Students,2022-23,112026,12254,99772,89.1,683,275,40.3
6,All Students,2018-19,65321,4806,60515,92.6,390,94,24.1
6,All Students,2019-20,37010,s,s,s,s,s,s
6,All Students,2020-21,53425,7870,45555,85.3,314,153,48.7
6,All Students,2021-22,36671,6144,30527,83.2,229,135,59.0
6,All Students,2022-23,30326,2506,27820,91.7,192,59,30.7
7,All Students,2018-19,68006,5760,62246,91.5,400,124,31.0
7,All Students,2019-20,40180,3041,37139,92.4,361,92,25.5
7,All Students,2020-21,53914,6637,47277,87.7,315,127,40.3
7,All Students,2021-22,47527,5941,41586,87.5,286,127,44.4
7,All Students,2022-23,34976,4608,30368,86.8,209,102,48.8
8,All Students,2018-19,63192,6664,56528,89.5,362,122,33.7
8,All Students,2019-20,42498,3611,38887,91.5,383,111,29.0
8,All Students,2020-21,58826,7134,51692,87.9,347,144,41.5
8,All Students,2021-22,52033,7265,44768,86.0,304,157,51.6
8,All Students,2022-23,46724,5140,41584,89.0,282,114,40.4
9,All Students,2018-19,129,s,s,s,s,s,s
9,All Students,2019-20,16,s,s,s,s,s,s
9,All Students,2020-21,370,s,s,s,s,s,s
10,All Students,2018-19,1,s,s,s,s,s,s
10,All Students,2020-21,12,s,s,s,s,s,s
All Grades,All Students,2018-19,257486,15844,241642,93.8,1554,260,16.7
All Grades,All Students,2019-20,172626,9954,162672,94.2,1570,258,16.4
All Grades,All Students,2020-21,272497,25571,246926,90.6,1583,433,27.4
All Grades,All Students,2021-22,246640,11970,234670,95.1,1485,205,13.8
All Grades,All Students,2022-23,235497,16230,219267,93.1,1437,266,18.5
6,All Students,2018-19,48658,2338,46320,95.2,281,36,12.8
6,All Students,2019-20,31056,1370,29686,95.6,280,31,11.1
6,All Students,2020-21,49104,4329,44775,91.2,285,81,28.4
6,All Students,2021-22,40947,1515,39432,96.3,240,23,9.6
6,All Students,2022-23,41773,2204,39569,94.7,242,30,12.4
7,All Students,2018-19,48471,2651,45820,94.5,284,39,13.7
7,All Students,2019-20,30941,1446,29495,95.3,279,32,11.5
7,All Students,2020-21,44102,3443,40659,92.2,257,57,22.2
7,All Students,2021-22,46900,1797,45103,96.2,278,30,10.8
7,All Students,2022-23,36416,2082,34334,94.3,226,35,15.5
8,All Students,2018-19,41483,2115,39368,94.9,250,36,14.4
8,All Students,2019-20,30520,1838,28682,94.0,273,46,16.8
8,All Students,2020-21,46948,3225,43723,93.1,275,64,23.3
8,All Students,2021-22,42883,1856,41027,95.7,260,29,11.2
8,All Students,2022-23,44820,2886,41934,93.6,276,53,19.2
9,All Students,2018-19,34862,2446,32416,93.0,216,34,15.7
9,All Students,2019-20,21719,1296,20423,94.0,203,32,15.8
9,All Students,2020-21,37720,4211,33509,88.8,221,68,30.8
9,All Students,2021-22,29513,1532,27981,94.8,182,28,15.4
9,All Students,2022-23,33194,2117,31077,93.6,206,29,14.1
10,All Students,2018-19,32861,2485,30376,92.4,209,49,23.4
10,All Students,2019-20,21666,1495,20171,93.1,200,40,20.0
10,All Students,2020-21,33914,4070,29844,88.0,197,64,32.5
10,All Students,2021-22,33822,2153,31669,93.6,207,47,22.7
10,All Students,2022-23,27432,2564,24868,90.7,167,38,22.8
11,All Students,2018-19,25488,1432,24056,94.4,158,20,12.7
11,All Students,2019-20,19749,1085,18664,94.5,181,28,15.5
11,All Students,2020-21,29545,2685,26860,90.9,169,35,20.7
11,All Students,2021-22,26043,1441,24602,94.5,161,27,16.8
11,All Students,2022-23,27974,2132,25842,92.4,172,36,20.9
12,All Students,2018-19,25663,2377,23286,90.7,156,46,29.5
12,All Students,2019-20,16975,1424,15551,91.6,154,49,31.8
12,All Students,2020-21,31164,3608,27556,88.4,179,64,35.8
12,All Students,2021-22,26532,1676,24856,93.7,157,21,13.4
12,All Students,2022-23,23888,2245,21643,90.6,148,45,30.4
All Grades,All Students,2018-19,34054,3050,31004,91.0,202,76,37.6
All Grades,All Students,2019-20,22168,1741,20427,92.1,200,62,31.0
All Grades,All Students,2020-21,27247,2428,24819,91.1,163,57,35.0
All Grades,All Students,2021-22,27202,3468,23734,87.3,160,77,48.1
All Grades,All Students,2022-23,25580,2125,23455,91.7,162,45,27.8
0K,All Students,2018-19,4448,352,4096,92.1,26,7,26.9
0K,All Students,2019-20,2724,256,2468,90.6,25,10,40.0
0K,All Students,2020-21,4227,390,3837,90.8,26,10,38.5
0K,All Students,2021-22,5213,832,4381,84.0,32,18,56.3
0K,All Students,2022-23,3720,364,3356,90.2,26,12,46.2
1,All Students,2018-19,4544,475,4069,89.5,28,10,35.7
1,All Students,2019-20,2646,157,2489,94.1,23,5,21.7
1,All Students,2020-21,3788,251,3537,93.4,23,6,26.1
1,All Students,2021-22,4141,395,3746,90.5,25,11,44.0
1,All Students,2022-23,4991,548,4443,89.0,31,10,32.3
2,All Students,2018-19,7022,708,6314,89.9,42,23,54.8
2,All Students,2019-20,2929,216,2713,92.6,27,7,25.9
2,All Students,2020-21,3785,320,3465,91.5,22,8,36.4
2,All Students,2021-22,3404,418,2986,87.7,20,7,35.0
2,All Students,2022-23,4656,281,4375,94.0,28,5,17.9
3,All Students,2018-19,5895,526,5369,91.1,35,12,34.3
3,All Students,2019-20,4470,383,4087,91.4,41,17,41.5
3,All Students,2020-21,4285,439,3846,89.8,25,8,32.0
3,All Students,2021-22,4028,399,3629,90.1,23,8,34.8
3,All Students,2022-23,3171,257,2914,91.9,22,6,27.3
4,All Students,2018-19,8051,655,7396,91.9,48,16,33.3
4,All Students,2019-20,3998,355,3643,91.1,35,10,28.6
4,All Students,2020-21,6027,550,5477,90.9,37,12,32.4
4,All Students,2021-22,4233,568,3665,86.6,25,15,60.0
4,All Students,2022-23,4025,257,3768,93.6,25,5,20.0
5,All Students,2018-19,4094,334,3760,91.8,23,8,34.8
5,All Students,2019-20,5401,374,5027,93.1,49,13,26.5
5,All Students,2020-21,5135,478,4657,90.7,30,13,43.3
5,All Students,2021-22,6183,856,5327,86.2,35,18,51.4
5,All Students,2022-23,5017,418,4599,91.7,30,7,23.3
All Grades,All Students,2018-19,168399,13014,155385,92.3,1003,304,30.3
All Grades,All Students,2019-20,104032,7181,96851,93.1,955,238,24.9
All Grades,All Students,2020-21,139059,17433,121626,87.5,834,330,39.6
All Grades,All Students,2021-22,122719,15491,107228,87.4,750,375,50.0
All Grades,All Students,2022-23,106631,11129,95502,89.6,650,271,41.7
0K,All Students,2018-19,22788,1985,20803,91.3,141,49,34.8
0K,All Students,2019-20,15179,1417,13762,90.7,141,47,33.3
0K,All Students,2020-21,15610,2550,13060,83.7,97,50,51.5
0K,All Students,2021-22,16788,2182,14606,87.0,106,63,59.4
0K,All Students,2022-23,13004,s,s,s,s,s,s
1,All Students,2018-19,28592,2312,26280,91.9,173,51,29.5
1,All Students,2019-20,15755,1207,14548,92.3,146,45,30.8
1,All Students,2020-21,23159,3544,19615,84.7,138,72,52.2
1,All Students,2021-22,15610,1969,13641,87.4,95,52,54.7
1,All Students,2022-23,16231,1727,14504,89.4,98,41,41.8
2,All Students,2018-19,28805,2479,26326,91.4,174,64,36.8
2,All Students,2019-20,17256,1113,16143,93.6,160,37,23.1
2,All Students,2020-21,24080,3506,20574,85.4,143,65,45.5
2,All Students,2021-22,21675,3075,18600,85.8,137,72,52.6
2,All Students,2022-23,15161,1600,13561,89.4,95,40,42.1
3,All Students,2018-19,28663,2230,26433,92.2,169,53,31.4
3,All Students,2019-20,17450,1246,16204,92.9,157,41,26.1
3,All Students,2020-21,24146,2836,21310,88.3,146,48,32.9
3,All Students,2021-22,22124,3046,19078,86.2,133,65,48.9
3,All Students,2022-23,20611,2207,18404,89.3,123,53,43.1
4,All Students,2018-19,33757,2479,31278,92.7,197,58,29.4
4,All Students,2019-20,16998,1003,15995,94.1,157,29,18.5
4,All Students,2020-21,26680,2595,24085,90.3,161,48,29.8
4,All Students,2021-22,22191,2444,19747,89.0,137,59,43.1
4,All Students,2022-23,21013,2319,18694,89.0,126,48,38.1
5,All Students,2018-19,25794,1529,24265,94.1,149,29,19.5
5,All Students,2019-20,21394,1195,20199,94.4,194,39,20.1
5,All Students,2020-21,25384,2402,22982,90.5,149,47,31.5
5,All Students,2021-22,24331,2775,21556,88.6,142,64,45.1
5,All Students,2022-23,20574,1806,18768,91.2,123,40,32.5
6,All Students,2022-23,37,s,s,s,s,s,s
All Grades,All Students,2018-19,41615,3989,37626,90.4,258,91,35.3
All Grades,All Students,2019-20,30964,2598,28366,91.6,281,74,26.3
All Grades,All Students,2020-21,44316,3968,40348,91.0,258,68,26.4
All Grades,All Students,2021-22,36957,5015,31942,86.4,227,124,54.6
All Grades,All Students,2022-23,32516,3572,28944,89.0,205,80,39.0
6,All Students,2018-19,17250,1598,15652,90.7,104,34,32.7
6,All Students,2019-20,10206,906,9300,91.1,93,25,26.9
6,All Students,2020-21,11916,1175,10741,90.1,70,22,31.4
6,All Students,2021-22,11295,1427,9868,87.4,71,37,52.1
6,All Students,2022-23,9191,790,8401,91.4,59,15,25.4
7,All Students,2018-19,12268,1211,11057,90.1,78,30,38.5
7,All Students,2019-20,12342,1023,11319,91.7,110,26,23.6
7,All Students,2020-21,14638,1023,13615,93.0,86,17,19.8
7,All Students,2021-22,11171,1565,9606,86.0,67,35,52.2
7,All Students,2022-23,12645,1507,11138,88.1,80,40,50.0
8,All Students,2018-19,12095,s,s,s,s,s,s
8,All Students,2019-20,8416,669,7747,92.1,78,23,29.5
8,All Students,2020-21,17762,1770,15992,90.0,102,29,28.4
8,All Students,2021-22,14491,2023,12468,86.0,89,52,58.4
8,All Students,2022-23,10680,1275,9405,88.1,66,25,37.9
9,All Students,2018-19,2,s,s,s,s,s,s
All Grades,All Students,2018-19,59758,5485,54273,90.8,362,135,37.3
All Grades,All Students,2019-20,43001,3670,39331,91.5,391,121,30.9
All Grades,All Students,2020-21,69633,7142,62491,89.7,406,148,36.5
All Grades,All Students,2021-22,60858,6706,54152,89.0,374,171,45.7
All Grades,All Students,2022-23,61161,5540,55621,90.9,376,148,39.4
PK in K-12 Schools,All Students,2018-19,6191,580,5611,90.6,37,12,32.4
PK in K-12 Schools,All Students,2019-20,3874,374,3500,90.3,38,17,44.7
PK in K-12 Schools,All Students,2020-21,3763,429,3334,88.6,22,10,45.5
PK in K-12 Schools,All Students,2021-22,4723,577,4146,87.8,35,16,45.7
PK in K-12 Schools,All Students,2022-23,5776,782,4994,86.5,42,27,64.3
0K,All Students,2018-19,10639,1059,9580,90.0,69,29,42.0
0K,All Students,2019-20,6880,644,6236,90.6,65,22,33.8
0K,All Students,2020-21,10390,1595,8795,84.6,61,33,54.1
0K,All Students,2021-22,7752,987,6765,87.3,49,28,57.1
0K,All Students,2022-23,8654,917,7737,89.4,54,29,53.7
1,All Students,2018-19,17737,1648,16089,90.7,107,37,34.6
1,All Students,2019-20,6305,529,5776,91.6,56,16,28.6
1,All Students,2020-21,9969,996,8973,90.0,59,18,30.5
1,All Students,2021-22,8054,1150,6904,85.7,51,32,62.7
1,All Students,2022-23,8071,843,7228,89.6,50,26,52.0
2,All Students,2018-19,11440,942,10498,91.8,67,27,40.3
2,All Students,2019-20,10551,908,9643,91.4,95,28,29.5
2,All Students,2020-21,8929,1179,7750,86.8,53,23,43.4
2,All Students,2021-22,10090,908,9182,91.0,60,23,38.3
2,All Students,2022-23,7734,740,6994,90.4,47,19,40.4
3,All Students,2018-19,13751,1256,12495,90.9,82,30,36.6
3,All Students,2019-20,6980,487,6493,93.0,62,16,25.8
3,All Students,2020-21,13630,1394,12236,89.8,78,30,38.5
3,All Students,2021-22,7934,764,7170,90.4,46,18,39.1
3,All Students,2022-23,9851,767,9084,92.2,58,16,27.6
4,All Students,2019-20,8411,728,7683,91.3,75,22,29.3
4,All Students,2020-21,10598,663,9935,93.7,62,17,27.4
4,All Students,2021-22,13007,1380,11627,89.4,76,30,39.5
4,All Students,2022-23,7958,547,7411,93.1,47,11,23.4
5,All Students,2020-21,12354,886,11468,92.8,71,17,23.9
5,All Students,2021-22,9298,940,8358,89.9,57,24,42.1
5,All Students,2022-23,13117,944,12173,92.8,78,20,25.6
All Grades,All Students,2018-19,48557,3067,45490,93.7,282,60,21.3
All Grades,All Students,2019-20,31670,2141,29529,93.2,288,62,21.5
All Grades,All Students,2020-21,43704,3505,40199,92.0,259,78,30.1
All Grades,All Students,2021-22,38553,4504,34049,88.3,230,118,51.3
All Grades,All Students,2022-23,32320,2685,29635,91.7,195,58,29.7
PK in K-12 Schools,All Students,2018-19,6357,371,5986,94.2,36,6,16.7
PK in K-12 Schools,All Students,2019-20,4025,336,3689,91.7,40,10,25.0
PK in K-12 Schools,All Students,2020-21,5590,417,5173,92.5,34,11,32.4
PK in K-12 Schools,All Students,2021-22,6093,811,5282,86.7,36,20,55.6
PK in K-12 Schools,All Students,2022-23,6103,s,s,s,s,s,s
0K,All Students,2018-19,16232,1072,15160,93.4,95,23,24.2
0K,All Students,2019-20,10123,709,9414,93.0,93,23,24.7
0K,All Students,2020-21,11155,1097,10058,90.2,66,20,30.3
0K,All Students,2021-22,12291,1522,10769,87.6,74,41,55.4
0K,All Students,2022-23,10188,901,9287,91.2,59,15,25.4
1,All Students,2018-19,13861,910,12951,93.4,80,18,22.5
1,All Students,2019-20,9023,536,8487,94.1,80,12,15.0
1,All Students,2020-21,14575,1100,13475,92.5,85,27,31.8
1,All Students,2021-22,9187,1107,8080,88.0,55,30,54.5
1,All Students,2022-23,9349,725,8624,92.2,57,17,29.8
2,All Students,2018-19,12107,714,11393,94.1,71,13,18.3
2,All Students,2019-20,8499,560,7939,93.4,75,17,22.7
2,All Students,2020-21,12384,891,11493,92.8,74,20,27.0
2,All Students,2021-22,10982,1064,9918,90.3,65,27,41.5
2,All Students,2022-23,6677,493,6184,92.6,40,11,27.5
3,All Students,2022-23,3,s,s,s,s,s,s
All Grades,All Students,2018-19,63696,13388,50308,79.0,406,211,52.0
All Grades,All Students,2019-20,41813,8329,33484,80.1,389,190,48.8
All Grades,All Students,2020-21,63382,14193,49189,77.6,371,176,47.4
All Grades,All Students,2021-22,63851,12829,51022,79.9,392,241,61.5
All Grades,All Students,2022-23,58297,10678,47619,81.7,375,219,58.4
9,All Students,2018-19,19677,4540,15137,76.9,132,61,46.2
9,All Students,2019-20,15264,3222,12042,78.9,146,74,50.7
9,All Students,2020-21,16547,4725,11822,71.4,102,60,58.8
9,All Students,2021-22,17688,3172,14516,82.1,109,63,57.8
9,All Students,2022-23,12175,1756,10419,85.6,83,36,43.4
10,All Students,2018-19,17461,4662,12799,73.3,110,68,61.8
10,All Students,2019-20,10945,2043,8902,81.3,97,37,38.1
10,All Students,2020-21,16038,3157,12881,80.3,92,43,46.7
10,All Students,2021-22,14956,2924,12032,80.4,95,60,63.2
10,All Students,2022-23,16157,3154,13003,80.5,105,68,64.8
11,All Students,2018-19,14990,2559,12431,82.9,94,47,50.0
11,All Students,2019-20,8202,1523,6679,81.4,77,37,48.1
11,All Students,2020-21,15401,2715,12686,82.4,88,29,33.0
11,All Students,2021-22,17146,3659,13487,78.7,104,68,65.4
11,All Students,2022-23,13701,2253,11448,83.6,86,50,58.1
12,All Students,2018-19,11568,1627,9941,85.9,70,35,50.0
12,All Students,2019-20,7402,1541,5861,79.2,69,42,60.9
12,All Students,2020-21,15396,3596,11800,76.6,89,44,49.4
12,All Students,2021-22,14061,3074,10987,78.1,84,50,59.5
12,All Students,2022-23,16264,3515,12749,78.4,101,65,64.4
All Grades,All Students,2018-19,89777,11521,78256,87.2,548,217,39.6
All Grades,All Students,2019-20,57639,6380,51259,88.9,537,207,38.5
All Grades,All Students,2020-21,94176,18027,76149,80.9,548,313,57.1
All Grades,All Students,2021-22,93300,18016,75284,80.7,564,356,63.1
All Grades,All Students,2022-23,80061,15116,64945,81.1,509,312,61.3
6,All Students,2018-19,11540,861,10679,92.5,70,16,22.9
6,All Students,2019-20,7988,693,7295,91.3,74,24,32.4
6,All Students,2020-21,12417,1542,10875,87.6,72,28,38.9
6,All Students,2021-22,9487,1566,7921,83.5,60,36,60.0
6,All Students,2022-23,5680,553,5127,90.3,36,14,38.9
7,All Students,2018-19,11446,851,10595,92.6,67,16,23.9
7,All Students,2019-20,6947,480,6467,93.1,62,14,22.6
7,All Students,2020-21,11805,1534,10271,87.0,69,34,49.3
7,All Students,2021-22,10627,1303,9324,87.7,64,35,54.7
7,All Students,2022-23,6917,1034,5883,85.1,45,26,57.8
8,All Students,2018-19,10633,714,9919,93.3,62,14,22.6
8,All Students,2019-20,6879,576,6303,91.6,62,17,27.4
8,All Students,2020-21,9145,1042,8103,88.6,53,20,37.7
8,All Students,2021-22,10665,1348,9317,87.4,63,33,52.4
8,All Students,2022-23,8280,905,7375,89.1,49,22,44.9
9,All Students,2018-19,17065,3261,13804,80.9,106,49,46.2
9,All Students,2019-20,12805,1804,11001,85.9,125,57,45.6
9,All Students,2020-21,22157,6052,16105,72.7,129,90,69.8
9,All Students,2021-22,22592,5677,16915,74.9,138,91,65.9
9,All Students,2022-23,17438,4046,13392,76.8,115,74,64.3
10,All Students,2018-19,13936,2698,11238,80.6,87,40,46.0
10,All Students,2019-20,8482,1120,7362,86.8,81,35,43.2
10,All Students,2020-21,16725,3658,13067,78.1,98,66,67.3
10,All Students,2021-22,16977,3577,13400,78.9,104,72,69.2
10,All Students,2022-23,16968,3661,13307,78.4,106,71,67.0
11,All Students,2018-19,12304,1413,10891,88.5,77,39,50.6
11,All Students,2019-20,6762,579,6183,91.4,62,18,29.0
11,All Students,2020-21,11110,2493,8617,77.6,64,44,68.8
11,All Students,2021-22,13026,2582,10444,80.2,77,48,62.3
11,All Students,2022-23,13604,2556,11048,81.2,88,55,62.5
12,All Students,2018-19,12853,1723,11130,86.6,79,43,54.4
12,All Students,2019-20,7776,1128,6648,85.5,71,42,59.2
12,All Students,2020-21,10817,1706,9111,84.2,63,31,49.2
12,All Students,2021-22,9926,1963,7963,80.2,58,41,70.7
12,All Students,2022-23,11174,2361,8813,78.9,70,50,71.4
All Grades,All Students,2018-19,79349,5055,74294,93.6,482,101,21.0
All Grades,All Students,2019-20,47337,3166,44171,93.3,437,86,19.7
All Grades,All Students,2020-21,63426,6264,57162,90.1,384,133,34.6
All Grades,All Students,2021-22,62389,6283,56106,89.9,383,149,38.9
All Grades,All Students,2022-23,60405,5000,55405,91.7,371,109,29.4
PK in K-12 Schools,All Students,2018-19,6286,485,5801,92.3,36,11,30.6
PK in K-12 Schools,All Students,2019-20,3997,395,3602,90.1,37,11,29.7
PK in K-12 Schools,All Students,2020-21,3636,521,3115,85.7,23,14,60.9
PK in K-12 Schools,All Students,2021-22,8107,1101,7006,86.4,56,33,58.9
PK in K-12 Schools,All Students,2022-23,8664,885,7779,89.8,53,21,39.6
0K,All Students,2018-19,10560,823,9737,92.2,66,21,31.8
0K,All Students,2019-20,6749,493,6256,92.7,64,16,25.0
0K,All Students,2020-21,9987,1709,8278,82.9,62,42,67.7
0K,All Students,2021-22,10093,1281,8812,87.3,63,32,50.8
0K,All Students,2022-23,8166,922,7244,88.7,51,23,45.1
1,All Students,2018-19,12830,829,12001,93.5,82,21,25.6
1,All Students,2019-20,6917,460,6457,93.3,63,11,17.5
1,All Students,2020-21,9047,754,8293,91.7,56,18,32.1
1,All Students,2021-22,8419,948,7471,88.7,51,26,51.0
1,All Students,2022-23,10900,959,9941,91.2,69,23,33.3
2,All Students,2018-19,12937,862,12075,93.3,80,15,18.8
2,All Students,2019-20,7322,474,6848,93.5,67,13,19.4
2,All Students,2020-21,10093,1032,9061,89.8,60,20,33.3
2,All Students,2021-22,8628,785,7843,90.9,51,16,31.4
2,All Students,2022-23,7415,660,6755,91.1,46,16,34.8
3,All Students,2018-19,12148,753,11395,93.8,73,13,17.8
3,All Students,2019-20,8641,552,8089,93.6,79,14,17.7
3,All Students,2020-21,9428,860,8568,90.9,56,12,21.4
3,All Students,2021-22,8766,626,8140,92.9,53,14,26.4
3,All Students,2022-23,8202,572,7630,93.0,50,12,24.0
4,All Students,2018-19,11239,612,10627,94.6,65,9,13.8
4,All Students,2019-20,6331,362,5969,94.3,58,9,15.5
4,All Students,2020-21,11481,613,10868,94.7,68,13,19.1
4,All Students,2021-22,8217,624,7593,92.4,50,10,20.0
4,All Students,2022-23,8943,468,8475,94.8,53,4,7.5
5,All Students,2018-19,13349,691,12658,94.8,80,11,13.8
5,All Students,2019-20,7380,430,6950,94.2,69,12,17.4
5,All Students,2020-21,9754,775,8979,92.1,59,14,23.7
5,All Students,2021-22,10159,918,9241,91.0,59,18,30.5
5,All Students,2022-23,8115,534,7581,93.4,49,10,20.4
All Grades,All Students,2018-19,47587,880,46707,98.2,271,5,1.8
All Grades,All Students,2019-20,30552,650,29902,97.9,268,8,3.0
All Grades,All Students,2020-21,46645,588,46057,98.7,270,5,1.9
All Grades,All Students,2021-22,46898,2267,44631,95.2,271,35,12.9
All Grades,All Students,2022-23,47859,2751,45108,94.3,271,48,17.7
6,All Students,2018-19,15847,244,15603,98.5,90,1,1.1
6,All Students,2019-20,10256,131,10125,98.7,90,2,2.2
6,All Students,2020-21,15345,149,15196,99.0,89,1,1.1
6,All Students,2021-22,16079,1199,14880,92.5,92,20,21.7
6,All Students,2022-23,15852,1036,14816,93.5,89,18,20.2
7,All Students,2018-19,15850,350,15500,97.8,91,3,3.3
7,All Students,2019-20,10247,267,9980,97.4,90,3,3.3
7,All Students,2020-21,15988,254,15734,98.4,93,3,3.2
7,All Students,2021-22,15714,567,15147,96.4,92,8,8.7
7,All Students,2022-23,16424,1130,15294,93.1,94,22,23.4
8,All Students,2018-19,15890,286,15604,98.2,90,1,1.1
8,All Students,2019-20,10049,252,9797,97.5,88,3,3.4
8,All Students,2020-21,15312,185,15127,98.8,88,1,1.1
8,All Students,2021-22,15103,s,s,s,s,s,s
8,All Students,2022-23,15583,585,14998,96.2,88,8,9.1
9,All Students,2021-22,2,s,s,s,s,s,s
All Grades,All Students,2018-19,71615,14898,56717,79.2,477,289,60.6
All Grades,All Students,2019-20,41484,8085,33399,80.5,392,209,53.3
All Grades,All Students,2020-21,65228,9793,55435,85.0,383,144,37.6
All Grades,All Students,2021-22,51988,12212,39776,76.5,336,227,67.6
All Grades,All Students,2022-23,44467,9161,35306,79.4,306,187,61.1
9,All Students,2018-19,19645,5488,14157,72.1,148,105,70.9
9,All Students,2019-20,11867,2498,9369,79.0,115,64,55.7
9,All Students,2020-21,19065,3495,15570,81.7,112,57,50.9
9,All Students,2021-22,17218,4539,12679,73.6,118,82,69.5
9,All Students,2022-23,14276,3365,10911,76.4,100,61,61.0
10,All Students,2018-19,19630,3496,16134,82.2,128,71,55.5
10,All Students,2019-20,10274,2232,8042,78.3,101,61,60.4
10,All Students,2020-21,19211,2707,16504,85.9,115,45,39.1
10,All Students,2021-22,15512,3675,11837,76.3,101,71,70.3
10,All Students,2022-23,13152,2648,10504,79.9,94,60,63.8
11,All Students,2018-19,15619,2675,12944,82.9,99,56,56.6
11,All Students,2019-20,10581,1773,8808,83.2,98,43,43.9
11,All Students,2020-21,10480,1329,9151,87.3,60,16,26.7
11,All Students,2021-22,10859,2112,8747,80.6,67,43,64.2
11,All Students,2022-23,7829,1467,6362,81.3,55,32,58.2
12,All Students,2018-19,16721,3239,13482,80.6,102,57,55.9
12,All Students,2019-20,8762,1582,7180,81.9,78,41,52.6
12,All Students,2020-21,16472,2262,14210,86.3,96,26,27.1
12,All Students,2021-22,8399,1886,6513,77.5,50,31,62.0
12,All Students,2022-23,9210,1681,7529,81.7,57,34,59.6
All Grades,All Students,2018-19,103617,10641,92976,89.7,609,165,27.1
All Grades,All Students,2019-20,68128,6182,61946,90.9,611,142,23.2
All Grades,All Students,2020-21,111750,10955,100795,90.2,647,191,29.5
All Grades,All Students,2021-22,112275,14150,98125,87.4,667,277,41.5
All Grades,All Students,2022-23,107046,9134,97912,91.5,660,182,27.6
6,All Students,2018-19,16934,1054,15880,93.8,99,26,26.3
6,All Students,2019-20,10607,506,10101,95.2,95,16,16.8
6,All Students,2020-21,18953,2030,16923,89.3,110,34,30.9
6,All Students,2021-22,17956,2190,15766,87.8,104,52,50.0
6,All Students,2022-23,14553,1105,13448,92.4,87,23,26.4
7,All Students,2018-19,17613,1065,16548,94.0,99,15,15.2
7,All Students,2019-20,10840,468,10372,95.7,98,13,13.3
7,All Students,2020-21,15987,1029,14958,93.6,92,17,18.5
7,All Students,2021-22,17586,1467,16119,91.7,102,27,26.5
7,All Students,2022-23,16786,1549,15237,90.8,99,37,37.4
8,All Students,2018-19,15193,1016,14177,93.3,88,18,20.5
8,All Students,2019-20,10996,558,10438,94.9,97,5,5.2
8,All Students,2020-21,16014,1685,14329,89.5,92,33,35.9
8,All Students,2021-22,15097,1164,13933,92.3,90,24,26.7
8,All Students,2022-23,16821,807,16014,95.2,98,14,14.3
9,All Students,2018-19,20823,2815,18008,86.5,124,42,33.9
9,All Students,2019-20,9264,876,8388,90.5,88,33,37.5
9,All Students,2020-21,19748,1684,18064,91.5,114,25,21.9
9,All Students,2021-22,17828,2726,15102,84.7,108,51,47.2
9,All Students,2022-23,15903,1336,14567,91.6,108,29,26.9
10,All Students,2018-19,14297,1612,12685,88.7,88,30,34.1
10,All Students,2019-20,10180,813,9367,92.0,97,26,26.8
10,All Students,2020-21,14182,1382,12800,90.3,81,26,32.1
10,All Students,2021-22,17526,2255,15271,87.1,104,43,41.3
10,All Students,2022-23,15045,1528,13517,89.8,94,27,28.7
11,All Students,2018-19,7868,944,6924,88.0,49,15,30.6
11,All Students,2019-20,7653,713,6940,90.7,70,22,31.4
11,All Students,2020-21,15644,1576,14068,89.9,91,26,28.6
11,All Students,2021-22,12419,2046,10373,83.5,76,41,53.9
11,All Students,2022-23,17158,1620,15538,90.6,106,25,23.6
12,All Students,2018-19,10889,2135,8754,80.4,62,19,30.6
12,All Students,2019-20,8588,2248,6340,73.8,66,27,40.9
12,All Students,2020-21,11222,1569,9653,86.0,67,30,44.8
12,All Students,2021-22,13863,2302,11561,83.4,83,39,47.0
12,All Students,2022-23,10780,1189,9591,89.0,68,27,39.7
All Grades,All Students,2018-19,132520,9970,122550,92.5,785,214,27.3
All Grades,All Students,2019-20,83003,5292,77711,93.6,746,134,18.0
All Grades,All Students,2020-21,119557,7523,112034,93.7,703,133,18.9
All Grades,All Students,2021-22,112867,12435,100432,89.0,672,281,41.8
All Grades,All Students,2022-23,110359,10811,99548,90.2,640,228,35.6
6,All Students,2018-19,34031,s,s,s,s,s,s
6,All Students,2019-20,22252,1307,20945,94.1,201,35,17.4
6,All Students,2020-21,34309,s,s,s,s,s,s
6,All Students,2021-22,31831,3539,28292,88.9,189,81,42.9
6,All Students,2022-23,29260,2529,26731,91.4,169,50,29.6
7,All Students,2018-19,47548,4162,43386,91.2,282,88,31.2
7,All Students,2019-20,29960,1762,28198,94.1,269,42,15.6
7,All Students,2020-21,41039,2752,38287,93.3,241,54,22.4
7,All Students,2021-22,40812,4627,36185,88.7,244,109,44.7
7,All Students,2022-23,40786,3987,36799,90.2,238,91,38.2
8,All Students,2018-19,50929,3498,47431,93.1,299,73,24.4
8,All Students,2019-20,30791,2223,28568,92.8,276,57,20.7
8,All Students,2020-21,44153,2221,41932,95.0,259,31,12.0
8,All Students,2021-22,40224,4269,35955,89.4,239,91,38.1
8,All Students,2022-23,40313,4295,36018,89.3,233,87,37.3
9,All Students,2018-19,12,s,s,s,s,s,s
9,All Students,2020-21,56,s,s,s,s,s,s
All Grades,All Students,2018-19,121452,10103,111349,91.7,731,230,31.5
All Grades,All Students,2019-20,72659,5379,67280,92.6,660,180,27.3
All Grades,All Students,2020-21,101888,12015,89873,88.2,598,271,45.3
All Grades,All Students,2021-22,95403,8960,86443,90.6,582,236,40.5
All Grades,All Students,2022-23,89460,7506,81954,91.6,545,192,35.2
0K,All Students,2018-19,18321,1837,16484,90.0,112,48,42.9
0K,All Students,2019-20,10313,969,9344,90.6,99,41,41.4
0K,All Students,2020-21,15695,1727,13968,89.0,94,37,39.4
0K,All Students,2021-22,14626,1878,12748,87.2,89,55,61.8
0K,All Students,2022-23,14624,1670,12954,88.6,91,49,53.8
1,All Students,2018-19,19649,1783,17866,90.9,120,44,36.7
1,All Students,2019-20,11813,886,10927,92.5,106,27,25.5
1,All Students,2020-21,15225,2010,13215,86.8,90,42,46.7
1,All Students,2021-22,16160,1452,14708,91.0,97,34,35.1
1,All Students,2022-23,14126,1347,12779,90.5,87,41,47.1
2,All Students,2018-19,19274,1901,17373,90.1,116,45,38.8
2,All Students,2019-20,12430,861,11569,93.1,113,24,21.2
2,All Students,2020-21,16522,2200,14322,86.7,96,49,51.0
2,All Students,2021-22,14654,1371,13283,90.6,90,33,36.7
2,All Students,2022-23,15981,1396,14585,91.3,96,33,34.4
3,All Students,2018-19,16979,1245,15734,92.7,102,29,28.4
3,All Students,2019-20,13007,994,12013,92.4,116,34,29.3
3,All Students,2020-21,18865,2200,16665,88.3,111,52,46.8
3,All Students,2021-22,15735,1642,14093,89.6,99,46,46.5
3,All Students,2022-23,13673,979,12694,92.8,84,23,27.4
4,All Students,2018-19,23040,1733,21307,92.5,137,31,22.6
4,All Students,2019-20,10227,699,9528,93.2,91,22,24.2
4,All Students,2020-21,19633,2141,17492,89.1,114,51,44.7
4,All Students,2021-22,17304,1240,16064,92.8,104,33,31.7
4,All Students,2022-23,15649,1230,14419,92.1,96,32,33.3
5,All Students,2018-19,24189,1604,22585,93.4,144,33,22.9
5,All Students,2019-20,14869,970,13899,93.5,135,32,23.7
5,All Students,2020-21,15948,1737,14211,89.1,93,40,43.0
5,All Students,2021-22,16924,1377,15547,91.9,103,35,34.0
5,All Students,2022-23,15407,884,14523,94.3,91,14,15.4
All Grades,All Students,2018-19,87719,7422,80297,91.5,528,166,31.4
All Grades,All Students,2019-20,53777,3923,49854,92.7,491,118,24.0
All Grades,All Students,2020-21,82533,6482,76051,92.1,483,130,26.9
All Grades,All Students,2021-22,80606,9721,70885,87.9,481,226,47.0
All Grades,All Students,2022-23,85028,8325,76703,90.2,524,190,36.3
6,All Students,2018-19,26128,s,s,s,s,s,s
6,All Students,2019-20,15002,919,14083,93.9,137,31,22.6
6,All Students,2020-21,30171,2594,27577,91.4,175,46,26.3
6,All Students,2021-22,26698,3069,23629,88.5,161,76,47.2
6,All Students,2022-23,27780,2544,25236,90.8,169,60,35.5
7,All Students,2018-19,31648,2598,29050,91.8,189,58,30.7
7,All Students,2019-20,17573,1260,16313,92.8,160,37,23.1
7,All Students,2020-21,24738,s,s,s,s,s,s
7,All Students,2021-22,29046,3452,25594,88.1,173,81,46.8
7,All Students,2022-23,26211,2594,23617,90.1,166,61,36.7
8,All Students,2018-19,29937,2793,27144,90.7,183,65,35.5
8,All Students,2019-20,21202,1744,19458,91.8,194,50,25.8
8,All Students,2020-21,27552,2180,25372,92.1,163,51,31.3
8,All Students,2021-22,24829,s,s,s,s,s,s
8,All Students,2022-23,31037,3187,27850,89.7,189,69,36.5
9,All Students,2018-19,6,s,s,s,s,s,s
9,All Students,2020-21,72,s,s,s,s,s,s
9,All Students,2021-22,33,s,s,s,s,s,s
All Grades,All Students,2018-19,67510,10132,57378,85.0,424,176,41.5
All Grades,All Students,2019-20,45366,6496,38870,85.7,432,175,40.5
All Grades,All Students,2020-21,71904,13068,58836,81.8,421,196,46.6
All Grades,All Students,2021-22,69155,16454,52701,76.2,426,291,68.3
All Grades,All Students,2022-23,61507,12445,49062,79.8,392,235,59.9
9,All Students,2018-19,18545,2461,16084,86.7,115,37,32.2
9,All Students,2019-20,13568,1934,11634,85.7,132,54,40.9
9,All Students,2020-21,26674,5486,21188,79.4,154,84,54.5
9,All Students,2021-22,22693,6285,16408,72.3,138,92,66.7
9,All Students,2022-23,21806,4705,17101,78.4,143,86,60.1
10,All Students,2018-19,17984,2934,15050,83.7,113,48,42.5
10,All Students,2019-20,11897,1296,10601,89.1,113,35,31.0
10,All Students,2020-21,15369,2721,12648,82.3,92,42,45.7
10,All Students,2021-22,19673,4487,15186,77.2,126,91,72.2
10,All Students,2022-23,14795,2640,12155,82.2,95,53,55.8
11,All Students,2018-19,16050,2164,13886,86.5,101,41,40.6
11,All Students,2019-20,9356,1361,7995,85.5,88,38,43.2
11,All Students,2020-21,15312,1650,13662,89.2,88,26,29.5
11,All Students,2021-22,12429,2456,9973,80.2,77,52,67.5
11,All Students,2022-23,12959,2597,10362,80.0,80,54,67.5
12,All Students,2018-19,14931,2573,12358,82.8,95,50,52.6
12,All Students,2019-20,10545,1905,8640,81.9,99,48,48.5
12,All Students,2020-21,14549,3211,11338,77.9,87,44,50.6
12,All Students,2021-22,14360,3226,11134,77.5,85,56,65.9
12,All Students,2022-23,11947,2503,9444,79.0,74,42,56.8
All Grades,All Students,2018-19,77341,11340,66001,85.3,491,228,46.4
All Grades,All Students,2019-20,47197,7933,39264,83.2,444,219,49.3
All Grades,All Students,2020-21,61606,18305,43301,70.3,349,189,54.2
All Grades,All Students,2021-22,43902,8593,35309,80.4,292,182,62.3
All Grades,All Students,2022-23,38424,5709,32715,85.1,259,125,48.3
9,All Students,2018-19,13967,1886,12081,86.5,90,44,48.9
9,All Students,2019-20,9437,1108,8329,88.3,97,39,40.2
9,All Students,2020-21,11613,3360,8253,71.1,74,50,67.6
9,All Students,2021-22,9676,1683,7993,82.6,75,43,57.3
9,All Students,2022-23,8460,1211,7249,85.7,65,28,43.1
10,All Students,2018-19,24883,5101,19782,79.5,164,94,57.3
10,All Students,2019-20,11073,1725,9348,84.4,107,52,48.6
10,All Students,2020-21,11914,2027,9887,83.0,71,28,39.4
10,All Students,2021-22,7163,867,6296,87.9,48,20,41.7
10,All Students,2022-23,10842,1731,9111,84.0,73,37,50.7
11,All Students,2018-19,19885,2106,17779,89.4,123,41,33.3
11,All Students,2019-20,14272,3129,11143,78.1,130,73,56.2
11,All Students,2020-21,22115,8447,13668,61.8,118,74,62.7
11,All Students,2021-22,17854,4490,13364,74.9,113,79,69.9
11,All Students,2022-23,9856,1409,8447,85.7,63,26,41.3
12,All Students,2018-19,18606,2247,16359,87.9,114,49,43.0
12,All Students,2019-20,12415,1971,10444,84.1,111,56,50.5
12,All Students,2020-21,15964,4471,11493,72.0,86,37,43.0
12,All Students,2021-22,9209,1553,7656,83.1,56,40,71.4
12,All Students,2022-23,9266,1358,7908,85.3,58,34,58.6
All Grades,All Students,2018-19,184128,11815,172313,93.6,1092,241,22.1
All Grades,All Students,2019-20,108748,7015,101733,93.5,984,214,21.7
All Grades,All Students,2020-21,154950,6918,148032,95.5,926,138,14.9
All Grades,All Students,2021-22,137725,13196,124529,90.4,817,283,34.6
All Grades,All Students,2022-23,132359,10414,121945,92.1,782,222,28.4
0K,All Students,2018-19,16656,1416,15240,91.5,99,39,39.4
0K,All Students,2019-20,7412,685,6727,90.8,70,26,37.1
0K,All Students,2020-21,10012,508,9504,94.9,60,10,16.7
0K,All Students,2021-22,10227,967,9260,90.5,62,24,38.7
0K,All Students,2022-23,7717,683,7034,91.1,47,15,31.9
1,All Students,2018-19,16115,1233,14882,92.3,99,25,25.3
1,All Students,2019-20,10121,679,9442,93.3,92,18,19.6
1,All Students,2020-21,10965,578,10387,94.7,67,12,17.9
1,All Students,2021-22,10231,1041,9190,89.8,61,27,44.3
1,All Students,2022-23,11242,970,10272,91.4,68,23,33.8
2,All Students,2018-19,18677,1105,17572,94.1,111,21,18.9
2,All Students,2019-20,9526,707,8819,92.6,86,21,24.4
2,All Students,2020-21,14468,648,13820,95.5,87,15,17.2
2,All Students,2021-22,9661,968,8693,90.0,58,23,39.7
2,All Students,2022-23,10555,897,9658,91.5,64,21,32.8
3,All Students,2018-19,20873,1356,19517,93.5,122,23,18.9
3,All Students,2019-20,12945,692,12253,94.7,115,17,14.8
3,All Students,2020-21,14282,608,13674,95.7,85,11,12.9
3,All Students,2021-22,13243,1296,11947,90.2,83,30,36.1
3,All Students,2022-23,10207,756,9451,92.6,61,14,23.0
4,All Students,2018-19,20735,1068,19667,94.8,125,23,18.4
4,All Students,2019-20,12189,723,11466,94.1,110,21,19.1
4,All Students,2020-21,19102,617,18485,96.8,113,10,8.8
4,All Students,2021-22,13066,1296,11770,90.1,77,26,33.8
4,All Students,2022-23,12903,983,11920,92.4,77,23,29.9
5,All Students,2018-19,20507,1153,19354,94.4,122,21,17.2
5,All Students,2019-20,12449,673,11776,94.6,112,21,18.8
5,All Students,2020-21,19014,527,18487,97.2,110,6,5.5
5,All Students,2021-22,16924,1545,15379,90.9,99,35,35.4
5,All Students,2022-23,13447,1052,12395,92.2,78,25,32.1
6,All Students,2018-19,24844,1521,23323,93.9,149,30,20.1
6,All Students,2019-20,14517,819,13698,94.4,133,21,15.8
6,All Students,2020-21,23339,1027,22312,95.6,142,22,15.5
6,All Students,2021-22,22539,2253,20286,90.0,132,43,32.6
6,All Students,2022-23,22755,1687,21068,92.6,135,35,25.9
7,All Students,2018-19,22998,1652,21346,92.8,134,32,23.9
7,All Students,2019-20,15263,1083,14180,92.9,136,37,27.2
7,All Students,2020-21,22341,1215,21126,94.6,129,23,17.8
7,All Students,2021-22,22122,1983,20139,91.0,129,42,32.6
7,All Students,2022-23,21330,1661,19669,92.2,125,32,25.6
8,All Students,2018-19,22723,1311,21412,94.2,131,27,20.6
8,All Students,2019-20,14326,954,13372,93.3,130,32,24.6
8,All Students,2020-21,21427,1190,20237,94.4,133,29,21.8
8,All Students,2021-22,19712,1847,17865,90.6,116,33,28.4
8,All Students,2022-23,22203,1725,20478,92.2,127,34,26.8
All Grades,All Students,2018-19,146407,11979,134428,91.8,854,263,30.8
All Grades,All Students,2019-20,92345,7086,85259,92.3,832,234,28.1
All Grades,All Students,2020-21,129207,16795,112412,87.0,765,332,43.4
All Grades,All Students,2021-22,127929,14361,113568,88.8,771,328,42.5
All Grades,All Students,2022-23,126445,13622,112823,89.2,757,328,43.3
0K,All Students,2018-19,11969,1144,10825,90.4,72,28,38.9
0K,All Students,2019-20,8110,779,7331,90.4,75,28,37.3
0K,All Students,2020-21,10493,1526,8967,85.5,66,30,45.5
0K,All Students,2021-22,12755,1795,10960,85.9,75,43,57.3
0K,All Students,2022-23,12180,1760,10420,85.6,76,48,63.2
1,All Students,2018-19,16183,1190,14993,92.6,95,26,27.4
1,All Students,2019-20,7820,643,7177,91.8,71,22,31.0
1,All Students,2020-21,12829,1685,11144,86.9,76,38,50.0
1,All Students,2021-22,13056,1612,11444,87.7,80,37,46.3
1,All Students,2022-23,12878,1559,11319,87.9,76,37,48.7
2,All Students,2018-19,13320,1127,12193,91.5,82,27,32.9
2,All Students,2019-20,11654,880,10774,92.4,106,29,27.4
2,All Students,2020-21,11408,1223,10185,89.3,69,28,40.6
2,All Students,2021-22,12971,1661,11310,87.2,79,39,49.4
2,All Students,2022-23,13033,1569,11464,88.0,80,40,50.0
3,All Students,2018-19,15321,1139,14182,92.6,90,28,31.1
3,All Students,2019-20,8783,682,8101,92.2,78,24,30.8
3,All Students,2020-21,17073,1796,15277,89.5,101,37,36.6
3,All Students,2021-22,13064,1362,11702,89.6,78,33,42.3
3,All Students,2022-23,13072,1485,11587,88.6,80,37,46.3
4,All Students,2018-19,17179,1323,15856,92.3,101,27,26.7
4,All Students,2019-20,10543,660,9883,93.7,95,19,20.0
4,All Students,2020-21,12529,1460,11069,88.3,72,27,37.5
4,All Students,2021-22,16818,1475,15343,91.2,102,31,30.4
4,All Students,2022-23,12442,1293,11149,89.6,76,30,39.5
5,All Students,2018-19,15621,1306,14315,91.6,90,29,32.2
5,All Students,2019-20,11585,851,10734,92.7,105,23,21.9
5,All Students,2020-21,14152,1581,12571,88.8,83,34,41.0
5,All Students,2021-22,10723,s,s,s,s,s,s
5,All Students,2022-23,16089,1344,14745,91.6,96,32,33.3
6,All Students,2018-19,17445,1285,16160,92.6,99,22,22.2
6,All Students,2019-20,10976,1009,9967,90.8,99,33,33.3
6,All Students,2020-21,17306,2487,14819,85.6,102,45,44.1
6,All Students,2021-22,17022,1874,15148,89.0,101,44,43.6
6,All Students,2022-23,13314,1506,11808,88.7,79,37,46.8
7,All Students,2018-19,17616,1347,16269,92.4,101,32,31.7
7,All Students,2019-20,11321,716,10605,93.7,101,25,24.8
7,All Students,2020-21,16562,2414,14148,85.4,98,47,48.0
7,All Students,2021-22,16653,1724,14929,89.6,101,37,36.6
7,All Students,2022-23,16618,1575,15043,90.5,98,38,38.8
8,All Students,2018-19,21753,2118,19635,90.3,124,44,35.5
8,All Students,2019-20,11553,866,10687,92.5,102,31,30.4
8,All Students,2020-21,16855,2623,14232,84.4,98,46,46.9
8,All Students,2021-22,14852,1614,13238,89.1,88,35,39.8
8,All Students,2022-23,16819,1531,15288,90.9,96,29,30.2
9,All Students,2021-22,15,s,s,s,s,s,s
All Grades,All Students,2018-19,62000,13164,48836,78.8,420,258,61.4
All Grades,All Students,2019-20,42656,8058,34598,81.1,402,197,49.0
All Grades,All Students,2020-21,60710,10572,50138,82.6,357,153,42.9
All Grades,All Students,2021-22,54471,11382,43089,79.1,352,207,58.8
All Grades,All Students,2022-23,55383,9484,45899,82.9,368,176,47.8
9,All Students,2018-19,17978,3838,14140,78.7,134,79,59.0
9,All Students,2019-20,11973,2514,9459,79.0,115,60,52.2
9,All Students,2020-21,14595,2895,11700,80.2,86,40,46.5
9,All Students,2021-22,15974,3084,12890,80.7,105,56,53.3
9,All Students,2022-23,15191,2602,12589,82.9,105,48,45.7
10,All Students,2018-19,17964,4074,13890,77.3,116,64,55.2
10,All Students,2019-20,9957,1927,8030,80.6,97,50,51.5
10,All Students,2020-21,16000,2672,13328,83.3,95,38,40.0
10,All Students,2021-22,12333,3060,9273,75.2,82,49,59.8
10,All Students,2022-23,15688,2689,12999,82.9,104,50,48.1
11,All Students,2018-19,13920,2365,11555,83.0,93,50,53.8
11,All Students,2019-20,10355,1667,8688,83.9,94,38,40.4
11,All Students,2020-21,14479,3254,11225,77.5,85,44,51.8
11,All Students,2021-22,14142,2312,11830,83.7,89,49,55.1
11,All Students,2022-23,11417,1906,9511,83.3,73,33,45.2
12,All Students,2018-19,12138,2887,9251,76.2,77,65,84.4
12,All Students,2019-20,10371,1950,8421,81.2,97,50,51.5
12,All Students,2020-21,15636,1751,13885,88.8,91,31,34.1
12,All Students,2021-22,12022,2926,9096,75.7,76,53,69.7
12,All Students,2022-23,13087,2287,10800,82.5,86,45,52.3
All Grades,All Students,2018-19,108294,9735,98559,91.0,654,228,34.9
All Grades,All Students,2019-20,66547,5211,61336,92.2,605,160,26.4
All Grades,All Students,2020-21,93037,16428,76609,82.3,546,306,56.0
All Grades,All Students,2021-22,79139,9040,70099,88.6,476,223,46.8
All Grades,All Students,2022-23,73382,7407,65975,89.9,441,169,38.3
0K,All Students,2018-19,16159,1895,14264,88.3,100,52,52.0
0K,All Students,2019-20,9863,821,9042,91.7,90,28,31.1
0K,All Students,2020-21,11203,2490,8713,77.8,68,52,76.5
0K,All Students,2021-22,8724,1090,7634,87.5,54,30,55.6
0K,All Students,2022-23,7867,1081,6786,86.3,51,25,49.0
1,All Students,2018-19,19456,1826,17630,90.6,116,41,35.3
1,All Students,2019-20,11075,912,10163,91.8,100,30,30.0
1,All Students,2020-21,15675,2745,12930,82.5,92,51,55.4
1,All Students,2021-22,10008,1304,8704,87.0,62,37,59.7
1,All Students,2022-23,8385,1000,7385,88.1,51,24,47.1
2,All Students,2018-19,16820,1376,15444,91.8,100,26,26.0
2,All Students,2019-20,12265,909,11356,92.6,110,25,22.7
2,All Students,2020-21,16454,2387,14067,85.5,96,43,44.8
2,All Students,2021-22,14721,1727,12994,88.3,85,40,47.1
2,All Students,2022-23,10550,981,9569,90.7,65,29,44.6
3,All Students,2018-19,17177,1278,15899,92.6,104,29,27.9
3,All Students,2019-20,11016,896,10120,91.9,100,30,30.0
3,All Students,2020-21,17395,3664,13731,78.9,102,57,55.9
3,All Students,2021-22,15397,1592,13805,89.7,93,37,39.8
3,All Students,2022-23,14534,1484,13050,89.8,85,33,38.8
4,All Students,2018-19,18406,1583,16823,91.4,111,33,29.7
4,All Students,2019-20,11457,757,10700,93.4,107,23,21.5
4,All Students,2020-21,16031,2466,13565,84.6,93,52,55.9
4,All Students,2021-22,16953,2038,14915,88.0,102,46,45.1
4,All Students,2022-23,16006,1496,14510,90.7,94,29,30.9
5,All Students,2018-19,20276,1777,18499,91.2,123,47,38.2
5,All Students,2019-20,10871,916,9955,91.6,98,24,24.5
5,All Students,2020-21,16279,2676,13603,83.6,95,51,53.7
5,All Students,2021-22,13336,1289,12047,90.3,80,33,41.3
5,All Students,2022-23,16040,1365,14675,91.5,95,29,30.5
All Grades,All Students,2018-19,116480,9081,107399,92.2,712,210,29.5
All Grades,All Students,2019-20,70286,4911,65375,93.0,643,161,25.0
All Grades,All Students,2020-21,95631,7572,88059,92.1,573,199,34.7
All Grades,All Students,2021-22,85685,8345,77340,90.3,517,201,38.9
All Grades,All Students,2022-23,79069,7260,71809,90.8,483,172,35.6
0K,All Students,2018-19,15157,1220,13937,92.0,97,35,36.1
0K,All Students,2019-20,9778,823,8955,91.6,95,36,37.9
0K,All Students,2020-21,9577,765,8812,92.0,60,22,36.7
0K,All Students,2021-22,10997,1174,9823,89.3,68,33,48.5
0K,All Students,2022-23,9914,1175,8739,88.1,65,33,50.8
1,All Students,2018-19,19704,1727,17977,91.2,123,41,33.3
1,All Students,2019-20,10377,751,9626,92.8,93,27,29.0
1,All Students,2020-21,15169,1377,13792,90.9,91,37,40.7
1,All Students,2021-22,9673,852,8821,91.2,60,25,41.7
1,All Students,2022-23,11318,1243,10075,89.0,71,33,46.5
2,All Students,2018-19,21423,1775,19648,91.7,132,41,31.1
2,All Students,2019-20,12627,1038,11589,91.8,120,31,25.8
2,All Students,2020-21,15125,1279,13846,91.5,92,37,40.2
2,All Students,2021-22,16688,1679,15009,89.9,98,35,35.7
2,All Students,2022-23,9244,763,8481,91.7,58,17,29.3
3,All Students,2018-19,18129,1350,16779,92.6,113,29,25.7
3,All Students,2019-20,13585,870,12715,93.6,119,22,18.5
3,All Students,2020-21,19016,1170,17846,93.8,112,30,26.8
3,All Students,2021-22,14541,1470,13071,89.9,91,37,40.7
3,All Students,2022-23,17176,1541,15635,91.0,104,35,33.7
4,All Students,2018-19,20387,1410,18977,93.1,120,32,26.7
4,All Students,2019-20,11478,741,10737,93.5,103,25,24.3
4,All Students,2020-21,19743,1622,18121,91.8,116,42,36.2
4,All Students,2021-22,16964,1592,15372,90.6,101,37,36.6
4,All Students,2022-23,14556,1087,13469,92.5,86,26,30.2
5,All Students,2018-19,21680,1599,20081,92.6,127,32,25.2
5,All Students,2019-20,12441,688,11753,94.5,113,20,17.7
5,All Students,2020-21,17001,1359,15642,92.0,102,31,30.4
5,All Students,2021-22,16822,1578,15244,90.6,99,34,34.3
5,All Students,2022-23,16861,1451,15410,91.4,99,28,28.3
All Grades,All Students,2018-19,59296,3034,56262,94.9,357,51,14.3
All Grades,All Students,2019-20,34298,1638,32660,95.2,314,36,11.5
All Grades,All Students,2020-21,48910,2857,46053,94.2,291,61,21.0
All Grades,All Students,2021-22,44364,4196,40168,90.5,266,103,38.7
All Grades,All Students,2022-23,40754,4146,36608,89.8,249,105,42.2
0K,All Students,2018-19,8786,573,8213,93.5,53,13,24.5
0K,All Students,2019-20,4781,285,4496,94.0,42,6,14.3
0K,All Students,2020-21,7108,762,6346,89.3,45,22,48.9
0K,All Students,2021-22,7845,864,6981,89.0,49,21,42.9
0K,All Students,2022-23,5205,657,4548,87.4,32,16,50.0
1,All Students,2018-19,8760,491,8269,94.4,56,10,17.9
1,All Students,2019-20,4698,219,4479,95.3,45,6,13.3
1,All Students,2020-21,6905,681,6224,90.1,41,15,36.6
1,All Students,2021-22,7162,786,6376,89.0,43,23,53.5
1,All Students,2022-23,8378,907,7471,89.2,52,24,46.2
2,All Students,2018-19,12011,521,11490,95.7,72,6,8.3
2,All Students,2019-20,4330,239,4091,94.5,39,3,7.7
2,All Students,2020-21,7921,373,7548,95.3,47,7,14.9
2,All Students,2021-22,6444,639,5805,90.1,38,16,42.1
2,All Students,2022-23,8066,800,7266,90.1,47,22,46.8
3,All Students,2018-19,10982,552,10430,95.0,64,10,15.6
3,All Students,2019-20,7426,366,7060,95.1,68,9,13.2
3,All Students,2020-21,6513,234,6279,96.4,38,4,10.5
3,All Students,2021-22,6839,525,6314,92.3,41,13,31.7
3,All Students,2022-23,6887,712,6175,89.7,42,16,38.1
4,All Students,2018-19,9812,479,9333,95.1,59,7,11.9
4,All Students,2019-20,6868,247,6621,96.4,64,6,9.4
4,All Students,2020-21,10405,551,9854,94.7,61,11,18.0
4,All Students,2021-22,6503,545,5958,91.6,38,12,31.6
4,All Students,2022-23,6645,509,6136,92.3,41,12,29.3
5,All Students,2018-19,8945,418,8527,95.3,53,5,9.4
5,All Students,2019-20,6195,282,5913,95.4,56,6,10.7
5,All Students,2020-21,10058,256,9802,97.5,59,2,3.4
5,All Students,2021-22,9571,837,8734,91.3,57,18,31.6
5,All Students,2022-23,5573,561,5012,89.9,35,15,42.9
All Grades,All Students,2018-19,47582,3434,44148,92.8,274,72,26.3
All Grades,All Students,2019-20,29850,2166,27684,92.7,267,76,28.5
All Grades,All Students,2020-21,46413,5298,41115,88.6,267,110,41.2
All Grades,All Students,2021-22,43977,5593,38384,87.3,257,122,47.5
All Grades,All Students,2022-23,45255,4419,40836,90.2,260,98,37.7
6,All Students,2018-19,16116,1018,15098,93.7,94,22,23.4
6,All Students,2019-20,10305,805,9500,92.2,93,28,30.1
6,All Students,2020-21,17170,1881,15289,89.0,99,38,38.4
6,All Students,2021-22,16142,1741,14401,89.2,95,39,41.1
6,All Students,2022-23,16554,1580,14974,90.5,95,35,36.8
7,All Students,2018-19,16483,1149,15334,93.0,95,25,26.3
7,All Students,2019-20,9875,637,9238,93.5,89,21,23.6
7,All Students,2020-21,14951,1782,13169,88.1,86,41,47.7
7,All Students,2021-22,13748,1655,12093,88.0,81,38,46.9
7,All Students,2022-23,15419,1467,13952,90.5,89,31,34.8
8,All Students,2018-19,14983,1267,13716,91.5,85,25,29.4
8,All Students,2019-20,9670,724,8946,92.5,85,27,31.8
8,All Students,2020-21,14292,1635,12657,88.6,82,31,37.8
8,All Students,2021-22,14087,2197,11890,84.4,81,45,55.6
8,All Students,2022-23,13282,1372,11910,89.7,76,32,42.1
All Grades,All Students,2018-19,119005,8573,110432,92.8,714,188,26.3
All Grades,All Students,2019-20,74036,5376,68660,92.7,677,195,28.8
All Grades,All Students,2020-21,99915,9529,90386,90.5,595,210,35.3
All Grades,All Students,2021-22,90032,9368,80664,89.6,534,229,42.9
All Grades,All Students,2022-23,82879,8723,74156,89.5,500,205,41.0
PK in K-12 Schools,All Students,2018-19,12013,1225,10788,89.8,73,33,45.2
PK in K-12 Schools,All Students,2019-20,7891,802,7089,89.8,75,35,46.7
PK in K-12 Schools,All Students,2020-21,6957,471,6486,93.2,43,9,20.9
PK in K-12 Schools,All Students,2021-22,6423,782,5641,87.8,38,19,50.0
PK in K-12 Schools,All Students,2022-23,10960,1513,9447,86.2,66,38,57.6
0K,All Students,2018-19,16650,1559,15091,90.6,99,38,38.4
0K,All Students,2019-20,10655,943,9712,91.1,97,41,42.3
0K,All Students,2020-21,14581,1780,12801,87.8,87,41,47.1
0K,All Students,2021-22,12484,1472,11012,88.2,75,35,46.7
0K,All Students,2022-23,7480,980,6500,86.9,48,23,47.9
1,All Students,2018-19,16678,1480,15198,91.1,102,40,39.2
1,All Students,2019-20,10980,842,10138,92.3,100,32,32.0
1,All Students,2020-21,14836,1678,13158,88.7,90,41,45.6
1,All Students,2021-22,14640,1734,12906,88.2,86,41,47.7
1,All Students,2022-23,12857,1233,11624,90.4,75,27,36.0
2,All Students,2018-19,19784,1266,18518,93.6,117,21,17.9
2,All Students,2019-20,10110,791,9319,92.2,93,32,34.4
2,All Students,2020-21,16475,1442,15033,91.2,99,33,33.3
2,All Students,2021-22,13263,1238,12025,90.7,76,32,42.1
2,All Students,2022-23,13584,1472,12112,89.2,81,34,42.0
3,All Students,2018-19,17223,1005,16218,94.2,103,20,19.4
3,All Students,2019-20,12307,770,11537,93.7,111,20,18.0
3,All Students,2020-21,12921,1372,11549,89.4,76,28,36.8
3,All Students,2021-22,13728,1458,12270,89.4,83,34,41.0
3,All Students,2022-23,13478,1305,12173,90.3,81,33,40.7
4,All Students,2018-19,18845,1065,17780,94.3,114,17,14.9
4,All Students,2019-20,11212,660,10552,94.1,102,19,18.6
4,All Students,2020-21,18262,1590,16672,91.3,108,39,36.1
4,All Students,2021-22,13254,1331,11923,90.0,79,34,43.0
4,All Students,2022-23,12199,1072,11127,91.2,74,23,31.1
5,All Students,2018-19,17812,973,16839,94.5,106,19,17.9
5,All Students,2019-20,10881,568,10313,94.8,99,16,16.2
5,All Students,2020-21,15883,1196,14687,92.5,92,19,20.7
5,All Students,2021-22,16240,1353,14887,91.7,97,34,35.1
5,All Students,2022-23,12321,1148,11173,90.7,75,27,36.0
All Grades,All Students,2018-19,40778,3041,37737,92.5,237,62,26.2
All Grades,All Students,2019-20,25918,1581,24337,93.9,233,45,19.3
All Grades,All Students,2020-21,39192,3390,35802,91.4,225,63,28.0
All Grades,All Students,2021-22,35085,3613,31472,89.7,205,78,38.0
All Grades,All Students,2022-23,33999,3106,30893,90.9,206,77,37.4
0K,All Students,2018-19,2842,279,2563,90.2,16,8,50.0
0K,All Students,2019-20,2291,204,2087,91.1,20,6,30.0
0K,All Students,2020-21,4003,298,3705,92.6,23,5,21.7
0K,All Students,2021-22,2945,420,2525,85.7,19,12,63.2
0K,All Students,2022-23,2876,323,2553,88.8,19,9,47.4
1,All Students,2018-19,3859,284,3575,92.6,22,5,22.7
1,All Students,2019-20,1969,174,1795,91.2,18,5,27.8
1,All Students,2020-21,3513,268,3245,92.4,20,4,20.0
1,All Students,2021-22,2722,202,2520,92.6,16,4,25.0
1,All Students,2022-23,3091,388,2703,87.4,20,11,55.0
2,All Students,2018-19,4505,267,4238,94.1,27,5,18.5
2,All Students,2019-20,2783,161,2622,94.2,25,5,20.0
2,All Students,2020-21,3147,303,2844,90.4,18,6,33.3
2,All Students,2021-22,3355,317,3038,90.6,19,9,47.4
2,All Students,2022-23,2925,160,2765,94.5,18,3,16.7
3,All Students,2018-19,3474,293,3181,91.6,22,9,40.9
3,All Students,2019-20,3393,183,3210,94.6,30,3,10.0
3,All Students,2020-21,4056,323,3733,92.0,24,6,25.0
3,All Students,2021-22,3411,434,2977,87.3,20,9,45.0
3,All Students,2022-23,3714,394,3320,89.4,23,11,47.8
4,All Students,2018-19,4317,265,4052,93.9,25,5,20.0
4,All Students,2019-20,2446,169,2277,93.1,22,5,22.7
4,All Students,2020-21,5247,467,4780,91.1,30,10,33.3
4,All Students,2021-22,3699,348,3351,90.6,21,7,33.3
4,All Students,2022-23,3510,368,3142,89.5,20,8,40.0
5,All Students,2018-19,4927,386,4541,92.2,28,9,32.1
5,All Students,2019-20,3053,140,2913,95.4,29,4,13.8
5,All Students,2020-21,3651,362,3289,90.1,21,5,23.8
5,All Students,2021-22,5103,513,4590,89.9,29,10,34.5
5,All Students,2022-23,3479,265,3214,92.4,21,7,33.3
6,All Students,2018-19,4679,402,4277,91.4,27,7,25.9
6,All Students,2019-20,3219,223,2996,93.1,28,7,25.0
6,All Students,2020-21,5600,500,5100,91.1,32,11,34.4
6,All Students,2021-22,4135,389,3746,90.6,25,8,32.0
6,All Students,2022-23,5031,422,4609,91.6,29,8,27.6
7,All Students,2018-19,5221,246,4975,95.3,30,3,10.0
7,All Students,2019-20,3450,174,3276,95.0,30,5,16.7
7,All Students,2020-21,4725,569,4156,88.0,27,11,40.7
7,All Students,2021-22,5113,503,4610,90.2,30,11,36.7
7,All Students,2022-23,4232,320,3912,92.4,26,7,26.9
8,All Students,2018-19,6954,619,6335,91.1,40,11,27.5
8,All Students,2019-20,3314,153,3161,95.4,31,5,16.1
8,All Students,2020-21,5250,300,4950,94.3,30,5,16.7
8,All Students,2021-22,4602,487,4115,89.4,26,8,30.8
8,All Students,2022-23,5141,466,4675,90.9,30,13,43.3
All Grades,All Students,2018-19,77828,4499,73329,94.2,462,79,17.1
All Grades,All Students,2019-20,50638,2702,47936,94.7,460,76,16.5
All Grades,All Students,2020-21,78334,6968,71366,91.1,457,140,30.6
All Grades,All Students,2021-22,71365,8193,63172,88.5,427,194,45.4
All Grades,All Students,2022-23,64909,5753,59156,91.1,401,141,35.2
6,All Students,2018-19,27854,1663,26191,94.0,166,31,18.7
6,All Students,2019-20,16327,870,15457,94.7,149,28,18.8
6,All Students,2020-21,26972,2679,24293,90.1,156,57,36.5
6,All Students,2021-22,23626,2755,20871,88.3,144,74,51.4
6,All Students,2022-23,20925,1915,19010,90.8,129,47,36.4
7,All Students,2018-19,24808,1312,23496,94.7,149,18,12.1
7,All Students,2019-20,18034,1029,17005,94.3,163,29,17.8
7,All Students,2020-21,24888,s,s,s,s,s,s
7,All Students,2021-22,24615,2810,21805,88.6,147,67,45.6
7,All Students,2022-23,21870,1911,19959,91.3,131,45,34.4
8,All Students,2018-19,25166,1524,23642,93.9,147,30,20.4
8,All Students,2019-20,16277,803,15474,95.1,148,19,12.8
8,All Students,2020-21,26366,1963,24403,92.6,153,34,22.2
8,All Students,2021-22,23124,2628,20496,88.6,136,53,39.0
8,All Students,2022-23,22114,1927,20187,91.3,141,49,34.8
10,All Students,2020-21,108,s,s,s,s,s,s
All Grades,All Students,2018-19,106427,9110,97317,91.4,641,224,34.9
All Grades,All Students,2019-20,65927,5819,60108,91.2,607,199,32.8
All Grades,All Students,2020-21,92325,10569,81756,88.6,544,207,38.1
All Grades,All Students,2021-22,82983,10102,72881,87.8,495,236,47.7
All Grades,All Students,2022-23,82964,8584,74380,89.7,492,209,42.5
PK in K-12 Schools,All Students,2018-19,3169,324,2845,89.8,19,8,42.1
PK in K-12 Schools,All Students,2019-20,3963,449,3514,88.7,37,19,51.4
PK in K-12 Schools,All Students,2020-21,5760,772,4988,86.6,36,17,47.2
PK in K-12 Schools,All Students,2021-22,5819,881,4938,84.9,36,23,63.9
PK in K-12 Schools,All Students,2022-23,6187,1041,5146,83.2,38,23,60.5
0K,All Students,2018-19,17116,1816,15300,89.4,104,49,47.1
0K,All Students,2019-20,9464,1087,8377,88.5,90,39,43.3
0K,All Students,2020-21,11328,2166,9162,80.9,68,40,58.8
0K,All Students,2021-22,11404,1514,9890,86.7,72,37,51.4
0K,All Students,2022-23,13136,1692,11444,87.1,79,45,57.0
1,All Students,2018-19,18468,1692,16776,90.8,114,42,36.8
1,All Students,2019-20,11451,1105,10346,90.4,110,40,36.4
1,All Students,2020-21,14350,1799,12551,87.5,85,31,36.5
1,All Students,2021-22,11234,1529,9705,86.4,68,36,52.9
1,All Students,2022-23,11804,1216,10588,89.7,73,32,43.8
2,All Students,2018-19,16512,1351,15161,91.8,98,34,34.7
2,All Students,2019-20,10131,833,9298,91.8,91,31,34.1
2,All Students,2020-21,15140,1682,13458,88.9,90,35,38.9
2,All Students,2021-22,12699,1650,11049,87.0,74,38,51.4
2,All Students,2022-23,10733,991,9742,90.8,63,24,38.1
3,All Students,2018-19,17469,1495,15974,91.4,105,35,33.3
3,All Students,2019-20,9972,802,9170,92.0,88,22,25.0
3,All Students,2020-21,14630,1025,13605,93.0,85,21,24.7
3,All Students,2021-22,15120,1840,13280,87.8,88,41,46.6
3,All Students,2022-23,13371,1314,12057,90.2,80,33,41.3
4,All Students,2018-19,16364,1227,15137,92.5,99,31,31.3
4,All Students,2019-20,11140,883,10257,92.1,104,27,26.0
4,All Students,2020-21,14927,1101,13826,92.6,87,21,24.1
4,All Students,2021-22,13678,1317,12361,90.4,79,32,40.5
4,All Students,2022-23,14624,1379,13245,90.6,84,31,36.9
5,All Students,2018-19,17329,1205,16124,93.0,102,25,24.5
5,All Students,2019-20,9806,660,9146,93.3,87,21,24.1
5,All Students,2020-21,16190,2024,14166,87.5,93,42,45.2
5,All Students,2021-22,13029,1371,11658,89.5,78,29,37.2
5,All Students,2022-23,13109,951,12158,92.7,75,21,28.0
All Grades,All Students,2018-19,88523,7183,81340,91.9,548,125,22.8
All Grades,All Students,2019-20,56349,5009,51340,91.1,549,129,23.5
All Grades,All Students,2020-21,90606,7834,82772,91.4,537,100,18.6
All Grades,All Students,2021-22,80970,7706,73264,90.5,507,149,29.4
All Grades,All Students,2022-23,82710,10036,72674,87.9,530,219,41.3
6,All Students,2018-19,8605,419,8186,95.1,51,7,13.7
6,All Students,2019-20,3229,133,3096,95.9,33,2,6.1
6,All Students,2020-21,7977,80,7897,99.0,47,0,0.0
6,All Students,2021-22,7028,402,6626,94.3,42,4,9.5
6,All Students,2022-23,7358,585,6773,92.0,47,13,27.7
7,All Students,2018-19,9470,498,8972,94.7,54,3,5.6
7,All Students,2019-20,5983,208,5775,96.5,56,3,5.4
7,All Students,2020-21,7127,98,7029,98.6,42,1,2.4
7,All Students,2021-22,7510,431,7079,94.3,48,8,16.7
7,All Students,2022-23,8923,621,8302,93.0,54,12,22.2
8,All Students,2018-19,8582,411,8171,95.2,52,5,9.6
8,All Students,2019-20,6485,287,6198,95.6,59,5,8.5
8,All Students,2020-21,9774,348,9426,96.4,57,5,8.8
8,All Students,2021-22,7094,367,6727,94.8,42,4,9.5
8,All Students,2022-23,9014,564,8450,93.7,54,13,24.1
9,All Students,2018-19,15436,1246,14190,91.9,94,20,21.3
9,All Students,2019-20,9885,806,9079,91.8,104,24,23.1
9,All Students,2020-21,17115,2034,15081,88.1,100,23,23.0
9,All Students,2021-22,15037,1099,13938,92.7,98,19,19.4
9,All Students,2022-23,13500,1726,11774,87.2,97,42,43.3
10,All Students,2018-19,14881,1098,13783,92.6,101,21,20.8
10,All Students,2019-20,10198,983,9215,90.4,102,23,22.5
10,All Students,2020-21,14775,1258,13517,91.5,89,17,19.1
10,All Students,2021-22,15351,1972,13379,87.2,99,37,37.4
10,All Students,2022-23,15232,2273,12959,85.1,98,46,46.9
11,All Students,2018-19,15219,1492,13727,90.2,94,26,27.7
11,All Students,2019-20,10031,1061,8970,89.4,95,26,27.4
11,All Students,2020-21,18687,2305,16382,87.7,112,33,29.5
11,All Students,2021-22,15536,1580,13956,89.8,96,39,40.6
11,All Students,2022-23,15674,2209,13465,85.9,100,47,47.0
12,All Students,2018-19,16330,2019,14311,87.6,102,43,42.2
12,All Students,2019-20,10538,1531,9007,85.5,100,46,46.0
12,All Students,2020-21,15151,1711,13440,88.7,90,21,23.3
12,All Students,2021-22,13414,1855,11559,86.2,82,38,46.3
12,All Students,2022-23,13009,2058,10951,84.2,80,46,57.5
All Grades,All Students,2018-19,66748,4023,62725,94.0,381,63,16.5
All Grades,All Students,2019-20,44172,2547,41625,94.2,390,65,16.7
All Grades,All Students,2020-21,63657,3279,60378,94.8,374,62,16.6
All Grades,All Students,2021-22,59967,5783,54184,90.4,343,128,37.3
All Grades,All Students,2022-23,54801,4337,50464,92.1,320,89,27.8
PK in K-12 Schools,All Students,2018-19,6068,521,5547,91.4,35,12,34.3
PK in K-12 Schools,All Students,2019-20,4000,402,3598,89.9,36,16,44.4
PK in K-12 Schools,All Students,2020-21,5336,663,4673,87.6,32,14,43.8
PK in K-12 Schools,All Students,2021-22,6326,768,5558,87.9,36,18,50.0
PK in K-12 Schools,All Students,2022-23,3976,520,3456,86.9,24,15,62.5
0K,All Students,2018-19,9096,577,8519,93.7,52,9,17.3
0K,All Students,2019-20,5868,382,5486,93.5,53,12,22.6
0K,All Students,2020-21,9772,612,9160,93.7,57,14,24.6
0K,All Students,2021-22,9228,1096,8132,88.1,52,27,51.9
0K,All Students,2022-23,9028,838,8190,90.7,53,19,35.8
1,All Students,2018-19,10161,511,9650,95.0,58,6,10.3
1,All Students,2019-20,6625,420,6205,93.7,58,11,19.0
1,All Students,2020-21,8742,323,8419,96.3,52,2,3.8
1,All Students,2021-22,9118,1030,8088,88.7,52,20,38.5
1,All Students,2022-23,8616,593,8023,93.1,51,7,13.7
2,All Students,2018-19,9233,598,8635,93.5,54,8,14.8
2,All Students,2019-20,6468,266,6202,95.9,57,5,8.8
2,All Students,2020-21,9966,358,9608,96.4,59,7,11.9
2,All Students,2021-22,8084,880,7204,89.1,47,22,46.8
2,All Students,2022-23,7568,606,6962,92.0,44,12,27.3
3,All Students,2018-19,11400,648,10752,94.3,65,10,15.4
3,All Students,2019-20,6906,324,6582,95.3,61,4,6.6
3,All Students,2020-21,9744,395,9349,95.9,56,8,14.3
3,All Students,2021-22,9294,676,8618,92.7,54,15,27.8
3,All Students,2022-23,8334,637,7697,92.4,49,14,28.6
4,All Students,2018-19,11003,725,10278,93.4,62,13,21.0
4,All Students,2019-20,7285,404,6881,94.5,64,8,12.5
4,All Students,2020-21,9784,452,9332,95.4,58,8,13.8
4,All Students,2021-22,9030,634,8396,93.0,51,10,19.6
4,All Students,2022-23,9634,667,8967,93.1,55,15,27.3
5,All Students,2018-19,9787,443,9344,95.5,55,5,9.1
5,All Students,2019-20,7020,349,6671,95.0,61,9,14.8
5,All Students,2020-21,10313,476,9837,95.4,60,9,15.0
5,All Students,2021-22,8887,699,8188,92.1,51,16,31.4
5,All Students,2022-23,7645,476,7169,93.8,44,7,15.9
All Grades,All Students,2018-19,92668,22108,70560,76.1,596,396,66.4
All Grades,All Students,2019-20,60807,12400,48407,79.6,572,371,64.9
All Grades,All Students,2020-21,95441,41897,53544,56.1,565,523,92.6
All Grades,All Students,2021-22,82132,27078,55054,67.0,495,434,87.7
All Grades,All Students,2022-23,70438,22351,48087,68.3,449,402,89.5
9,All Students,2018-19,28300,5027,23273,82.2,181,94,51.9
9,All Students,2019-20,15305,3270,12035,78.6,142,90,63.4
9,All Students,2020-21,18005,8338,9667,53.7,109,108,99.1
9,All Students,2021-22,19261,5029,14232,73.9,118,99,83.9
9,All Students,2022-23,19430,5296,14134,72.7,126,102,81.0
10,All Students,2018-19,26373,6194,20179,76.5,173,110,63.6
10,All Students,2019-20,17675,3357,14318,81.0,169,101,59.8
10,All Students,2020-21,26280,12374,13906,52.9,156,142,91.0
10,All Students,2021-22,17840,5921,11919,66.8,108,95,88.0
10,All Students,2022-23,19375,6249,13126,67.7,123,114,92.7
11,All Students,2018-19,19627,4255,15372,78.3,123,80,65.0
11,All Students,2019-20,16076,2785,13291,82.7,152,95,62.5
11,All Students,2020-21,26270,10465,15805,60.2,155,141,91.0
11,All Students,2021-22,20471,7590,12881,62.9,125,106,84.8
11,All Students,2022-23,16349,5846,10503,64.2,107,101,94.4
12,All Students,2018-19,18368,6632,11736,63.9,119,112,94.1
12,All Students,2019-20,11751,2988,8763,74.6,109,85,78.0
12,All Students,2020-21,24886,10720,14166,56.9,145,132,91.0
12,All Students,2021-22,24560,8538,16022,65.2,144,134,93.1
12,All Students,2022-23,15284,4960,10324,67.5,93,85,91.4
All Grades,All Students,2018-19,90262,7775,82487,91.4,550,158,28.7
All Grades,All Students,2019-20,63759,4825,58934,92.4,597,162,27.1
All Grades,All Students,2020-21,105014,6900,98114,93.4,606,127,21.0
All Grades,All Students,2021-22,99073,12714,86359,87.2,614,283,46.1
All Grades,All Students,2022-23,102686,12249,90437,88.1,652,268,41.1
9,All Students,2018-19,26743,1702,25041,93.6,164,36,22.0
9,All Students,2019-20,17428,1246,16182,92.9,164,45,27.4
9,All Students,2020-21,28659,1987,26672,93.1,166,38,22.9
9,All Students,2021-22,27854,2700,25154,90.3,176,62,35.2
9,All Students,2022-23,32968,3414,29554,89.6,205,72,35.1
10,All Students,2018-19,23051,1910,21141,91.7,140,26,18.6
10,All Students,2019-20,17083,1128,15955,93.4,159,34,21.4
10,All Students,2020-21,26898,2330,24568,91.3,155,42,27.1
10,All Students,2021-22,25005,3324,21681,86.7,157,79,50.3
10,All Students,2022-23,25547,2688,22859,89.5,168,62,36.9
11,All Students,2018-19,24468,2287,22181,90.7,149,52,34.9
11,All Students,2019-20,14690,1134,13556,92.3,136,36,26.5
11,All Students,2020-21,26293,1599,24694,93.9,152,31,20.4
11,All Students,2021-22,23343,3548,19795,84.8,145,75,51.7
11,All Students,2022-23,22700,3032,19668,86.6,146,68,46.6
12,All Students,2018-19,16000,1876,14124,88.3,97,44,45.4
12,All Students,2019-20,14558,1317,13241,91.0,138,47,34.1
12,All Students,2020-21,23164,984,22180,95.8,133,16,12.0
12,All Students,2021-22,22871,3142,19729,86.3,136,67,49.3
12,All Students,2022-23,21471,3115,18356,85.5,133,66,49.6
All Grades,All Students,2018-19,76554,7356,69198,90.4,459,194,42.3
All Grades,All Students,2019-20,45259,4154,41105,90.8,423,158,37.4
All Grades,All Students,2020-21,62700,7638,55062,87.8,378,163,43.1
All Grades,All Students,2021-22,61632,8111,53521,86.8,378,213,56.3
All Grades,All Students,2022-23,54954,6292,48662,88.6,341,159,46.6
PK in K-12 Schools,All Students,2018-19,8450,1340,7110,84.1,52,37,71.2
PK in K-12 Schools,All Students,2019-20,5668,871,4797,84.6,56,33,58.9
PK in K-12 Schools,All Students,2020-21,5264,878,4386,83.3,34,20,58.8
PK in K-12 Schools,All Students,2021-22,7691,1087,6604,85.9,46,28,60.9
PK in K-12 Schools,All Students,2022-23,6759,1146,5613,83.0,50,37,74.0
0K,All Students,2018-19,8399,809,7590,90.4,50,21,42.0
0K,All Students,2019-20,5081,461,4620,90.9,48,19,39.6
0K,All Students,2020-21,8955,1083,7872,87.9,54,22,40.7
0K,All Students,2021-22,7461,1271,6190,83.0,49,32,65.3
0K,All Students,2022-23,7671,908,6763,88.2,51,27,52.9
1,All Students,2018-19,11855,1201,10654,89.9,73,35,47.9
1,All Students,2019-20,5851,518,5333,91.1,57,22,38.6
1,All Students,2020-21,7573,1104,6469,85.4,48,29,60.4
1,All Students,2021-22,9137,1202,7935,86.8,56,33,58.9
1,All Students,2022-23,7267,828,6439,88.6,44,19,43.2
2,All Students,2018-19,12220,1102,11118,91.0,73,34,46.6
2,All Students,2019-20,6382,553,5829,91.3,61,19,31.1
2,All Students,2020-21,8375,1083,7292,87.1,51,23,45.1
2,All Students,2021-22,8143,1023,7120,87.4,51,26,51.0
2,All Students,2022-23,8626,879,7747,89.8,52,21,40.4
3,All Students,2018-19,12849,1164,11685,90.9,77,27,35.1
3,All Students,2019-20,7323,564,6759,92.3,65,19,29.2
3,All Students,2020-21,9612,1038,8574,89.2,55,22,40.0
3,All Students,2021-22,8649,1102,7547,87.3,54,29,53.7
3,All Students,2022-23,7292,772,6520,89.4,43,17,39.5
4,All Students,2018-19,11006,912,10094,91.7,65,22,33.8
4,All Students,2019-20,8152,659,7493,91.9,75,26,34.7
4,All Students,2020-21,10739,1100,9639,89.8,65,24,36.9
4,All Students,2021-22,9172,1032,8140,88.7,54,29,53.7
4,All Students,2022-23,8322,925,7397,88.9,50,20,40.0
5,All Students,2018-19,11775,828,10947,93.0,69,18,26.1
5,All Students,2019-20,6802,528,6274,92.2,61,20,32.8
5,All Students,2020-21,12182,1352,10830,88.9,71,23,32.4
5,All Students,2021-22,11379,1394,9985,87.7,68,36,52.9
5,All Students,2022-23,9017,834,8183,90.8,51,18,35.3
All Grades,All Students,2018-19,103106,7275,95831,92.9,602,152,25.2
All Grades,All Students,2019-20,101975,8348,93627,91.8,913,257,28.1
All Grades,All Students,2020-21,141432,19554,121878,86.2,833,349,41.9
All Grades,All Students,2021-22,127639,16694,110945,86.9,765,386,50.5
All Grades,All Students,2022-23,127466,14481,112985,88.6,764,320,41.9
6,All Students,2018-19,30104,2009,28095,93.3,178,43,24.2
6,All Students,2019-20,30005,2109,27896,93.0,270,67,24.8
6,All Students,2020-21,34656,s,s,s,s,s,s
6,All Students,2021-22,33512,3848,29664,88.5,203,101,49.8
6,All Students,2022-23,38612,4094,34518,89.4,235,102,43.4
7,All Students,2018-19,38230,2522,35708,93.4,224,50,22.3
7,All Students,2019-20,34998,2641,32357,92.5,312,80,25.6
7,All Students,2020-21,52752,8087,44665,84.7,308,131,42.5
7,All Students,2021-22,43315,5826,37489,86.5,265,132,49.8
7,All Students,2022-23,43288,4708,38580,89.1,259,106,40.9
8,All Students,2018-19,34772,2744,32028,92.1,200,59,29.5
8,All Students,2019-20,36972,3598,33374,90.3,331,110,33.2
8,All Students,2020-21,54007,6601,47406,87.8,315,117,37.1
8,All Students,2021-22,50812,7020,43792,86.2,297,153,51.5
8,All Students,2022-23,45566,5679,39887,87.5,270,112,41.5
9,All Students,2020-21,17,s,s,s,s,s,s
All Grades,All Students,2018-19,175793,13513,162280,92.3,1070,264,24.7
All Grades,All Students,2019-20,112181,7837,104344,93.0,1037,236,22.8
All Grades,All Students,2020-21,172252,29068,143184,83.1,1009,531,52.6
All Grades,All Students,2021-22,162704,18207,144497,88.8,990,409,41.3
All Grades,All Students,2022-23,157837,13743,144094,91.3,977,276,28.2
6,All Students,2018-19,26922,1476,25446,94.5,156,23,14.7
6,All Students,2019-20,14324,724,13600,94.9,133,16,12.0
6,All Students,2020-21,22954,2723,20231,88.1,133,56,42.1
6,All Students,2021-22,24951,2848,22103,88.6,150,71,47.3
6,All Students,2022-23,24107,1688,22419,93.0,147,36,24.5
7,All Students,2018-19,28349,1772,26577,93.7,171,32,18.7
7,All Students,2019-20,17437,1106,16331,93.7,159,29,18.2
7,All Students,2020-21,21916,2858,19058,87.0,127,58,45.7
7,All Students,2021-22,24077,2411,21666,90.0,143,54,37.8
7,All Students,2022-23,24089,2182,21907,90.9,151,51,33.8
8,All Students,2018-19,30165,2681,27484,91.1,178,48,27.0
8,All Students,2019-20,18088,1018,17070,94.4,166,32,19.3
8,All Students,2020-21,24850,3589,21261,85.6,146,73,50.0
8,All Students,2021-22,21612,2004,19608,90.7,129,44,34.1
8,All Students,2022-23,24012,1849,22163,92.3,149,30,20.1
9,All Students,2018-19,27353,2440,24913,91.1,171,48,28.1
9,All Students,2019-20,18587,1361,17226,92.7,175,39,22.3
9,All Students,2020-21,31007,6037,24970,80.5,180,103,57.2
9,All Students,2021-22,24709,2834,21875,88.5,153,60,39.2
9,All Students,2022-23,22652,1760,20892,92.2,140,32,22.9
10,All Students,2018-19,28024,2362,25662,91.6,178,50,28.1
10,All Students,2019-20,20193,1957,18236,90.3,188,62,33.0
10,All Students,2020-21,29124,6178,22946,78.8,175,105,60.0
10,All Students,2021-22,29068,3842,25226,86.8,185,98,53.0
10,All Students,2022-23,24432,3039,21393,87.6,153,60,39.2
11,All Students,2018-19,17712,1245,16467,93.0,110,30,27.3
11,All Students,2019-20,11423,743,10680,93.5,104,24,23.1
11,All Students,2020-21,20705,2705,18000,86.9,120,51,42.5
11,All Students,2021-22,18323,2095,16228,88.6,110,37,33.6
11,All Students,2022-23,18634,1553,17081,91.7,116,35,30.2
12,All Students,2018-19,17268,1537,15731,91.1,106,33,31.1
12,All Students,2019-20,12129,928,11201,92.3,112,34,30.4
12,All Students,2020-21,21696,4978,16718,77.1,128,85,66.4
12,All Students,2021-22,19964,2173,17791,89.1,120,45,37.5
12,All Students,2022-23,19911,1672,18239,91.6,121,32,26.4
All Grades,All Students,2018-19,76831,11442,65389,85.1,469,212,45.2
All Grades,All Students,2019-20,44646,5373,39273,88.0,420,182,43.3
All Grades,All Students,2020-21,69272,10006,59266,85.6,403,175,43.4
All Grades,All Students,2021-22,63963,11588,52375,81.9,397,245,61.7
All Grades,All Students,2022-23,65036,11496,53540,82.3,406,231,56.9
9,All Students,2018-19,20094,2299,17795,88.6,120,41,34.2
9,All Students,2019-20,10896,1366,9530,87.5,103,44,42.7
9,All Students,2020-21,18232,2639,15593,85.5,108,45,41.7
9,All Students,2021-22,17785,2755,15030,84.5,114,61,53.5
9,All Students,2022-23,22173,2757,19416,87.6,136,57,41.9
10,All Students,2018-19,21801,3146,18655,85.6,135,55,40.7
10,All Students,2019-20,12294,1271,11023,89.7,115,41,35.7
10,All Students,2020-21,15482,2546,12936,83.6,90,42,46.7
10,All Students,2021-22,16498,3236,13262,80.4,102,62,60.8
10,All Students,2022-23,15750,2572,13178,83.7,99,53,53.5
11,All Students,2018-19,17091,2952,14139,82.7,106,52,49.1
11,All Students,2019-20,11260,1225,10035,89.1,105,37,35.2
11,All Students,2020-21,16838,1822,15016,89.2,97,34,35.1
11,All Students,2021-22,12992,2277,10715,82.5,81,49,60.5
11,All Students,2022-23,14669,3065,11604,79.1,92,58,63.0
12,All Students,2018-19,17845,3045,14800,82.9,108,64,59.3
12,All Students,2019-20,10196,1511,8685,85.2,97,60,61.9
12,All Students,2020-21,18720,2999,15721,84.0,108,54,50.0
12,All Students,2021-22,16688,3320,13368,80.1,100,73,73.0
12,All Students,2022-23,12444,3102,9342,75.1,79,63,79.7
All Grades,All Students,2018-19,51006,4197,46809,91.8,302,80,26.5
All Grades,All Students,2019-20,31712,2297,29415,92.8,298,71,23.8
All Grades,All Students,2020-21,48620,7967,40653,83.6,288,136,47.2
All Grades,All Students,2021-22,42084,3798,38286,91.0,255,91,35.7
All Grades,All Students,2022-23,43408,3548,39860,91.8,262,82,31.3
0K,All Students,2018-19,8000,829,7171,89.6,48,20,41.7
0K,All Students,2019-20,4467,387,4080,91.3,42,12,28.6
0K,All Students,2020-21,8265,1926,6339,76.7,50,30,60.0
0K,All Students,2021-22,5017,540,4477,89.2,31,14,45.2
0K,All Students,2022-23,7197,888,6309,87.7,43,20,46.5
1,All Students,2018-19,6689,512,6177,92.3,39,11,28.2
1,All Students,2019-20,5278,515,4763,90.2,51,18,35.3
1,All Students,2020-21,6588,966,5622,85.3,39,18,46.2
1,All Students,2021-22,6507,598,5909,90.8,40,15,37.5
1,All Students,2022-23,5523,621,4902,88.8,36,20,55.6
2,All Students,2018-19,7930,660,7270,91.7,48,12,25.0
2,All Students,2019-20,4286,268,4018,93.7,42,9,21.4
2,All Students,2020-21,8245,1226,7019,85.1,49,22,44.9
2,All Students,2021-22,6548,638,5910,90.3,39,15,38.5
2,All Students,2022-23,7100,528,6572,92.6,43,13,30.2
3,All Students,2018-19,10110,994,9116,90.2,59,13,22.0
3,All Students,2019-20,5270,321,4949,93.9,50,13,26.0
3,All Students,2020-21,7254,793,6461,89.1,44,11,25.0
3,All Students,2021-22,8557,797,7760,90.7,52,20,38.5
3,All Students,2022-23,6601,436,6165,93.4,41,10,24.4
4,All Students,2018-19,8239,637,7602,92.3,49,13,26.5
4,All Students,2019-20,7000,547,6453,92.2,62,13,21.0
4,All Students,2020-21,7690,751,6939,90.2,44,16,36.4
4,All Students,2021-22,7439,634,6805,91.5,46,13,28.3
4,All Students,2022-23,8886,639,8247,92.8,51,12,23.5
5,All Students,2018-19,10038,565,9473,94.4,59,11,18.6
5,All Students,2019-20,5411,259,5152,95.2,51,6,11.8
5,All Students,2020-21,10578,2305,8273,78.2,62,39,62.9
5,All Students,2021-22,8016,591,7425,92.6,47,14,29.8
5,All Students,2022-23,8101,436,7665,94.6,48,7,14.6
All Grades,All Students,2018-19,106034,6944,99090,93.5,631,144,22.8
All Grades,All Students,2019-20,66729,5035,61694,92.5,605,170,28.1
All Grades,All Students,2020-21,89214,13945,75269,84.4,523,268,51.2
All Grades,All Students,2021-22,81438,8261,73177,89.9,487,206,42.3
All Grades,All Students,2022-23,76827,6081,70746,92.1,461,135,29.3
PK in K-12 Schools,All Students,2018-19,12436,1076,11360,91.3,75,22,29.3
PK in K-12 Schools,All Students,2019-20,7934,816,7118,89.7,74,39,52.7
PK in K-12 Schools,All Students,2020-21,7146,1258,5888,82.4,45,26,57.8
PK in K-12 Schools,All Students,2021-22,13826,1987,11839,85.6,85,57,67.1
PK in K-12 Schools,All Students,2022-23,13948,1514,12434,89.1,85,37,43.5
0K,All Students,2018-19,15339,1278,14061,91.7,91,26,28.6
0K,All Students,2019-20,10303,801,9502,92.2,93,25,26.9
0K,All Students,2020-21,11005,1994,9011,81.9,63,34,54.0
0K,All Students,2021-22,8061,942,7119,88.3,48,25,52.1
0K,All Students,2022-23,8458,706,7752,91.7,49,14,28.6
1,All Students,2018-19,15301,982,14319,93.6,92,22,23.9
1,All Students,2019-20,9146,815,8331,91.1,84,30,35.7
1,All Students,2020-21,16041,2550,13491,84.1,93,47,50.5
1,All Students,2021-22,9602,915,8687,90.5,58,21,36.2
1,All Students,2022-23,8275,661,7614,92.0,52,17,32.7
2,All Students,2018-19,13837,943,12894,93.2,86,21,24.4
2,All Students,2019-20,10344,710,9634,93.1,92,18,19.6
2,All Students,2020-21,12640,1560,11080,87.7,74,34,45.9
2,All Students,2021-22,14479,1456,13023,89.9,89,36,40.4
2,All Students,2022-23,9156,642,8514,93.0,56,12,21.4
3,All Students,2018-19,16810,959,15851,94.3,96,20,20.8
3,All Students,2019-20,8499,540,7959,93.6,79,19,24.1
3,All Students,2020-21,15129,2719,12410,82.0,89,53,59.6
3,All Students,2021-22,11684,1082,10602,90.7,68,28,41.2
3,All Students,2022-23,13639,853,12786,93.7,79,18,22.8
4,All Students,2018-19,14997,868,14129,94.2,90,18,20.0
4,All Students,2019-20,10903,746,10157,93.2,97,22,22.7
4,All Students,2020-21,11840,1505,10335,87.3,69,32,46.4
4,All Students,2021-22,12579,907,11672,92.8,74,19,25.7
4,All Students,2022-23,11300,825,10475,92.7,69,21,30.4
5,All Students,2018-19,17314,838,16476,95.2,101,15,14.9
5,All Students,2019-20,9600,607,8993,93.7,86,17,19.8
5,All Students,2020-21,15413,2359,13054,84.7,90,42,46.7
5,All Students,2021-22,11207,972,10235,91.3,65,20,30.8
5,All Students,2022-23,12051,880,11171,92.7,71,16,22.5
All Grades,All Students,2018-19,96569,4857,91712,95.0,568,75,13.2
All Grades,All Students,2019-20,63360,3438,59922,94.6,576,90,15.6
All Grades,All Students,2020-21,96178,6368,89810,93.4,557,120,21.5
All Grades,All Students,2021-22,83286,8325,74961,90.0,494,205,41.5
All Grades,All Students,2022-23,70270,6311,63959,91.0,420,131,31.2
5,All Students,2018-19,13,s,s,s,s,s,s
6,All Students,2018-19,30225,1510,28715,95.0,178,22,12.4
6,All Students,2019-20,22838,1206,21632,94.7,206,28,13.6
6,All Students,2020-21,31860,1847,30013,94.2,184,38,20.7
6,All Students,2021-22,22818,s,s,s,s,s,s
6,All Students,2022-23,19599,1746,17853,91.1,119,37,31.1
7,All Students,2018-19,33933,1643,32290,95.2,200,27,13.5
7,All Students,2019-20,20765,1270,19495,93.9,188,39,20.7
7,All Students,2020-21,33473,2472,31001,92.6,196,46,23.5
7,All Students,2021-22,29977,3023,26954,89.9,176,72,40.9
7,All Students,2022-23,21475,2002,19473,90.7,130,46,35.4
8,All Students,2018-19,32377,1683,30694,94.8,189,26,13.8
8,All Students,2019-20,19757,962,18795,95.1,182,23,12.6
8,All Students,2020-21,30845,2049,28796,93.4,177,36,20.3
8,All Students,2021-22,30487,2974,27513,90.2,182,72,39.6
8,All Students,2022-23,29196,2563,26633,91.2,171,48,28.1
9,All Students,2018-19,21,s,s,s,s,s,s
9,All Students,2021-22,4,s,s,s,s,s,s
All Grades,All Students,2018-19,83830,6917,76913,91.7,533,134,25.1
All Grades,All Students,2019-20,54113,4354,49759,92.0,504,132,26.2
All Grades,All Students,2020-21,71744,9156,62588,87.2,425,163,38.4
All Grades,All Students,2021-22,64052,8547,55505,86.7,399,204,51.1
All Grades,All Students,2022-23,64430,7473,56957,88.4,402,156,38.8
5,All Students,2020-21,13,s,s,s,s,s,s
6,All Students,2018-19,26646,2083,24563,92.2,173,46,26.6
6,All Students,2019-20,15618,1050,14568,93.3,145,30,20.7
6,All Students,2020-21,19186,2316,16870,87.9,114,46,40.4
6,All Students,2021-22,19481,2493,16988,87.2,120,61,50.8
6,All Students,2022-23,19153,1627,17526,91.5,118,36,30.5
7,All Students,2018-19,30544,2565,27979,91.6,194,42,21.6
7,All Students,2019-20,18014,1389,16625,92.3,166,45,27.1
7,All Students,2020-21,25607,3131,22476,87.8,150,60,40.0
7,All Students,2021-22,19977,2702,17275,86.5,129,71,55.0
7,All Students,2022-23,22136,2751,19385,87.6,139,58,41.7
8,All Students,2018-19,26634,s,s,s,s,s,s
8,All Students,2019-20,20481,1915,18566,90.6,193,57,29.5
8,All Students,2020-21,26922,3693,23229,86.3,160,57,35.6
8,All Students,2021-22,24594,3352,21242,86.4,150,72,48.0
8,All Students,2022-23,23141,3095,20046,86.6,145,62,42.8
9,All Students,2018-19,6,s,s,s,s,s,s
9,All Students,2020-21,16,s,s,s,s,s,s
All Grades,All Students,2018-19,53117,3077,50040,94.2,328,62,18.9
All Grades,All Students,2019-20,33391,2295,31096,93.1,307,76,24.8
All Grades,All Students,2020-21,47887,4056,43831,91.5,286,77,26.9
All Grades,All Students,2021-22,43017,4301,38716,90.0,268,107,39.9
All Grades,All Students,2022-23,38968,3342,35626,91.4,236,72,30.5
PK in K-12 Schools,All Students,2018-19,6257,398,5859,93.6,39,10,25.6
PK in K-12 Schools,All Students,2019-20,4036,389,3647,90.4,36,14,38.9
PK in K-12 Schools,All Students,2020-21,5454,572,4882,89.5,34,15,44.1
PK in K-12 Schools,All Students,2021-22,5991,847,5144,85.9,37,24,64.9
PK in K-12 Schools,All Students,2022-23,6175,744,5431,88.0,39,20,51.3
0K,All Students,2018-19,7367,543,6824,92.6,47,14,29.8
0K,All Students,2019-20,4631,324,4307,93.0,43,12,27.9
0K,All Students,2020-21,6562,820,5742,87.5,40,17,42.5
0K,All Students,2021-22,4908,528,4380,89.2,33,17,51.5
0K,All Students,2022-23,5878,613,5265,89.6,35,14,40.0
1,All Students,2018-19,8299,481,7818,94.2,51,10,19.6
1,All Students,2019-20,4946,344,4602,93.0,47,13,27.7
1,All Students,2020-21,7169,651,6518,90.9,42,13,31.0
1,All Students,2021-22,6920,703,6217,89.8,43,16,37.2
1,All Students,2022-23,4903,362,4541,92.6,30,7,23.3
2,All Students,2018-19,6810,333,6477,95.1,41,2,4.9
2,All Students,2019-20,4791,257,4534,94.6,44,5,11.4
2,All Students,2020-21,8107,699,7408,91.4,48,12,25.0
2,All Students,2021-22,5999,500,5499,91.7,37,11,29.7
2,All Students,2022-23,5665,464,5201,91.8,34,9,26.5
3,All Students,2018-19,7038,416,6622,94.1,43,10,23.3
3,All Students,2019-20,5077,296,4781,94.2,47,10,21.3
3,All Students,2020-21,6541,327,6214,95.0,38,5,13.2
3,All Students,2021-22,6404,634,5770,90.1,39,16,41.0
3,All Students,2022-23,5815,375,5440,93.6,34,6,17.6
4,All Students,2018-19,8655,548,8107,93.7,53,11,20.8
4,All Students,2019-20,4895,340,4555,93.1,43,12,27.9
4,All Students,2020-21,7322,581,6741,92.1,44,9,20.5
4,All Students,2021-22,5985,502,5483,91.6,38,10,26.3
4,All Students,2022-23,5629,398,5231,92.9,35,9,25.7
5,All Students,2018-19,8691,358,8333,95.9,54,5,9.3
5,All Students,2019-20,5015,345,4670,93.1,47,10,21.3
5,All Students,2020-21,6696,397,6299,94.1,39,5,12.8
5,All Students,2021-22,6810,587,6223,91.4,41,13,31.7
5,All Students,2022-23,4898,s,s,s,s,s,s
6,All Students,2022-23,5,s,s,s,s,s,s
All Grades,All Students,2018-19,67243,10096,57147,85.0,436,208,47.7
All Grades,All Students,2019-20,44863,5649,39214,87.4,423,173,40.9
All Grades,All Students,2020-21,69857,7465,62392,89.3,413,162,39.2
All Grades,All Students,2021-22,65529,9434,56095,85.6,415,210,50.6
All Grades,All Students,2022-23,62727,5763,56964,90.8,397,102,25.7
9,All Students,2018-19,18130,3153,14977,82.6,116,54,46.6
9,All Students,2019-20,12190,1092,11098,91.0,116,29,25.0
9,All Students,2020-21,18273,1488,16785,91.9,107,33,30.8
9,All Students,2021-22,18156,2504,15652,86.2,119,59,49.6
9,All Students,2022-23,14169,1092,13077,92.3,90,14,15.6
10,All Students,2018-19,17195,1847,15348,89.3,120,48,40.0
10,All Students,2019-20,11163,1665,9498,85.1,106,46,43.4
10,All Students,2020-21,17741,1619,16122,90.9,103,30,29.1
10,All Students,2021-22,16049,2169,13880,86.5,100,47,47.0
10,All Students,2022-23,16773,1734,15039,89.7,107,36,33.6
11,All Students,2018-19,17431,2900,14531,83.4,111,61,55.0
11,All Students,2019-20,11240,1369,9871,87.8,105,47,44.8
11,All Students,2020-21,17733,2191,15542,87.6,105,46,43.8
11,All Students,2021-22,17332,2294,15038,86.8,107,52,48.6
11,All Students,2022-23,16358,1688,14670,89.7,104,29,27.9
12,All Students,2018-19,14487,2196,12291,84.8,89,45,50.6
12,All Students,2019-20,10270,1523,8747,85.2,96,51,53.1
12,All Students,2020-21,16110,2167,13943,86.5,98,53,54.1
12,All Students,2021-22,13992,2467,11525,82.4,89,52,58.4
12,All Students,2022-23,15427,1249,14178,91.9,96,23,24.0
All Grades,All Students,2018-19,64887,7076,57811,89.1,393,115,29.3
All Grades,All Students,2019-20,42835,4423,38412,89.7,399,112,28.1
All Grades,All Students,2020-21,69548,12476,57072,82.1,395,171,43.3
All Grades,All Students,2021-22,65993,5630,60363,91.5,396,108,27.3
All Grades,All Students,2022-23,60349,5548,54801,90.8,373,113,30.3
9,All Students,2018-19,22007,2448,19559,88.9,132,28,21.2
9,All Students,2019-20,12458,1196,11262,90.4,116,21,18.1
9,All Students,2020-21,21059,3257,17802,84.5,120,41,34.2
9,All Students,2021-22,17392,1946,15446,88.8,105,35,33.3
9,All Students,2022-23,16277,1768,14509,89.1,100,37,37.0
10,All Students,2018-19,15638,2053,13585,86.9,96,39,40.6
10,All Students,2019-20,13761,1422,12339,89.7,129,34,26.4
10,All Students,2020-21,19108,2562,16546,86.6,108,41,38.0
10,All Students,2021-22,17391,1154,16237,93.4,106,22,20.8
10,All Students,2022-23,15126,1194,13932,92.1,93,18,19.4
11,All Students,2018-19,14077,986,13091,93.0,86,17,19.8
11,All Students,2019-20,7571,906,6665,88.0,71,28,39.4
11,All Students,2020-21,16517,2337,14180,85.9,94,31,33.0
11,All Students,2021-22,15648,1160,14488,92.6,92,20,21.7
11,All Students,2022-23,14709,1020,13689,93.1,92,23,25.0
12,All Students,2018-19,13165,1589,11576,87.9,79,31,39.2
12,All Students,2019-20,9045,899,8146,90.1,83,29,34.9
12,All Students,2020-21,12864,4320,8544,66.4,73,58,79.5
12,All Students,2021-22,15562,1370,14192,91.2,93,31,33.3
12,All Students,2022-23,14237,1566,12671,89.0,88,35,39.8
All Grades,All Students,2018-19,52565,4560,48005,91.3,323,82,25.4
All Grades,All Students,2019-20,40357,3071,37286,92.4,374,97,25.9
All Grades,All Students,2020-21,69868,5812,64056,91.7,401,91,22.7
All Grades,All Students,2021-22,66789,6447,60342,90.3,400,129,32.3
All Grades,All Students,2022-23,65103,5993,59110,90.8,401,119,29.7
9,All Students,2018-19,14877,1315,13562,91.2,93,18,19.4
9,All Students,2019-20,15551,931,14620,94.0,145,27,18.6
9,All Students,2020-21,21875,1845,20030,91.6,125,27,21.6
9,All Students,2021-22,18982,1860,17122,90.2,117,35,29.9
9,All Students,2022-23,14932,1105,13827,92.6,92,22,23.9
10,All Students,2018-19,15715,1060,14655,93.3,97,18,18.6
10,All Students,2019-20,8619,758,7861,91.2,80,24,30.0
10,All Students,2020-21,21393,1648,19745,92.3,124,28,22.6
10,All Students,2021-22,17676,1668,16008,90.6,105,32,30.5
10,All Students,2022-23,16357,1648,14709,89.9,103,37,35.9
11,All Students,2018-19,11943,1183,10760,90.1,72,26,36.1
11,All Students,2019-20,8812,484,8328,94.5,81,16,19.8
11,All Students,2020-21,12425,863,11562,93.1,71,13,18.3
11,All Students,2021-22,18231,1602,16629,91.2,108,28,25.9
11,All Students,2022-23,16224,1459,14765,91.0,99,29,29.3
12,All Students,2018-19,10030,1002,9028,90.0,61,20,32.8
12,All Students,2019-20,7375,898,6477,87.8,68,30,44.1
12,All Students,2020-21,14175,1456,12719,89.7,81,23,28.4
12,All Students,2021-22,11900,1317,10583,88.9,70,34,48.6
12,All Students,2022-23,17590,1781,15809,89.9,107,31,29.0
All Grades,All Students,2018-19,57201,3242,53959,94.3,361,55,15.2
All Grades,All Students,2019-20,41047,2409,38638,94.1,388,70,18.0
All Grades,All Students,2020-21,67532,2952,64580,95.6,416,48,11.5
All Grades,All Students,2021-22,68541,6229,62312,90.9,427,133,31.1
11,All Students,2018-19,43157,5101,38056,88.2,269,110,40.9
All Grades,All Students,2022-23,64876,6630,58246,89.8,426,154,36.2
9,All Students,2018-19,19869,1396,18473,93.0,128,21,16.4
9,All Students,2019-20,14971,1046,13925,93.0,138,18,13.0
9,All Students,2020-21,21831,1156,20675,94.7,126,17,13.5
9,All Students,2021-22,16976,1146,15830,93.2,110,24,21.8
9,All Students,2022-23,17438,1206,16232,93.1,114,24,21.1
10,All Students,2018-19,14779,687,14092,95.4,93,12,12.9
10,All Students,2019-20,11334,516,10818,95.4,107,17,15.9
10,All Students,2020-21,21876,1056,20820,95.2,128,17,13.3
10,All Students,2021-22,18248,1717,16531,90.6,113,39,34.5
10,All Students,2022-23,15246,1333,13913,91.3,100,31,31.0
11,All Students,2018-19,12874,752,12122,94.2,79,15,19.0
11,All Students,2019-20,7322,473,6849,93.5,71,17,23.9
11,All Students,2020-21,16418,590,15828,96.4,94,10,10.6
11,All Students,2021-22,18971,1624,17347,91.4,115,36,31.3
11,All Students,2022-23,16684,1829,14855,89.0,105,47,44.8
12,All Students,2018-19,9679,407,9272,95.8,61,7,11.5
12,All Students,2019-20,7420,374,7046,95.0,72,18,25.0
12,All Students,2020-21,7407,150,7257,98.0,68,4,5.9
12,All Students,2021-22,14346,1742,12604,87.9,89,34,38.2
12,All Students,2022-23,15508,2262,13246,85.4,107,52,48.6
All Grades,All Students,2018-19,66635,8346,58289,87.5,417,183,43.9
All Grades,All Students,2019-20,43716,4188,39528,90.4,410,144,35.1
All Grades,All Students,2020-21,68212,6186,62026,90.9,410,115,28.0
All Grades,All Students,2021-22,67051,9608,57443,85.7,407,206,50.6
All Grades,All Students,2022-23,60472,7284,53188,88.0,396,185,46.7
9,All Students,2018-19,19886,2459,17427,87.6,125,52,41.6
9,All Students,2019-20,12714,1335,11379,89.5,122,38,31.1
9,All Students,2020-21,19941,1444,18497,92.8,118,20,16.9
9,All Students,2021-22,19679,2168,17511,89.0,120,52,43.3
9,All Students,2022-23,16618,1851,14767,88.9,108,44,40.7
10,All Students,2018-19,18487,2820,15667,84.7,117,57,48.7
10,All Students,2019-20,13382,1356,12026,89.9,125,48,38.4
10,All Students,2020-21,18283,2278,16005,87.5,113,47,41.6
10,All Students,2021-22,17822,2491,15331,86.0,108,49,45.4
10,All Students,2022-23,18905,2533,16372,86.6,125,61,48.8
11,All Students,2018-19,14567,1462,13105,90.0,89,31,34.8
11,All Students,2019-20,7936,537,7399,93.2,74,19,25.7
11,All Students,2020-21,16246,1252,14994,92.3,98,27,27.6
11,All Students,2021-22,14671,2207,12464,85.0,90,47,52.2
11,All Students,2022-23,13213,1442,11771,89.1,83,38,45.8
12,All Students,2018-19,13695,1605,12090,88.3,86,43,50.0
12,All Students,2019-20,9684,960,8724,90.1,89,39,43.8
12,All Students,2020-21,13742,1212,12530,91.2,81,21,25.9
12,All Students,2021-22,14879,2742,12137,81.6,89,58,65.2
12,All Students,2022-23,11736,1458,10278,87.6,80,42,52.5
All Grades,All Students,2018-19,177436,31084,146352,82.5,1121,540,48.2
All Grades,All Students,2019-20,106991,16135,90856,84.9,1016,455,44.8
All Grades,All Students,2020-21,165383,23219,142164,86.0,969,357,36.8
All Grades,All Students,2021-22,169731,30575,139156,82.0,1055,582,55.2
All Grades,All Students,2022-23,168429,17350,151079,89.7,1089,361,33.1
9,All Students,2018-19,57420,11453,45967,80.1,372,181,48.7
9,All Students,2019-20,31990,6274,25716,80.4,311,149,47.9
9,All Students,2020-21,53142,8306,44836,84.4,312,112,35.9
9,All Students,2021-22,57789,9729,48060,83.2,361,183,50.7
9,All Students,2022-23,53889,6098,47791,88.7,353,120,34.0
10,All Students,2018-19,38517,7777,30740,79.8,245,119,48.6
10,All Students,2019-20,28592,4131,24461,85.6,277,112,40.4
10,All Students,2020-21,43979,7868,36111,82.1,260,127,48.8
10,All Students,2021-22,46385,7674,38711,83.5,288,141,49.0
10,All Students,2022-23,50024,5345,44679,89.3,321,108,33.6
11,All Students,2019-20,17140,1531,15609,91.1,161,57,35.4
11,All Students,2020-21,35719,2897,32822,91.9,208,47,22.6
11,All Students,2021-22,29387,5303,24084,82.0,187,109,58.3
11,All Students,2022-23,36016,2907,33109,91.9,232,59,25.4
12,All Students,2018-19,38342,6753,31589,82.4,235,130,55.3
12,All Students,2019-20,29269,4199,25070,85.7,268,138,51.5
12,All Students,2020-21,32543,4148,28395,87.3,189,71,37.6
12,All Students,2021-22,36170,7869,28301,78.2,219,149,68.0
12,All Students,2022-23,28500,3000,25500,89.5,183,74,40.4
All Grades,All Students,2018-19,69893,5627,64266,91.9,429,127,29.6
All Grades,All Students,2019-20,48134,3034,45100,93.7,446,104,23.3
All Grades,All Students,2020-21,79463,4330,75133,94.6,459,59,12.9
All Grades,All Students,2021-22,72269,6611,65658,90.9,434,130,30.0
All Grades,All Students,2022-23,68376,4169,64207,93.9,421,82,19.5
9,All Students,2018-19,21361,1534,19827,92.8,134,34,25.4
9,All Students,2019-20,16056,819,15237,94.9,148,20,13.5
9,All Students,2020-21,23531,1233,22298,94.8,136,17,12.5
9,All Students,2021-22,18453,1321,17132,92.8,112,28,25.0
9,All Students,2022-23,18668,1383,17285,92.6,115,31,27.0
10,All Students,2018-19,17541,1095,16446,93.8,108,24,22.2
10,All Students,2019-20,11821,678,11143,94.3,110,24,21.8
10,All Students,2020-21,23316,1141,22175,95.1,136,14,10.3
10,All Students,2021-22,18236,1450,16786,92.0,109,22,20.2
10,All Students,2022-23,16818,881,15937,94.8,105,16,15.2
11,All Students,2018-19,15619,1098,14521,93.0,95,22,23.2
11,All Students,2019-20,9569,551,9018,94.2,89,19,21.3
11,All Students,2020-21,16166,858,15308,94.7,93,12,12.9
11,All Students,2021-22,18479,1571,16908,91.5,111,31,27.9
11,All Students,2022-23,14838,636,14202,95.7,90,10,11.1
12,All Students,2018-19,15372,1900,13472,87.6,92,47,51.1
12,All Students,2019-20,10688,986,9702,90.8,99,41,41.4
12,All Students,2020-21,16450,1098,15352,93.3,94,16,17.0
12,All Students,2021-22,17101,2269,14832,86.7,102,49,48.0
12,All Students,2022-23,18052,1269,16783,93.0,111,25,22.5
All Grades,All Students,2018-19,503062,15695,487367,96.9,3026,222,7.3
All Grades,All Students,2019-20,327832,8339,319493,97.5,2984,169,5.7
All Grades,All Students,2020-21,513610,9547,504063,98.1,2938,99,3.4
All Grades,All Students,2021-22,505767,23662,482105,95.3,2982,413,13.8
All Grades,All Students,2022-23,485948,20791,465157,95.7,2955,316,10.7
9,All Students,2018-19,126782,1835,124947,98.6,763,16,2.1
9,All Students,2019-20,81722,1031,80691,98.7,744,10,1.3
9,All Students,2020-21,125870,1048,124822,99.2,721,8,1.1
9,All Students,2021-22,132853,3729,129124,97.2,783,49,6.3
9,All Students,2022-23,121260,3164,118096,97.4,739,33,4.5
10,All Students,2018-19,126109,2513,123596,98.0,761,19,2.5
10,All Students,2019-20,81591,1591,80000,98.1,743,25,3.4
10,All Students,2020-21,129950,1697,128253,98.7,744,14,1.9
10,All Students,2021-22,123961,4233,119728,96.6,730,47,6.4
10,All Students,2022-23,125880,4253,121627,96.6,766,48,6.3
11,All Students,2018-19,126291,3232,123059,97.4,758,28,3.7
11,All Students,2019-20,81749,1713,80036,97.9,744,29,3.9
11,All Students,2020-21,128282,1961,126321,98.5,733,19,2.6
11,All Students,2021-22,125022,4708,120314,96.2,739,73,9.9
11,All Students,2022-23,118918,4642,114276,96.1,722,59,8.2
12,All Students,2018-19,123880,8115,115765,93.4,744,159,21.4
12,All Students,2019-20,82770,4004,78766,95.2,753,105,13.9
12,All Students,2020-21,129508,4841,124667,96.3,740,58,7.8
12,All Students,2021-22,123931,10992,112939,91.1,730,244,33.4
12,All Students,2022-23,119890,8732,111158,92.7,728,176,24.2
All Grades,All Students,2018-19,81561,4940,76621,93.9,473,98,20.7
All Grades,All Students,2019-20,52373,2781,49592,94.7,466,85,18.2
All Grades,All Students,2020-21,78093,7169,70924,90.8,457,135,29.5
All Grades,All Students,2021-22,76576,6727,69849,91.2,451,138,30.6
All Grades,All Students,2022-23,77191,6122,71069,92.1,459,157,34.2
6,All Students,2018-19,24319,1229,23090,94.9,141,22,15.6
6,All Students,2019-20,16417,690,15727,95.8,146,22,15.1
6,All Students,2020-21,27609,1825,25784,93.4,160,33,20.6
6,All Students,2021-22,25070,2356,22714,90.6,151,54,35.8
6,All Students,2022-23,23639,1806,21833,92.4,142,55,38.7
7,All Students,2018-19,28280,1667,26613,94.1,163,35,21.5
7,All Students,2019-20,17307,917,16390,94.7,155,29,18.7
7,All Students,2020-21,24907,2699,22208,89.2,147,52,35.4
7,All Students,2021-22,27939,2731,25208,90.2,163,54,33.1
7,All Students,2022-23,25402,1981,23421,92.2,149,49,32.9
8,All Students,2018-19,28962,2044,26918,92.9,169,41,24.3
8,All Students,2019-20,18649,1174,17475,93.7,165,34,20.6
8,All Students,2020-21,25577,2645,22932,89.7,150,50,33.3
8,All Students,2021-22,23567,1640,21927,93.0,137,30,21.9
8,All Students,2022-23,28150,2335,25815,91.7,168,53,31.5
All Grades,All Students,2018-19,53676,5513,48163,89.7,326,114,35.0
6,All Students,2018-19,16178,s,s,s,s,s,s
7,All Students,2018-19,19778,1797,17981,90.9,123,39,31.7
8,All Students,2018-19,17716,2346,15370,86.8,108,46,42.6
9,All Students,2018-19,4,s,s,s,s,s,s
All Grades,All Students,2018-19,73802,5090,68712,93.1,458,85,18.6
All Grades,All Students,2019-20,48955,3506,45449,92.8,463,113,24.4
All Grades,All Students,2020-21,71266,7242,64024,89.8,447,131,29.3
All Grades,All Students,2021-22,72975,7234,65741,90.1,448,151,33.7
All Grades,All Students,2022-23,68587,6824,61763,90.1,432,151,35.0
9,All Students,2018-19,18286,1212,17074,93.4,115,13,11.3
9,All Students,2019-20,12592,869,11723,93.1,124,28,22.6
9,All Students,2020-21,16943,1628,15315,90.4,108,32,29.6
9,All Students,2021-22,18662,1956,16706,89.5,117,36,30.8
9,All Students,2022-23,17885,1616,16269,91.0,114,31,27.2
10,All Students,2018-19,18277,1180,17097,93.5,115,22,19.1
10,All Students,2019-20,12248,854,11394,93.0,116,21,18.1
10,All Students,2020-21,18184,1649,16535,90.9,115,25,21.7
10,All Students,2021-22,17235,1467,15768,91.5,110,38,34.5
10,All Students,2022-23,18056,1365,16691,92.4,117,31,26.5
11,All Students,2018-19,19358,1210,18148,93.7,119,20,16.8
11,All Students,2019-20,11842,766,11076,93.5,111,19,17.1
11,All Students,2020-21,19137,2115,17022,88.9,118,35,29.7
11,All Students,2021-22,18120,1828,16292,89.9,109,38,34.9
11,All Students,2022-23,16446,1813,14633,89.0,102,37,36.3
12,All Students,2018-19,17881,1488,16393,91.7,109,30,27.5
12,All Students,2019-20,12273,1017,11256,91.7,112,45,40.2
12,All Students,2020-21,17002,1850,15152,89.1,106,39,36.8
12,All Students,2021-22,18958,1983,16975,89.5,112,39,34.8
12,All Students,2022-23,16200,2030,14170,87.5,99,52,52.5
All Grades,All Students,2018-19,56659,6974,49685,87.7,356,98,27.5
All Grades,All Students,2019-20,36366,4790,31576,86.8,363,168,46.3
All Grades,All Students,2020-21,55116,9045,46071,83.6,364,187,51.4
All Grades,All Students,2021-22,53326,12159,41167,77.2,355,243,68.5
All Grades,All Students,2022-23,56794,8282,48512,85.4,395,169,42.8
9,All Students,2018-19,13418,874,12544,93.5,90,10,11.1
9,All Students,2019-20,9581,773,8808,91.9,100,37,37.0
9,All Students,2020-21,7956,890,7066,88.8,66,26,39.4
9,All Students,2021-22,10973,1897,9076,82.7,84,48,57.1
9,All Students,2022-23,14320,1317,13003,90.8,114,30,26.3
10,All Students,2018-19,15445,1721,13724,88.9,98,26,26.5
10,All Students,2019-20,8134,995,7139,87.8,81,36,44.4
10,All Students,2020-21,14755,1751,13004,88.1,102,43,42.2
10,All Students,2021-22,10846,2363,8483,78.2,73,48,65.8
10,All Students,2022-23,14832,1529,13303,89.7,104,32,30.8
11,All Students,2018-19,15280,2409,12871,84.2,93,33,35.5
11,All Students,2019-20,9790,1497,8293,84.7,99,47,47.5
11,All Students,2020-21,15121,2637,12484,82.6,95,51,53.7
11,All Students,2021-22,17855,4043,13812,77.4,113,79,69.9
11,All Students,2022-23,14951,2165,12786,85.5,98,50,51.0
12,All Students,2018-19,12516,1970,10546,84.3,75,29,38.7
12,All Students,2019-20,8861,1525,7336,82.8,83,48,57.8
12,All Students,2020-21,17284,3767,13517,78.2,101,67,66.3
12,All Students,2021-22,13652,3856,9796,71.8,85,68,80.0
12,All Students,2022-23,12691,3271,9420,74.2,79,57,72.2
All Grades,All Students,2022-23,64567,12516,52051,80.6,403,304,75.4
PK in K-12 Schools,All Students,2022-23,64557,s,s,s,s,s,s
0K,All Students,2022-23,10,s,s,s,s,s,s
All Grades,All Students,2018-19,57299,11108,46191,80.6,390,220,56.4
All Grades,All Students,2019-20,35695,5871,29824,83.6,350,168,48.0
All Grades,All Students,2020-21,50693,6504,44189,87.2,327,113,34.6
All Grades,All Students,2021-22,44665,8727,35938,80.5,308,187,60.7
All Grades,All Students,2022-23,41257,7209,34048,82.5,289,152,52.6
9,All Students,2018-19,17093,3362,13731,80.3,121,64,52.9
9,All Students,2019-20,10394,1759,8635,83.1,107,46,43.0
9,All Students,2020-21,16796,2545,14251,84.8,102,37,36.3
9,All Students,2021-22,12415,2627,9788,78.8,88,52,59.1
9,All Students,2022-23,12533,2126,10407,83.0,84,45,53.6
10,All Students,2018-19,18022,4350,13672,75.9,124,70,56.5
10,All Students,2019-20,8186,1168,7018,85.7,82,37,45.1
10,All Students,2020-21,13072,2030,11042,84.5,82,35,42.7
10,All Students,2021-22,12705,2582,10123,79.7,82,48,58.5
10,All Students,2022-23,10438,1928,8510,81.5,70,43,61.4
11,All Students,2018-19,12800,1807,10993,85.9,88,44,50.0
11,All Students,2019-20,8922,1820,7102,79.6,85,46,54.1
11,All Students,2020-21,9469,1038,8431,89.0,59,16,27.1
11,All Students,2021-22,10622,1718,8904,83.8,65,38,58.5
11,All Students,2022-23,10785,1885,8900,82.5,69,32,46.4
12,All Students,2018-19,9384,1589,7795,83.1,57,42,73.7
12,All Students,2019-20,8193,1124,7069,86.3,76,39,51.3
12,All Students,2020-21,11356,891,10465,92.2,84,25,29.8
12,All Students,2021-22,8923,1800,7123,79.8,73,49,67.1
12,All Students,2022-23,7501,1270,6231,83.1,66,32,48.5
All Grades,All Students,2018-19,78460,8986,69474,88.5,495,137,27.7
All Grades,All Students,2019-20,48825,5124,43701,89.5,471,118,25.1
All Grades,All Students,2020-21,77346,6755,70591,91.3,468,143,30.6
All Grades,All Students,2021-22,69498,12418,57080,82.1,427,231,54.1
All Grades,All Students,2022-23,69720,7477,62243,89.3,454,123,27.1
8,All Students,2018-19,162,s,s,s,s,s,s
9,All Students,2018-19,18093,s,s,s,s,s,s
9,All Students,2019-20,13968,1123,12845,92.0,133,22,16.5
9,All Students,2020-21,21825,1723,20102,92.1,133,33,24.8
9,All Students,2021-22,17254,2759,14495,84.0,109,59,54.1
9,All Students,2022-23,17168,1512,15656,91.2,116,29,25.0
10,All Students,2018-19,20129,2519,17610,87.5,129,40,31.0
10,All Students,2019-20,10836,1230,9606,88.6,112,31,27.7
10,All Students,2020-21,21684,1949,19735,91.0,131,48,36.6
10,All Students,2021-22,18377,3607,14770,80.4,112,53,47.3
10,All Students,2022-23,16193,2469,13724,84.8,111,43,38.7
11,All Students,2018-19,18455,2933,15522,84.1,116,40,34.5
11,All Students,2019-20,11267,1369,9898,87.8,107,31,29.0
11,All Students,2020-21,16009,1653,14356,89.7,97,31,32.0
11,All Students,2021-22,18418,3120,15298,83.1,115,64,55.7
11,All Students,2022-23,18660,1934,16726,89.6,120,30,25.0
12,All Students,2018-19,21621,2077,19544,90.4,133,35,26.3
12,All Students,2019-20,12754,1402,11352,89.0,119,34,28.6
12,All Students,2020-21,17828,1430,16398,92.0,107,31,29.0
12,All Students,2021-22,15449,2932,12517,81.0,91,55,60.4
12,All Students,2022-23,17699,1562,16137,91.2,107,21,19.6
All Grades,All Students,2018-19,67113,11365,55748,83.1,431,226,52.4
All Grades,All Students,2019-20,41530,6152,35378,85.2,404,205,50.7
All Grades,All Students,2020-21,71453,4323,67130,93.9,419,74,17.7
All Grades,All Students,2021-22,69332,14024,55308,79.8,435,294,67.6
All Grades,All Students,2022-23,65791,12551,53240,80.9,435,263,60.5
8,All Students,2020-21,10,s,s,s,s,s,s
9,All Students,2018-19,20167,2904,17263,85.6,134,62,46.3
9,All Students,2019-20,12977,2128,10849,83.6,129,71,55.0
9,All Students,2020-21,22177,1467,20710,93.4,130,26,20.0
9,All Students,2021-22,19541,3372,16169,82.7,122,70,57.4
9,All Students,2022-23,20613,4220,16393,79.5,139,81,58.3
10,All Students,2018-19,16242,2328,13914,85.7,103,47,45.6
10,All Students,2019-20,11217,1625,9592,85.5,109,55,50.5
10,All Students,2020-21,19040,1398,17642,92.7,111,23,20.7
10,All Students,2021-22,18679,4081,14598,78.2,122,85,69.7
10,All Students,2022-23,17125,3023,14102,82.3,115,65,56.5
11,All Students,2018-19,15276,3389,11887,77.8,97,54,55.7
11,All Students,2019-20,9351,1313,8038,86.0,92,43,46.7
11,All Students,2020-21,16196,798,15398,95.1,95,11,11.6
11,All Students,2021-22,14356,3043,11313,78.8,90,63,70.0
11,All Students,2022-23,14797,2853,11944,80.7,97,57,58.8
12,All Students,2018-19,15428,2744,12684,82.2,97,63,64.9
12,All Students,2019-20,7985,1086,6899,86.4,74,36,48.6
12,All Students,2020-21,14030,s,s,s,s,s,s
12,All Students,2021-22,16756,3528,13228,78.9,101,76,75.2
12,All Students,2022-23,13256,2455,10801,81.5,84,60,71.4
All Grades,All Students,2018-19,68418,2556,65862,96.3,412,32,7.8
All Grades,All Students,2019-20,41970,1223,40747,97.1,383,19,5.0
All Grades,All Students,2020-21,67175,372,66803,99.4,387,4,1.0
All Grades,All Students,2021-22,69025,3054,65971,95.6,408,44,10.8
All Grades,All Students,2022-23,66103,2799,63304,95.8,401,40,10.0
9,All Students,2018-19,17447,448,16999,97.4,106,4,3.8
9,All Students,2019-20,9020,193,8827,97.9,82,3,3.7
9,All Students,2020-21,17348,83,17265,99.5,101,1,1.0
9,All Students,2021-22,20982,665,20317,96.8,124,8,6.5
9,All Students,2022-23,16677,613,16064,96.3,101,6,5.9
10,All Students,2018-19,15964,478,15486,97.0,96,6,6.3
10,All Students,2019-20,11000,255,10745,97.7,100,3,3.0
10,All Students,2020-21,16130,59,16071,99.6,93,0,0.0
10,All Students,2021-22,16092,590,15502,96.3,96,7,7.3
10,All Students,2022-23,19961,808,19153,96.0,120,14,11.7
11,All Students,2018-19,18313,687,17626,96.2,110,7,6.4
11,All Students,2019-20,10230,287,9943,97.2,93,5,5.4
11,All Students,2020-21,17422,57,17365,99.7,100,0,0.0
11,All Students,2021-22,15119,606,14513,96.0,89,7,7.9
11,All Students,2022-23,15104,609,14495,96.0,94,10,10.6
12,All Students,2018-19,16694,943,15751,94.4,100,15,15.0
12,All Students,2019-20,11720,488,11232,95.8,108,8,7.4
12,All Students,2020-21,16275,173,16102,98.9,93,3,3.2
12,All Students,2021-22,16832,1193,15639,92.9,99,22,22.2
12,All Students,2022-23,14361,769,13592,94.6,86,10,11.6
All Grades,All Students,2018-19,60225,6587,53638,89.1,378,170,45.0
All Grades,All Students,2019-20,37138,3501,33637,90.6,345,127,36.8
All Grades,All Students,2020-21,50979,6263,44716,87.7,304,115,37.8
All Grades,All Students,2021-22,49537,7084,42453,85.7,311,184,59.2
All Grades,All Students,2022-23,55479,6374,49105,88.5,352,177,50.3
PK in K-12 Schools,All Students,2018-19,5185,782,4403,84.9,37,23,62.2
PK in K-12 Schools,All Students,2019-20,4065,507,3558,87.5,36,19,52.8
PK in K-12 Schools,All Students,2020-21,4924,660,4264,86.6,30,15,50.0
PK in K-12 Schools,All Students,2021-22,5804,915,4889,84.2,41,29,70.7
PK in K-12 Schools,All Students,2022-23,6288,687,5601,89.1,41,22,53.7
0K,All Students,2018-19,8402,1150,7252,86.3,51,31,60.8
0K,All Students,2019-20,4770,467,4303,90.2,48,19,39.6
0K,All Students,2020-21,6559,990,5569,84.9,39,21,53.8
0K,All Students,2021-22,7062,1195,5867,83.1,45,34,75.6
0K,All Students,2022-23,8614,1229,7385,85.7,56,33,58.9
1,All Students,2018-19,6214,667,5547,89.3,43,20,46.5
1,All Students,2019-20,5449,584,4865,89.3,51,21,41.2
1,All Students,2020-21,7789,1216,6573,84.4,47,23,48.9
1,All Students,2021-22,6919,1220,5699,82.4,45,28,62.2
1,All Students,2022-23,9514,1114,8400,88.3,59,33,55.9
2,All Students,2018-19,7710,695,7015,91.0,46,17,37.0
2,All Students,2019-20,3996,322,3674,91.9,37,14,37.8
2,All Students,2020-21,8037,926,7111,88.5,49,19,38.8
2,All Students,2021-22,7621,938,6683,87.7,45,22,48.9
2,All Students,2022-23,7413,938,6475,87.3,48,30,62.5
3,All Students,2018-19,9681,1082,8599,88.8,61,28,45.9
3,All Students,2019-20,5033,377,4656,92.5,46,10,21.7
3,All Students,2020-21,6222,585,5637,90.6,37,11,29.7
3,All Students,2021-22,7794,1076,6718,86.2,48,28,58.3
3,All Students,2022-23,8818,879,7939,90.0,55,20,36.4
4,All Students,2018-19,11767,1178,10589,90.0,73,26,35.6
4,All Students,2019-20,6414,552,5862,91.4,60,18,30.0
4,All Students,2020-21,8050,866,7184,89.2,46,14,30.4
4,All Students,2021-22,6516,805,5711,87.6,39,21,53.8
4,All Students,2022-23,8137,876,7261,89.2,53,24,45.3
5,All Students,2018-19,11266,1033,10233,90.8,67,25,37.3
5,All Students,2019-20,7411,692,6719,90.7,67,26,38.8
5,All Students,2020-21,9398,1020,8378,89.1,56,12,21.4
5,All Students,2021-22,7821,935,6886,88.0,48,22,45.8
5,All Students,2022-23,6695,651,6044,90.3,40,15,37.5
All Grades,All Students,2018-19,93504,5287,88217,94.3,549,92,16.8
All Grades,All Students,2019-20,60563,2992,57571,95.1,563,62,11.0
All Grades,All Students,2020-21,93596,2898,90698,96.9,553,41,7.4
All Grades,All Students,2021-22,104845,6455,98390,93.8,616,115,18.7
All Grades,All Students,2022-23,113191,7543,105648,93.3,666,146,21.9
PK in K-12 Schools,All Students,2020-21,2961,133,2828,95.5,19,4,21.1
PK in K-12 Schools,All Students,2021-22,3167,s,s,s,s,s,s
PK in K-12 Schools,All Students,2022-23,3186,235,2951,92.6,18,4,22.2
0K,All Students,2018-19,8868,517,8351,94.2,53,8,15.1
0K,All Students,2019-20,5377,300,5077,94.4,49,5,10.2
0K,All Students,2020-21,8055,240,7815,97.0,48,5,10.4
0K,All Students,2021-22,11575,991,10584,91.4,69,17,24.6
0K,All Students,2022-23,12611,1056,11555,91.6,75,24,32.0
1,All Students,2018-19,10981,558,10423,94.9,64,9,14.1
1,All Students,2019-20,6124,301,5823,95.1,57,6,10.5
1,All Students,2020-21,7353,247,7106,96.6,43,5,11.6
1,All Students,2021-22,8846,465,8381,94.7,53,4,7.5
1,All Students,2022-23,11263,850,10413,92.5,67,19,28.4
2,All Students,2018-19,8672,494,8178,94.3,50,7,14.0
2,All Students,2019-20,7199,270,6929,96.2,65,0,0.0
2,All Students,2020-21,9658,280,9378,97.1,59,4,6.8
2,All Students,2021-22,7890,497,7393,93.7,47,8,17.0
2,All Students,2022-23,9222,614,8608,93.3,56,12,21.4
3,All Students,2018-19,10695,455,10240,95.7,64,9,14.1
3,All Students,2019-20,5868,284,5584,95.2,56,8,14.3
3,All Students,2020-21,10744,221,10523,97.9,62,2,3.2
3,All Students,2021-22,11096,622,10474,94.4,65,13,20.0
3,All Students,2022-23,8308,463,7845,94.4,50,8,16.0
4,All Students,2018-19,11203,465,10738,95.8,65,8,12.3
4,All Students,2019-20,7338,311,7027,95.8,68,4,5.9
4,All Students,2020-21,9510,408,9102,95.7,58,7,12.1
4,All Students,2021-22,11160,516,10644,95.4,66,8,12.1
4,All Students,2022-23,11615,617,10998,94.7,68,12,17.6
5,All Students,2018-19,10993,554,10439,95.0,64,8,12.5
5,All Students,2019-20,7239,238,7001,96.7,70,5,7.1
5,All Students,2020-21,10964,311,10653,97.2,64,2,3.1
5,All Students,2021-22,9808,613,9195,93.8,57,12,21.1
5,All Students,2022-23,11820,635,11185,94.6,69,10,14.5
6,All Students,2018-19,10245,549,9696,94.6,59,9,15.3
6,All Students,2019-20,7642,403,7239,94.7,70,7,10.0
6,All Students,2020-21,11806,308,11498,97.4,68,3,4.4
6,All Students,2021-22,15872,1156,14716,92.7,92,28,30.4
6,All Students,2022-23,14823,950,13873,93.6,86,14,16.3
7,All Students,2018-19,11346,699,10647,93.8,66,12,18.2
7,All Students,2019-20,6765,375,6390,94.5,65,13,20.0
7,All Students,2020-21,11700,338,11362,97.1,70,5,7.1
7,All Students,2021-22,13934,714,13220,94.9,81,10,12.3
7,All Students,2022-23,15658,1212,14446,92.3,90,25,27.8
8,All Students,2018-19,10501,996,9505,90.5,64,22,34.4
8,All Students,2019-20,7011,510,6501,92.7,63,14,22.2
8,All Students,2020-21,10845,412,10433,96.2,62,4,6.5
8,All Students,2021-22,11477,702,10775,93.9,67,12,17.9
8,All Students,2022-23,14685,911,13774,93.8,87,18,20.7
9,All Students,2021-22,20,s,s,s,s,s,s
All Grades,All Students,2018-19,117345,11124,106221,90.5,716,260,36.3
All Grades,All Students,2019-20,68669,7065,61604,89.7,650,245,37.7
All Grades,All Students,2020-21,93442,7159,86283,92.3,580,157,27.1
All Grades,All Students,2021-22,87663,12447,75216,85.8,548,291,53.1
All Grades,All Students,2022-23,86433,10442,75991,87.9,551,276,50.1
0K,All Students,2018-19,16251,2038,14213,87.5,103,50,48.5
0K,All Students,2019-20,10643,1360,9283,87.2,103,51,49.5
0K,All Students,2020-21,12190,1002,11188,91.8,81,30,37.0
0K,All Students,2021-22,12529,1731,10798,86.2,80,50,62.5
0K,All Students,2022-23,12159,1674,10485,86.2,82,50,61.0
1,All Students,2018-19,18091,1862,16229,89.7,114,44,38.6
1,All Students,2019-20,11601,1439,10162,87.6,107,49,45.8
1,All Students,2020-21,15118,1452,13666,90.4,94,36,38.3
1,All Students,2021-22,12436,2322,10114,81.3,79,55,69.6
1,All Students,2022-23,14106,2028,12078,85.6,89,49,55.1
2,All Students,2018-19,20435,2014,18421,90.1,126,52,41.3
2,All Students,2019-20,8875,678,8197,92.4,83,27,32.5
2,All Students,2020-21,18520,1926,16594,89.6,112,34,30.4
2,All Students,2021-22,13967,2113,11854,84.9,90,51,56.7
2,All Students,2022-23,12508,1724,10784,86.2,78,44,56.4
3,All Students,2018-19,16627,1381,15246,91.7,100,34,34.0
3,All Students,2019-20,12813,1266,11547,90.1,125,48,38.4
3,All Students,2020-21,12286,745,11541,93.9,76,13,17.1
3,All Students,2021-22,18726,2554,16172,86.4,115,57,49.6
3,All Students,2022-23,14948,1675,13273,88.8,98,43,43.9
4,All Students,2018-19,22945,1873,21072,91.8,137,38,27.7
4,All Students,2019-20,10683,1055,9628,90.1,105,34,32.4
4,All Students,2020-21,19551,1169,18382,94.0,122,25,20.5
4,All Students,2021-22,12694,1635,11059,87.1,80,37,46.3
4,All Students,2022-23,17631,2023,15608,88.5,112,55,49.1
5,All Students,2018-19,22996,1956,21040,91.5,136,42,30.9
5,All Students,2019-20,14054,1267,12787,91.0,127,36,28.3
5,All Students,2020-21,15777,865,14912,94.5,95,19,20.0
5,All Students,2021-22,17311,2092,15219,87.9,104,41,39.4
5,All Students,2022-23,15081,1318,13763,91.3,92,35,38.0
All Grades,All Students,2018-19,153034,14447,138587,90.6,921,350,38.0
All Grades,All Students,2019-20,94031,9233,84798,90.2,877,327,37.3
All Grades,All Students,2020-21,125525,15287,110238,87.8,759,311,41.0
All Grades,All Students,2021-22,115425,16361,99064,85.8,704,379,53.8
All Grades,All Students,2022-23,109393,13007,96386,88.1,684,334,48.8
0K,All Students,2018-19,20184,1882,18302,90.7,125,47,37.6
0K,All Students,2019-20,14881,1789,13092,88.0,148,72,48.6
0K,All Students,2020-21,16985,s,s,s,s,s,s
0K,All Students,2021-22,15611,2557,13054,83.6,94,58,61.7
0K,All Students,2022-23,14096,2186,11910,84.5,91,60,65.9
1,All Students,2018-19,24690,2713,21977,89.0,149,68,45.6
1,All Students,2019-20,13287,1414,11873,89.4,124,52,41.9
1,All Students,2020-21,19658,3002,16656,84.7,121,63,52.1
1,All Students,2021-22,18090,2528,15562,86.0,113,59,52.2
1,All Students,2022-23,18065,2270,15795,87.4,111,66,59.5
2,All Students,2018-19,24858,2323,22535,90.7,152,57,37.5
2,All Students,2019-20,16227,1529,14698,90.6,149,56,37.6
2,All Students,2020-21,18095,1735,16360,90.4,108,37,34.3
2,All Students,2021-22,19566,2842,16724,85.5,117,61,52.1
2,All Students,2022-23,16769,1908,14861,88.6,110,52,47.3
3,All Students,2018-19,26870,2407,24463,91.0,160,57,35.6
3,All Students,2019-20,16203,1441,14762,91.1,147,44,29.9
3,All Students,2020-21,23302,2948,20354,87.3,142,64,45.1
3,All Students,2021-22,18067,2594,15473,85.6,111,61,55.0
3,All Students,2022-23,19910,2322,17588,88.3,125,58,46.4
4,All Students,2018-19,26949,2682,24267,90.0,162,70,43.2
4,All Students,2019-20,16102,1481,14621,90.8,149,51,34.2
4,All Students,2020-21,23637,2861,20776,87.9,140,56,40.0
4,All Students,2021-22,21945,2877,19068,86.9,134,66,49.3
4,All Students,2022-23,18659,1887,16772,89.9,115,45,39.1
5,All Students,2018-19,29483,2440,27043,91.7,173,51,29.5
5,All Students,2019-20,17331,1579,15752,90.9,160,52,32.5
5,All Students,2020-21,23681,2367,21314,90.0,139,38,27.3
5,All Students,2021-22,22146,2963,19183,86.6,135,74,54.8
5,All Students,2022-23,21894,2434,19460,88.9,132,53,40.2
6,All Students,2020-21,167,s,s,s,s,s,s
All Grades,All Students,2018-19,115518,9427,106091,91.8,692,207,29.9
All Grades,All Students,2019-20,65490,4277,61213,93.5,598,128,21.4
All Grades,All Students,2020-21,89663,8389,81274,90.6,542,174,32.1
All Grades,All Students,2021-22,78733,8547,70186,89.1,483,226,46.8
All Grades,All Students,2022-23,85491,9032,76459,89.4,519,214,41.2
PK in K-12 Schools,All Students,2018-19,3172,359,2813,88.7,19,8,42.1
PK in K-12 Schools,All Students,2019-20,2062,143,1919,93.1,18,3,16.7
PK in K-12 Schools,All Students,2020-21,2998,297,2701,90.1,18,6,33.3
PK in K-12 Schools,All Students,2021-22,3178,312,2866,90.2,19,9,47.4
PK in K-12 Schools,All Students,2022-23,3145,384,2761,87.8,18,12,66.7
0K,All Students,2018-19,15794,1667,14127,89.4,95,42,44.2
0K,All Students,2019-20,8345,654,7691,92.2,78,20,25.6
0K,All Students,2020-21,10056,1132,8924,88.7,66,26,39.4
0K,All Students,2021-22,10335,1238,9097,88.0,66,37,56.1
0K,All Students,2022-23,15788,2375,13413,85.0,99,60,60.6
1,All Students,2018-19,16597,1374,15223,91.7,101,30,29.7
1,All Students,2019-20,9849,755,9094,92.3,89,29,32.6
1,All Students,2020-21,12781,1164,11617,90.9,78,26,33.3
1,All Students,2021-22,11150,1143,10007,89.7,69,31,44.9
1,All Students,2022-23,12744,1207,11537,90.5,77,24,31.2
2,All Students,2018-19,16722,1395,15327,91.7,102,31,30.4
2,All Students,2019-20,10042,657,9385,93.5,94,18,19.1
2,All Students,2020-21,13698,1425,12273,89.6,81,31,38.3
2,All Students,2021-22,12995,1435,11560,89.0,79,39,49.4
2,All Students,2022-23,12034,1135,10899,90.6,73,23,31.5
3,All Students,2018-19,20632,1618,19014,92.2,124,38,30.6
3,All Students,2019-20,10462,638,9824,93.9,95,17,17.9
3,All Students,2020-21,15146,1361,13785,91.0,89,29,32.6
3,All Students,2021-22,14292,1614,12678,88.7,87,43,49.4
3,All Students,2022-23,12762,1272,11490,90.0,78,28,35.9
4,All Students,2018-19,20644,1451,19193,93.0,124,34,27.4
4,All Students,2019-20,13203,888,12315,93.3,121,24,19.8
4,All Students,2020-21,15668,1213,14455,92.3,94,23,24.5
4,All Students,2021-22,12485,1183,11302,90.5,78,31,39.7
4,All Students,2022-23,14948,1506,13442,89.9,90,39,43.3
5,All Students,2018-19,21957,1563,20394,92.9,127,24,18.9
5,All Students,2019-20,11527,542,10985,95.3,103,17,16.5
5,All Students,2020-21,19316,1797,17519,90.7,116,33,28.4
5,All Students,2021-22,14298,1622,12676,88.7,85,36,42.4
5,All Students,2022-23,14070,1153,12917,91.8,84,28,33.3
All Grades,All Students,2018-19,157288,13335,143953,91.5,960,332,34.6
All Grades,All Students,2019-20,96588,7969,88619,91.7,883,288,32.6
All Grades,All Students,2020-21,137557,11557,126000,91.6,819,245,29.9
All Grades,All Students,2021-22,121923,13616,108307,88.8,762,355,46.6
All Grades,All Students,2022-23,119834,11931,107903,90.0,737,314,42.6
0K,All Students,2018-19,21646,2259,19387,89.6,133,54,40.6
0K,All Students,2019-20,14313,1557,12756,89.1,133,66,49.6
0K,All Students,2020-21,21107,2536,18571,88.0,130,58,44.6
0K,All Students,2021-22,17811,2404,15407,86.5,115,70,60.9
0K,All Students,2022-23,18201,2368,15833,87.0,118,72,61.0
1,All Students,2018-19,24751,2279,22472,90.8,155,66,42.6
1,All Students,2019-20,15676,1264,14412,91.9,144,50,34.7
1,All Students,2020-21,22253,2552,19701,88.5,132,48,36.4
1,All Students,2021-22,20586,2254,18332,89.1,124,51,41.1
1,All Students,2022-23,19221,2067,17154,89.2,120,54,45.0
2,All Students,2018-19,27060,2161,24899,92.0,164,57,34.8
2,All Students,2019-20,16084,1407,14677,91.3,148,51,34.5
2,All Students,2020-21,23262,2365,20897,89.8,141,51,36.2
2,All Students,2021-22,19365,2286,17079,88.2,123,66,53.7
2,All Students,2022-23,19916,2167,17749,89.1,124,56,45.2
3,All Students,2018-19,26472,2290,24182,91.3,162,56,34.6
3,All Students,2019-20,15876,1272,14604,92.0,145,44,30.3
3,All Students,2020-21,23399,1551,21848,93.4,139,36,25.9
3,All Students,2021-22,19562,1934,17628,90.1,125,52,41.6
3,All Students,2022-23,19523,1900,17623,90.3,118,49,41.5
4,All Students,2018-19,28157,2193,25964,92.2,170,51,30.0
4,All Students,2019-20,16904,1232,15672,92.7,153,41,26.8
4,All Students,2020-21,23102,1338,21764,94.2,135,30,22.2
4,All Students,2021-22,23139,2599,20540,88.8,144,66,45.8
4,All Students,2022-23,19531,1511,18020,92.3,115,36,31.3
5,All Students,2018-19,29202,2153,27049,92.6,176,48,27.3
5,All Students,2019-20,17735,1237,16498,93.0,160,36,22.5
5,All Students,2020-21,24434,1215,23219,95.0,142,22,15.5
5,All Students,2021-22,21460,2139,19321,90.0,131,50,38.2
5,All Students,2022-23,23442,1918,21524,91.8,142,47,33.1
All Grades,All Students,2018-19,144921,14014,130907,90.3,902,355,39.4
All Grades,All Students,2019-20,86633,7823,78810,91.0,815,293,36.0
All Grades,All Students,2020-21,120390,15431,104959,87.2,734,311,42.4
All Grades,All Students,2021-22,107366,15691,91675,85.4,696,395,56.8
All Grades,All Students,2022-23,107767,13382,94385,87.6,689,348,50.5
PK in K-12 Schools,All Students,2018-19,6112,567,5545,90.7,41,16,39.0
PK in K-12 Schools,All Students,2019-20,4035,357,3678,91.2,38,13,34.2
PK in K-12 Schools,All Students,2020-21,4580,488,4092,89.3,31,10,32.3
PK in K-12 Schools,All Students,2021-22,5992,845,5147,85.9,37,26,70.3
PK in K-12 Schools,All Students,2022-23,6259,s,s,s,s,s,s
0K,All Students,2018-19,20434,2565,17869,87.4,133,72,54.1
0K,All Students,2019-20,12546,1408,11138,88.8,117,52,44.4
0K,All Students,2020-21,16366,2148,14218,86.9,106,49,46.2
0K,All Students,2021-22,11860,1958,9902,83.5,87,50,57.5
0K,All Students,2022-23,15413,2281,13132,85.2,103,62,60.2
1,All Students,2018-19,23641,2616,21025,88.9,144,70,48.6
1,All Students,2019-20,11784,1210,10574,89.7,111,48,43.2
1,All Students,2020-21,18436,2520,15916,86.3,114,51,44.7
1,All Students,2021-22,16761,2642,14119,84.2,105,62,59.0
1,All Students,2022-23,13030,1800,11230,86.2,93,57,61.3
2,All Students,2018-19,23121,2052,21069,91.1,148,50,33.8
2,All Students,2019-20,13905,1168,12737,91.6,134,51,38.1
2,All Students,2020-21,17552,2543,15009,85.5,103,48,46.6
2,All Students,2021-22,18102,2817,15285,84.4,120,63,52.5
2,All Students,2022-23,17850,2210,15640,87.6,112,55,49.1
3,All Students,2018-19,21716,1902,19814,91.2,135,47,34.8
3,All Students,2019-20,13625,1174,12451,91.4,125,44,35.2
3,All Students,2020-21,19965,2638,17327,86.8,119,50,42.0
3,All Students,2021-22,17248,2258,14990,86.9,112,61,54.5
3,All Students,2022-23,18712,2471,16241,86.8,120,58,48.3
4,All Students,2018-19,26475,2445,24030,90.8,161,58,36.0
4,All Students,2019-20,14251,1199,13052,91.6,137,40,29.2
4,All Students,2020-21,21457,2326,19131,89.2,129,53,41.1
4,All Students,2021-22,17828,2530,15298,85.8,113,59,52.2
4,All Students,2022-23,18369,2028,16341,89.0,113,42,37.2
5,All Students,2018-19,23422,1867,21555,92.0,140,42,30.0
5,All Students,2019-20,16487,1307,15180,92.1,153,45,29.4
5,All Students,2020-21,22034,2768,19266,87.4,132,50,37.9
5,All Students,2021-22,19575,2641,16934,86.5,122,74,60.7
5,All Students,2022-23,18050,1826,16224,89.9,110,51,46.4
8,All Students,2022-23,84,s,s,s,s,s,s
All Grades,All Students,2018-19,293644,15748,277896,94.6,1753,246,14.0
All Grades,All Students,2019-20,188460,10164,178296,94.6,1744,259,14.9
All Grades,All Students,2020-21,278503,12331,266172,95.6,1659,193,11.6
All Grades,All Students,2021-22,287453,22289,265164,92.2,1735,484,27.9
All Grades,All Students,2022-23,278219,20097,258122,92.8,1676,429,25.6
0K,All Students,2018-19,23322,1516,21806,93.5,138,25,18.1
0K,All Students,2019-20,14891,1038,13853,93.0,143,31,21.7
0K,All Students,2020-21,21893,562,21331,97.4,135,4,3.0
0K,All Students,2021-22,25699,1694,24005,93.4,159,32,20.1
0K,All Students,2022-23,23584,1551,22033,93.4,145,32,22.1
1,All Students,2018-19,26046,1483,24563,94.3,164,31,18.9
1,All Students,2019-20,17433,1067,16366,93.9,164,31,18.9
1,All Students,2020-21,22887,630,22257,97.2,140,10,7.1
1,All Students,2021-22,25366,1702,23664,93.3,155,34,21.9
1,All Students,2022-23,27431,1915,25516,93.0,166,35,21.1
2,All Students,2018-19,27105,1404,25701,94.8,163,22,13.5
2,All Students,2019-20,17739,1093,16646,93.8,168,33,19.6
2,All Students,2020-21,27627,615,27012,97.8,164,9,5.5
2,All Students,2021-22,25863,1518,24345,94.1,161,30,18.6
2,All Students,2022-23,24731,1634,23097,93.4,149,31,20.8
3,All Students,2018-19,28813,1280,27533,95.6,173,18,10.4
3,All Students,2019-20,17446,885,16561,94.9,161,21,13.0
3,All Students,2020-21,27785,825,26960,97.0,165,9,5.5
3,All Students,2021-22,27992,2037,25955,92.7,166,40,24.1
3,All Students,2022-23,25647,1860,23787,92.7,157,47,29.9
4,All Students,2018-19,35107,1686,33421,95.2,202,22,10.9
4,All Students,2019-20,19592,915,18677,95.3,182,24,13.2
4,All Students,2020-21,27351,648,26703,97.6,163,7,4.3
4,All Students,2021-22,27755,1733,26022,93.8,168,35,20.8
4,All Students,2022-23,26786,1750,25036,93.5,163,34,20.9
5,All Students,2018-19,35605,1728,33877,95.1,213,27,12.7
5,All Students,2019-20,22708,1129,21579,95.0,209,27,12.9
5,All Students,2020-21,29802,1317,28485,95.6,179,19,10.6
5,All Students,2021-22,28636,2378,26258,91.7,178,53,29.8
5,All Students,2022-23,28884,2139,26745,92.6,173,47,27.2
6,All Students,2018-19,39251,1963,37288,95.0,235,24,10.2
6,All Students,2019-20,27546,1350,26196,95.1,252,28,11.1
6,All Students,2020-21,41895,2376,39519,94.3,250,39,15.6
6,All Students,2021-22,41528,3736,37792,91.0,247,89,36.0
6,All Students,2022-23,40179,2950,37229,92.7,240,56,23.3
7,All Students,2018-19,39309,2043,37266,94.8,236,37,15.7
7,All Students,2019-20,24888,1278,23610,94.9,230,32,13.9
7,All Students,2020-21,41123,3029,38094,92.6,239,56,23.4
7,All Students,2021-22,41988,3898,38090,90.7,250,89,35.6
7,All Students,2022-23,40395,2874,37521,92.9,242,67,27.7
8,All Students,2018-19,39086,2645,36441,93.2,229,40,17.5
8,All Students,2019-20,26217,1409,24808,94.6,235,32,13.6
8,All Students,2020-21,38099,2327,35772,93.9,223,40,17.9
8,All Students,2021-22,42626,3593,39033,91.6,251,82,32.7
8,All Students,2022-23,40582,3424,37158,91.6,241,80,33.2
All Grades,All Students,2018-19,103867,7862,96005,92.4,636,179,28.1
All Grades,All Students,2019-20,59364,4841,54523,91.8,547,164,30.0
All Grades,All Students,2020-21,77613,9262,68351,88.1,463,183,39.5
All Grades,All Students,2021-22,61602,8527,53075,86.2,377,203,53.8
All Grades,All Students,2022-23,56997,5826,51171,89.8,355,143,40.3
0K,All Students,2018-19,15088,1466,13622,90.3,92,31,33.7
0K,All Students,2019-20,6156,573,5583,90.7,57,21,36.8
0K,All Students,2020-21,9425,689,8736,92.7,60,19,31.7
0K,All Students,2021-22,9550,1482,8068,84.5,60,37,61.7
0K,All Students,2022-23,8231,962,7269,88.3,53,29,54.7
1,All Students,2018-19,16211,1413,14798,91.3,104,38,36.5
1,All Students,2019-20,11681,1142,10539,90.2,111,43,38.7
1,All Students,2020-21,9138,927,8211,89.9,54,19,35.2
1,All Students,2021-22,9559,1388,8171,85.5,58,31,53.4
1,All Students,2022-23,9766,899,8867,90.8,60,20,33.3
2,All Students,2018-19,13867,1325,12542,90.4,85,35,41.2
2,All Students,2019-20,8867,635,8232,92.8,81,18,22.2
2,All Students,2020-21,15367,2161,13206,85.9,93,41,44.1
2,All Students,2021-22,6367,907,5460,85.8,39,23,59.0
2,All Students,2022-23,9954,937,9017,90.6,61,27,44.3
3,All Students,2018-19,19221,1245,17976,93.5,116,23,19.8
3,All Students,2019-20,8980,837,8143,90.7,86,28,32.6
3,All Students,2020-21,12520,1627,10893,87.0,74,30,40.5
3,All Students,2021-22,12324,1568,10756,87.3,76,38,50.0
3,All Students,2022-23,6275,567,5708,91.0,40,11,27.5
4,All Students,2018-19,18304,1241,17063,93.2,113,29,25.7
4,All Students,2019-20,11763,871,10892,92.6,105,27,25.7
4,All Students,2020-21,13124,1710,11414,87.0,76,36,47.4
4,All Students,2021-22,10630,1337,9293,87.4,64,32,50.0
4,All Students,2022-23,11625,1297,10328,88.8,72,31,43.1
5,All Students,2018-19,21176,1172,20004,94.5,126,23,18.3
5,All Students,2019-20,11917,783,11134,93.4,107,27,25.2
5,All Students,2020-21,18039,2148,15891,88.1,106,38,35.8
5,All Students,2021-22,13172,1845,11327,86.0,80,42,52.5
5,All Students,2022-23,11146,1164,9982,89.6,69,25,36.2
All Grades,All Students,2018-19,275400,22096,253304,92.0,1636,503,30.7
All Grades,All Students,2019-20,173520,12110,161410,93.0,1572,382,24.3
All Grades,All Students,2020-21,244798,19441,225357,92.1,1449,338,23.3
All Grades,All Students,2021-22,225705,21561,204144,90.4,1367,521,38.1
All Grades,All Students,2022-23,214361,22765,191596,89.4,1275,537,42.1
PK in K-12 Schools,All Students,2018-19,9191,851,8340,90.7,56,24,42.9
PK in K-12 Schools,All Students,2019-20,6159,525,5634,91.5,55,20,36.4
PK in K-12 Schools,All Students,2020-21,8494,912,7582,89.3,54,17,31.5
PK in K-12 Schools,All Students,2021-22,8073,940,7133,88.4,52,30,57.7
PK in K-12 Schools,All Students,2022-23,8322,1008,7314,87.9,53,30,56.6
0K,All Students,2018-19,28026,2827,25199,89.9,168,67,39.9
0K,All Students,2019-20,13773,1175,12598,91.5,127,39,30.7
0K,All Students,2020-21,16854,1565,15289,90.7,105,35,33.3
0K,All Students,2021-22,20236,2364,17872,88.3,124,68,54.8
0K,All Students,2022-23,17569,2107,15462,88.0,104,51,49.0
1,All Students,2018-19,27535,2751,24784,90.0,168,67,39.9
1,All Students,2019-20,18241,1418,16823,92.2,165,43,26.1
1,All Students,2020-21,19211,1915,17296,90.0,115,30,26.1
1,All Students,2021-22,16290,1926,14364,88.2,101,52,51.5
1,All Students,2022-23,18696,2373,16323,87.3,113,66,58.4
2,All Students,2018-19,24579,2209,22370,91.0,150,55,36.7
2,All Students,2019-20,17550,1442,16108,91.8,159,48,30.2
2,All Students,2020-21,25141,2454,22687,90.2,150,39,26.0
2,All Students,2021-22,19365,2220,17145,88.5,117,51,43.6
2,All Students,2022-23,16642,1846,14796,88.9,99,46,46.5
3,All Students,2018-19,30884,2462,28422,92.0,185,58,31.4
3,All Students,2019-20,15813,1081,14732,93.2,143,37,25.9
3,All Students,2020-21,25770,2007,23763,92.2,152,36,23.7
3,All Students,2021-22,22009,1964,20045,91.1,133,43,32.3
3,All Students,2022-23,18488,2158,16330,88.3,112,46,41.1
4,All Students,2018-19,26952,1919,25033,92.9,160,40,25.0
4,All Students,2019-20,19662,1363,18299,93.1,180,44,24.4
4,All Students,2020-21,22591,1305,21286,94.2,136,20,14.7
4,All Students,2021-22,25708,2707,23001,89.5,156,69,44.2
4,All Students,2022-23,23114,2403,20711,89.6,136,53,39.0
5,All Students,2018-19,30608,1927,28681,93.7,180,43,23.9
5,All Students,2019-20,17177,1047,16130,93.9,156,31,19.9
5,All Students,2020-21,29846,2114,27732,92.9,172,34,19.8
5,All Students,2021-22,20344,2125,18219,89.6,128,53,41.4
5,All Students,2022-23,24244,2162,22082,91.1,145,53,36.6
6,All Students,2018-19,35227,2505,32722,92.9,206,55,26.7
6,All Students,2019-20,22325,1398,20927,93.7,202,39,19.3
6,All Students,2020-21,29772,1577,28195,94.7,175,31,17.7
6,All Students,2021-22,33388,3040,30348,90.9,196,71,36.2
6,All Students,2022-23,26398,2547,23851,90.4,157,56,35.7
7,All Students,2018-19,32806,2085,30721,93.6,190,41,21.6
7,All Students,2019-20,22722,1440,21282,93.7,205,47,22.9
7,All Students,2020-21,33349,2399,30950,92.8,195,37,19.0
7,All Students,2021-22,28499,2575,25924,91.0,173,60,34.7
7,All Students,2022-23,31574,3259,28315,89.7,185,73,39.5
8,All Students,2018-19,29592,2560,27032,91.3,173,53,30.6
8,All Students,2019-20,20098,1221,18877,93.9,180,34,18.9
8,All Students,2020-21,33770,3193,30577,90.5,195,59,30.3
8,All Students,2021-22,31793,1700,30093,94.7,187,24,12.8
8,All Students,2022-23,29314,2902,26412,90.1,171,63,36.8
All Grades,All Students,2018-19,159374,13913,145461,91.3,929,308,33.2
All Grades,All Students,2019-20,97125,7710,89415,92.1,879,267,30.4
All Grades,All Students,2020-21,149340,9300,140040,93.8,888,178,20.0
All Grades,All Students,2021-22,146373,12883,133490,91.2,876,290,33.1
All Grades,All Students,2022-23,149948,12138,137810,91.9,900,271,30.1
PK in K-12 Schools,All Students,2020-21,3124,128,2996,95.9,18,1,5.6
PK in K-12 Schools,All Students,2021-22,5681,334,5347,94.1,36,6,16.7
PK in K-12 Schools,All Students,2022-23,5809,s,s,s,s,s,s
0K,All Students,2018-19,26205,2410,23795,90.8,155,56,36.1
0K,All Students,2019-20,15717,1650,14067,89.5,148,64,43.2
0K,All Students,2020-21,24477,1524,22953,93.8,151,32,21.2
0K,All Students,2021-22,24248,2423,21825,90.0,151,66,43.7
0K,All Students,2022-23,26077,2161,23916,91.7,158,51,32.3
1,All Students,2018-19,26934,2447,24487,90.9,157,49,31.2
1,All Students,2019-20,17468,1239,16229,92.9,157,39,24.8
1,All Students,2020-21,23469,2234,21235,90.5,140,44,31.4
1,All Students,2021-22,23438,2214,21224,90.6,143,48,33.6
1,All Students,2022-23,25436,2376,23060,90.7,154,53,34.4
2,All Students,2018-19,26872,2427,24445,91.0,155,55,35.5
2,All Students,2019-20,16309,1181,15128,92.8,147,41,27.9
2,All Students,2020-21,24608,1076,23532,95.6,150,19,12.7
2,All Students,2021-22,22651,1954,20697,91.4,135,45,33.3
2,All Students,2022-23,24205,2370,21835,90.2,144,52,36.1
3,All Students,2018-19,25818,2407,23411,90.7,152,54,35.5
3,All Students,2019-20,17166,1362,15804,92.1,151,46,30.5
3,All Students,2020-21,25224,1328,23896,94.7,146,21,14.4
3,All Students,2021-22,22506,1804,20702,92.0,132,38,28.8
3,All Students,2022-23,22946,1631,21315,92.9,137,37,27.0
4,All Students,2018-19,23958,2027,21931,91.5,140,42,30.0
4,All Students,2019-20,16064,1214,14850,92.4,143,44,30.8
4,All Students,2020-21,25045,1413,23632,94.4,147,30,20.4
4,All Students,2021-22,23400,1816,21584,92.2,139,37,26.6
4,All Students,2022-23,22364,1425,20939,93.6,135,30,22.2
5,All Students,2018-19,29587,2195,27392,92.6,170,52,30.6
5,All Students,2019-20,14401,1064,13337,92.6,133,33,24.8
5,All Students,2020-21,23393,1597,21796,93.2,136,31,22.8
5,All Students,2021-22,24449,2338,22111,90.4,140,50,35.7
5,All Students,2022-23,23067,1718,21349,92.6,136,37,27.2
6,All Students,2022-23,44,s,s,s,s,s,s
All Grades,All Students,2018-19,108042,7156,100886,93.4,655,160,24.4
All Grades,All Students,2019-20,67540,4181,63359,93.8,615,118,19.2
All Grades,All Students,2020-21,87397,6816,80581,92.2,527,146,27.7
All Grades,All Students,2021-22,91501,9036,82465,90.1,560,225,40.2
All Grades,All Students,2022-23,97657,9227,88430,90.6,594,221,37.2
PK in K-12 Schools,All Students,2018-19,3045,245,2800,92.0,19,7,36.8
PK in K-12 Schools,All Students,2019-20,2038,188,1850,90.8,18,6,33.3
PK in K-12 Schools,All Students,2020-21,2876,182,2694,93.7,18,4,22.2
PK in K-12 Schools,All Students,2021-22,8077,1178,6899,85.4,50,32,64.0
PK in K-12 Schools,All Students,2022-23,11243,1705,9538,84.8,73,45,61.6
0K,All Students,2018-19,16726,1334,15392,92.0,101,34,33.7
0K,All Students,2019-20,10429,878,9551,91.6,96,35,36.5
0K,All Students,2020-21,11701,1031,10670,91.2,73,24,32.9
0K,All Students,2021-22,12734,1415,11319,88.9,81,40,49.4
0K,All Students,2022-23,13715,1592,12123,88.4,84,44,52.4
1,All Students,2018-19,16054,1226,14828,92.4,98,29,29.6
1,All Students,2019-20,10875,635,10240,94.2,100,18,18.0
1,All Students,2020-21,13436,1403,12033,89.6,80,30,37.5
1,All Students,2021-22,13314,1538,11776,88.4,84,41,48.8
1,All Students,2022-23,15443,1479,13964,90.4,93,41,44.1
2,All Students,2018-19,16401,998,15403,93.9,101,21,20.8
2,All Students,2019-20,10816,646,10170,94.0,97,16,16.5
2,All Students,2020-21,15760,1128,14632,92.8,94,23,24.5
2,All Students,2021-22,14555,1331,13224,90.9,86,33,38.4
2,All Students,2022-23,13628,1107,12521,91.9,83,24,28.9
3,All Students,2018-19,18250,1042,17208,94.3,110,20,18.2
3,All Students,2019-20,9522,529,8993,94.4,87,15,17.2
3,All Students,2020-21,14577,1462,13115,90.0,88,32,36.4
3,All Students,2021-22,15300,1217,14083,92.0,92,24,26.1
3,All Students,2022-23,13225,1079,12146,91.8,81,23,28.4
4,All Students,2018-19,18859,1217,17642,93.5,113,28,24.8
4,All Students,2019-20,11836,607,11229,94.9,107,13,12.1
4,All Students,2020-21,13092,620,12472,95.3,78,11,14.1
4,All Students,2021-22,14394,1371,13023,90.5,88,32,36.4
4,All Students,2022-23,15378,1129,14249,92.7,90,22,24.4
5,All Students,2018-19,18707,1094,17613,94.2,113,21,18.6
5,All Students,2019-20,12024,698,11326,94.2,110,15,13.6
5,All Students,2020-21,15955,990,14965,93.8,96,22,22.9
5,All Students,2021-22,13127,986,12141,92.5,79,23,29.1
5,All Students,2022-23,15025,1136,13889,92.4,90,22,24.4
All Grades,All Students,2018-19,182705,19409,163296,89.4,1112,468,42.1
All Grades,All Students,2019-20,108849,11222,97627,89.7,1006,387,38.5
All Grades,All Students,2020-21,147544,16762,130782,88.6,888,321,36.1
All Grades,All Students,2021-22,132378,17278,115100,86.9,811,421,51.9
All Grades,All Students,2022-23,130339,14488,115851,88.9,820,357,43.5
PK in K-12 Schools,All Students,2019-20,2035,s,s,s,s,s,s
PK in K-12 Schools,All Students,2020-21,2897,372,2525,87.2,17,7,41.2
PK in K-12 Schools,All Students,2021-22,3137,s,s,s,s,s,s
PK in K-12 Schools,All Students,2022-23,5760,s,s,s,s,s,s
0K,All Students,2018-19,26592,3797,22795,85.7,169,94,55.6
0K,All Students,2019-20,13485,1651,11834,87.8,135,67,49.6
0K,All Students,2020-21,19770,2771,16999,86.0,126,56,44.4
0K,All Students,2021-22,20667,3083,17584,85.1,130,75,57.7
0K,All Students,2022-23,22122,3162,18960,85.7,144,86,59.7
1,All Students,2018-19,29167,3650,25517,87.5,183,92,50.3
1,All Students,2019-20,17694,2346,15348,86.7,162,81,50.0
1,All Students,2020-21,19257,2810,16447,85.4,117,52,44.4
1,All Students,2021-22,20446,3320,17126,83.8,126,78,61.9
1,All Students,2022-23,20911,2598,18313,87.6,134,66,49.3
2,All Students,2018-19,26322,2807,23515,89.3,161,71,44.1
2,All Students,2019-20,16656,1671,14985,90.0,150,53,35.3
2,All Students,2020-21,25102,3408,21694,86.4,154,69,44.8
2,All Students,2021-22,18028,2129,15899,88.2,112,51,45.5
2,All Students,2022-23,22008,2460,19548,88.8,139,65,46.8
3,All Students,2018-19,34114,3287,30827,90.4,201,76,37.8
3,All Students,2019-20,16084,1708,14376,89.4,154,67,43.5
3,All Students,2020-21,24841,2204,22637,91.1,148,38,25.7
3,All Students,2021-22,23389,2833,20556,87.9,144,68,47.2
3,All Students,2022-23,15796,1522,14274,90.4,100,36,36.0
4,All Students,2018-19,36430,3382,33048,90.7,216,77,35.6
4,All Students,2019-20,21657,1754,19903,91.9,195,54,27.7
4,All Students,2020-21,23909,2302,21607,90.4,140,43,30.7
4,All Students,2021-22,22996,2545,20451,88.9,138,65,47.1
4,All Students,2022-23,21804,2100,19704,90.4,135,46,34.1
5,All Students,2018-19,30080,2486,27594,91.7,182,58,31.9
5,All Students,2019-20,21232,1769,19463,91.7,192,56,29.2
5,All Students,2020-21,31768,2895,28873,90.9,186,56,30.1
5,All Students,2021-22,23712,2952,20760,87.6,142,74,52.1
5,All Students,2022-23,21769,1574,20195,92.8,132,32,24.2
6,All Students,2019-20,6,s,s,s,s,s,s
6,All Students,2021-22,3,s,s,s,s,s,s
6,All Students,2022-23,169,s,s,s,s,s,s
All Grades,All Students,2018-19,182320,15423,166897,91.5,1119,364,32.5
All Grades,All Students,2019-20,111872,7725,104147,93.1,1059,254,24.0
All Grades,All Students,2020-21,155744,12078,143666,92.2,933,250,26.8
All Grades,All Students,2021-22,130563,14518,116045,88.9,804,377,46.9
All Grades,All Students,2022-23,125551,13545,112006,89.2,789,377,47.8
PK in K-12 Schools,All Students,2018-19,9377,1001,8376,89.3,57,20,35.1
PK in K-12 Schools,All Students,2019-20,5915,563,5352,90.5,59,24,40.7
PK in K-12 Schools,All Students,2020-21,8167,968,7199,88.1,50,18,36.0
PK in K-12 Schools,All Students,2021-22,9314,s,s,s,s,s,s
PK in K-12 Schools,All Students,2022-23,9362,1316,8046,85.9,58,37,63.8
0K,All Students,2018-19,31416,3742,27674,88.1,204,102,50.0
0K,All Students,2019-20,17014,1539,15475,91.0,164,59,36.0
0K,All Students,2020-21,20254,2421,17833,88.0,129,55,42.6
0K,All Students,2021-22,15852,2034,13818,87.2,100,56,56.0
0K,All Students,2022-23,16907,2174,14733,87.1,110,70,63.6
1,All Students,2018-19,30038,2420,27618,91.9,187,61,32.6
1,All Students,2019-20,18569,1477,17092,92.0,174,38,21.8
1,All Students,2020-21,26211,2360,23851,91.0,155,48,31.0
1,All Students,2021-22,19204,2067,17137,89.2,119,55,46.2
1,All Students,2022-23,15971,1840,14131,88.5,100,52,52.0
2,All Students,2018-19,22734,1645,21089,92.8,140,33,23.6
2,All Students,2019-20,16564,996,15568,94.0,157,34,21.7
2,All Students,2020-21,25553,2183,23370,91.5,151,51,33.8
2,All Students,2021-22,22253,2541,19712,88.6,134,63,47.0
2,All Students,2022-23,19179,2161,17018,88.7,120,59,49.2
3,All Students,2018-19,27826,2258,25568,91.9,168,55,32.7
3,All Students,2019-20,15400,870,14530,94.4,144,30,20.8
3,All Students,2020-21,24735,1266,23469,94.9,145,23,15.9
3,All Students,2021-22,20347,2407,17940,88.2,128,60,46.9
3,All Students,2022-23,21207,1923,19284,90.9,136,50,36.8
4,All Students,2018-19,30972,2266,28706,92.7,184,48,26.1
4,All Students,2019-20,18251,974,17277,94.7,175,26,14.9
4,All Students,2020-21,23195,1051,22144,95.5,137,23,16.8
4,All Students,2021-22,22923,2311,20612,89.9,143,61,42.7
4,All Students,2022-23,20201,2092,18109,89.6,126,58,46.0
5,All Students,2018-19,29957,2091,27866,93.0,179,45,25.1
5,All Students,2019-20,20159,1306,18853,93.5,186,43,23.1
5,All Students,2020-21,27581,1816,25765,93.4,165,31,18.8
5,All Students,2021-22,20661,2126,18535,89.7,124,54,43.5
5,All Students,2022-23,22724,2039,20685,91.0,139,51,36.7
6,All Students,2021-22,9,s,s,s,s,s,s
All Grades,All Students,2018-19,196479,15082,181397,92.3,1185,312,26.3
All Grades,All Students,2019-20,123552,9077,114475,92.7,1145,297,25.9
All Grades,All Students,2020-21,167238,14538,152700,91.3,1016,288,28.3
All Grades,All Students,2021-22,158606,17481,141125,89.0,983,439,44.7
All Grades,All Students,2022-23,158891,14983,143908,90.6,963,364,37.8
PK in K-12 Schools,All Students,2018-19,9475,1212,8263,87.2,56,32,57.1
PK in K-12 Schools,All Students,2019-20,6123,741,5382,87.9,55,30,54.5
PK in K-12 Schools,All Students,2020-21,8276,933,7343,88.7,52,21,40.4
PK in K-12 Schools,All Students,2021-22,11646,2153,9493,81.5,72,50,69.4
PK in K-12 Schools,All Students,2022-23,12100,s,s,s,s,s,s
0K,All Students,2018-19,30729,3058,27671,90.0,195,69,35.4
0K,All Students,2019-20,20233,1896,18337,90.6,199,77,38.7
0K,All Students,2020-21,23480,1896,21584,91.9,147,42,28.6
0K,All Students,2021-22,22565,2638,19927,88.3,145,70,48.3
0K,All Students,2022-23,22537,2856,19681,87.3,143,75,52.4
1,All Students,2018-19,31589,2633,28956,91.7,191,54,28.3
1,All Students,2019-20,18935,1511,17424,92.0,174,40,23.0
1,All Students,2020-21,29217,2746,26471,90.6,179,48,26.8
1,All Students,2021-22,22421,2630,19791,88.3,149,62,41.6
1,All Students,2022-23,24659,2495,22164,89.9,153,60,39.2
2,All Students,2018-19,29010,2413,26597,91.7,175,51,29.1
2,All Students,2019-20,18737,1367,17370,92.7,172,46,26.7
2,All Students,2020-21,26739,2115,24624,92.1,164,39,23.8
2,All Students,2021-22,25609,2838,22771,88.9,161,77,47.8
2,All Students,2022-23,23228,2001,21227,91.4,139,47,33.8
3,All Students,2018-19,30730,1808,28922,94.1,185,38,20.5
3,All Students,2019-20,17609,1145,16464,93.5,160,33,20.6
3,All Students,2020-21,26690,2429,24261,90.9,163,52,31.9
3,All Students,2021-22,26441,2563,23878,90.3,159,63,39.6
3,All Students,2022-23,24271,2059,22212,91.5,147,50,34.0
4,All Students,2018-19,35859,2151,33708,94.0,210,37,17.6
4,All Students,2019-20,19070,1001,18069,94.8,174,27,15.5
4,All Students,2020-21,26636,2553,24083,90.4,158,50,31.6
4,All Students,2021-22,25696,2303,23393,91.0,153,57,37.3
4,All Students,2022-23,27202,2282,24920,91.6,164,57,34.8
5,All Students,2018-19,29087,1807,27280,93.8,173,31,17.9
5,All Students,2019-20,22845,1416,21429,93.8,211,44,20.9
5,All Students,2020-21,26200,1866,24334,92.9,153,36,23.5
5,All Students,2021-22,24228,2356,21872,90.3,144,60,41.7
5,All Students,2022-23,24725,1758,22967,92.9,146,37,25.3
6,All Students,2022-23,169,s,s,s,s,s,s
All Grades,All Students,2018-19,105025,5608,99417,94.7,619,87,14.1
All Grades,All Students,2019-20,66297,3636,62661,94.5,603,93,15.4
All Grades,All Students,2020-21,93981,2325,91656,97.5,566,26,4.6
All Grades,All Students,2021-22,90691,4900,85791,94.6,553,62,11.2
All Grades,All Students,2022-23,85467,5478,79989,93.6,510,99,19.4
PK in K-12 Schools,All Students,2018-19,3191,202,2989,93.7,19,3,15.8
PK in K-12 Schools,All Students,2019-20,2038,166,1872,91.9,18,6,33.3
PK in K-12 Schools,All Students,2020-21,3136,158,2978,95.0,18,3,16.7
PK in K-12 Schools,All Students,2021-22,3138,202,2936,93.6,19,3,15.8
PK in K-12 Schools,All Students,2022-23,3175,290,2885,90.9,18,7,38.9
0K,All Students,2018-19,17661,1140,16521,93.5,104,20,19.2
0K,All Students,2019-20,10557,682,9875,93.5,98,22,22.4
0K,All Students,2020-21,16274,442,15832,97.3,100,3,3.0
0K,All Students,2021-22,15946,986,14960,93.8,102,14,13.7
0K,All Students,2022-23,15084,1195,13889,92.1,97,24,24.7
1,All Students,2018-19,16057,922,15135,94.3,93,16,17.2
1,All Students,2019-20,11904,603,11301,94.9,108,16,14.8
1,All Students,2020-21,14834,329,14505,97.8,89,4,4.5
1,All Students,2021-22,15631,775,14856,95.0,96,5,5.2
1,All Students,2022-23,14562,937,13625,93.6,90,20,22.2
2,All Students,2018-19,18977,984,17993,94.8,113,13,11.5
2,All Students,2019-20,9662,464,9198,95.2,88,8,9.1
2,All Students,2020-21,16004,444,15560,97.2,95,4,4.2
2,All Students,2021-22,12475,641,11834,94.9,77,7,9.1
2,All Students,2022-23,13838,876,12962,93.7,81,16,19.8
3,All Students,2018-19,17401,771,16630,95.6,101,10,9.9
3,All Students,2019-20,12562,724,11838,94.2,113,18,15.9
3,All Students,2020-21,13132,249,12883,98.1,77,1,1.3
3,All Students,2021-22,15615,775,14840,95.0,93,10,10.8
3,All Students,2022-23,13058,638,12420,95.1,75,5,6.7
4,All Students,2018-19,16351,825,15526,95.0,98,13,13.3
4,All Students,2019-20,10297,522,9775,94.9,94,12,12.8
4,All Students,2020-21,16417,455,15962,97.2,102,9,8.8
4,All Students,2021-22,12336,702,11634,94.3,74,12,16.2
4,All Students,2022-23,15310,853,14457,94.4,88,13,14.8
5,All Students,2018-19,15387,764,14623,95.0,91,12,13.2
5,All Students,2019-20,9277,475,8802,94.9,84,11,13.1
5,All Students,2020-21,14184,248,13936,98.3,85,2,2.4
5,All Students,2021-22,15550,819,14731,94.7,92,11,12.0
5,All Students,2022-23,10440,689,9751,93.4,61,14,23.0
All Grades,All Students,2018-19,113480,11837,101643,89.6,707,314,44.4
All Grades,All Students,2019-20,69600,6824,62776,90.2,651,260,39.9
All Grades,All Students,2020-21,87303,12673,74630,85.5,525,268,51.0
All Grades,All Students,2021-22,85648,14109,71539,83.5,544,353,64.9
All Grades,All Students,2022-23,76924,11048,65876,85.6,485,278,57.3
PK in K-12 Schools,All Students,2018-19,8109,1197,6912,85.2,57,37,64.9
PK in K-12 Schools,All Students,2019-20,5106,565,4541,88.9,55,27,49.1
PK in K-12 Schools,All Students,2020-21,4613,846,3767,81.7,31,18,58.1
PK in K-12 Schools,All Students,2021-22,8106,s,s,s,s,s,s
PK in K-12 Schools,All Students,2022-23,8088,1446,6642,82.1,54,37,68.5
0K,All Students,2018-19,17892,2319,15573,87.0,113,65,57.5
0K,All Students,2019-20,8258,1069,7189,87.1,78,43,55.1
0K,All Students,2020-21,9762,2036,7726,79.1,62,43,69.4
0K,All Students,2021-22,13053,2351,10702,82.0,86,58,67.4
0K,All Students,2022-23,8333,1294,7039,84.5,55,32,58.2
1,All Students,2018-19,18263,2118,16145,88.4,112,53,47.3
1,All Students,2019-20,11817,1329,10488,88.8,110,49,44.5
1,All Students,2020-21,13195,2088,11107,84.2,81,54,66.7
1,All Students,2021-22,11857,2209,9648,81.4,75,60,80.0
1,All Students,2022-23,12276,1821,10455,85.2,80,47,58.8
2,All Students,2018-19,16758,1681,15077,90.0,106,45,42.5
2,All Students,2019-20,10122,1071,9051,89.4,93,44,47.3
2,All Students,2020-21,15534,2121,13413,86.3,91,43,47.3
2,All Students,2021-22,12113,1959,10154,83.8,76,49,64.5
2,All Students,2022-23,12143,2058,10085,83.1,75,51,68.0
3,All Students,2018-19,17884,1698,16186,90.5,111,43,38.7
3,All Students,2019-20,10489,919,9570,91.2,97,35,36.1
3,All Students,2020-21,13325,2035,11290,84.7,79,43,54.4
3,All Students,2021-22,13436,2079,11357,84.5,83,50,60.2
3,All Students,2022-23,11067,1408,9659,87.3,72,38,52.8
4,All Students,2018-19,18694,1528,17166,91.8,113,41,36.3
4,All Students,2019-20,11686,983,10703,91.6,111,36,32.4
4,All Students,2020-21,15163,1697,13466,88.8,89,37,41.6
4,All Students,2021-22,12542,1902,10640,84.8,79,44,55.7
4,All Students,2022-23,13242,1721,11521,87.0,79,40,50.6
5,All Students,2018-19,15880,1296,14584,91.8,95,30,31.6
5,All Students,2019-20,12122,888,11234,92.7,107,26,24.3
5,All Students,2020-21,15711,1850,13861,88.2,92,30,32.6
5,All Students,2021-22,14517,2144,12373,85.2,86,53,61.6
5,All Students,2022-23,11775,1300,10475,89.0,70,33,47.1
6,All Students,2021-22,24,s,s,s,s,s,s
All Grades,All Students,2018-19,75466,6800,68666,91.0,463,180,38.9
All Grades,All Students,2019-20,46129,4360,41769,90.5,426,157,36.9
All Grades,All Students,2020-21,64558,8539,56019,86.8,387,176,45.5
All Grades,All Students,2021-22,67379,9388,57991,86.1,403,244,60.5
All Grades,All Students,2022-23,70486,8016,62470,88.6,434,196,45.2
PK in K-12 Schools,All Students,2018-19,7706,862,6844,88.8,50,24,48.0
PK in K-12 Schools,All Students,2019-20,4375,469,3906,89.3,46,17,37.0
PK in K-12 Schools,All Students,2020-21,4214,547,3667,87.0,27,15,55.6
PK in K-12 Schools,All Students,2021-22,9014,1469,7545,83.7,55,41,74.5
PK in K-12 Schools,All Students,2022-23,9011,1493,7518,83.4,59,42,71.2
0K,All Students,2018-19,13551,1423,12128,89.5,80,38,47.5
0K,All Students,2019-20,6873,739,6134,89.2,65,29,44.6
0K,All Students,2020-21,10146,1223,8923,87.9,62,26,41.9
0K,All Students,2021-22,11568,1748,9820,84.9,70,48,68.6
0K,All Students,2022-23,10684,1310,9374,87.7,66,30,45.5
1,All Students,2018-19,13418,1310,12108,90.2,81,32,39.5
1,All Students,2019-20,8906,747,8159,91.6,80,28,35.0
1,All Students,2020-21,10430,1674,8756,84.0,63,34,54.0
1,All Students,2021-22,10292,1418,8874,86.2,61,39,63.9
1,All Students,2022-23,11393,1393,10000,87.8,69,28,40.6
2,All Students,2018-19,8301,786,7515,90.5,53,20,37.7
2,All Students,2019-20,8171,798,7373,90.2,73,25,34.2
2,All Students,2020-21,11748,1626,10122,86.2,70,34,48.6
2,All Students,2021-22,9266,1353,7913,85.4,56,33,58.9
2,All Students,2022-23,10329,1054,9275,89.8,65,25,38.5
3,All Students,2018-19,10494,872,9622,91.7,69,25,36.2
3,All Students,2019-20,5086,541,4545,89.4,47,19,40.4
3,All Students,2020-21,11787,1395,10392,88.2,70,28,40.0
3,All Students,2021-22,10370,1272,9098,87.7,61,33,54.1
3,All Students,2022-23,9231,992,8239,89.3,56,25,44.6
4,All Students,2018-19,10042,803,9239,92.0,60,22,36.7
4,All Students,2019-20,6121,527,5594,91.4,55,20,36.4
4,All Students,2020-21,7133,1023,6110,85.7,43,21,48.8
4,All Students,2021-22,9908,1138,8770,88.5,58,29,50.0
4,All Students,2022-23,9974,978,8996,90.2,59,28,47.5
5,All Students,2018-19,11954,744,11210,93.8,70,19,27.1
5,All Students,2019-20,6597,539,6058,91.8,60,19,31.7
5,All Students,2020-21,9100,1051,8049,88.5,52,18,34.6
5,All Students,2021-22,6961,990,5971,85.8,42,21,50.0
5,All Students,2022-23,9864,796,9068,91.9,60,18,30.0
All Grades,All Students,2018-19,149807,11825,137982,92.1,889,262,29.5
All Grades,All Students,2019-20,90021,6188,83833,93.1,828,205,24.8
All Grades,All Students,2020-21,121642,12021,109621,90.1,728,211,29.0
All Grades,All Students,2021-22,102647,11755,90892,88.5,633,270,42.7
All Grades,All Students,2022-23,98092,10316,87776,89.5,607,260,42.8
PK in K-12 Schools,All Students,2018-19,6290,713,5577,88.7,37,15,40.5
PK in K-12 Schools,All Students,2019-20,4113,470,3643,88.6,37,15,40.5
PK in K-12 Schools,All Students,2020-21,5807,495,5312,91.5,36,11,30.6
PK in K-12 Schools,All Students,2021-22,6311,756,5555,88.0,36,20,55.6
PK in K-12 Schools,All Students,2022-23,5298,745,4553,85.9,33,21,63.6
0K,All Students,2018-19,17821,1799,16022,89.9,111,50,45.0
0K,All Students,2019-20,10771,901,9870,91.6,103,35,34.0
0K,All Students,2020-21,15667,1653,14014,89.4,98,32,32.7
0K,All Students,2021-22,15678,2030,13648,87.1,98,49,50.0
0K,All Students,2022-23,15592,1955,13637,87.5,99,49,49.5
1,All Students,2018-19,22703,1670,21033,92.6,135,37,27.4
1,All Students,2019-20,12327,923,11404,92.5,115,33,28.7
1,All Students,2020-21,16000,1988,14012,87.6,94,34,36.2
1,All Students,2021-22,13903,1548,12355,88.9,86,37,43.0
1,All Students,2022-23,15810,1819,13991,88.5,99,43,43.4
2,All Students,2018-19,24471,1971,22500,91.9,146,44,30.1
2,All Students,2019-20,14078,869,13209,93.8,128,28,21.9
2,All Students,2020-21,18572,1743,16829,90.6,113,29,25.7
2,All Students,2021-22,12768,1653,11115,87.1,84,35,41.7
2,All Students,2022-23,13498,1331,12167,90.1,82,30,36.6
3,All Students,2018-19,23500,1567,21933,93.3,141,32,22.7
3,All Students,2019-20,15520,907,14613,94.2,143,29,20.3
3,All Students,2020-21,20752,1873,18879,91.0,122,26,21.3
3,All Students,2021-22,16630,2038,14592,87.7,104,45,43.3
3,All Students,2022-23,14680,1348,13332,90.8,93,34,36.6
4,All Students,2018-19,27513,2198,25315,92.0,160,49,30.6
4,All Students,2019-20,15103,948,14155,93.7,137,33,24.1
4,All Students,2020-21,22419,1999,20420,91.1,134,37,27.6
4,All Students,2021-22,18215,2063,16152,88.7,111,43,38.7
4,All Students,2022-23,15578,1418,14160,90.9,96,38,39.6
5,All Students,2018-19,27509,1907,25602,93.1,159,35,22.0
5,All Students,2019-20,18109,1170,16939,93.5,165,32,19.4
5,All Students,2020-21,22425,2270,20155,89.9,131,42,32.1
5,All Students,2021-22,19142,1667,17475,91.3,114,41,36.0
5,All Students,2022-23,17636,1700,15936,90.4,105,45,42.9
All Grades,All Students,2018-19,153749,9899,143850,93.6,897,193,21.5
All Grades,All Students,2019-20,94314,5378,88936,94.3,862,151,17.5
All Grades,All Students,2020-21,152924,13688,139236,91.0,896,264,29.5
All Grades,All Students,2021-22,142467,11853,130614,91.7,845,248,29.3
All Grades,All Students,2022-23,145079,12153,132926,91.6,866,271,31.3
6,All Students,2018-19,56153,3110,53043,94.5,332,58,17.5
6,All Students,2019-20,28538,1667,26871,94.2,266,49,18.4
6,All Students,2020-21,52824,4104,48720,92.2,308,78,25.3
6,All Students,2021-22,47058,3771,43287,92.0,282,84,29.8
6,All Students,2022-23,41639,4088,37551,90.2,251,103,41.0
7,All Students,2018-19,43422,s,s,s,s,s,s
7,All Students,2019-20,36312,1986,34326,94.5,329,53,16.1
7,All Students,2020-21,43334,3493,39841,91.9,258,68,26.4
7,All Students,2021-22,51939,4202,47737,91.9,307,83,27.0
7,All Students,2022-23,49397,3549,45848,92.8,294,76,25.9
8,All Students,2018-19,54167,4111,50056,92.4,309,75,24.3
8,All Students,2019-20,29464,1725,27739,94.1,267,49,18.4
8,All Students,2020-21,56766,6091,50675,89.3,330,118,35.8
8,All Students,2021-22,43354,s,s,s,s,s,s
8,All Students,2022-23,54043,4516,49527,91.6,321,92,28.7
9,All Students,2018-19,7,s,s,s,s,s,s
9,All Students,2021-22,116,s,s,s,s,s,s
All Grades,All Students,2018-19,86270,8478,77792,90.2,517,188,36.4
All Grades,All Students,2019-20,51754,4450,47304,91.4,473,152,32.1
All Grades,All Students,2020-21,76079,6858,69221,91.0,447,133,29.8
All Grades,All Students,2021-22,72267,7473,64794,89.7,440,161,36.6
All Grades,All Students,2022-23,72546,6561,65985,91.0,448,168,37.5
5,All Students,2021-22,1,s,s,s,s,s,s
6,All Students,2018-19,26872,s,s,s,s,s,s
6,All Students,2019-20,14224,1133,13091,92.0,131,37,28.2
6,All Students,2020-21,28123,2886,25237,89.7,164,59,36.0
6,All Students,2021-22,23391,s,s,s,s,s,s
6,All Students,2022-23,21116,1838,19278,91.3,134,53,39.6
7,All Students,2018-19,28016,2330,25686,91.7,172,60,34.9
7,All Students,2019-20,17332,1595,15737,90.8,162,60,37.0
7,All Students,2020-21,21931,s,s,s,s,s,s
7,All Students,2021-22,25360,2776,22584,89.1,152,58,38.2
7,All Students,2022-23,25075,2270,22805,90.9,148,52,35.1
8,All Students,2018-19,31376,3314,28062,89.4,185,62,33.5
8,All Students,2019-20,20198,1722,18476,91.5,180,55,30.6
8,All Students,2020-21,26022,2216,23806,91.5,153,44,28.8
8,All Students,2021-22,23515,2305,21210,90.2,142,53,37.3
8,All Students,2022-23,26355,2453,23902,90.7,166,63,38.0
9,All Students,2018-19,6,s,s,s,s,s,s
9,All Students,2020-21,3,s,s,s,s,s,s
All Grades,All Students,2018-19,110035,5249,104786,95.2,639,83,13.0
All Grades,All Students,2019-20,69529,3419,66110,95.1,625,86,13.8
All Grades,All Students,2020-21,93230,3052,90178,96.7,547,44,8.0
All Grades,All Students,2021-22,81066,5585,75481,93.1,480,111,23.1
All Grades,All Students,2022-23,82468,5830,76638,92.9,489,125,25.6
PK in K-12 Schools,All Students,2018-19,3091,194,2897,93.7,18,4,22.2
PK in K-12 Schools,All Students,2019-20,2052,120,1932,94.2,18,4,22.2
PK in K-12 Schools,All Students,2020-21,2373,39,2334,98.4,16,0,0.0
PK in K-12 Schools,All Students,2021-22,2638,197,2441,92.5,16,5,31.3
PK in K-12 Schools,All Students,2022-23,3072,277,2795,91.0,18,6,33.3
0K,All Students,2018-19,14746,843,13903,94.3,85,15,17.6
0K,All Students,2019-20,8035,467,7568,94.2,76,17,22.4
0K,All Students,2020-21,9371,287,9084,96.9,56,4,7.1
0K,All Students,2021-22,10372,655,9717,93.7,62,12,19.4
0K,All Students,2022-23,12819,1018,11801,92.1,78,24,30.8
1,All Students,2018-19,16445,850,15595,94.8,97,16,16.5
1,All Students,2019-20,10741,537,10204,95.0,98,16,16.3
1,All Students,2020-21,12663,444,12219,96.5,75,6,8.0
1,All Students,2021-22,9216,732,8484,92.1,53,15,28.3
1,All Students,2022-23,11865,761,11104,93.6,73,15,20.5
2,All Students,2018-19,15821,704,15117,95.6,91,10,11.0
2,All Students,2019-20,11413,603,10810,94.7,103,12,11.7
2,All Students,2020-21,16553,528,16025,96.8,96,10,10.4
2,All Students,2021-22,11748,797,10951,93.2,69,15,21.7
2,All Students,2022-23,11195,835,10360,92.5,68,15,22.1
3,All Students,2018-19,20913,1006,19907,95.2,122,15,12.3
3,All Students,2019-20,11706,573,11133,95.1,102,13,12.7
3,All Students,2020-21,15825,434,15391,97.3,92,7,7.6
3,All Students,2021-22,15697,995,14702,93.7,96,20,20.8
3,All Students,2022-23,13079,918,12161,93.0,76,20,26.3
4,All Students,2018-19,20710,753,19957,96.4,119,9,7.6
4,All Students,2019-20,12615,648,11967,94.9,113,15,13.3
4,All Students,2020-21,17538,617,16921,96.5,104,8,7.7
4,All Students,2021-22,15086,1005,14081,93.3,88,17,19.3
4,All Students,2022-23,15605,1008,14597,93.5,90,24,26.7
5,All Students,2018-19,18309,899,17410,95.1,107,14,13.1
5,All Students,2019-20,12967,471,12496,96.4,115,9,7.8
5,All Students,2020-21,18907,703,18204,96.3,108,9,8.3
5,All Students,2021-22,16309,1204,15105,92.6,96,27,28.1
5,All Students,2022-23,14833,1013,13820,93.2,86,21,24.4
All Grades,All Students,2018-19,67182,3925,63257,94.2,402,70,17.4
All Grades,All Students,2019-20,44600,2476,42124,94.4,408,64,15.7
All Grades,All Students,2020-21,60835,2555,58280,95.8,371,47,12.7
All Grades,All Students,2021-22,58010,5093,52917,91.2,349,113,32.4
All Grades,All Students,2022-23,58628,4636,53992,92.1,351,104,29.6
PK in K-12 Schools,All Students,2018-19,7596,515,7081,93.2,45,10,22.2
PK in K-12 Schools,All Students,2019-20,5861,349,5512,94.0,55,8,14.5
PK in K-12 Schools,All Students,2020-21,6522,363,6159,94.4,41,8,19.5
PK in K-12 Schools,All Students,2021-22,8349,918,7431,89.0,51,25,49.0
PK in K-12 Schools,All Students,2022-23,7776,726,7050,90.7,45,22,48.9
0K,All Students,2018-19,8125,479,7646,94.1,50,7,14.0
0K,All Students,2019-20,5593,344,5249,93.8,52,11,21.2
0K,All Students,2020-21,9924,557,9367,94.4,60,9,15.0
0K,All Students,2021-22,7153,583,6570,91.8,44,12,27.3
0K,All Students,2022-23,8703,835,7868,90.4,53,18,34.0
1,All Students,2018-19,9010,636,8374,92.9,58,13,22.4
1,All Students,2019-20,5073,303,4770,94.0,46,7,15.2
1,All Students,2020-21,7452,228,7224,96.9,45,3,6.7
1,All Students,2021-22,10071,880,9191,91.3,61,20,32.8
1,All Students,2022-23,7331,550,6781,92.5,45,11,24.4
2,All Students,2018-19,10503,677,9826,93.6,63,15,23.8
2,All Students,2019-20,6105,351,5754,94.3,54,11,20.4
2,All Students,2020-21,7180,349,6831,95.1,44,7,15.9
2,All Students,2021-22,6960,641,6319,90.8,43,13,30.2
2,All Students,2022-23,10995,949,10046,91.4,65,20,30.8
3,All Students,2018-19,11400,610,10790,94.6,67,11,16.4
3,All Students,2019-20,6799,362,6437,94.7,64,8,12.5
3,All Students,2020-21,8194,275,7919,96.6,50,4,8.0
3,All Students,2021-22,7654,572,7082,92.5,47,12,25.5
3,All Students,2022-23,7329,450,6879,93.9,43,9,20.9
4,All Students,2018-19,11751,483,11268,95.9,67,6,9.0
4,All Students,2019-20,7494,428,7066,94.3,68,12,17.6
4,All Students,2020-21,10137,313,9824,96.9,61,6,9.8
4,All Students,2021-22,7727,591,7136,92.4,46,12,26.1
4,All Students,2022-23,8228,500,7728,93.9,51,11,21.6
5,All Students,2018-19,8797,525,8272,94.0,52,8,15.4
5,All Students,2019-20,7675,339,7336,95.6,69,7,10.1
5,All Students,2020-21,11363,465,10898,95.9,68,9,13.2
5,All Students,2021-22,10096,908,9188,91.0,57,19,33.3
5,All Students,2022-23,8266,626,7640,92.4,49,13,26.5
All Grades,All Students,2018-19,75819,5527,70292,92.7,451,126,27.9
All Grades,All Students,2019-20,48008,3300,44708,93.1,440,104,23.6
All Grades,All Students,2020-21,66536,3954,62582,94.1,401,81,20.2
All Grades,All Students,2021-22,57161,5798,51363,89.9,348,145,41.7
All Grades,All Students,2022-23,54852,5075,49777,90.7,338,117,34.6
PK in K-12 Schools,All Students,2018-19,6337,514,5823,91.9,36,12,33.3
PK in K-12 Schools,All Students,2019-20,4095,351,3744,91.4,37,12,32.4
PK in K-12 Schools,All Students,2020-21,5916,457,5459,92.3,36,8,22.2
PK in K-12 Schools,All Students,2021-22,6107,s,s,s,s,s,s
PK in K-12 Schools,All Students,2022-23,6059,537,5522,91.1,37,15,40.5
0K,All Students,2018-19,9153,824,8329,91.0,54,20,37.0
0K,All Students,2019-20,5344,395,4949,92.6,49,12,24.5
0K,All Students,2020-21,8801,734,8067,91.7,56,22,39.3
0K,All Students,2021-22,6925,747,6178,89.2,46,21,45.7
0K,All Students,2022-23,8202,1074,7128,86.9,53,28,52.8
1,All Students,2018-19,10955,833,10122,92.4,65,21,32.3
1,All Students,2019-20,5866,389,5477,93.4,56,16,28.6
1,All Students,2020-21,8827,467,8360,94.7,54,11,20.4
1,All Students,2021-22,8954,930,8024,89.6,54,25,46.3
1,All Students,2022-23,6185,474,5711,92.3,38,9,23.7
2,All Students,2018-19,10150,787,9363,92.2,63,22,34.9
2,All Students,2019-20,7797,609,7188,92.2,71,16,22.5
2,All Students,2020-21,8868,410,8458,95.4,53,8,15.1
2,All Students,2021-22,8621,840,7781,90.3,52,17,32.7
2,All Students,2022-23,8939,886,8053,90.1,55,22,40.0
3,All Students,2018-19,12946,781,12165,94.0,77,14,18.2
3,All Students,2019-20,6772,501,6271,92.6,61,17,27.9
3,All Students,2020-21,11420,424,10996,96.3,68,7,10.3
3,All Students,2021-22,8098,859,7239,89.4,48,20,41.7
3,All Students,2022-23,8274,648,7626,92.2,51,14,27.5
4,All Students,2018-19,14360,957,13403,93.3,86,20,23.3
4,All Students,2019-20,8644,479,8165,94.5,81,15,18.5
4,All Students,2020-21,9026,567,8459,93.7,55,9,16.4
4,All Students,2021-22,10773,976,9797,90.9,65,22,33.8
4,All Students,2022-23,7370,639,6731,91.3,46,15,32.6
5,All Students,2018-19,11918,831,11087,93.0,70,17,24.3
5,All Students,2019-20,9490,576,8914,93.9,85,16,18.8
5,All Students,2020-21,13678,895,12783,93.5,79,16,20.3
5,All Students,2021-22,7682,823,6859,89.3,46,23,50.0
5,All Students,2022-23,9823,817,9006,91.7,58,14,24.1
6,All Students,2021-22,1,s,s,s,s,s,s
All Grades,All Students,2018-19,56082,2709,53373,95.2,328,20,6.1
All Grades,All Students,2019-20,34635,1936,32699,94.4,308,47,15.3
All Grades,All Students,2020-21,49307,2710,46597,94.5,288,50,17.4
All Grades,All Students,2021-22,42640,3003,39637,93.0,256,63,24.6
All Grades,All Students,2022-23,42401,3547,38854,91.6,247,78,31.6
0K,All Students,2018-19,4846,217,4629,95.5,30,2,6.7
0K,All Students,2019-20,3088,278,2810,91.0,28,11,39.3
0K,All Students,2020-21,4132,158,3974,96.2,24,3,12.5
0K,All Students,2021-22,2909,155,2754,94.7,17,2,11.8
0K,All Students,2022-23,4126,458,3668,88.9,24,12,50.0
1,All Students,2018-19,4126,183,3943,95.6,24,0,0.0
1,All Students,2019-20,3712,154,3558,95.9,33,3,9.1
1,All Students,2020-21,4126,375,3751,90.9,24,10,41.7
1,All Students,2021-22,4466,287,4179,93.6,26,7,26.9
1,All Students,2022-23,2740,155,2585,94.3,16,3,18.8
2,All Students,2018-19,6329,308,6021,95.1,37,2,5.4
2,All Students,2019-20,3028,173,2855,94.3,27,4,14.8
2,All Students,2020-21,5796,356,5440,93.9,34,9,26.5
2,All Students,2021-22,4143,358,3785,91.4,25,7,28.0
2,All Students,2022-23,4956,330,4626,93.3,28,5,17.9
3,All Students,2018-19,7701,337,7364,95.6,44,2,4.5
3,All Students,2019-20,4300,230,4070,94.7,38,4,10.5
3,All Students,2020-21,4550,166,4384,96.4,26,0,0.0
3,All Students,2021-22,6147,424,5723,93.1,36,8,22.2
3,All Students,2022-23,4731,422,4309,91.1,28,11,39.3
4,All Students,2018-19,6390,265,6125,95.9,37,1,2.7
4,All Students,2019-20,4805,248,4557,94.8,42,5,11.9
4,All Students,2020-21,6407,365,6042,94.3,38,4,10.5
4,All Students,2021-22,4316,257,4059,94.0,25,4,16.0
4,All Students,2022-23,5924,387,5537,93.5,36,8,22.2
5,All Students,2018-19,4686,221,4465,95.3,28,3,10.7
5,All Students,2019-20,4271,193,4078,95.5,38,5,13.2
5,All Students,2020-21,6471,367,6104,94.3,38,7,18.4
5,All Students,2021-22,5944,375,5569,93.7,36,8,22.2
5,All Students,2022-23,4062,280,3782,93.1,23,5,21.7
6,All Students,2018-19,7499,344,7155,95.4,43,3,7.0
6,All Students,2019-20,3450,198,3252,94.3,32,7,21.9
6,All Students,2020-21,5750,375,5375,93.5,35,9,25.7
6,All Students,2021-22,5639,471,5168,91.6,36,12,33.3
6,All Students,2022-23,5526,413,5113,92.5,32,9,28.1
7,All Students,2018-19,4977,301,4676,94.0,30,4,13.3
7,All Students,2019-20,5017,241,4776,95.2,44,3,6.8
7,All Students,2020-21,4375,176,4199,96.0,25,3,12.0
7,All Students,2021-22,4784,319,4465,93.3,30,8,26.7
7,All Students,2022-23,5911,645,5266,89.1,35,15,42.9
8,All Students,2018-19,9528,533,8995,94.4,55,3,5.5
8,All Students,2019-20,2964,221,2743,92.5,26,5,19.2
8,All Students,2020-21,7700,372,7328,95.2,44,5,11.4
8,All Students,2021-22,4292,357,3935,91.7,25,7,28.0
8,All Students,2022-23,4425,457,3968,89.7,25,10,40.0
All Grades,All Students,2018-19,73862,5089,68773,93.1,440,102,23.2
All Grades,All Students,2019-20,41289,2866,38423,93.1,387,105,27.1
All Grades,All Students,2020-21,61045,5117,55928,91.6,365,83,22.7
All Grades,All Students,2021-22,57745,5319,52426,90.8,355,124,34.9
All Grades,All Students,2022-23,57185,5264,51921,90.8,360,127,35.3
PK in K-12 Schools,All Students,2020-21,2627,182,2445,93.1,16,2,12.5
PK in K-12 Schools,All Students,2021-22,5648,711,4937,87.4,35,18,51.4
PK in K-12 Schools,All Students,2022-23,7663,878,6785,88.5,51,25,49.0
0K,All Students,2018-19,11493,1240,10253,89.2,70,30,42.9
0K,All Students,2019-20,5590,533,5057,90.5,57,20,35.1
0K,All Students,2020-21,9954,1162,8792,88.3,58,18,31.0
0K,All Students,2021-22,7042,839,6203,88.1,43,22,51.2
0K,All Students,2022-23,6390,891,5499,86.1,45,25,55.6
1,All Students,2018-19,9682,660,9022,93.2,60,12,20.0
1,All Students,2019-20,6313,520,5793,91.8,60,23,38.3
1,All Students,2020-21,9101,1157,7944,87.3,56,21,37.5
1,All Students,2021-22,9048,819,8229,90.9,57,16,28.1
1,All Students,2022-23,8150,911,7239,88.8,50,21,42.0
2,All Students,2018-19,12917,897,12020,93.1,74,20,27.0
2,All Students,2019-20,6207,458,5749,92.6,60,22,36.7
2,All Students,2020-21,9157,941,8216,89.7,57,16,28.1
2,All Students,2021-22,7751,595,7156,92.3,50,14,28.0
2,All Students,2022-23,8661,715,7946,91.7,55,17,30.9
3,All Students,2018-19,11283,804,10479,92.9,67,16,23.9
3,All Students,2019-20,7564,403,7161,94.7,70,14,20.0
3,All Students,2020-21,8374,234,8140,97.2,48,3,6.3
3,All Students,2021-22,8538,873,7665,89.8,51,19,37.3
3,All Students,2022-23,7478,410,7068,94.5,46,6,13.0
4,All Students,2018-19,12394,696,11698,94.4,71,11,15.5
4,All Students,2019-20,7472,503,6969,93.3,67,13,19.4
4,All Students,2020-21,10457,718,9739,93.1,63,14,22.2
4,All Students,2021-22,9355,755,8600,91.9,57,20,35.1
4,All Students,2022-23,9043,621,8422,93.1,53,13,24.5
5,All Students,2018-19,16093,792,15301,95.1,98,13,13.3
5,All Students,2019-20,8143,449,7694,94.5,73,13,17.8
5,All Students,2020-21,11375,723,10652,93.6,67,9,13.4
5,All Students,2021-22,10363,727,9636,93.0,62,15,24.2
5,All Students,2022-23,9800,838,8962,91.4,60,20,33.3
All Grades,All Students,2018-19,180711,9491,171220,94.7,1044,143,13.7
All Grades,All Students,2019-20,120413,5899,114514,95.1,1071,146,13.6
All Grades,All Students,2020-21,171652,13267,158385,92.3,998,249,24.9
All Grades,All Students,2021-22,148610,13635,134975,90.8,876,300,34.2
All Grades,All Students,2022-23,134207,12396,121811,90.8,801,271,33.8
6,All Students,2018-19,65219,2969,62250,95.4,377,43,11.4
6,All Students,2019-20,38899,s,s,s,s,s,s
6,All Students,2020-21,50814,s,s,s,s,s,s
6,All Students,2021-22,49624,4723,44901,90.5,296,101,34.1
6,All Students,2022-23,44196,3856,40340,91.3,268,85,31.7
7,All Students,2018-19,62126,2762,59364,95.6,362,42,11.6
7,All Students,2019-20,41160,2143,39017,94.8,369,56,15.2
7,All Students,2020-21,56828,3828,53000,93.3,333,78,23.4
7,All Students,2021-22,45861,s,s,s,s,s,s
7,All Students,2022-23,45684,4162,41522,90.9,273,92,33.7
8,All Students,2018-19,53351,s,s,s,s,s,s
8,All Students,2019-20,40347,1958,38389,95.1,355,46,13.0
8,All Students,2020-21,63843,5242,58601,91.8,367,93,25.3
8,All Students,2021-22,53112,5042,48070,90.5,310,118,38.1
8,All Students,2022-23,44327,4378,39949,90.1,260,94,36.2
9,All Students,2018-19,15,s,s,s,s,s,s
9,All Students,2019-20,7,s,s,s,s,s,s
9,All Students,2020-21,167,s,s,s,s,s,s
9,All Students,2021-22,13,s,s,s,s,s,s
All Grades,All Students,2018-19,157818,10402,147416,93.4,914,211,23.1
All Grades,All Students,2019-20,100525,5450,95075,94.6,892,134,15.0
All Grades,All Students,2020-21,148609,8375,140234,94.4,860,153,17.8
All Grades,All Students,2021-22,130394,11570,118824,91.1,764,230,30.1
All Grades,All Students,2022-23,112072,9243,102829,91.8,667,189,28.3
6,All Students,2018-19,57227,3481,53746,93.9,332,70,21.1
6,All Students,2019-20,35109,1813,33296,94.8,314,47,15.0
6,All Students,2020-21,47723,2354,45369,95.1,277,47,17.0
6,All Students,2021-22,38869,3391,35478,91.3,227,71,31.3
6,All Students,2022-23,32253,2466,29787,92.4,191,43,22.5
7,All Students,2018-19,50210,s,s,s,s,s,s
7,All Students,2019-20,34413,2026,32387,94.1,307,50,16.3
7,All Students,2020-21,50520,2714,47806,94.6,292,51,17.5
7,All Students,2021-22,42676,4093,38583,90.4,254,80,31.5
7,All Students,2022-23,37688,2704,34984,92.8,227,53,23.3
8,All Students,2018-19,50378,3942,46436,92.2,292,79,27.1
8,All Students,2019-20,31003,1611,29392,94.8,271,37,13.7
8,All Students,2020-21,50366,3307,47059,93.4,291,55,18.9
8,All Students,2021-22,48849,4086,44763,91.6,283,79,27.9
8,All Students,2022-23,42131,4073,38058,90.3,249,93,37.3
10,All Students,2018-19,3,s,s,s,s,s,s
All Grades,All Students,2018-19,68151,5431,62720,92.0,417,140,33.6
All Grades,All Students,2019-20,42483,3632,38851,91.5,390,137,35.1
All Grades,All Students,2020-21,55126,5723,49403,89.6,336,125,37.2
All Grades,All Students,2021-22,51716,7051,44665,86.4,322,172,53.4
All Grades,All Students,2022-23,48175,5865,42310,87.8,325,168,51.7
PK in K-12 Schools,All Students,2018-19,7371,666,6705,91.0,46,20,43.5
PK in K-12 Schools,All Students,2019-20,5185,666,4519,87.2,51,26,51.0
PK in K-12 Schools,All Students,2020-21,4819,551,4268,88.6,31,17,54.8
PK in K-12 Schools,All Students,2021-22,5432,1048,4384,80.7,38,29,76.3
PK in K-12 Schools,All Students,2022-23,5980,1045,4935,82.5,44,36,81.8
0K,All Students,2018-19,8880,827,8053,90.7,58,21,36.2
0K,All Students,2019-20,5759,538,5221,90.7,52,19,36.5
0K,All Students,2020-21,7577,1178,6399,84.5,48,23,47.9
0K,All Students,2021-22,7057,948,6109,86.6,44,23,52.3
0K,All Students,2022-23,6400,901,5499,85.9,53,31,58.5
1,All Students,2018-19,8044,741,7303,90.8,51,21,41.2
1,All Students,2019-20,5684,487,5197,91.4,51,20,39.2
1,All Students,2020-21,8225,844,7381,89.7,51,17,33.3
1,All Students,2021-22,6867,1112,5755,83.8,42,27,64.3
1,All Students,2022-23,7127,929,6198,87.0,46,24,52.2
2,All Students,2018-19,10321,689,9632,93.3,62,18,29.0
2,All Students,2019-20,5733,465,5268,91.9,55,21,38.2
2,All Students,2020-21,8165,788,7377,90.3,47,15,31.9
2,All Students,2021-22,7820,1035,6785,86.8,47,22,46.8
2,All Students,2022-23,6189,611,5578,90.1,41,14,34.1
3,All Students,2018-19,9028,751,8277,91.7,54,21,38.9
3,All Students,2019-20,7089,479,6610,93.2,63,14,22.2
3,All Students,2020-21,8108,579,7529,92.9,49,15,30.6
3,All Students,2021-22,6973,883,6090,87.3,44,25,56.8
3,All Students,2022-23,7788,937,6851,88.0,52,26,50.0
4,All Students,2018-19,12821,953,11868,92.6,77,23,29.9
4,All Students,2019-20,5033,429,4604,91.5,44,18,40.9
4,All Students,2020-21,9912,829,9083,91.6,60,19,31.7
4,All Students,2021-22,8392,1135,7257,86.5,51,24,47.1
4,All Students,2022-23,6429,660,5769,89.7,41,18,43.9
5,All Students,2018-19,11686,804,10882,93.1,69,16,23.2
5,All Students,2019-20,8000,568,7432,92.9,74,19,25.7
5,All Students,2020-21,8320,954,7366,88.5,50,19,38.0
5,All Students,2021-22,9175,890,8285,90.3,56,22,39.3
5,All Students,2022-23,8262,782,7480,90.5,48,19,39.6
All Grades,All Students,2018-19,229170,14079,215091,93.9,1359,283,20.8
All Grades,All Students,2019-20,146326,9189,137137,93.7,1318,278,21.1
All Grades,All Students,2020-21,206249,15093,191156,92.7,1217,308,25.3
All Grades,All Students,2021-22,202294,20438,181856,89.9,1202,484,40.3
All Grades,All Students,2022-23,199044,18733,180311,90.6,1204,428,35.5
0K,All Students,2018-19,22092,1783,20309,91.9,131,36,27.5
0K,All Students,2019-20,14689,1186,13503,91.9,136,38,27.9
0K,All Students,2020-21,22192,2194,19998,90.1,131,45,34.4
0K,All Students,2021-22,21910,2514,19396,88.5,136,66,48.5
0K,All Students,2022-23,20923,3034,17889,85.5,134,73,54.5
1,All Students,2018-19,21541,1603,19938,92.6,133,37,27.8
1,All Students,2019-20,14729,1178,13551,92.0,135,36,26.7
1,All Students,2020-21,20838,1634,19204,92.2,124,30,24.2
1,All Students,2021-22,21412,2387,19025,88.9,126,61,48.4
1,All Students,2022-23,21317,2097,19220,90.2,128,59,46.1
2,All Students,2018-19,18889,s,s,s,s,s,s
2,All Students,2019-20,14111,963,13148,93.2,129,30,23.3
2,All Students,2020-21,21545,1406,20139,93.5,127,28,22.0
2,All Students,2021-22,19995,2103,17892,89.5,117,45,38.5
2,All Students,2022-23,20956,1958,18998,90.7,129,47,36.4
3,All Students,2018-19,22221,1186,21035,94.7,132,21,15.9
3,All Students,2019-20,12182,666,11516,94.5,110,21,19.1
3,All Students,2020-21,20309,1833,18476,91.0,121,41,33.9
3,All Students,2021-22,20836,2247,18589,89.2,122,55,45.1
3,All Students,2022-23,20124,1614,18510,92.0,123,34,27.6
4,All Students,2018-19,24411,1356,23055,94.4,143,27,18.9
4,All Students,2019-20,15239,865,14374,94.3,135,23,17.0
4,All Students,2020-21,17451,1275,16176,92.7,104,26,25.0
4,All Students,2021-22,20594,1973,18621,90.4,123,45,36.6
4,All Students,2022-23,20856,1663,19193,92.0,123,31,25.2
5,All Students,2018-19,28423,1485,26938,94.8,167,32,19.2
5,All Students,2019-20,15836,941,14895,94.1,144,33,22.9
5,All Students,2020-21,21998,1535,20463,93.0,131,32,24.4
5,All Students,2021-22,18270,s,s,s,s,s,s
5,All Students,2022-23,19264,1591,17673,91.7,116,37,31.9
6,All Students,2018-19,27899,1834,26065,93.4,165,37,22.4
6,All Students,2019-20,20951,1298,19653,93.8,186,39,21.0
6,All Students,2020-21,25147,1433,23714,94.3,148,27,18.2
6,All Students,2021-22,23952,2279,21673,90.5,142,48,33.8
6,All Students,2022-23,26327,2008,24319,92.4,159,33,20.8
7,All Students,2018-19,33561,1618,31943,95.2,194,27,13.9
7,All Students,2019-20,17641,981,16660,94.4,157,29,18.5
7,All Students,2020-21,29971,1985,27986,93.4,174,41,23.6
7,All Students,2021-22,26504,2567,23937,90.3,159,61,38.4
7,All Students,2022-23,23006,2110,20896,90.8,134,44,32.8
8,All Students,2018-19,30049,2170,27879,92.8,178,46,25.8
8,All Students,2019-20,20948,1111,19837,94.7,186,29,15.6
8,All Students,2020-21,26798,1798,25000,93.3,157,38,24.2
8,All Students,2021-22,28820,2603,26217,91.0,170,61,35.9
8,All Students,2022-23,26271,2658,23613,89.9,158,70,44.3
9,All Students,2018-19,84,s,s,s,s,s,s
9,All Students,2021-22,1,s,s,s,s,s,s
All Grades,All Students,2018-19,47702,2763,44939,94.2,301,46,15.3
All Grades,All Students,2019-20,31468,1712,29756,94.6,307,48,15.6
All Grades,All Students,2020-21,58105,3770,54335,93.5,340,55,16.2
All Grades,All Students,2021-22,59426,8516,50910,85.7,389,189,48.6
All Grades,All Students,2022-23,57516,9177,48339,84.0,400,202,50.5
9,All Students,2018-19,18415,1144,17271,93.8,119,23,19.3
9,All Students,2019-20,11047,755,10292,93.2,112,29,25.9
9,All Students,2020-21,25056,2419,22637,90.3,148,40,27.0
9,All Students,2021-22,21747,3083,18664,85.8,143,71,49.7
9,All Students,2022-23,16927,3175,13752,81.2,137,73,53.3
10,All Students,2018-19,11174,559,10615,95.0,68,8,11.8
10,All Students,2019-20,7877,354,7523,95.5,77,11,14.3
10,All Students,2020-21,11603,673,10930,94.2,68,9,13.2
10,All Students,2021-22,18694,3124,15570,83.3,120,60,50.0
10,All Students,2022-23,16811,2277,14534,86.5,112,54,48.2
11,All Students,2018-19,9742,654,9088,93.3,60,8,13.3
11,All Students,2019-20,6615,370,6245,94.4,63,5,7.9
11,All Students,2020-21,11121,552,10569,95.0,65,6,9.2
11,All Students,2021-22,8027,848,7179,89.4,53,19,35.8
11,All Students,2022-23,15736,2461,13275,84.4,100,49,49.0
12,All Students,2018-19,8371,406,7965,95.1,54,7,13.0
12,All Students,2019-20,5929,233,5696,96.1,55,3,5.5
12,All Students,2020-21,10325,126,10199,98.8,59,0,0.0
12,All Students,2021-22,10958,1461,9497,86.7,73,39,53.4
12,All Students,2022-23,8042,1264,6778,84.3,51,26,51.0
All Grades,All Students,2018-19,52252,8211,44041,84.3,353,146,41.4
All Grades,All Students,2019-20,33242,6373,26869,80.8,327,157,48.0
All Grades,All Students,2020-21,45223,5639,39584,87.5,280,82,29.3
All Grades,All Students,2021-22,36821,5053,31768,86.3,264,105,39.8
All Grades,All Students,2022-23,29452,6277,23175,78.7,222,129,58.1
9,All Students,2018-19,13172,2422,10750,81.6,89,42,47.2
9,All Students,2019-20,9501,2697,6804,71.6,94,57,60.6
9,All Students,2020-21,11192,2623,8569,76.6,70,34,48.6
9,All Students,2021-22,10856,1505,9351,86.1,82,28,34.1
9,All Students,2022-23,7253,1575,5678,78.3,59,34,57.6
10,All Students,2018-19,15063,2464,12599,83.6,108,42,38.9
10,All Students,2019-20,8484,1557,6927,81.6,84,34,40.5
10,All Students,2020-21,11292,1561,9731,86.2,74,25,33.8
10,All Students,2021-22,8443,1505,6938,82.2,62,30,48.4
10,All Students,2022-23,11337,2664,8673,76.5,79,48,60.8
11,All Students,2018-19,11310,1759,9551,84.4,75,32,42.7
11,All Students,2019-20,8211,904,7307,89.0,83,30,36.1
11,All Students,2020-21,10505,669,9836,93.6,62,10,16.1
11,All Students,2021-22,7893,971,6922,87.7,57,26,45.6
11,All Students,2022-23,5418,760,4658,86.0,40,22,55.0
12,All Students,2018-19,12707,1566,11141,87.7,81,30,37.0
12,All Students,2019-20,7046,1215,5831,82.8,66,36,54.5
12,All Students,2020-21,12234,786,11448,93.6,74,13,17.6
12,All Students,2021-22,9629,1072,8557,88.9,63,21,33.3
12,All Students,2022-23,5444,1278,4166,76.5,44,25,56.8
All Grades,All Students,2018-19,60046,11408,48638,81.0,401,201,50.1
All Grades,All Students,2019-20,37427,7849,29578,79.0,359,193,53.8
All Grades,All Students,2020-21,51096,20263,30833,60.3,311,290,93.2
All Grades,All Students,2021-22,42355,10219,32136,75.9,278,191,68.7
All Grades,All Students,2022-23,36965,8217,28748,77.8,249,152,61.0
9,All Students,2018-19,16752,3608,13144,78.5,118,64,54.2
9,All Students,2019-20,11805,2991,8814,74.7,117,64,54.7
9,All Students,2020-21,9741,3205,6536,67.1,59,44,74.6
9,All Students,2021-22,10455,2560,7895,75.5,79,52,65.8
9,All Students,2022-23,6107,1307,4800,78.6,52,35,67.3
10,All Students,2018-19,16383,3317,13066,79.8,110,63,57.3
10,All Students,2019-20,9367,2221,7146,76.3,93,57,61.3
10,All Students,2020-21,12878,4900,7978,62.0,78,75,96.2
10,All Students,2021-22,9335,2114,7221,77.4,61,46,75.4
10,All Students,2022-23,11726,2808,8918,76.1,75,44,58.7
11,All Students,2018-19,12903,2488,10415,80.7,87,43,49.4
11,All Students,2019-20,8916,1635,7281,81.7,81,47,58.0
11,All Students,2020-21,13693,6471,7222,52.7,82,79,96.3
11,All Students,2021-22,11977,2866,9111,76.1,75,54,72.0
11,All Students,2022-23,8027,1963,6064,75.5,53,36,67.9
12,All Students,2018-19,14008,1995,12013,85.8,86,31,36.0
12,All Students,2019-20,7339,1002,6337,86.3,67,24,35.8
12,All Students,2020-21,14784,5687,9097,61.5,92,92,100.0
12,All Students,2021-22,10588,2679,7909,74.7,63,39,61.9
12,All Students,2022-23,11105,2139,8966,80.7,69,37,53.6
All Grades,All Students,2018-19,59894,9561,50333,84.0,393,199,50.6
All Grades,All Students,2019-20,40319,5854,34465,85.5,398,172,43.2
All Grades,All Students,2020-21,62148,8911,53237,85.7,387,185,47.8
All Grades,All Students,2021-22,64432,5029,59403,92.2,427,115,26.9
All Grades,All Students,2022-23,63469,6219,57250,90.2,417,131,31.4
9,All Students,2018-19,17436,3107,14329,82.2,114,61,53.5
9,All Students,2019-20,10879,1989,8890,81.7,109,51,46.8
9,All Students,2020-21,16353,2562,13791,84.3,101,50,49.5
9,All Students,2021-22,19118,1453,17665,92.4,126,28,22.2
9,All Students,2022-23,15562,1629,13933,89.5,105,31,29.5
10,All Students,2018-19,14445,2078,12367,85.6,97,39,40.2
10,All Students,2019-20,10691,1283,9408,88.0,110,50,45.5
10,All Students,2020-21,16939,2418,14521,85.7,108,48,44.4
10,All Students,2021-22,16709,1381,15328,91.7,111,31,27.9
10,All Students,2022-23,18528,1517,17011,91.8,123,31,25.2
11,All Students,2018-19,14256,1992,12264,86.0,95,49,51.6
11,All Students,2019-20,10343,1376,8967,86.7,98,36,36.7
11,All Students,2020-21,16024,2027,13997,87.4,99,47,47.5
11,All Students,2021-22,16032,1032,15000,93.6,109,30,27.5
11,All Students,2022-23,14180,1195,12985,91.6,91,22,24.2
12,All Students,2018-19,13757,2384,11373,82.7,87,50,57.5
12,All Students,2019-20,8406,1206,7200,85.7,82,36,43.9
12,All Students,2020-21,12832,1904,10928,85.2,79,40,50.6
12,All Students,2021-22,12573,1163,11410,90.8,81,26,32.1
12,All Students,2022-23,15199,1878,13321,87.6,98,47,48.0
All Grades,All Students,2018-19,88116,11104,77012,87.4,570,184,32.3
All Grades,All Students,2019-20,58902,7438,51464,87.4,559,177,31.7
All Grades,All Students,2020-21,85880,13276,72604,84.5,508,190,37.4
All Grades,All Students,2021-22,82226,10678,71548,87.0,522,205,39.3
All Grades,All Students,2022-23,76220,9683,66537,87.3,489,173,35.4
9,All Students,2018-19,31239,4919,26320,84.3,207,77,37.2
9,All Students,2019-20,20692,3354,17338,83.8,197,71,36.0
9,All Students,2020-21,20290,4020,16270,80.2,125,55,44.0
9,All Students,2021-22,29283,4096,25187,86.0,189,76,40.2
9,All Students,2022-23,25647,3547,22100,86.2,166,69,41.6
10,All Students,2018-19,25762,3578,22184,86.1,167,59,35.3
10,All Students,2019-20,19381,2512,16869,87.0,187,58,31.0
10,All Students,2020-21,27094,5072,22022,81.3,158,66,41.8
10,All Students,2021-22,19482,2872,16610,85.3,123,48,39.0
10,All Students,2022-23,22056,2597,19459,88.2,145,42,29.0
11,All Students,2018-19,14371,1006,13365,93.0,92,14,15.2
11,All Students,2019-20,7777,548,7229,93.0,72,17,23.6
11,All Students,2020-21,22122,2331,19791,89.5,128,35,27.3
11,All Students,2021-22,14838,1481,13357,90.0,92,32,34.8
11,All Students,2022-23,10572,1009,9563,90.5,67,16,23.9
12,All Students,2018-19,16744,1601,15143,90.4,104,34,32.7
12,All Students,2019-20,11052,1024,10028,90.7,103,31,30.1
12,All Students,2020-21,16374,1853,14521,88.7,97,34,35.1
12,All Students,2021-22,18623,2229,16394,88.0,118,49,41.5
12,All Students,2022-23,17945,2530,15415,85.9,111,46,41.4
All Grades,All Students,2018-19,101514,11016,90498,89.1,625,243,38.9
All Grades,All Students,2019-20,58727,6384,52343,89.1,549,205,37.3
All Grades,All Students,2020-21,74461,11316,63145,84.8,439,192,43.7
All Grades,All Students,2021-22,65639,11394,54245,82.6,422,256,60.7
All Grades,All Students,2022-23,65887,9063,56824,86.2,424,200,47.2
6,All Students,2018-19,32678,3548,29130,89.1,205,80,39.0
6,All Students,2019-20,16403,s,s,s,s,s,s
6,All Students,2020-21,21976,s,s,s,s,s,s
6,All Students,2021-22,19887,3149,16738,84.2,135,75,55.6
6,All Students,2022-23,20963,2961,18002,85.9,136,74,54.4
7,All Students,2018-19,33382,3592,29790,89.2,204,78,38.2
7,All Students,2019-20,19804,2363,17441,88.1,185,78,42.2
7,All Students,2020-21,22558,3938,18620,82.5,134,66,49.3
7,All Students,2021-22,23743,4488,19255,81.1,151,99,65.6
7,All Students,2022-23,19998,2055,17943,89.7,133,45,33.8
8,All Students,2018-19,35454,3876,31578,89.1,216,85,39.4
8,All Students,2019-20,22513,2335,20178,89.6,207,72,34.8
8,All Students,2020-21,29920,4865,25055,83.7,173,75,43.4
8,All Students,2021-22,22009,3757,18252,82.9,136,82,60.3
8,All Students,2022-23,24926,4047,20879,83.8,155,81,52.3
9,All Students,2019-20,7,s,s,s,s,s,s
9,All Students,2020-21,7,s,s,s,s,s,s
All Grades,All Students,2018-19,100452,10950,89502,89.1,626,174,27.8
All Grades,All Students,2019-20,62988,5896,57092,90.6,603,153,25.4
All Grades,All Students,2020-21,97610,15454,82156,84.2,599,242,40.4
All Grades,All Students,2021-22,95304,9432,85872,90.1,592,169,28.5
All Grades,All Students,2022-23,90252,8149,82103,91.0,573,138,24.1
9,All Students,2018-19,25256,3656,21600,85.5,161,53,32.9
9,All Students,2019-20,15725,1929,13796,87.7,162,53,32.7
9,All Students,2020-21,27686,5980,21706,78.4,167,86,51.5
9,All Students,2021-22,23579,2150,21429,90.9,148,39,26.4
9,All Students,2022-23,24422,2394,22028,90.2,155,38,24.5
10,All Students,2018-19,27257,3141,24116,88.5,172,43,25.0
10,All Students,2019-20,16148,1598,14550,90.1,154,37,24.0
10,All Students,2020-21,23289,3615,19674,84.5,143,47,32.9
10,All Students,2021-22,25914,3054,22860,88.2,162,53,32.7
10,All Students,2022-23,23972,2652,21320,88.9,156,48,30.8
11,All Students,2018-19,24335,1697,22638,93.0,148,29,19.6
11,All Students,2019-20,15655,1032,14623,93.4,145,24,16.6
11,All Students,2020-21,24632,3307,21325,86.6,151,49,32.5
11,All Students,2021-22,22664,1816,20848,92.0,142,33,23.2
11,All Students,2022-23,22517,1611,20906,92.8,140,28,20.0
12,All Students,2018-19,23604,2456,21148,89.6,145,49,33.8
12,All Students,2019-20,15460,1337,14123,91.4,143,40,28.0
12,All Students,2020-21,22003,2552,19451,88.4,138,60,43.5
12,All Students,2021-22,23147,2412,20735,89.6,140,44,31.4
12,All Students,2022-23,19341,1492,17849,92.3,122,24,19.7
All Grades,All Students,2018-19,60313,5953,54360,90.1,406,134,33.0
All Grades,All Students,2019-20,39226,4138,35088,89.5,384,128,33.3
All Grades,All Students,2020-21,66036,12859,53177,80.5,390,201,51.5
All Grades,All Students,2021-22,60860,7484,53376,87.7,400,177,44.3
All Grades,All Students,2022-23,55858,7281,48577,87.0,382,152,39.8
9,All Students,2018-19,20295,2474,17821,87.8,140,59,42.1
9,All Students,2019-20,12551,1704,10847,86.4,129,54,41.9
9,All Students,2020-21,21791,4468,17323,79.5,128,73,57.0
9,All Students,2021-22,18927,2512,16415,86.7,133,65,48.9
9,All Students,2022-23,17124,2956,14168,82.7,119,49,41.2
10,All Students,2018-19,15514,1523,13991,90.2,107,37,34.6
10,All Students,2019-20,9985,1121,8864,88.8,98,31,31.6
10,All Students,2020-21,17780,4690,13090,73.6,105,63,60.0
10,All Students,2021-22,16680,2196,14484,86.8,109,55,50.5
10,All Students,2022-23,15300,2020,13280,86.8,105,41,39.0
11,All Students,2018-19,11914,948,10966,92.0,81,19,23.5
11,All Students,2019-20,9609,671,8938,93.0,90,18,20.0
11,All Students,2020-21,13217,2005,11212,84.8,80,33,41.3
11,All Students,2021-22,13569,1536,12033,88.7,85,31,36.5
11,All Students,2022-23,13614,1342,12272,90.1,92,36,39.1
12,All Students,2018-19,12590,1008,11582,92.0,78,19,24.4
12,All Students,2019-20,7081,642,6439,90.9,68,26,38.2
12,All Students,2020-21,13248,1696,11552,87.2,77,32,41.6
12,All Students,2021-22,11684,1240,10444,89.4,73,26,35.6
12,All Students,2022-23,9820,963,8857,90.2,66,26,39.4
All Grades,All Students,2018-19,81379,12837,68542,84.2,501,214,42.7
All Grades,All Students,2019-20,52764,6773,45991,87.2,499,181,36.3
All Grades,All Students,2020-21,82652,13771,68881,83.3,479,186,38.8
All Grades,All Students,2021-22,75481,11877,63604,84.3,461,249,54.0
All Grades,All Students,2022-23,70672,8473,62199,88.0,446,162,36.3
9,All Students,2018-19,28771,5353,23418,81.4,178,75,42.1
9,All Students,2019-20,16432,2659,13773,83.8,162,58,35.8
9,All Students,2020-21,22813,4702,18111,79.4,131,55,42.0
9,All Students,2021-22,23826,3797,20029,84.1,145,72,49.7
9,All Students,2022-23,21110,2957,18153,86.0,134,51,38.1
10,All Students,2018-19,18875,2582,16293,86.3,119,46,38.7
10,All Students,2019-20,14577,1696,12881,88.4,138,48,34.8
10,All Students,2020-21,21704,3681,18023,83.0,126,51,40.5
10,All Students,2021-22,18498,3038,15460,83.6,118,74,62.7
10,All Students,2022-23,20358,2503,17855,87.7,128,50,39.1
11,All Students,2018-19,17401,1692,15709,90.3,106,33,31.1
11,All Students,2019-20,10112,956,9156,90.5,94,32,34.0
11,All Students,2020-21,20491,2540,17951,87.6,117,35,29.9
11,All Students,2021-22,17053,2269,14784,86.7,102,44,43.1
11,All Students,2022-23,14169,1778,12391,87.5,90,40,44.4
12,All Students,2018-19,16332,3210,13122,80.3,98,60,61.2
12,All Students,2019-20,11643,1462,10181,87.4,105,43,41.0
12,All Students,2020-21,17644,2848,14796,83.9,105,45,42.9
12,All Students,2021-22,16104,2773,13331,82.8,96,59,61.5
12,All Students,2022-23,15035,1235,13800,91.8,94,21,22.3
All Grades,All Students,2018-19,72354,6205,66149,91.4,424,121,28.5
All Grades,All Students,2019-20,47085,3298,43787,93.0,429,106,24.7
All Grades,All Students,2020-21,72092,6589,65503,90.9,431,123,28.5
All Grades,All Students,2021-22,64134,7552,56582,88.2,392,176,44.9
All Grades,All Students,2022-23,61440,6524,54916,89.4,379,168,44.3
6,All Students,2018-19,25616,1866,23750,92.7,146,32,21.9
6,All Students,2019-20,15376,1046,14330,93.2,140,35,25.0
6,All Students,2020-21,23644,2909,20735,87.7,146,59,40.4
6,All Students,2021-22,20959,2392,18567,88.6,131,59,45.0
6,All Students,2022-23,19850,2345,17505,88.2,124,65,52.4
7,All Students,2018-19,21935,s,s,s,s,s,s
7,All Students,2019-20,16469,1047,15422,93.6,150,33,22.0
7,All Students,2020-21,23015,1765,21250,92.3,134,36,26.9
7,All Students,2021-22,20175,2578,17597,87.2,123,61,49.6
7,All Students,2022-23,21683,2354,19329,89.1,132,56,42.4
8,All Students,2018-19,24802,2434,22368,90.2,147,54,36.7
8,All Students,2019-20,15240,1205,14035,92.1,139,38,27.3
8,All Students,2020-21,25433,1915,23518,92.5,151,28,18.5
8,All Students,2021-22,23000,2582,20418,88.8,138,56,40.6
8,All Students,2022-23,19907,1825,18082,90.8,123,47,38.2
9,All Students,2018-19,1,s,s,s,s,s,s
All Grades,All Students,2018-19,53570,4409,49161,91.8,324,87,26.9
All Grades,All Students,2019-20,36198,3220,32978,91.1,338,118,34.9
All Grades,All Students,2020-21,51966,5093,46873,90.2,304,105,34.5
All Grades,All Students,2021-22,45895,7535,38360,83.6,277,164,59.2
All Grades,All Students,2022-23,38246,4446,33800,88.4,239,99,41.4
6,All Students,2018-19,17135,s,s,s,s,s,s
6,All Students,2019-20,12736,1111,11625,91.3,120,41,34.2
6,All Students,2020-21,17238,1833,15405,89.4,101,41,40.6
6,All Students,2021-22,14659,2453,12206,83.3,87,51,58.6
6,All Students,2022-23,8522,909,7613,89.3,60,19,31.7
7,All Students,2018-19,17636,1410,16226,92.0,106,32,30.2
7,All Students,2019-20,12036,1246,10790,89.6,115,46,40.0
7,All Students,2020-21,18146,1567,16579,91.4,106,32,30.2
7,All Students,2021-22,14275,2273,12002,84.1,85,52,61.2
7,All Students,2022-23,16153,1598,14555,90.1,98,34,34.7
8,All Students,2018-19,18718,1569,17149,91.6,112,26,23.2
8,All Students,2019-20,11216,s,s,s,s,s,s
8,All Students,2020-21,16574,s,s,s,s,s,s
8,All Students,2021-22,16961,2809,14152,83.4,105,61,58.1
8,All Students,2022-23,13571,1939,11632,85.7,81,46,56.8
9,All Students,2018-19,81,s,s,s,s,s,s
9,All Students,2019-20,210,s,s,s,s,s,s
9,All Students,2020-21,8,s,s,s,s,s,s
All Grades,All Students,2018-19,75117,5006,70111,93.3,457,112,24.5
All Grades,All Students,2019-20,49393,2735,46658,94.5,445,68,15.3
All Grades,All Students,2020-21,70659,2853,67806,96.0,415,50,12.0
All Grades,All Students,2021-22,64542,5740,58802,91.1,388,129,33.2
All Grades,All Students,2022-23,65694,5787,59907,91.2,395,138,34.9
PK in K-12 Schools,All Students,2018-19,6283,519,5764,91.7,38,13,34.2
PK in K-12 Schools,All Students,2019-20,4120,286,3834,93.1,37,9,24.3
PK in K-12 Schools,All Students,2020-21,5797,178,5619,96.9,34,2,5.9
PK in K-12 Schools,All Students,2021-22,6116,739,5377,87.9,38,23,60.5
PK in K-12 Schools,All Students,2022-23,6298,862,5436,86.3,36,24,66.7
0K,All Students,2018-19,13189,984,12205,92.5,83,19,22.9
0K,All Students,2019-20,8664,484,8180,94.4,80,13,16.3
0K,All Students,2020-21,12582,616,11966,95.1,75,12,16.0
0K,All Students,2021-22,9735,919,8816,90.6,60,23,38.3
0K,All Students,2022-23,10508,1132,9376,89.2,65,29,44.6
1,All Students,2018-19,12140,824,11316,93.2,74,19,25.7
1,All Students,2019-20,8691,472,8219,94.6,79,16,20.3
1,All Students,2020-21,12154,426,11728,96.5,71,5,7.0
1,All Students,2021-22,10301,837,9464,91.9,66,16,24.2
1,All Students,2022-23,9807,803,9004,91.8,60,23,38.3
2,All Students,2018-19,10760,676,10084,93.7,65,16,24.6
2,All Students,2019-20,7121,377,6744,94.7,63,7,11.1
2,All Students,2020-21,12133,475,11658,96.1,71,9,12.7
2,All Students,2021-22,10519,796,9723,92.4,60,15,25.0
2,All Students,2022-23,10782,864,9918,92.0,66,17,25.8
3,All Students,2018-19,10690,565,10125,94.7,64,11,17.2
3,All Students,2019-20,6727,359,6368,94.7,61,8,13.1
3,All Students,2020-21,9803,351,9452,96.4,58,6,10.3
3,All Students,2021-22,11005,897,10108,91.8,66,19,28.8
3,All Students,2022-23,10292,723,9569,93.0,60,11,18.3
4,All Students,2018-19,11915,720,11195,94.0,72,17,23.6
4,All Students,2019-20,6801,361,6440,94.7,61,8,13.1
4,All Students,2020-21,9450,389,9061,95.9,55,8,14.5
4,All Students,2021-22,8141,793,7348,90.3,48,18,37.5
4,All Students,2022-23,10645,781,9864,92.7,62,16,25.8
5,All Students,2018-19,10140,718,9422,92.9,61,17,27.9
5,All Students,2019-20,7269,396,6873,94.6,64,7,10.9
5,All Students,2020-21,8740,418,8322,95.2,51,8,15.7
5,All Students,2021-22,8725,759,7966,91.3,50,15,30.0
5,All Students,2022-23,7362,622,6740,91.6,46,18,39.1
All Grades,All Students,2018-19,76799,6747,70052,91.2,471,145,30.8
All Grades,All Students,2019-20,53525,4234,49291,92.1,493,138,28.0
All Grades,All Students,2020-21,76521,8902,67619,88.4,457,161,35.2
All Grades,All Students,2021-22,70836,11020,59816,84.4,442,273,61.8
All Grades,All Students,2022-23,70898,8126,62772,88.5,445,194,43.6
6,All Students,2018-19,26339,2275,24064,91.4,160,47,29.4
6,All Students,2019-20,17325,s,s,s,s,s,s
6,All Students,2020-21,21619,2850,18769,86.8,130,54,41.5
6,All Students,2021-22,20790,3383,17407,83.7,133,90,67.7
6,All Students,2022-23,21982,2282,19700,89.6,139,56,40.3
7,All Students,2018-19,25053,2098,22955,91.6,155,50,32.3
7,All Students,2019-20,18181,1532,16649,91.6,167,50,29.9
7,All Students,2020-21,26134,2853,23281,89.1,158,51,32.3
7,All Students,2021-22,22687,3568,19119,84.3,143,87,60.8
7,All Students,2022-23,21941,2574,19367,88.3,138,64,46.4
8,All Students,2018-19,25407,2374,23033,90.7,156,48,30.8
8,All Students,2019-20,18015,1590,16425,91.2,164,52,31.7
8,All Students,2020-21,28768,3199,25569,88.9,169,56,33.1
8,All Students,2021-22,27359,4069,23290,85.1,166,96,57.8
8,All Students,2022-23,26975,3270,23705,87.9,168,74,44.0
9,All Students,2019-20,4,s,s,s,s,s,s
All Grades,All Students,2018-19,74853,12313,62540,83.6,481,262,54.5
All Grades,All Students,2019-20,48225,5916,42309,87.7,458,180,39.3
All Grades,All Students,2020-21,81538,15296,66242,81.2,476,217,45.6
All Grades,All Students,2021-22,72305,14111,58194,80.5,463,291,62.9
All Grades,All Students,2022-23,67224,10922,56302,83.8,433,217,50.1
9,All Students,2018-19,24850,5226,19624,79.0,158,83,52.5
9,All Students,2019-20,15580,2774,12806,82.2,151,65,43.0
9,All Students,2020-21,22419,4900,17519,78.1,133,71,53.4
9,All Students,2021-22,18917,2758,16159,85.4,117,61,52.1
9,All Students,2022-23,18094,2223,15871,87.7,118,39,33.1
10,All Students,2018-19,21404,3196,18208,85.1,140,77,55.0
10,All Students,2019-20,12975,1520,11455,88.3,124,49,39.5
10,All Students,2020-21,22282,5134,17148,77.0,130,64,49.2
10,All Students,2021-22,20053,4287,15766,78.6,126,85,67.5
10,All Students,2022-23,19182,3227,15955,83.2,120,68,56.7
11,All Students,2018-19,14003,2082,11921,85.1,91,52,57.1
11,All Students,2019-20,11371,993,10378,91.3,107,42,39.3
11,All Students,2020-21,19165,3079,16086,83.9,111,49,44.1
11,All Students,2021-22,16771,3616,13155,78.4,109,63,57.8
11,All Students,2022-23,16795,3156,13639,81.2,109,58,53.2
12,All Students,2018-19,14596,1809,12787,87.6,92,50,54.3
12,All Students,2019-20,8299,629,7670,92.4,76,24,31.6
12,All Students,2020-21,17672,2183,15489,87.6,102,33,32.4
12,All Students,2021-22,16564,3450,13114,79.2,111,82,73.9
12,All Students,2022-23,13153,2316,10837,82.4,86,52,60.5
All Grades,All Students,2018-19,342869,36973,305896,89.2,2228,572,25.7
All Grades,All Students,2019-20,238781,24920,213861,89.6,2295,652,28.4
All Grades,All Students,2020-21,385821,76879,308942,80.1,2268,1318,58.1
All Grades,All Students,2021-22,353143,70121,283022,80.1,2225,1314,59.1
All Grades,All Students,2022-23,306416,31497,274919,89.7,2014,632,31.4
9,All Students,2018-19,122912,18685,104227,84.8,802,259,32.3
9,All Students,2019-20,85586,11671,73915,86.4,821,274,33.4
9,All Students,2020-21,121877,29959,91918,75.4,715,461,64.5
9,All Students,2021-22,111861,24308,87553,78.3,699,421,60.2
9,All Students,2022-23,71536,10552,60984,85.2,491,209,42.6
10,All Students,2018-19,83792,8599,75193,89.7,564,147,26.1
10,All Students,2019-20,58485,5958,52527,89.8,572,154,26.9
10,All Students,2020-21,105276,19148,86128,81.8,621,351,56.5
10,All Students,2021-22,79890,16056,63834,79.9,512,306,59.8
10,All Students,2022-23,88065,9191,78874,89.6,583,181,31.0
11,All Students,2018-19,67789,5058,62731,92.5,435,84,19.3
11,All Students,2019-20,46867,3250,43617,93.1,451,101,22.4
11,All Students,2020-21,84657,14784,69873,82.5,496,258,52.0
11,All Students,2021-22,79740,12744,66996,84.0,510,258,50.6
11,All Students,2022-23,67046,4829,62217,92.8,438,98,22.4
12,All Students,2018-19,68376,4631,63745,93.2,427,82,19.2
12,All Students,2019-20,47843,4041,43802,91.6,451,123,27.3
12,All Students,2020-21,74011,12988,61023,82.5,436,248,56.9
12,All Students,2021-22,81652,17013,64639,79.2,504,329,65.3
12,All Students,2022-23,79769,6925,72844,91.3,502,144,28.7
All Grades,All Students,2018-19,46065,3680,42385,92.0,275,75,27.3
All Grades,All Students,2019-20,28893,2208,26685,92.4,259,60,23.2
All Grades,All Students,2020-21,41153,2355,38798,94.3,240,32,13.3
All Grades,All Students,2021-22,35333,4267,31066,87.9,215,107,49.8
All Grades,All Students,2022-23,28959,3255,25704,88.8,188,79,42.0
6,All Students,2018-19,15167,s,s,s,s,s,s
6,All Students,2019-20,9367,726,8641,92.2,84,18,21.4
6,All Students,2020-21,14741,864,13877,94.1,88,11,12.5
6,All Students,2021-22,9445,1050,8395,88.9,56,25,44.6
6,All Students,2022-23,9496,995,8501,89.5,63,26,41.3
7,All Students,2018-19,15472,1177,14295,92.4,92,25,27.2
7,All Students,2019-20,9663,698,8965,92.8,87,21,24.1
7,All Students,2020-21,12622,s,s,s,s,s,s
7,All Students,2021-22,13272,1528,11744,88.5,83,38,45.8
7,All Students,2022-23,7636,951,6685,87.5,50,19,38.0
8,All Students,2018-19,15424,1377,14047,91.1,91,26,28.6
8,All Students,2019-20,9863,784,9079,92.1,88,21,23.9
8,All Students,2020-21,13756,842,12914,93.9,80,14,17.5
8,All Students,2021-22,12616,1689,10927,86.6,76,44,57.9
8,All Students,2022-23,11827,1309,10518,88.9,75,34,45.3
9,All Students,2020-21,34,s,s,s,s,s,s
10,All Students,2018-19,2,s,s,s,s,s,s
All Grades,All Students,2018-19,60315,4637,55678,92.3,361,96,26.6
All Grades,All Students,2019-20,40564,2355,38209,94.2,370,65,17.6
All Grades,All Students,2020-21,56675,1377,55298,97.6,328,18,5.5
All Grades,All Students,2021-22,49171,4451,44720,90.9,287,93,32.4
All Grades,All Students,2022-23,49750,4772,44978,90.4,289,110,38.1
6,All Students,2018-19,20582,1502,19080,92.7,127,34,26.8
6,All Students,2019-20,11759,601,11158,94.9,108,13,12.0
6,All Students,2020-21,17603,367,17236,97.9,101,3,3.0
6,All Students,2021-22,16184,1205,14979,92.6,94,20,21.3
6,All Students,2022-23,16834,1505,15329,91.1,98,39,39.8
7,All Students,2018-19,21342,1407,19935,93.4,128,29,22.7
7,All Students,2019-20,14773,916,13857,93.8,137,28,20.4
7,All Students,2020-21,17337,450,16887,97.4,100,5,5.0
7,All Students,2021-22,16167,1460,14707,91.0,95,30,31.6
7,All Students,2022-23,17094,1506,15588,91.2,97,29,29.9
8,All Students,2018-19,18391,1728,16663,90.6,106,33,31.1
8,All Students,2019-20,14032,838,13194,94.0,125,24,19.2
8,All Students,2020-21,21735,560,21175,97.4,127,10,7.9
8,All Students,2021-22,16820,1786,15034,89.4,98,43,43.9
8,All Students,2022-23,15822,1761,14061,88.9,94,42,44.7
All Grades,All Students,2018-19,37723,2794,34929,92.6,230,61,26.5
All Grades,All Students,2019-20,30246,1964,28282,93.5,270,58,21.5
All Grades,All Students,2020-21,47759,3763,43996,92.1,286,85,29.7
All Grades,All Students,2021-22,49558,4333,45225,91.3,300,107,35.7
All Grades,All Students,2022-23,50552,4488,46064,91.1,297,104,35.0
0K,All Students,2018-19,11989,990,10999,91.7,75,24,32.0
0K,All Students,2019-20,8228,672,7556,91.8,74,20,27.0
0K,All Students,2020-21,9682,989,8693,89.8,58,23,39.7
0K,All Students,2021-22,10237,889,9348,91.3,66,25,37.9
0K,All Students,2022-23,11231,1355,9876,87.9,68,39,57.4
1,All Students,2018-19,9891,674,9217,93.2,59,14,23.7
1,All Students,2019-20,6421,449,5972,93.0,57,17,29.8
1,All Students,2020-21,9170,753,8417,91.8,55,17,30.9
1,All Students,2021-22,8494,759,7735,91.1,51,18,35.3
1,All Students,2022-23,10073,869,9204,91.4,58,18,31.0
2,All Students,2018-19,9238,691,8547,92.5,54,13,24.1
2,All Students,2019-20,6228,349,5879,94.4,55,10,18.2
2,All Students,2020-21,9174,494,8680,94.6,57,10,17.5
2,All Students,2021-22,8565,770,7795,91.0,49,16,32.7
2,All Students,2022-23,8442,669,7773,92.1,49,15,30.6
3,All Students,2018-19,6605,439,6166,93.4,42,10,23.8
3,All Students,2019-20,5275,319,4956,94.0,47,7,14.9
3,All Students,2020-21,8540,791,7749,90.7,50,18,36.0
3,All Students,2021-22,8124,754,7370,90.7,51,22,43.1
3,All Students,2022-23,7012,510,6502,92.7,41,7,17.1
4,All Students,2019-20,4094,175,3919,95.7,37,4,10.8
4,All Students,2020-21,6192,557,5635,91.0,37,14,37.8
4,All Students,2021-22,7798,676,7122,91.3,45,17,37.8
4,All Students,2022-23,8118,666,7452,91.8,48,17,35.4
5,All Students,2020-21,5001,179,4822,96.4,29,3,10.3
5,All Students,2021-22,6340,485,5855,92.4,38,9,23.7
5,All Students,2022-23,5676,419,5257,92.6,33,8,24.2
All Grades,All Students,2018-19,29730,2897,26833,90.3,181,70,38.7
All Grades,All Students,2019-20,24503,2149,22354,91.2,223,68,30.5
All Grades,All Students,2020-21,43342,3380,39962,92.2,254,64,25.2
All Grades,All Students,2021-22,42645,4664,37981,89.1,251,118,47.0
All Grades,All Students,2022-23,44540,4283,40257,90.4,275,112,40.7
0K,All Students,2018-19,8179,998,7181,87.8,53,30,56.6
0K,All Students,2019-20,4138,376,3762,90.9,39,12,30.8
0K,All Students,2020-21,7968,661,7307,91.7,48,14,29.2
0K,All Students,2021-22,6073,732,5341,87.9,36,24,66.7
0K,All Students,2022-23,6143,693,5450,88.7,39,20,51.3
1,All Students,2018-19,7945,690,7255,91.3,47,15,31.9
1,All Students,2019-20,5971,650,5321,89.1,53,23,43.4
1,All Students,2020-21,6655,518,6137,92.2,39,10,25.6
1,All Students,2021-22,7936,988,6948,87.6,47,25,53.2
1,All Students,2022-23,6728,687,6041,89.8,43,19,44.2
2,All Students,2018-19,7790,775,7015,90.1,45,15,33.3
2,All Students,2019-20,5665,413,5252,92.7,51,14,27.5
2,All Students,2020-21,8008,732,7276,90.9,46,11,23.9
2,All Students,2021-22,5817,618,5199,89.4,35,13,37.1
2,All Students,2022-23,7958,785,7173,90.1,47,18,38.3
3,All Students,2018-19,5816,434,5382,92.5,36,10,27.8
3,All Students,2019-20,4964,483,4481,90.3,45,14,31.1
3,All Students,2020-21,7936,461,7475,94.2,47,10,21.3
3,All Students,2021-22,8158,873,7285,89.3,48,21,43.8
3,All Students,2022-23,5509,450,5059,91.8,36,10,27.8
4,All Students,2019-20,3765,227,3538,94.0,35,5,14.3
4,All Students,2020-21,7300,603,6697,91.7,42,14,33.3
4,All Students,2021-22,8197,873,7324,89.3,48,23,47.9
4,All Students,2022-23,8765,766,7999,91.3,51,20,39.2
5,All Students,2020-21,5475,405,5070,92.6,32,5,15.6
5,All Students,2021-22,6464,580,5884,91.0,37,12,32.4
5,All Students,2022-23,9437,902,8535,90.4,59,25,42.4
All Grades,All Students,2018-19,114670,6371,108299,94.4,662,98,14.8
All Grades,All Students,2019-20,75135,3554,71581,95.3,661,79,12.0
All Grades,All Students,2020-21,110335,4262,106073,96.1,644,74,11.5
All Grades,All Students,2021-22,102901,9017,93884,91.2,603,201,33.3
All Grades,All Students,2022-23,107632,8160,99472,92.4,623,170,27.3
0K,All Students,2018-19,9019,643,8376,92.9,53,13,24.5
0K,All Students,2019-20,5667,305,5362,94.6,50,8,16.0
0K,All Students,2020-21,7594,542,7052,92.9,48,13,27.1
0K,All Students,2021-22,7673,723,6950,90.6,48,21,43.8
0K,All Students,2022-23,8640,788,7852,90.9,52,21,40.4
1,All Students,2018-19,12434,740,11694,94.0,73,12,16.4
1,All Students,2019-20,7254,330,6924,95.5,64,7,10.9
1,All Students,2020-21,9500,308,9192,96.8,55,7,12.7
1,All Students,2021-22,7800,797,7003,89.8,47,21,44.7
1,All Students,2022-23,8321,620,7701,92.5,49,12,24.5
2,All Students,2018-19,11262,558,10704,95.0,65,7,10.8
2,All Students,2019-20,8040,382,7658,95.2,71,6,8.5
2,All Students,2020-21,10894,213,10681,98.0,64,2,3.1
2,All Students,2021-22,9134,715,8419,92.2,52,17,32.7
2,All Students,2022-23,9131,838,8293,90.8,53,19,35.8
3,All Students,2018-19,11175,552,10623,95.1,64,8,12.5
3,All Students,2019-20,7413,320,7093,95.7,66,5,7.6
3,All Students,2020-21,12184,552,11632,95.5,70,9,12.9
3,All Students,2021-22,9657,746,8911,92.3,56,15,26.8
3,All Students,2022-23,10076,754,9322,92.5,58,14,24.1
4,All Students,2018-19,11324,525,10799,95.4,65,9,13.8
4,All Students,2019-20,7309,321,6988,95.6,64,6,9.4
4,All Students,2020-21,11118,401,10717,96.4,64,6,9.4
4,All Students,2021-22,11194,804,10390,92.8,66,15,22.7
4,All Students,2022-23,10479,693,9786,93.4,61,11,18.0
5,All Students,2018-19,11079,557,10522,95.0,64,8,12.5
5,All Students,2019-20,7359,314,7045,95.7,64,9,14.1
5,All Students,2020-21,11049,392,10657,96.5,64,3,4.7
5,All Students,2021-22,10515,847,9668,91.9,61,17,27.9
5,All Students,2022-23,11868,676,11192,94.3,67,13,19.4
6,All Students,2018-19,15692,837,14855,94.7,91,12,13.2
6,All Students,2019-20,10895,536,10359,95.1,96,14,14.6
6,All Students,2020-21,15236,649,14587,95.7,89,13,14.6
6,All Students,2021-22,15898,1505,14393,90.5,92,35,38.0
6,All Students,2022-23,16463,1067,15396,93.5,93,21,22.6
7,All Students,2018-19,16047,957,15090,94.0,93,16,17.2
7,All Students,2019-20,10925,450,10475,95.9,95,4,4.2
7,All Students,2020-21,16663,671,15992,96.0,97,13,13.4
7,All Students,2021-22,15550,1379,14171,91.1,92,27,29.3
7,All Students,2022-23,16744,1411,15333,91.6,97,30,30.9
8,All Students,2018-19,16638,1002,15636,94.0,94,13,13.8
8,All Students,2019-20,10273,596,9677,94.2,91,20,22.0
8,All Students,2020-21,16097,534,15563,96.7,93,8,8.6
8,All Students,2021-22,15480,1501,13979,90.3,89,33,37.1
8,All Students,2022-23,15898,1312,14586,91.7,92,29,31.5
All Grades,All Students,2018-19,76042,11256,64786,85.2,481,243,50.5
All Grades,All Students,2019-20,49936,5948,43988,88.1,474,179,37.8
All Grades,All Students,2020-21,79008,14535,64473,81.6,461,236,51.2
All Grades,All Students,2021-22,66858,12332,54526,81.6,416,243,58.4
All Grades,All Students,2022-23,61168,7799,53369,87.2,392,155,39.5
9,All Students,2018-19,18970,2168,16802,88.6,123,48,39.0
9,All Students,2019-20,12661,1592,11069,87.4,123,46,37.4
9,All Students,2020-21,19984,3165,16819,84.2,117,54,46.2
9,All Students,2021-22,18345,2982,15363,83.7,112,61,54.5
9,All Students,2022-23,16431,1891,14540,88.5,104,30,28.8
10,All Students,2018-19,20806,3203,17603,84.6,132,68,51.5
10,All Students,2019-20,12055,1395,10660,88.4,118,42,35.6
10,All Students,2020-21,19615,4073,15542,79.2,113,58,51.3
10,All Students,2021-22,17328,3628,13700,79.1,110,66,60.0
10,All Students,2022-23,17321,2356,14965,86.4,109,48,44.0
11,All Students,2018-19,19239,2668,16571,86.1,121,53,43.8
11,All Students,2019-20,13022,1541,11481,88.2,120,49,40.8
11,All Students,2020-21,17677,2734,14943,84.5,104,45,43.3
11,All Students,2021-22,15466,3043,12423,80.3,98,64,65.3
11,All Students,2022-23,11965,1310,10655,89.1,79,29,36.7
12,All Students,2018-19,17027,3217,13810,81.1,105,74,70.5
12,All Students,2019-20,12198,1420,10778,88.4,112,41,36.6
12,All Students,2020-21,21732,4563,17169,79.0,127,79,62.2
12,All Students,2021-22,15719,2679,13040,83.0,96,52,54.2
12,All Students,2022-23,15451,2242,13209,85.5,100,48,48.0
All Grades,All Students,2018-19,61353,6147,55206,90.0,397,141,35.5
All Grades,All Students,2019-20,40385,4209,36176,89.6,404,140,34.7
All Grades,All Students,2020-21,63923,6966,56957,89.1,395,127,32.2
All Grades,All Students,2021-22,56776,7074,49702,87.5,365,168,46.0
All Grades,All Students,2022-23,58205,5691,52514,90.2,380,123,32.4
8,All Students,2022-23,2,s,s,s,s,s,s
9,All Students,2018-19,15810,1174,14636,92.6,106,31,29.2
9,All Students,2019-20,10783,969,9814,91.0,120,35,29.2
9,All Students,2020-21,12422,1361,11061,89.0,86,28,32.6
9,All Students,2021-22,12120,1108,11012,90.9,81,32,39.5
9,All Students,2022-23,12336,s,s,s,s,s,s
10,All Students,2018-19,17008,2091,14917,87.7,109,43,39.4
10,All Students,2019-20,9849,1051,8798,89.3,98,32,32.7
10,All Students,2020-21,17433,1958,15475,88.8,105,35,33.3
10,All Students,2021-22,13089,1515,11574,88.4,85,39,45.9
10,All Students,2022-23,15132,1281,13851,91.5,97,27,27.8
11,All Students,2018-19,14585,1360,13225,90.7,96,33,34.4
11,All Students,2019-20,11561,1192,10369,89.7,111,43,38.7
11,All Students,2020-21,16725,1578,15147,90.6,101,30,29.7
11,All Students,2021-22,18953,2626,16327,86.1,122,55,45.1
11,All Students,2022-23,15314,1791,13523,88.3,101,30,29.7
12,All Students,2018-19,13950,1522,12428,89.1,86,34,39.5
12,All Students,2019-20,8192,997,7195,87.8,75,30,40.0
12,All Students,2020-21,17343,2069,15274,88.1,103,34,33.0
12,All Students,2021-22,12614,1825,10789,85.5,77,42,54.5
12,All Students,2022-23,15421,1506,13915,90.2,96,35,36.5
All Grades,All Students,2018-19,63400,6450,56950,89.8,406,119,29.3
All Grades,All Students,2019-20,40096,3265,36831,91.9,382,106,27.7
All Grades,All Students,2020-21,62090,6964,55126,88.8,379,152,40.1
All Grades,All Students,2021-22,52971,5528,47443,89.6,337,116,34.4
All Grades,All Students,2022-23,51988,4506,47482,91.3,351,87,24.8
8,All Students,2022-23,8,s,s,s,s,s,s
9,All Students,2018-19,19859,1742,18117,91.2,130,28,21.5
9,All Students,2019-20,11828,922,10906,92.2,113,32,28.3
9,All Students,2020-21,16690,2167,14523,87.0,103,55,53.4
9,All Students,2021-22,12610,1635,10975,87.0,81,27,33.3
9,All Students,2022-23,13956,988,12968,92.9,105,19,18.1
10,All Students,2018-19,16683,2317,14366,86.1,108,39,36.1
10,All Students,2019-20,10511,848,9663,91.9,102,23,22.5
10,All Students,2020-21,17599,2123,15476,87.9,103,39,37.9
10,All Students,2021-22,11486,891,10595,92.2,72,17,23.6
10,All Students,2022-23,11921,s,s,s,s,s,s
11,All Students,2018-19,14653,1390,13263,90.5,91,25,27.5
11,All Students,2019-20,9220,741,8479,92.0,89,27,30.3
11,All Students,2020-21,14783,1016,13767,93.1,90,21,23.3
11,All Students,2021-22,16156,1675,14481,89.6,104,35,33.7
11,All Students,2022-23,12492,758,11734,93.9,78,10,12.8
12,All Students,2018-19,12205,1001,11204,91.8,77,27,35.1
12,All Students,2019-20,8537,754,7783,91.2,78,24,30.8
12,All Students,2020-21,13018,1658,11360,87.3,83,37,44.6
12,All Students,2021-22,12719,1327,11392,89.6,80,37,46.3
12,All Students,2022-23,13611,1358,12253,90.0,85,34,40.0
All Grades,All Students,2018-19,60650,5601,55049,90.8,405,115,28.4
All Grades,All Students,2019-20,38554,3781,34773,90.2,377,116,30.8
All Grades,All Students,2020-21,62958,9078,53880,85.6,397,151,38.0
All Grades,All Students,2021-22,56413,10415,45998,81.5,369,225,61.0
All Grades,All Students,2022-23,61369,5894,55475,90.4,400,135,33.8
8,All Students,2021-22,2,s,s,s,s,s,s
9,All Students,2018-19,18152,1772,16380,90.2,125,38,30.4
9,All Students,2019-20,11448,1272,10176,88.9,112,43,38.4
9,All Students,2020-21,20732,3323,17409,84.0,124,50,40.3
9,All Students,2021-22,20236,3934,16302,80.6,132,85,64.4
9,All Students,2022-23,19775,1673,18102,91.5,128,40,31.3
10,All Students,2018-19,17080,2071,15009,87.9,118,44,37.3
10,All Students,2019-20,10904,1352,9552,87.6,110,37,33.6
10,All Students,2020-21,17480,3455,14025,80.2,120,52,43.3
10,All Students,2021-22,15691,2859,12832,81.8,107,63,58.9
10,All Students,2022-23,17798,1991,15807,88.8,119,50,42.0
11,All Students,2018-19,12760,721,12039,94.3,84,13,15.5
11,All Students,2019-20,7783,487,7296,93.7,76,16,21.1
11,All Students,2020-21,13091,1295,11796,90.1,83,26,31.3
11,All Students,2021-22,10901,1664,9237,84.7,72,41,56.9
11,All Students,2022-23,13599,1206,12393,91.1,89,25,28.1
12,All Students,2018-19,12658,1037,11621,91.8,78,20,25.6
12,All Students,2019-20,8419,670,7749,92.0,79,20,25.3
12,All Students,2020-21,11655,1005,10650,91.4,70,23,32.9
12,All Students,2021-22,9583,s,s,s,s,s,s
12,All Students,2022-23,10197,1024,9173,90.0,64,20,31.3
All Grades,All Students,2018-19,60227,4350,55877,92.8,352,84,23.9
All Grades,All Students,2019-20,37724,2251,35473,94.0,337,68,20.2
All Grades,All Students,2020-21,58893,5156,53737,91.2,342,98,28.7
All Grades,All Students,2021-22,56647,5572,51075,90.2,336,133,39.6
All Grades,All Students,2022-23,58809,4371,54438,92.6,338,84,24.9
6,All Students,2018-19,20137,1484,18653,92.6,119,30,25.2
6,All Students,2019-20,12964,725,12239,94.4,116,24,20.7
6,All Students,2020-21,20071,1519,18552,92.4,117,26,22.2
6,All Students,2021-22,18195,1853,16342,89.8,107,48,44.9
6,All Students,2022-23,19344,1491,17853,92.3,111,29,26.1
7,All Students,2018-19,19577,1285,18292,93.4,114,24,21.1
7,All Students,2019-20,12846,777,12069,94.0,113,21,18.6
7,All Students,2020-21,20022,1801,18221,91.0,116,36,31.0
7,All Students,2021-22,19496,1950,17546,90.0,116,43,37.1
7,All Students,2022-23,19885,1566,18319,92.1,114,33,28.9
8,All Students,2018-19,20513,1581,18932,92.3,119,30,25.2
8,All Students,2019-20,11914,749,11165,93.7,108,23,21.3
8,All Students,2020-21,18800,1836,16964,90.2,109,36,33.0
8,All Students,2021-22,18956,1769,17187,90.7,113,42,37.2
8,All Students,2022-23,19580,1314,18266,93.3,113,22,19.5
All Grades,All Students,2018-19,50768,4192,46576,91.7,305,88,28.9
All Grades,All Students,2019-20,33119,2700,30419,91.8,311,85,27.3
All Grades,All Students,2020-21,49106,4351,44755,91.1,289,85,29.4
All Grades,All Students,2021-22,50791,5045,45746,90.1,308,123,39.9
All Grades,All Students,2022-23,49531,5082,44449,89.7,300,107,35.7
6,All Students,2018-19,15840,1428,14412,91.0,95,29,30.5
6,All Students,2019-20,10973,s,s,s,s,s,s
6,All Students,2020-21,14257,1178,13079,91.7,84,25,29.8
6,All Students,2021-22,17580,1899,15681,89.2,106,53,50.0
6,All Students,2022-23,15489,s,s,s,s,s,s
7,All Students,2018-19,16925,1310,15615,92.3,106,30,28.3
7,All Students,2019-20,10993,1103,9890,90.0,102,32,31.4
7,All Students,2020-21,17508,1484,16024,91.5,104,30,28.8
7,All Students,2021-22,15716,s,s,s,s,s,s
7,All Students,2022-23,17562,1818,15744,89.6,106,40,37.7
8,All Students,2018-19,18003,1454,16549,91.9,104,29,27.9
8,All Students,2019-20,11110,674,10436,93.9,103,18,17.5
8,All Students,2020-21,17341,1689,15652,90.3,101,30,29.7
8,All Students,2021-22,17440,1634,15806,90.6,104,37,35.6
8,All Students,2022-23,16413,1556,14857,90.5,100,30,30.0
9,All Students,2021-22,55,s,s,s,s,s,s
9,All Students,2022-23,67,s,s,s,s,s,s
10,All Students,2019-20,43,s,s,s,s,s,s
All Grades,All Students,2018-19,84547,9553,74994,88.7,522,174,33.3
All Grades,All Students,2019-20,54677,5832,48845,89.3,520,182,35.0
All Grades,All Students,2020-21,85986,9744,76242,88.7,504,174,34.5
All Grades,All Students,2021-22,82758,10386,72372,87.5,508,211,41.5
All Grades,All Students,2022-23,73864,7243,66621,90.2,465,145,31.2
9,All Students,2018-19,22144,2849,19295,87.1,137,38,27.7
9,All Students,2019-20,14339,1461,12878,89.8,140,45,32.1
9,All Students,2020-21,21710,2857,18853,86.8,126,54,42.9
9,All Students,2021-22,21941,2584,19357,88.2,135,49,36.3
9,All Students,2022-23,19473,1543,17930,92.1,120,21,17.5
10,All Students,2018-19,22486,2533,19953,88.7,141,50,35.5
10,All Students,2019-20,14593,1690,12903,88.4,143,52,36.4
10,All Students,2020-21,23300,2942,20358,87.4,138,47,34.1
10,All Students,2021-22,21294,2756,18538,87.1,132,53,40.2
10,All Students,2022-23,20677,2177,18500,89.5,132,48,36.4
11,All Students,2018-19,18914,1644,17270,91.3,117,33,28.2
11,All Students,2019-20,12243,1012,11231,91.7,116,37,31.9
11,All Students,2020-21,20423,1794,18629,91.2,118,33,28.0
11,All Students,2021-22,19163,2256,16907,88.2,117,46,39.3
11,All Students,2022-23,14891,1330,13561,91.1,94,27,28.7
12,All Students,2018-19,21003,2527,18476,88.0,127,53,41.7
12,All Students,2019-20,13502,1669,11833,87.6,121,48,39.7
12,All Students,2020-21,20553,2151,18402,89.5,122,40,32.8
12,All Students,2021-22,20360,2790,17570,86.3,124,63,50.8
12,All Students,2022-23,18823,2193,16630,88.3,119,49,41.2
All Grades,All Students,2018-19,62491,8714,53777,86.1,452,186,41.2
All Grades,All Students,2019-20,39097,6984,32113,82.1,400,214,53.5
All Grades,All Students,2020-21,52983,8524,44459,83.9,342,139,40.6
All Grades,All Students,2021-22,47682,13299,34383,72.1,320,237,74.1
All Grades,All Students,2022-23,45127,7128,37999,84.2,317,154,48.6
9,All Students,2018-19,12413,2090,10323,83.2,104,45,43.3
9,All Students,2019-20,11414,2137,9277,81.3,118,57,48.3
9,All Students,2020-21,14420,2672,11748,81.5,89,39,43.8
9,All Students,2021-22,20124,5007,15117,75.1,128,95,74.2
9,All Students,2022-23,11406,2083,9323,81.7,81,41,50.6
10,All Students,2018-19,15091,2079,13012,86.2,113,52,46.0
10,All Students,2019-20,8771,1649,7122,81.2,90,48,53.3
10,All Students,2020-21,16123,3012,13111,81.3,100,50,50.0
10,All Students,2021-22,11787,3576,8211,69.7,77,52,67.5
10,All Students,2022-23,18231,3180,15051,82.6,131,64,48.9
11,All Students,2018-19,16119,1582,14537,90.2,100,30,30.0
11,All Students,2019-20,9359,1253,8106,86.6,94,46,48.9
11,All Students,2020-21,9456,753,8703,92.0,57,13,22.8
11,All Students,2021-22,10571,2627,7944,75.1,69,50,72.5
11,All Students,2022-23,9113,903,8210,90.1,62,23,37.1
12,All Students,2018-19,18868,2963,15905,84.3,135,59,43.7
12,All Students,2019-20,9553,1945,7608,79.6,98,63,64.3
12,All Students,2020-21,12984,2087,10897,83.9,96,37,38.5
12,All Students,2021-22,5200,2089,3111,59.8,46,40,87.0
12,All Students,2022-23,6377,962,5415,84.9,43,26,60.5
All Grades,All Students,2018-19,50031,11894,38137,76.2,336,226,67.3
All Grades,All Students,2019-20,28483,6860,21623,75.9,285,166,58.2
All Grades,All Students,2020-21,34331,4235,30096,87.7,217,62,28.6
All Grades,All Students,2021-22,28996,3188,25808,89.0,197,54,27.4
All Grades,All Students,2022-23,24941,2444,22497,90.2,169,48,28.4
8,All Students,2018-19,8,s,s,s,s,s,s
9,All Students,2018-19,10761,s,s,s,s,s,s
9,All Students,2019-20,5814,1457,4357,74.9,61,35,57.4
9,All Students,2020-21,6111,899,5212,85.3,43,12,27.9
9,All Students,2021-22,7471,915,6556,87.8,51,11,21.6
9,All Students,2022-23,5174,430,4744,91.7,37,10,27.0
10,All Students,2018-19,15614,3954,11660,74.7,104,66,63.5
10,All Students,2019-20,7947,1932,6015,75.7,81,46,56.8
10,All Students,2020-21,9157,1788,7369,80.5,60,29,48.3
10,All Students,2021-22,7758,1118,6640,85.6,57,24,42.1
10,All Students,2022-23,7362,746,6616,89.9,51,14,27.5
11,All Students,2018-19,11427,2707,8720,76.3,75,48,64.0
11,All Students,2019-20,7524,1499,6025,80.1,75,39,52.0
11,All Students,2020-21,9191,764,8427,91.7,54,10,18.5
11,All Students,2021-22,7621,719,6902,90.6,51,13,25.5
11,All Students,2022-23,6109,708,5401,88.4,41,12,29.3
12,All Students,2018-19,12221,3182,9039,74.0,77,64,83.1
12,All Students,2019-20,7198,1972,5226,72.6,69,46,66.7
12,All Students,2020-21,9872,784,9088,92.1,60,11,18.3
12,All Students,2021-22,6146,436,5710,92.9,38,6,15.8
12,All Students,2022-23,6296,560,5736,91.1,40,12,30.0
All Grades,All Students,2018-19,72506,7073,65433,90.2,428,145,33.9
All Grades,All Students,2019-20,46971,4105,42866,91.3,430,117,27.2
All Grades,All Students,2020-21,67897,7964,59933,88.3,397,133,33.5
All Grades,All Students,2021-22,69010,10071,58939,85.4,414,232,56.0
All Grades,All Students,2022-23,64762,7183,57579,88.9,393,180,45.8
6,All Students,2018-19,25902,2374,23528,90.8,150,41,27.3
6,All Students,2019-20,15685,1306,14379,91.7,146,36,24.7
6,All Students,2020-21,19969,1636,18333,91.8,118,28,23.7
6,All Students,2021-22,25560,3269,22291,87.2,155,83,53.5
6,All Students,2022-23,17320,1752,15568,89.9,105,47,44.8
7,All Students,2018-19,22131,2195,19936,90.1,132,41,31.1
7,All Students,2019-20,16733,1357,15376,91.9,152,41,27.0
7,All Students,2020-21,23189,3292,19897,85.8,135,55,40.7
7,All Students,2021-22,20605,3155,17450,84.7,122,71,58.2
7,All Students,2022-23,26228,2684,23544,89.8,158,62,39.2
8,All Students,2018-19,24473,2504,21969,89.8,146,63,43.2
8,All Students,2019-20,14553,1442,13111,90.1,132,40,30.3
8,All Students,2020-21,24739,3036,21703,87.7,144,50,34.7
8,All Students,2021-22,22845,3647,19198,84.0,137,78,56.9
8,All Students,2022-23,21214,2747,18467,87.1,130,71,54.6
All Grades,All Students,2018-19,84220,8001,76219,90.5,500,177,35.4
All Grades,All Students,2019-20,50571,4773,45798,90.6,470,174,37.0
All Grades,All Students,2020-21,73603,6066,67537,91.8,428,112,26.2
All Grades,All Students,2021-22,59922,6758,53164,88.7,376,186,49.5
All Grades,All Students,2022-23,54044,5333,48711,90.1,339,114,33.6
6,All Students,2018-19,26795,2414,24381,91.0,166,61,36.7
6,All Students,2019-20,15272,1459,13813,90.4,141,54,38.3
6,All Students,2020-21,24734,2100,22634,91.5,146,36,24.7
6,All Students,2021-22,15647,1739,13908,88.9,99,49,49.5
6,All Students,2022-23,13584,1250,12334,90.8,88,30,34.1
7,All Students,2018-19,27258,2674,24584,90.2,161,60,37.3
7,All Students,2019-20,16855,1547,15308,90.8,160,58,36.3
7,All Students,2020-21,22109,s,s,s,s,s,s
7,All Students,2021-22,22161,2543,19618,88.5,136,70,51.5
7,All Students,2022-23,16944,1563,15381,90.8,110,34,30.9
8,All Students,2018-19,30167,2913,27254,90.3,173,56,32.4
8,All Students,2019-20,18444,1767,16677,90.4,169,62,36.7
8,All Students,2020-21,26706,2079,24627,92.2,155,43,27.7
8,All Students,2021-22,22114,2476,19638,88.8,141,67,47.5
8,All Students,2022-23,23516,2520,20996,89.3,141,50,35.5
9,All Students,2020-21,54,s,s,s,s,s,s
All Grades,All Students,2018-19,68729,6258,62471,90.9,420,155,36.9
All Grades,All Students,2019-20,44405,3829,40576,91.4,414,136,32.9
All Grades,All Students,2020-21,63982,5730,58252,91.0,387,118,30.5
All Grades,All Students,2021-22,62656,7385,55271,88.2,385,191,49.6
All Grades,All Students,2022-23,57436,5335,52101,90.7,358,153,42.7
PK in K-12 Schools,All Students,2018-19,3524,463,3061,86.9,20,14,70.0
PK in K-12 Schools,All Students,2019-20,2300,s,s,s,s,s,s
PK in K-12 Schools,All Students,2020-21,3213,s,s,s,s,s,s
PK in K-12 Schools,All Students,2021-22,3060,452,2608,85.2,18,14,77.8
PK in K-12 Schools,All Students,2022-23,3135,388,2747,87.6,19,11,57.9
0K,All Students,2018-19,9856,1021,8835,89.6,61,28,45.9
0K,All Students,2019-20,5421,603,4818,88.9,54,26,48.1
0K,All Students,2020-21,9529,1083,8446,88.6,59,22,37.3
0K,All Students,2021-22,8823,1194,7629,86.5,54,34,63.0
0K,All Students,2022-23,7534,930,6604,87.7,46,26,56.5
1,All Students,2018-19,9848,859,8989,91.3,61,19,31.1
1,All Students,2019-20,6685,669,6016,90.0,63,22,34.9
1,All Students,2020-21,8306,858,7448,89.7,52,19,36.5
1,All Students,2021-22,9637,1083,8554,88.8,61,28,45.9
1,All Students,2022-23,9237,963,8274,89.6,58,32,55.2
2,All Students,2018-19,12312,1273,11039,89.7,75,33,44.0
2,All Students,2019-20,6542,595,5947,90.9,62,24,38.7
2,All Students,2020-21,10344,887,9457,91.4,60,18,30.0
2,All Students,2021-22,8742,931,7811,89.4,55,24,43.6
2,All Students,2022-23,8750,698,8052,92.0,57,22,38.6
3,All Students,2018-19,12178,1003,11175,91.8,73,24,32.9
3,All Students,2019-20,7642,593,7049,92.2,70,18,25.7
3,All Students,2020-21,9540,600,8940,93.7,59,11,18.6
3,All Students,2021-22,10355,1182,9173,88.6,64,29,45.3
3,All Students,2022-23,8619,792,7827,90.8,53,24,45.3
4,All Students,2018-19,12578,835,11743,93.4,77,19,24.7
4,All Students,2019-20,8011,599,7412,92.5,74,23,31.1
4,All Students,2020-21,11137,873,10264,92.2,65,18,27.7
4,All Students,2021-22,10380,1098,9282,89.4,63,28,44.4
4,All Students,2022-23,10089,767,9322,92.4,64,21,32.8
5,All Students,2018-19,8433,804,7629,90.5,53,18,34.0
5,All Students,2019-20,7792,577,7215,92.6,71,17,23.9
5,All Students,2020-21,11740,979,10761,91.7,71,19,26.8
5,All Students,2021-22,11659,1445,10214,87.6,70,34,48.6
5,All Students,2022-23,10072,797,9275,92.1,61,17,27.9
6,All Students,2019-20,12,s,s,s,s,s,s
6,All Students,2020-21,167,s,s,s,s,s,s
All Grades,All Students,2018-19,93956,10820,83136,88.5,583,287,49.2
All Grades,All Students,2019-20,59545,5368,54177,91.0,559,193,34.5
All Grades,All Students,2020-21,88896,12437,76459,86.0,535,275,51.4
All Grades,All Students,2021-22,81031,11371,69660,86.0,507,284,56.0
All Grades,All Students,2022-23,79108,10930,68178,86.2,486,265,54.5
PK in K-12 Schools,All Students,2018-19,8724,1236,7488,85.8,55,33,60.0
PK in K-12 Schools,All Students,2019-20,6013,644,5369,89.3,57,28,49.1
PK in K-12 Schools,All Students,2020-21,7903,1440,6463,81.8,52,35,67.3
PK in K-12 Schools,All Students,2021-22,8287,1181,7106,85.7,55,36,65.5
PK in K-12 Schools,All Students,2022-23,7147,1305,5842,81.7,48,31,64.6
0K,All Students,2018-19,14196,2074,12122,85.4,90,56,62.2
0K,All Students,2019-20,9375,1086,8289,88.4,88,37,42.0
0K,All Students,2020-21,12931,1672,11259,87.1,80,40,50.0
0K,All Students,2021-22,11261,1723,9538,84.7,73,47,64.4
0K,All Students,2022-23,11682,1850,9832,84.2,71,45,63.4
1,All Students,2018-19,12805,1413,11392,89.0,80,38,47.5
1,All Students,2019-20,9017,1005,8012,88.9,88,38,43.2
1,All Students,2020-21,13761,2191,11570,84.1,81,46,56.8
1,All Students,2021-22,12019,1988,10031,83.5,80,51,63.8
1,All Students,2022-23,12301,1668,10633,86.4,75,44,58.7
2,All Students,2018-19,14029,1694,12335,87.9,90,44,48.9
2,All Students,2019-20,8792,749,8043,91.5,81,28,34.6
2,All Students,2020-21,13048,2533,10515,80.6,78,54,69.2
2,All Students,2021-22,12261,1764,10497,85.6,73,38,52.1
2,All Students,2022-23,11519,1821,9698,84.2,71,42,59.2
3,All Students,2018-19,16528,1743,14785,89.5,100,47,47.0
3,All Students,2019-20,8470,660,7810,92.2,79,23,29.1
3,All Students,2020-21,13920,1229,12691,91.2,81,23,28.4
3,All Students,2021-22,12534,1768,10766,85.9,77,41,53.2
3,All Students,2022-23,11788,1524,10264,87.1,74,34,45.9
4,All Students,2018-19,13029,1287,11742,90.1,82,31,37.8
4,All Students,2019-20,9705,688,9017,92.9,93,22,23.7
4,All Students,2020-21,13250,1944,11306,85.3,78,40,51.3
4,All Students,2021-22,12051,1294,10757,89.3,74,32,43.2
4,All Students,2022-23,12031,1626,10405,86.5,72,40,55.6
5,All Students,2018-19,14645,1373,13272,90.6,86,38,44.2
5,All Students,2019-20,8173,536,7637,93.4,73,17,23.3
5,All Students,2020-21,14083,1428,12655,89.9,85,37,43.5
5,All Students,2021-22,12618,1653,10965,86.9,75,39,52.0
5,All Students,2022-23,12640,1136,11504,91.0,75,29,38.7
All Grades,All Students,2018-19,51397,5437,45960,89.4,334,148,44.3
All Grades,All Students,2019-20,30554,3031,27523,90.1,292,123,42.1
All Grades,All Students,2020-21,43923,5985,37938,86.4,275,142,51.6
All Grades,All Students,2021-22,39711,5566,34145,86.0,262,149,56.9
All Grades,All Students,2022-23,39808,4934,34874,87.6,250,141,56.4
PK in K-12 Schools,All Students,2018-19,3988,453,3535,88.6,30,16,53.3
PK in K-12 Schools,All Students,2019-20,1940,220,1720,88.7,18,10,55.6
PK in K-12 Schools,All Students,2020-21,2379,181,2198,92.4,17,7,41.2
PK in K-12 Schools,All Students,2021-22,4818,683,4135,85.8,34,23,67.6
PK in K-12 Schools,All Students,2022-23,5389,748,4641,86.1,33,19,57.6
0K,All Students,2018-19,7942,926,7016,88.3,50,24,48.0
0K,All Students,2019-20,4634,485,4149,89.5,47,26,55.3
0K,All Students,2020-21,4642,629,4013,86.4,30,15,50.0
0K,All Students,2021-22,6152,1057,5095,82.8,44,28,63.6
0K,All Students,2022-23,4394,532,3862,87.9,30,17,56.7
1,All Students,2018-19,7669,749,6920,90.2,50,18,36.0
1,All Students,2019-20,5496,666,4830,87.9,56,26,46.4
1,All Students,2020-21,7834,1247,6587,84.1,49,25,51.0
1,All Students,2021-22,5272,1023,4249,80.6,35,27,77.1
1,All Students,2022-23,6137,883,5254,85.6,38,25,65.8
2,All Students,2018-19,7724,853,6871,89.0,51,25,49.0
2,All Students,2019-20,5024,469,4555,90.7,46,18,39.1
2,All Students,2020-21,8994,1277,7717,85.8,57,27,47.4
2,All Students,2021-22,6319,686,5633,89.1,39,13,33.3
2,All Students,2022-23,5342,811,4531,84.8,32,23,71.9
3,All Students,2018-19,9021,1038,7983,88.5,62,30,48.4
3,All Students,2019-20,4043,383,3660,90.5,38,12,31.6
3,All Students,2020-21,7368,1054,6314,85.7,47,27,57.4
3,All Students,2021-22,7055,838,6217,88.1,47,24,51.1
3,All Students,2022-23,5135,544,4591,89.4,32,17,53.1
4,All Students,2018-19,8151,809,7342,90.1,48,21,43.8
4,All Students,2019-20,5053,404,4649,92.0,47,16,34.0
4,All Students,2020-21,5848,613,5235,89.5,35,18,51.4
4,All Students,2021-22,5881,766,5115,87.0,38,22,57.9
4,All Students,2022-23,7750,775,6975,90.0,50,23,46.0
5,All Students,2018-19,6902,609,6293,91.2,43,14,32.6
5,All Students,2019-20,4364,404,3960,90.7,40,15,37.5
5,All Students,2020-21,6858,984,5874,85.7,40,23,57.5
5,All Students,2021-22,4214,513,3701,87.8,25,12,48.0
5,All Students,2022-23,5661,641,5020,88.7,35,17,48.6
All Grades,All Students,2018-19,189072,13522,175550,92.8,1152,281,24.4
All Grades,All Students,2019-20,116983,7058,109925,94.0,1078,204,18.9
All Grades,All Students,2020-21,163909,16076,147833,90.2,977,318,32.5
All Grades,All Students,2021-22,147805,17025,130780,88.5,922,431,46.7
All Grades,All Students,2022-23,144900,13935,130965,90.4,883,330,37.4
0K,All Students,2018-19,28513,2607,25906,90.9,170,58,34.1
0K,All Students,2019-20,18638,1344,17294,92.8,169,44,26.0
0K,All Students,2020-21,21425,2369,19056,88.9,132,47,35.6
0K,All Students,2021-22,25606,3176,22430,87.6,162,81,50.0
0K,All Students,2022-23,22095,2343,19752,89.4,138,62,44.9
1,All Students,2018-19,25705,2177,23528,91.5,159,50,31.4
1,All Students,2019-20,18840,1329,17511,92.9,177,41,23.2
1,All Students,2020-21,28716,3095,25621,89.2,169,69,40.8
1,All Students,2021-22,20882,2424,18458,88.4,141,74,52.5
1,All Students,2022-23,26302,2888,23414,89.0,158,71,44.9
2,All Students,2018-19,29690,2043,27647,93.1,182,44,24.2
2,All Students,2019-20,15951,s,s,s,s,s,s
2,All Students,2020-21,27562,2797,24765,89.9,164,55,33.5
2,All Students,2021-22,28610,3659,24951,87.2,179,96,53.6
2,All Students,2022-23,21006,s,s,s,s,s,s
3,All Students,2018-19,37111,2769,34342,92.5,227,55,24.2
3,All Students,2019-20,18597,1032,17565,94.5,171,26,15.2
3,All Students,2020-21,23662,2220,21442,90.6,139,45,32.4
3,All Students,2021-22,24573,2877,21696,88.3,149,63,42.3
3,All Students,2022-23,27875,2717,25158,90.3,170,64,37.6
4,All Students,2018-19,32293,1852,30441,94.3,198,33,16.7
4,All Students,2019-20,23678,1371,22307,94.2,214,34,15.9
4,All Students,2020-21,27628,3157,24471,88.6,164,59,36.0
4,All Students,2021-22,22971,2354,20617,89.8,140,60,42.9
4,All Students,2022-23,23583,2256,21327,90.4,142,52,36.6
5,All Students,2018-19,35760,2074,33686,94.2,216,41,19.0
5,All Students,2019-20,21267,999,20268,95.3,196,27,13.8
5,All Students,2020-21,34916,2438,32478,93.0,209,43,20.6
5,All Students,2021-22,25163,2535,22628,89.9,151,57,37.7
5,All Students,2022-23,23895,1816,22079,92.4,143,40,28.0
6,All Students,2019-20,12,s,s,s,s,s,s
6,All Students,2022-23,144,s,s,s,s,s,s
All Grades,All Students,2018-19,101882,11353,90529,88.9,641,304,47.4
All Grades,All Students,2019-20,63147,5940,57207,90.6,602,246,40.9
All Grades,All Students,2020-21,82116,9091,73025,88.9,481,202,42.0
All Grades,All Students,2021-22,72694,10113,62581,86.1,454,262,57.7
All Grades,All Students,2022-23,70386,9378,61008,86.7,444,250,56.3
PK in K-12 Schools,All Students,2018-19,6092,559,5533,90.8,38,13,34.2
PK in K-12 Schools,All Students,2019-20,3623,367,3256,89.9,35,15,42.9
PK in K-12 Schools,All Students,2020-21,4837,484,4353,90.0,30,15,50.0
PK in K-12 Schools,All Students,2021-22,5118,885,4233,82.7,32,23,71.9
PK in K-12 Schools,All Students,2022-23,5787,760,5027,86.9,39,23,59.0
0K,All Students,2018-19,13662,1978,11684,85.5,90,51,56.7
0K,All Students,2019-20,8440,757,7683,91.0,80,29,36.3
0K,All Students,2020-21,8179,809,7370,90.1,49,17,34.7
0K,All Students,2021-22,11111,1867,9244,83.2,72,51,70.8
0K,All Students,2022-23,8114,1210,6904,85.1,51,36,70.6
1,All Students,2018-19,14982,1667,13315,88.9,93,42,45.2
1,All Students,2019-20,9336,939,8397,89.9,90,42,46.7
1,All Students,2020-21,12810,1225,11585,90.4,75,26,34.7
1,All Students,2021-22,8417,1015,7402,87.9,53,24,45.3
1,All Students,2022-23,11459,1731,9728,84.9,75,48,64.0
2,All Students,2018-19,12750,1499,11251,88.2,84,43,51.2
2,All Students,2019-20,9462,876,8586,90.7,88,33,37.5
2,All Students,2020-21,13456,1545,11911,88.5,79,36,45.6
2,All Students,2021-22,11879,1508,10371,87.3,74,40,54.1
2,All Students,2022-23,8399,850,7549,89.9,54,22,40.7
3,All Students,2018-19,19081,1938,17143,89.8,121,53,43.8
3,All Students,2019-20,8367,782,7585,90.7,83,33,39.8
3,All Students,2020-21,13809,1651,12158,88.0,80,34,42.5
3,All Students,2021-22,11154,1593,9561,85.7,71,42,59.2
3,All Students,2022-23,12144,1572,10572,87.1,74,38,51.4
4,All Students,2018-19,18154,1956,16198,89.2,114,61,53.5
4,All Students,2019-20,12952,1214,11738,90.6,125,53,42.4
4,All Students,2020-21,11606,1316,10290,88.7,67,25,37.3
4,All Students,2021-22,13828,2048,11780,85.2,85,51,60.0
4,All Students,2022-23,11696,1522,10174,87.0,74,39,52.7
5,All Students,2018-19,17161,1756,15405,89.8,101,41,40.6
5,All Students,2019-20,10967,1005,9962,90.8,101,41,40.6
5,All Students,2020-21,17419,2061,15358,88.2,101,49,48.5
5,All Students,2021-22,11187,1197,9990,89.3,67,31,46.3
5,All Students,2022-23,12787,1733,11054,86.4,77,44,57.1
All Grades,All Students,2018-19,52248,4269,47979,91.8,325,105,32.3
All Grades,All Students,2019-20,30488,2354,28134,92.3,271,72,26.6
All Grades,All Students,2020-21,44266,6283,37983,85.8,267,131,49.1
All Grades,All Students,2021-22,43015,4987,38028,88.4,267,128,47.9
All Grades,All Students,2022-23,41172,4015,37157,90.2,254,102,40.2
PK in K-12 Schools,All Students,2018-19,5327,570,4757,89.3,38,19,50.0
PK in K-12 Schools,All Students,2019-20,2585,404,2181,84.4,23,15,65.2
PK in K-12 Schools,All Students,2020-21,3285,s,s,s,s,s,s
PK in K-12 Schools,All Students,2021-22,6385,874,5511,86.3,39,24,61.5
PK in K-12 Schools,All Students,2022-23,5741,638,5103,88.9,39,17,43.6
0K,All Students,2018-19,8699,894,7805,89.7,54,23,42.6
0K,All Students,2019-20,4564,455,4109,90.0,41,17,41.5
0K,All Students,2020-21,5643,643,5000,88.6,34,13,38.2
0K,All Students,2021-22,4609,588,4021,87.2,30,17,56.7
0K,All Students,2022-23,4311,483,3828,88.8,27,13,48.1
1,All Students,2018-19,7384,572,6812,92.3,46,15,32.6
1,All Students,2019-20,4727,384,4343,91.9,41,13,31.7
1,All Students,2020-21,7312,1306,6006,82.1,42,24,57.1
1,All Students,2021-22,5052,680,4372,86.5,32,18,56.3
1,All Students,2022-23,5334,534,4800,90.0,34,15,44.1
2,All Students,2018-19,6508,465,6043,92.9,41,9,22.0
2,All Students,2019-20,4802,282,4520,94.1,44,7,15.9
2,All Students,2020-21,7002,989,6013,85.9,41,17,41.5
2,All Students,2021-22,6453,874,5579,86.5,41,21,51.2
2,All Students,2022-23,5082,484,4598,90.5,31,12,38.7
3,All Students,2018-19,8850,638,8212,92.8,53,12,22.6
3,All Students,2019-20,4779,306,4473,93.6,43,7,16.3
3,All Students,2020-21,7176,1007,6169,86.0,43,23,53.5
3,All Students,2021-22,7099,693,6406,90.2,43,15,34.9
3,All Students,2022-23,6127,624,5503,89.8,35,13,37.1
4,All Students,2018-19,6096,370,5726,93.9,38,7,18.4
4,All Students,2019-20,5291,271,5020,94.9,46,6,13.0
4,All Students,2020-21,6903,1063,5840,84.6,41,21,51.2
4,All Students,2021-22,7012,640,6372,90.9,43,16,37.2
4,All Students,2022-23,7425,643,6782,91.3,46,15,32.6
5,All Students,2018-19,9384,760,8624,91.9,55,20,36.4
5,All Students,2019-20,3740,252,3488,93.3,33,7,21.2
5,All Students,2020-21,6944,665,6279,90.4,42,14,33.3
5,All Students,2021-22,6405,638,5767,90.0,39,17,43.6
5,All Students,2022-23,7152,609,6543,91.5,42,17,40.5
6,All Students,2020-21,1,s,s,s,s,s,s
All Grades,All Students,2018-19,105660,10744,94916,89.8,671,266,39.6
All Grades,All Students,2019-20,61945,4864,57081,92.1,603,185,30.7
All Grades,All Students,2020-21,90692,11172,79520,87.7,568,240,42.3
All Grades,All Students,2021-22,84899,10858,74041,87.2,538,285,53.0
All Grades,All Students,2022-23,87184,10372,76812,88.1,550,305,55.5
PK in K-12 Schools,All Students,2018-19,11478,s,s,s,s,s,s
PK in K-12 Schools,All Students,2019-20,7209,640,6569,91.1,78,31,39.7
PK in K-12 Schools,All Students,2020-21,7938,s,s,s,s,s,s
PK in K-12 Schools,All Students,2021-22,11196,1572,9624,86.0,70,43,61.4
PK in K-12 Schools,All Students,2022-23,13430,1976,11454,85.3,87,61,70.1
0K,All Students,2018-19,12932,1429,11503,88.9,80,34,42.5
0K,All Students,2019-20,8939,848,8091,90.5,91,39,42.9
0K,All Students,2020-21,13832,2069,11763,85.0,87,47,54.0
0K,All Students,2021-22,11934,1900,10034,84.1,77,50,64.9
0K,All Students,2022-23,11131,1506,9625,86.5,71,46,64.8
1,All Students,2018-19,17452,1832,15620,89.5,112,45,40.2
1,All Students,2019-20,7580,608,6972,92.0,74,22,29.7
1,All Students,2020-21,13520,2183,11337,83.9,81,45,55.6
1,All Students,2021-22,13184,1794,11390,86.4,88,55,62.5
1,All Students,2022-23,12236,1580,10656,87.1,80,44,55.0
2,All Students,2018-19,12739,1100,11639,91.4,77,27,35.1
2,All Students,2019-20,10089,727,9362,92.8,94,25,26.6
2,All Students,2020-21,10562,1474,9088,86.0,69,29,42.0
2,All Students,2021-22,11549,1456,10093,87.4,71,39,54.9
2,All Students,2022-23,12929,1509,11420,88.3,80,49,61.3
3,All Students,2018-19,17780,1803,15977,89.9,113,51,45.1
3,All Students,2019-20,8080,485,7595,94.0,79,15,19.0
3,All Students,2020-21,16196,1723,14473,89.4,103,34,33.0
3,All Students,2021-22,10131,1209,8922,88.1,63,25,39.7
3,All Students,2022-23,11640,1106,10534,90.5,73,31,42.5
4,All Students,2018-19,17112,1662,15450,90.3,109,37,33.9
4,All Students,2019-20,10214,780,9434,92.4,95,25,26.3
4,All Students,2020-21,13420,1272,12148,90.5,84,24,28.6
4,All Students,2021-22,15491,1831,13660,88.2,96,43,44.8
4,All Students,2022-23,10948,1115,9833,89.8,70,33,47.1
5,All Students,2018-19,16020,1597,14423,90.0,99,39,39.4
5,All Students,2019-20,9834,776,9058,92.1,92,28,30.4
5,All Students,2020-21,15223,1443,13780,90.5,91,31,34.1
5,All Students,2021-22,11414,1096,10318,90.4,73,30,41.1
5,All Students,2022-23,14870,1580,13290,89.4,89,41,46.1
6,All Students,2018-19,147,s,s,s,s,s,s
6,All Students,2020-21,1,s,s,s,s,s,s
All Grades,All Students,2018-19,88186,9668,78518,89.0,544,251,46.1
All Grades,All Students,2019-20,49584,4611,44973,90.7,471,176,37.4
All Grades,All Students,2020-21,64268,6576,57692,89.8,399,136,34.1
All Grades,All Students,2021-22,62690,7023,55667,88.8,402,188,46.8
All Grades,All Students,2022-23,54174,6671,47503,87.7,341,180,52.8
PK in K-12 Schools,All Students,2018-19,7718,844,6874,89.1,51,28,54.9
PK in K-12 Schools,All Students,2019-20,3449,477,2972,86.2,39,22,56.4
PK in K-12 Schools,All Students,2020-21,3930,284,3646,92.8,29,8,27.6
PK in K-12 Schools,All Students,2021-22,6410,s,s,s,s,s,s
PK in K-12 Schools,All Students,2022-23,6608,995,5613,84.9,44,29,65.9
0K,All Students,2018-19,9692,1336,8356,86.2,64,38,59.4
0K,All Students,2019-20,6882,734,6148,89.3,69,29,42.0
0K,All Students,2020-21,8399,844,7555,90.0,56,23,41.1
0K,All Students,2021-22,8118,1229,6889,84.9,51,32,62.7
0K,All Students,2022-23,7743,929,6814,88.0,52,27,51.9
1,All Students,2018-19,11921,1557,10364,86.9,75,40,53.3
1,All Students,2019-20,6682,674,6008,89.9,62,24,38.7
1,All Students,2020-21,10328,1192,9136,88.5,62,21,33.9
1,All Students,2021-22,9445,969,8476,89.7,60,28,46.7
1,All Students,2022-23,7838,1173,6665,85.0,50,30,60.0
2,All Students,2018-19,15792,1657,14135,89.5,97,42,43.3
2,All Students,2019-20,6541,567,5974,91.3,62,24,38.7
2,All Students,2020-21,9656,1071,8585,88.9,61,19,31.1
2,All Students,2021-22,9304,952,8352,89.8,59,24,40.7
2,All Students,2022-23,8844,1049,7795,88.1,56,29,51.8
3,All Students,2018-19,12207,1295,10912,89.4,73,29,39.7
3,All Students,2019-20,9143,828,8315,90.9,84,33,39.3
3,All Students,2020-21,8806,910,7896,89.7,53,22,41.5
3,All Students,2021-22,8438,762,7676,91.0,56,21,37.5
3,All Students,2022-23,8254,1010,7244,87.8,50,25,50.0
4,All Students,2018-19,15767,1646,14121,89.6,95,41,43.2
4,All Students,2019-20,7008,639,6369,90.9,65,20,30.8
4,All Students,2020-21,13246,1191,12055,91.0,79,23,29.1
4,All Students,2021-22,9393,1046,8347,88.9,61,29,47.5
4,All Students,2022-23,5538,480,5058,91.3,34,16,47.1
5,All Students,2018-19,15089,1333,13756,91.2,89,33,37.1
5,All Students,2019-20,9879,692,9187,93.0,90,24,26.7
5,All Students,2020-21,9903,1084,8819,89.1,59,20,33.9
5,All Students,2021-22,11579,1165,10414,89.9,70,29,41.4
5,All Students,2022-23,9349,1035,8314,88.9,55,24,43.6
6,All Students,2021-22,3,s,s,s,s,s,s
All Grades,All Students,2018-19,49795,7377,42418,85.2,328,186,56.7
All Grades,All Students,2019-20,29148,3808,25340,86.9,266,131,49.2
All Grades,All Students,2020-21,32635,4559,28076,86.0,193,88,45.6
All Grades,All Students,2021-22,27908,3592,24316,87.1,179,92,51.4
All Grades,All Students,2022-23,20926,2156,18770,89.7,140,52,37.1
6,All Students,2018-19,12395,s,s,s,s,s,s
6,All Students,2019-20,7233,903,6330,87.5,66,31,47.0
6,All Students,2020-21,6232,479,5753,92.3,37,11,29.7
6,All Students,2021-22,6059,911,5148,85.0,41,26,63.4
6,All Students,2022-23,4900,s,s,s,s,s,s
7,All Students,2018-19,17769,2098,15671,88.2,118,63,53.4
7,All Students,2019-20,8935,1275,7660,85.7,83,51,61.4
7,All Students,2020-21,12735,2173,10562,82.9,76,44,57.9
7,All Students,2021-22,8240,872,7368,89.4,54,24,44.4
7,All Students,2022-23,7066,904,6162,87.2,46,21,45.7
8,All Students,2018-19,19620,3317,16303,83.1,131,76,58.0
8,All Students,2019-20,12980,1630,11350,87.4,117,49,41.9
8,All Students,2020-21,13668,1907,11761,86.0,80,33,41.3
8,All Students,2021-22,13609,1809,11800,86.7,84,42,50.0
8,All Students,2022-23,8857,838,8019,90.5,59,21,35.6
9,All Students,2018-19,11,s,s,s,s,s,s
9,All Students,2022-23,103,s,s,s,s,s,s
All Grades,All Students,2018-19,94970,8073,86897,91.5,561,148,26.4
All Grades,All Students,2019-20,59035,5378,53657,90.9,538,187,34.8
All Grades,All Students,2020-21,84914,12700,72214,85.0,496,225,45.4
All Grades,All Students,2021-22,67993,9383,58610,86.2,414,224,54.1
All Grades,All Students,2022-23,52684,6045,46639,88.5,320,148,46.3
6,All Students,2018-19,33458,2696,30762,91.9,201,53,26.4
6,All Students,2019-20,19950,1612,18338,91.9,182,57,31.3
6,All Students,2020-21,24899,3858,21041,84.5,150,68,45.3
6,All Students,2021-22,17818,2501,15317,86.0,107,61,57.0
6,All Students,2022-23,12717,1202,11515,90.5,78,28,35.9
7,All Students,2018-19,29517,2751,26766,90.7,173,50,28.9
7,All Students,2019-20,20277,2025,18252,90.0,186,74,39.8
7,All Students,2020-21,29321,3892,25429,86.7,169,77,45.6
7,All Students,2021-22,23207,3350,19857,85.6,145,83,57.2
7,All Students,2022-23,17671,1967,15704,88.9,109,50,45.9
8,All Students,2018-19,31995,2626,29369,91.8,187,45,24.1
8,All Students,2019-20,18806,s,s,s,s,s,s
8,All Students,2020-21,30694,4950,25744,83.9,177,80,45.2
8,All Students,2021-22,26968,3532,23436,86.9,162,80,49.4
8,All Students,2022-23,22296,2876,19420,87.1,133,70,52.6
9,All Students,2019-20,2,s,s,s,s,s,s
All Grades,All Students,2018-19,111518,12356,99162,88.9,696,318,45.7
All Grades,All Students,2019-20,66657,6103,60554,90.8,632,238,37.7
All Grades,All Students,2020-21,88867,10704,78163,88.0,540,216,40.0
All Grades,All Students,2021-22,78983,11083,67900,86.0,493,279,56.6
All Grades,All Students,2022-23,76029,8385,67644,89.0,488,220,45.1
PK in K-12 Schools,All Students,2018-19,7948,1202,6746,84.9,51,31,60.8
PK in K-12 Schools,All Students,2019-20,5419,631,4788,88.4,53,30,56.6
PK in K-12 Schools,All Students,2020-21,5560,248,5312,95.5,38,5,13.2
PK in K-12 Schools,All Students,2021-22,7241,1113,6128,84.6,50,30,60.0
PK in K-12 Schools,All Students,2022-23,8399,1022,7377,87.8,55,30,54.5
0K,All Students,2018-19,17042,2416,14626,85.8,109,57,52.3
0K,All Students,2019-20,10197,1229,8968,87.9,102,55,53.9
0K,All Students,2020-21,13012,2123,10889,83.7,81,48,59.3
0K,All Students,2021-22,10029,1591,8438,84.1,63,40,63.5
0K,All Students,2022-23,8510,1120,7390,86.8,59,29,49.2
1,All Students,2018-19,14369,1562,12807,89.1,94,45,47.9
1,All Students,2019-20,9288,911,8377,90.2,88,38,43.2
1,All Students,2020-21,15200,2173,13027,85.7,93,44,47.3
1,All Students,2021-22,12737,2027,10710,84.1,80,50,62.5
1,All Students,2022-23,10193,1253,8940,87.7,64,31,48.4
2,All Students,2018-19,17046,1861,15185,89.1,109,51,46.8
2,All Students,2019-20,8900,772,8128,91.3,82,27,32.9
2,All Students,2020-21,12513,2033,10480,83.8,74,43,58.1
2,All Students,2021-22,12617,1862,10755,85.2,76,48,63.2
2,All Students,2022-23,12662,1480,11182,88.3,81,39,48.1
3,All Students,2018-19,17912,1709,16203,90.5,107,40,37.4
3,All Students,2019-20,10326,865,9461,91.6,98,31,31.6
3,All Students,2020-21,12126,1511,10615,87.5,72,29,40.3
3,All Students,2021-22,11279,1395,9884,87.6,73,34,46.6
3,All Students,2022-23,13019,1327,11692,89.8,83,40,48.2
4,All Students,2018-19,20248,2070,18178,89.8,123,55,44.7
4,All Students,2019-20,10305,808,9497,92.2,99,27,27.3
4,All Students,2020-21,15232,1585,13647,89.6,93,30,32.3
4,All Students,2021-22,11109,1520,9589,86.3,67,41,61.2
4,All Students,2022-23,11713,1104,10609,90.6,73,24,32.9
5,All Students,2018-19,16953,1536,15417,90.9,103,39,37.9
5,All Students,2019-20,12222,887,11335,92.7,110,30,27.3
5,All Students,2020-21,15224,1031,14193,93.2,89,17,19.1
5,All Students,2021-22,13971,1575,12396,88.7,84,36,42.9
5,All Students,2022-23,11533,1079,10454,90.6,73,27,37.0
All Grades,All Students,2018-19,139445,13691,125754,90.2,833,313,37.6
All Grades,All Students,2019-20,81562,6257,75305,92.3,757,216,28.5
All Grades,All Students,2020-21,106684,13362,93322,87.5,640,287,44.8
All Grades,All Students,2021-22,96033,12121,83912,87.4,599,307,51.3
All Grades,All Students,2022-23,92889,11819,81070,87.3,579,305,52.7
PK in K-12 Schools,All Students,2018-19,6405,s,s,s,s,s,s
PK in K-12 Schools,All Students,2019-20,4112,453,3659,89.0,36,17,47.2
PK in K-12 Schools,All Students,2020-21,5247,1061,4186,79.8,36,24,66.7
PK in K-12 Schools,All Students,2021-22,5922,828,5094,86.0,38,25,65.8
PK in K-12 Schools,All Students,2022-23,5817,s,s,s,s,s,s
0K,All Students,2018-19,19570,2224,17346,88.6,118,51,43.2
0K,All Students,2019-20,11111,964,10147,91.3,108,39,36.1
0K,All Students,2020-21,10908,1612,9296,85.2,72,39,54.2
0K,All Students,2021-22,12614,1886,10728,85.0,84,44,52.4
0K,All Students,2022-23,12243,1851,10392,84.9,78,52,66.7
1,All Students,2018-19,21998,2637,19361,88.0,135,67,49.6
1,All Students,2019-20,12081,1027,11054,91.5,112,40,35.7
1,All Students,2020-21,16311,2644,13667,83.8,96,49,51.0
1,All Students,2021-22,10232,1138,9094,88.9,65,30,46.2
1,All Students,2022-23,13866,2083,11783,85.0,89,54,60.7
2,All Students,2018-19,21280,1980,19300,90.7,127,46,36.2
2,All Students,2019-20,12805,1096,11709,91.4,121,37,30.6
2,All Students,2020-21,17654,1879,15775,89.4,106,43,40.6
2,All Students,2021-22,16602,2188,14414,86.8,103,58,56.3
2,All Students,2022-23,11505,1252,10253,89.1,75,35,46.7
3,All Students,2018-19,21185,1825,19360,91.4,126,41,32.5
3,All Students,2019-20,12615,761,11854,94.0,113,17,15.0
3,All Students,2020-21,18255,2366,15889,87.0,106,52,49.1
3,All Students,2021-22,16458,2123,14335,87.1,99,49,49.5
3,All Students,2022-23,16419,2163,14256,86.8,98,52,53.1
4,All Students,2018-19,25514,2334,23180,90.9,153,51,33.3
4,All Students,2019-20,12789,820,11969,93.6,122,28,23.0
4,All Students,2020-21,18993,2028,16965,89.3,113,39,34.5
4,All Students,2021-22,15674,1938,13736,87.6,96,47,49.0
4,All Students,2022-23,16490,1969,14521,88.1,102,49,48.0
5,All Students,2018-19,23318,2011,21307,91.4,137,42,30.7
5,All Students,2019-20,16049,1136,14913,92.9,145,38,26.2
5,All Students,2020-21,19316,1772,17544,90.8,111,41,36.9
5,All Students,2021-22,18531,2020,16511,89.1,114,54,47.4
5,All Students,2022-23,16537,1698,14839,89.7,97,40,41.2
6,All Students,2018-19,175,s,s,s,s,s,s
6,All Students,2022-23,12,s,s,s,s,s,s
All Grades,All Students,2018-19,49288,4329,44959,91.2,298,104,34.9
All Grades,All Students,2019-20,31265,2136,29129,93.2,290,66,22.8
All Grades,All Students,2020-21,46899,3806,43093,91.9,275,72,26.2
All Grades,All Students,2021-22,41686,4827,36859,88.4,258,135,52.3
All Grades,All Students,2022-23,39322,3981,35341,89.9,240,96,40.0
6,All Students,2018-19,16741,1308,15433,92.2,99,30,30.3
6,All Students,2019-20,11005,913,10092,91.7,101,33,32.7
6,All Students,2020-21,15113,1505,13608,90.0,88,35,39.8
6,All Students,2021-22,13087,1607,11480,87.7,81,46,56.8
6,All Students,2022-23,12160,1090,11070,91.0,73,24,32.9
7,All Students,2018-19,15824,1428,14396,91.0,96,35,36.5
7,All Students,2019-20,10472,570,9902,94.6,100,18,18.0
7,All Students,2020-21,16102,1280,14822,92.1,95,20,21.1
7,All Students,2021-22,13397,1629,11768,87.8,84,45,53.6
7,All Students,2022-23,13183,1517,11666,88.5,80,34,42.5
8,All Students,2018-19,16723,1593,15130,90.5,103,39,37.9
8,All Students,2019-20,9786,s,s,s,s,s,s
8,All Students,2020-21,15684,1021,14663,93.5,92,17,18.5
8,All Students,2021-22,15202,1591,13611,89.5,93,44,47.3
8,All Students,2022-23,13979,1374,12605,90.2,87,38,43.7
9,All Students,2019-20,2,s,s,s,s,s,s
All Grades,All Students,2018-19,158105,13562,144543,91.4,956,302,31.6
All Grades,All Students,2019-20,99500,6955,92545,93.0,899,213,23.7
All Grades,All Students,2020-21,137454,16065,121389,88.3,828,358,43.2
All Grades,All Students,2021-22,142405,14339,128066,89.9,849,319,37.6
All Grades,All Students,2022-23,132525,11411,121114,91.4,809,246,30.4
PK in K-12 Schools,All Students,2018-19,6365,769,5596,87.9,36,16,44.4
PK in K-12 Schools,All Students,2019-20,4090,346,3744,91.5,37,12,32.4
PK in K-12 Schools,All Students,2020-21,6058,1047,5011,82.7,37,25,67.6
PK in K-12 Schools,All Students,2021-22,8973,836,8137,90.7,54,18,33.3
PK in K-12 Schools,All Students,2022-23,8949,943,8006,89.5,54,23,42.6
0K,All Students,2018-19,21707,2215,19492,89.8,132,50,37.9
0K,All Students,2019-20,14489,1205,13284,91.7,133,40,30.1
0K,All Students,2020-21,18089,2489,15600,86.2,115,60,52.2
0K,All Students,2021-22,22989,2160,20829,90.6,140,52,37.1
0K,All Students,2022-23,17530,1605,15925,90.8,108,35,32.4
1,All Students,2018-19,22993,2120,20873,90.8,145,54,37.2
1,All Students,2019-20,13624,992,12632,92.7,124,31,25.0
1,All Students,2020-21,21278,2744,18534,87.1,130,55,42.3
1,All Students,2021-22,22063,2436,19627,89.0,132,51,38.6
1,All Students,2022-23,21531,1979,19552,90.8,134,41,30.6
2,All Students,2018-19,29272,2685,26587,90.8,178,58,32.6
2,All Students,2019-20,15249,1112,14137,92.7,139,34,24.5
2,All Students,2020-21,19315,2111,17204,89.1,117,46,39.3
2,All Students,2021-22,22210,2511,19699,88.7,133,59,44.4
2,All Students,2022-23,21940,1927,20013,91.2,135,40,29.6
3,All Students,2018-19,27872,2255,25617,91.9,168,49,29.2
3,All Students,2019-20,18091,1194,16897,93.4,165,38,23.0
3,All Students,2020-21,20984,2196,18788,89.5,126,45,35.7
3,All Students,2021-22,20507,2122,18385,89.7,122,44,36.1
3,All Students,2022-23,22534,1903,20631,91.6,136,46,33.8
4,All Students,2018-19,24660,1844,22816,92.5,148,37,25.0
4,All Students,2019-20,18344,1219,17125,93.4,161,36,22.4
4,All Students,2020-21,25646,2977,22669,88.4,152,68,44.7
4,All Students,2021-22,21475,2232,19243,89.6,129,51,39.5
4,All Students,2022-23,19662,1580,18082,92.0,119,29,24.4
5,All Students,2018-19,25236,1674,23562,93.4,149,38,25.5
5,All Students,2019-20,15613,887,14726,94.3,140,22,15.7
5,All Students,2020-21,26084,2501,23583,90.4,151,59,39.1
5,All Students,2021-22,24188,2042,22146,91.6,139,44,31.7
5,All Students,2022-23,20379,1474,18905,92.8,123,32,26.0
All Grades,All Students,2018-19,155884,10965,144919,93.0,937,258,27.5
All Grades,All Students,2019-20,93943,6349,87594,93.2,876,215,24.5
All Grades,All Students,2020-21,130480,10559,119921,91.9,773,202,26.1
All Grades,All Students,2021-22,128243,12948,115295,89.9,770,303,39.4
All Grades,All Students,2022-23,122091,11046,111045,91.0,758,264,34.8
PK in K-12 Schools,All Students,2018-19,6104,366,5738,94.0,36,7,19.4
PK in K-12 Schools,All Students,2019-20,6061,520,5541,91.4,58,19,32.8
PK in K-12 Schools,All Students,2020-21,8191,384,7807,95.3,49,6,12.2
PK in K-12 Schools,All Students,2021-22,12151,1329,10822,89.1,75,27,36.0
PK in K-12 Schools,All Students,2022-23,12108,1152,10956,90.5,72,26,36.1
0K,All Students,2018-19,21402,1936,19466,91.0,127,51,40.2
0K,All Students,2019-20,12160,1117,11043,90.8,112,41,36.6
0K,All Students,2020-21,17733,2489,15244,86.0,106,43,40.6
0K,All Students,2021-22,18534,2362,16172,87.3,112,62,55.4
0K,All Students,2022-23,16175,1775,14400,89.0,103,47,45.6
1,All Students,2018-19,22831,1612,21219,92.9,141,41,29.1
1,All Students,2019-20,12600,1004,11596,92.0,119,38,31.9
1,All Students,2020-21,18650,1534,17116,91.8,110,31,28.2
1,All Students,2021-22,17085,1985,15100,88.4,102,44,43.1
1,All Students,2022-23,18159,1938,16221,89.3,118,51,43.2
2,All Students,2018-19,23334,1488,21846,93.6,137,33,24.1
2,All Students,2019-20,14603,921,13682,93.7,134,27,20.1
2,All Students,2020-21,19358,1935,17423,90.0,116,44,37.9
2,All Students,2021-22,18823,1863,16960,90.1,117,52,44.4
2,All Students,2022-23,17858,1722,16136,90.4,109,41,37.6
3,All Students,2018-19,27466,1956,25510,92.9,170,45,26.5
3,All Students,2019-20,14173,853,13320,94.0,132,25,18.9
3,All Students,2020-21,21708,1390,20318,93.6,128,25,19.5
3,All Students,2021-22,20418,1987,18431,90.3,121,49,40.5
3,All Students,2022-23,19193,1502,17691,92.2,118,35,29.7
4,All Students,2018-19,28084,1822,26262,93.5,170,43,25.3
4,All Students,2019-20,16804,1020,15784,93.9,157,33,21.0
4,All Students,2020-21,21973,1442,20531,93.4,128,24,18.8
4,All Students,2021-22,19871,1908,17963,90.4,119,44,37.0
4,All Students,2022-23,19652,1522,18130,92.3,121,29,24.0
5,All Students,2018-19,26663,1785,24878,93.3,156,38,24.4
5,All Students,2019-20,17542,914,16628,94.8,164,32,19.5
5,All Students,2020-21,22867,1385,21482,93.9,136,29,21.3
5,All Students,2021-22,21361,1514,19847,92.9,124,25,20.2
5,All Students,2022-23,18946,1435,17511,92.4,117,35,29.9
All Grades,All Students,2018-19,101558,5020,96538,95.1,601,82,13.6
All Grades,All Students,2019-20,58006,2871,55135,95.1,536,82,15.3
All Grades,All Students,2020-21,79360,6316,73044,92.0,466,109,23.4
All Grades,All Students,2021-22,72203,8625,63578,88.1,427,188,44.0
All Grades,All Students,2022-23,35616,3225,32391,90.9,211,81,38.4
PK in K-12 Schools,All Students,2018-19,4431,349,4082,92.1,26,7,26.9
PK in K-12 Schools,All Students,2019-20,2519,243,2276,90.4,24,7,29.2
PK in K-12 Schools,All Students,2020-21,1498,s,s,s,s,s,s
PK in K-12 Schools,All Students,2021-22,4424,695,3729,84.3,27,14,51.9
PK in K-12 Schools,All Students,2022-23,5138,669,4469,87.0,31,16,51.6
0K,All Students,2018-19,7811,621,7190,92.0,44,15,34.1
0K,All Students,2019-20,5316,361,4955,93.2,52,16,30.8
0K,All Students,2020-21,6012,1100,4912,81.7,38,21,55.3
0K,All Students,2021-22,5495,866,4629,84.2,33,20,60.6
0K,All Students,2022-23,3892,501,3391,87.1,24,13,54.2
1,All Students,2018-19,7933,485,7448,93.9,50,11,22.0
1,All Students,2019-20,4551,267,4284,94.1,44,11,25.0
1,All Students,2020-21,7700,503,7197,93.5,44,6,13.6
1,All Students,2021-22,5105,706,4399,86.2,31,18,58.1
1,All Students,2022-23,5401,444,4957,91.8,32,12,37.5
2,All Students,2018-19,11189,614,10575,94.5,64,10,15.6
2,All Students,2019-20,4723,282,4441,94.0,42,11,26.2
2,All Students,2020-21,6653,632,6021,90.5,39,9,23.1
2,All Students,2021-22,5993,703,5290,88.3,36,12,33.3
2,All Students,2022-23,4419,354,4065,92.0,26,7,26.9
3,All Students,2018-19,10027,487,9540,95.1,58,5,8.6
3,All Students,2019-20,6316,212,6104,96.6,58,5,8.6
3,All Students,2020-21,6276,535,5741,91.5,38,12,31.6
3,All Students,2021-22,4841,637,4204,86.8,28,17,60.7
3,All Students,2022-23,6357,507,5850,92.0,38,14,36.8
4,All Students,2018-19,11422,447,10975,96.1,66,7,10.6
4,All Students,2019-20,5787,260,5527,95.5,53,5,9.4
4,All Students,2020-21,8148,371,7777,95.4,47,6,12.8
4,All Students,2021-22,6989,811,6178,88.4,41,15,36.6
4,All Students,2022-23,4345,332,4013,92.4,25,11,44.0
5,All Students,2018-19,11512,531,10981,95.4,71,7,9.9
5,All Students,2019-20,6719,271,6448,96.0,60,6,10.0
5,All Students,2020-21,8032,425,7607,94.7,47,7,14.9
5,All Students,2021-22,7583,821,6762,89.2,44,22,50.0
5,All Students,2022-23,6064,418,5646,93.1,35,8,22.9
6,All Students,2018-19,11072,369,10703,96.7,65,5,7.7
6,All Students,2019-20,8710,439,8271,95.0,81,9,11.1
6,All Students,2020-21,11739,1626,10113,86.1,68,33,48.5
6,All Students,2021-22,9759,1047,8712,89.3,57,22,38.6
7,All Students,2018-19,10479,406,10073,96.1,62,5,8.1
7,All Students,2019-20,7061,222,6839,96.9,66,4,6.1
7,All Students,2020-21,12811,574,12237,95.5,74,7,9.5
7,All Students,2021-22,10945,1159,9786,89.4,66,24,36.4
8,All Students,2018-19,15682,711,14971,95.5,95,10,10.5
8,All Students,2019-20,6304,314,5990,95.0,56,8,14.3
8,All Students,2020-21,10477,397,10080,96.2,60,3,5.0
8,All Students,2021-22,11069,1180,9889,89.3,64,24,37.5
9,All Students,2020-21,14,s,s,s,s,s,s
All Grades,All Students,2018-19,33219,3242,29977,90.2,210,78,37.1
All Grades,All Students,2019-20,18030,1651,16379,90.8,171,59,34.5
PK in K-12 Schools,All Students,2018-19,4836,779,4057,83.9,33,19,57.6
PK in K-12 Schools,All Students,2019-20,1655,130,1525,92.1,17,1,5.9
0K,All Students,2018-19,4421,500,3921,88.7,30,14,46.7
0K,All Students,2019-20,3464,456,3008,86.8,34,18,52.9
1,All Students,2018-19,4103,337,3766,91.8,25,6,24.0
1,All Students,2019-20,2175,184,1991,91.5,21,8,38.1
2,All Students,2018-19,4671,349,4322,92.5,30,10,33.3
2,All Students,2019-20,2349,169,2180,92.8,23,5,21.7
3,All Students,2018-19,4529,317,4212,93.0,26,8,30.8
3,All Students,2019-20,2513,246,2267,90.2,24,10,41.7
4,All Students,2018-19,5276,436,4840,91.7,33,9,27.3
4,All Students,2019-20,3039,201,2838,93.4,27,8,29.6
5,All Students,2018-19,5383,524,4859,90.3,33,12,36.4
5,All Students,2019-20,2835,265,2570,90.7,25,9,36.0
All Grades,All Students,2018-19,197910,20613,177297,89.6,1206,479,39.7
All Grades,All Students,2019-20,125807,11092,114715,91.2,1168,362,31.0
All Grades,All Students,2020-21,174408,12591,161817,92.8,1035,279,27.0
All Grades,All Students,2021-22,165036,22309,142727,86.5,1002,565,56.4
All Grades,All Students,2022-23,151487,20993,130494,86.1,918,505,55.0
PK in K-12 Schools,All Students,2018-19,8671,1123,7548,87.0,57,31,54.4
PK in K-12 Schools,All Students,2019-20,5749,563,5186,90.2,58,28,48.3
PK in K-12 Schools,All Students,2020-21,6924,s,s,s,s,s,s
PK in K-12 Schools,All Students,2021-22,7158,1121,6037,84.3,45,27,60.0
PK in K-12 Schools,All Students,2022-23,7673,1244,6429,83.8,47,27,57.4
0K,All Students,2018-19,15210,1761,13449,88.4,91,37,40.7
0K,All Students,2019-20,6837,566,6271,91.7,68,22,32.4
0K,All Students,2020-21,10989,402,10587,96.3,68,3,4.4
0K,All Students,2021-22,12348,1766,10582,85.7,75,48,64.0
0K,All Students,2022-23,10346,1586,8760,84.7,63,38,60.3
1,All Students,2018-19,12680,1410,11270,88.9,77,32,41.6
1,All Students,2019-20,9729,998,8731,89.7,93,34,36.6
1,All Students,2020-21,9496,505,8991,94.7,57,12,21.1
1,All Students,2021-22,10252,1323,8929,87.1,61,32,52.5
1,All Students,2022-23,12574,1645,10929,86.9,76,39,51.3
2,All Students,2018-19,16666,1631,15035,90.2,100,37,37.0
2,All Students,2019-20,10144,836,9308,91.8,92,29,31.5
2,All Students,2020-21,13193,798,12395,94.0,77,17,22.1
2,All Students,2021-22,8778,1223,7555,86.1,55,29,52.7
2,All Students,2022-23,9306,1128,8178,87.9,56,29,51.8
3,All Students,2018-19,20082,1569,18513,92.2,122,37,30.3
3,All Students,2019-20,13817,1092,12725,92.1,127,34,26.8
3,All Students,2020-21,16971,980,15991,94.2,100,19,19.0
3,All Students,2021-22,16070,1970,14100,87.7,94,46,48.9
3,All Students,2022-23,9600,1230,8370,87.2,59,29,49.2
4,All Students,2018-19,20361,1724,18637,91.5,119,40,33.6
4,All Students,2019-20,12952,871,12081,93.3,119,26,21.8
4,All Students,2020-21,20267,1475,18792,92.7,119,34,28.6
4,All Students,2021-22,14581,1982,12599,86.4,87,50,57.5
4,All Students,2022-23,15993,1925,14068,88.0,96,40,41.7
5,All Students,2018-19,18319,1331,16988,92.7,112,32,28.6
5,All Students,2019-20,13674,1063,12611,92.2,123,36,29.3
5,All Students,2020-21,19557,1238,18319,93.7,115,23,20.0
5,All Students,2021-22,19651,2625,17026,86.6,117,68,58.1
5,All Students,2022-23,14083,1539,12544,89.1,85,40,47.1
6,All Students,2018-19,26933,2688,24245,90.0,165,64,38.8
6,All Students,2019-20,17465,1326,16139,92.4,163,38,23.3
6,All Students,2020-21,26338,2614,23724,90.1,157,65,41.4
6,All Students,2021-22,24781,3394,21387,86.3,151,87,57.6
6,All Students,2022-23,22164,3078,19086,86.1,138,80,58.0
7,All Students,2018-19,27549,3340,24209,87.9,170,76,44.7
7,All Students,2019-20,17748,1700,16048,90.4,163,55,33.7
7,All Students,2020-21,24855,2354,22501,90.5,148,54,36.5
7,All Students,2021-22,26060,3920,22140,85.0,163,102,62.6
7,All Students,2022-23,24585,3660,20925,85.1,149,93,62.4
8,All Students,2018-19,31439,4036,27403,87.2,193,93,48.2
8,All Students,2019-20,17692,2077,15615,88.3,162,60,37.0
8,All Students,2020-21,25806,2011,23795,92.2,150,47,31.3
8,All Students,2021-22,25357,2985,22372,88.2,154,76,49.4
8,All Students,2022-23,25163,3958,21205,84.3,149,90,60.4
9,All Students,2020-21,12,s,s,s,s,s,s
All Grades,All Students,2018-19,60689,5894,54795,90.3,372,138,37.1
All Grades,All Students,2019-20,38856,3127,35729,92.0,359,98,27.3
All Grades,All Students,2020-21,53300,3428,49872,93.6,321,63,19.6
All Grades,All Students,2021-22,46182,6033,40149,86.9,289,159,55.0
All Grades,All Students,2022-23,35165,4851,30314,86.2,221,127,57.5
6,All Students,2018-19,26007,2336,23671,91.0,155,54,34.8
6,All Students,2019-20,12394,914,11480,92.6,115,29,25.2
6,All Students,2020-21,13572,957,12615,92.9,84,20,23.8
6,All Students,2021-22,14974,2022,12952,86.5,97,54,55.7
6,All Students,2022-23,7549,841,6708,88.9,45,24,53.3
7,All Students,2018-19,18059,1715,16344,90.5,112,48,42.9
7,All Students,2019-20,15159,1194,13965,92.1,141,37,26.2
7,All Students,2020-21,17329,880,16449,94.9,104,15,14.4
7,All Students,2021-22,13257,s,s,s,s,s,s
7,All Students,2022-23,14387,2120,12267,85.3,92,56,60.9
8,All Students,2018-19,16623,1843,14780,88.9,105,36,34.3
8,All Students,2019-20,11303,1019,10284,91.0,103,32,31.1
8,All Students,2020-21,22389,1591,20798,92.9,132,28,21.2
8,All Students,2021-22,17944,2429,15515,86.5,111,61,55.0
8,All Students,2022-23,13229,1890,11339,85.7,84,47,56.0
10,All Students,2021-22,7,s,s,s,s,s,s
All Grades,All Students,2018-19,114506,10255,104251,91.0,684,209,30.6
All Grades,All Students,2019-20,73774,5547,68227,92.5,672,157,23.4
All Grades,All Students,2020-21,117594,11801,105793,90.0,679,210,30.9
All Grades,All Students,2021-22,115527,12085,103442,89.5,685,261,38.1
All Grades,All Students,2022-23,111325,10319,101006,90.7,672,238,35.4
6,All Students,2018-19,17662,853,16809,95.2,101,13,12.9
6,All Students,2019-20,11608,454,11154,96.1,103,10,9.7
6,All Students,2020-21,18409,1370,17039,92.6,107,28,26.2
6,All Students,2021-22,17768,1606,16162,91.0,103,43,41.7
6,All Students,2022-23,16236,1031,15205,93.6,93,22,23.7
7,All Students,2018-19,18495,1086,17409,94.1,106,19,17.9
7,All Students,2019-20,11126,581,10545,94.8,101,18,17.8
7,All Students,2020-21,16789,1081,15708,93.6,96,20,20.8
7,All Students,2021-22,17873,1745,16128,90.2,105,39,37.1
7,All Students,2022-23,17187,1459,15728,91.5,100,35,35.0
8,All Students,2018-19,17105,1440,15665,91.6,97,22,22.7
8,All Students,2019-20,11334,678,10656,94.0,100,17,17.0
8,All Students,2020-21,16547,1333,15214,91.9,96,23,24.0
8,All Students,2021-22,16583,1220,15363,92.6,95,23,24.2
8,All Students,2022-23,16806,1293,15513,92.3,99,28,28.3
9,All Students,2018-19,15555,1452,14103,90.7,96,27,28.1
9,All Students,2019-20,11979,934,11045,92.2,111,19,17.1
9,All Students,2020-21,20714,2514,18200,87.9,118,44,37.3
9,All Students,2021-22,17607,2049,15558,88.4,105,44,41.9
9,All Students,2022-23,14959,1197,13762,92.0,95,32,33.7
10,All Students,2018-19,16506,1669,14837,89.9,103,37,35.9
10,All Students,2019-20,9085,991,8094,89.1,85,29,34.1
10,All Students,2020-21,16378,1518,14860,90.7,96,26,27.1
10,All Students,2021-22,17464,1811,15653,89.6,107,36,33.6
10,All Students,2022-23,16406,1916,14490,88.3,100,47,47.0
11,All Students,2018-19,14116,1685,12431,88.1,87,39,44.8
11,All Students,2019-20,9225,703,8522,92.4,85,24,28.2
11,All Students,2020-21,14353,1543,12810,89.2,83,24,28.9
11,All Students,2021-22,14329,1512,12817,89.4,86,29,33.7
11,All Students,2022-23,16505,1974,14531,88.0,103,46,44.7
12,All Students,2018-19,15067,2070,12997,86.3,94,52,55.3
12,All Students,2019-20,9417,1206,8211,87.2,87,40,46.0
12,All Students,2020-21,14404,2442,11962,83.0,83,45,54.2
12,All Students,2021-22,13903,2142,11761,84.6,84,47,56.0
12,All Students,2022-23,13226,1449,11777,89.0,82,28,34.1
All Grades,All Students,2018-19,57278,12846,44432,77.6,400,252,63.0
All Grades,All Students,2019-20,28862,6178,22684,78.6,276,171,62.0
All Grades,All Students,2020-21,26507,3200,23307,87.9,172,59,34.3
All Grades,All Students,2021-22,24398,3401,20997,86.1,175,79,45.1
All Grades,All Students,2022-23,25165,4178,20987,83.4,185,96,51.9
9,All Students,2018-19,14539,4625,9914,68.2,107,75,70.1
9,All Students,2019-20,7318,2288,5030,68.7,71,46,64.8
9,All Students,2020-21,5318,960,4358,81.9,36,16,44.4
9,All Students,2021-22,7622,1072,6550,85.9,59,26,44.1
9,All Students,2022-23,6971,1551,5420,77.8,54,36,66.7
10,All Students,2018-19,14227,3304,10923,76.8,102,67,65.7
10,All Students,2019-20,6769,1439,5330,78.7,69,45,65.2
10,All Students,2020-21,7543,1081,6462,85.7,50,25,50.0
10,All Students,2021-22,5153,853,4300,83.4,42,23,54.8
10,All Students,2022-23,8209,1243,6966,84.9,64,34,53.1
11,All Students,2018-19,13128,2197,10931,83.3,91,55,60.4
11,All Students,2019-20,4934,766,4168,84.5,47,29,61.7
11,All Students,2020-21,4584,261,4323,94.3,27,4,14.8
11,All Students,2021-22,4574,513,4061,88.8,31,10,32.3
11,All Students,2022-23,3165,497,2668,84.3,24,14,58.3
12,All Students,2018-19,15384,2720,12664,82.3,100,55,55.0
12,All Students,2019-20,9841,1685,8156,82.9,89,51,57.3
12,All Students,2020-21,9062,898,8164,90.1,59,14,23.7
12,All Students,2021-22,7049,963,6086,86.3,43,20,46.5
12,All Students,2022-23,6820,887,5933,87.0,43,12,27.9
All Grades,All Students,2018-19,52444,9449,42995,82.0,370,209,56.5
All Grades,All Students,2019-20,34569,5788,28781,83.3,343,164,47.8
All Grades,All Students,2020-21,55462,7484,47978,86.5,346,142,41.0
All Grades,All Students,2021-22,53601,8898,44703,83.4,347,164,47.3
All Grades,All Students,2022-23,46126,5028,41098,89.1,314,90,28.7
9,All Students,2018-19,13178,1859,11319,85.9,100,49,49.0
9,All Students,2019-20,10718,1176,9542,89.0,109,40,36.7
9,All Students,2020-21,15038,1283,13755,91.5,93,24,25.8
9,All Students,2021-22,11971,1295,10676,89.2,79,31,39.2
9,All Students,2022-23,9524,738,8786,92.3,71,14,19.7
10,All Students,2018-19,10844,1731,9113,84.0,76,38,50.0
10,All Students,2019-20,9530,1580,7950,83.4,94,47,50.0
10,All Students,2020-21,17729,2673,15056,84.9,111,55,49.5
10,All Students,2021-22,14719,2567,12152,82.6,97,44,45.4
10,All Students,2022-23,11005,1158,9847,89.5,76,26,34.2
11,All Students,2018-19,14739,3161,11578,78.6,95,57,60.0
11,All Students,2019-20,6329,1198,5131,81.1,61,29,47.5
11,All Students,2020-21,13561,1892,11669,86.0,80,30,37.5
11,All Students,2021-22,14719,2965,11754,79.9,92,48,52.2
11,All Students,2022-23,12978,1846,11132,85.8,88,34,38.6
12,All Students,2018-19,13683,2698,10985,80.3,99,65,65.7
12,All Students,2019-20,7992,1834,6158,77.1,79,48,60.8
12,All Students,2020-21,9134,1636,7498,82.1,62,33,53.2
12,All Students,2021-22,12192,2071,10121,83.0,79,41,51.9
12,All Students,2022-23,12619,1286,11333,89.8,79,16,20.3
All Grades,All Students,2018-19,99078,9861,89217,90.0,586,176,30.0
All Grades,All Students,2019-20,59012,4954,54058,91.6,530,136,25.7
All Grades,All Students,2020-21,95794,9655,86139,89.9,552,201,36.4
All Grades,All Students,2021-22,89089,10844,78245,87.8,524,241,46.0
All Grades,All Students,2022-23,83703,10450,73253,87.5,509,250,49.1
6,All Students,2018-19,13374,1014,12360,92.4,77,17,22.1
6,All Students,2019-20,8081,496,7585,93.9,74,15,20.3
6,All Students,2020-21,17215,1872,15343,89.1,101,41,40.6
6,All Students,2021-22,10666,1139,9527,89.3,63,25,39.7
6,All Students,2022-23,9308,1093,8215,88.3,54,27,50.0
7,All Students,2018-19,14277,1097,13180,92.3,83,22,26.5
7,All Students,2019-20,8509,545,7964,93.6,75,22,29.3
7,All Students,2020-21,11197,1124,10073,90.0,64,25,39.1
7,All Students,2021-22,15238,1796,13442,88.2,88,39,44.3
7,All Students,2022-23,9992,957,9035,90.4,61,21,34.4
8,All Students,2018-19,14806,1529,13277,89.7,87,33,37.9
8,All Students,2019-20,8204,509,7695,93.8,73,12,16.4
8,All Students,2020-21,12553,995,11558,92.1,72,23,31.9
8,All Students,2021-22,9918,1102,8816,88.9,57,26,45.6
8,All Students,2022-23,13420,1573,11847,88.3,82,40,48.8
9,All Students,2018-19,14133,1339,12794,90.5,85,19,22.4
9,All Students,2019-20,8314,687,7627,91.7,76,17,22.4
9,All Students,2020-21,16465,1475,14990,91.0,94,30,31.9
9,All Students,2021-22,15059,1739,13320,88.5,88,34,38.6
9,All Students,2022-23,13416,1581,11835,88.2,83,38,45.8
10,All Students,2018-19,12621,970,11651,92.3,76,16,21.1
10,All Students,2019-20,8858,783,8075,91.2,79,18,22.8
10,All Students,2020-21,12461,1455,11006,88.3,71,31,43.7
10,All Students,2021-22,14296,1646,12650,88.5,87,43,49.4
10,All Students,2022-23,13882,1666,12216,88.0,86,44,51.2
11,All Students,2018-19,14936,1525,13411,89.8,90,22,24.4
11,All Students,2019-20,7933,788,7145,90.1,72,20,27.8
11,All Students,2020-21,13236,1371,11865,89.6,75,26,34.7
11,All Students,2021-22,11366,1549,9817,86.4,67,33,49.3
11,All Students,2022-23,12828,1685,11143,86.9,77,36,46.8
12,All Students,2018-19,14931,2387,12544,84.0,88,47,53.4
12,All Students,2019-20,9113,1146,7967,87.4,81,32,39.5
12,All Students,2020-21,12667,1363,11304,89.2,75,25,33.3
12,All Students,2021-22,12546,1873,10673,85.1,74,41,55.4
12,All Students,2022-23,10857,1895,8962,82.5,66,44,66.7
All Grades,All Students,2018-19,114026,15641,98385,86.3,722,309,42.8
All Grades,All Students,2019-20,72669,8274,64395,88.6,692,261,37.7
All Grades,All Students,2020-21,115320,13926,101394,87.9,676,258,38.2
All Grades,All Students,2021-22,96030,17300,78730,82.0,586,359,61.3
All Grades,All Students,2022-23,101198,14823,86375,85.4,651,322,49.5
6,All Students,2018-19,15554,1120,14434,92.8,93,18,19.4
6,All Students,2019-20,9864,664,9200,93.3,92,20,21.7
6,All Students,2020-21,13300,1120,12180,91.6,78,24,30.8
6,All Students,2021-22,9113,1286,7827,85.9,55,28,50.9
6,All Students,2022-23,12463,1299,11164,89.6,77,31,40.3
7,All Students,2018-19,16669,2012,14657,87.9,103,49,47.6
7,All Students,2019-20,10297,946,9351,90.8,95,30,31.6
7,All Students,2020-21,14920,1179,13741,92.1,86,25,29.1
7,All Students,2021-22,11650,2065,9585,82.3,71,46,64.8
7,All Students,2022-23,10976,1601,9375,85.4,69,35,50.7
8,All Students,2018-19,17203,1731,15472,89.9,106,36,34.0
8,All Students,2019-20,10865,889,9976,91.8,104,36,34.6
8,All Students,2020-21,16004,1314,14690,91.8,92,22,23.9
8,All Students,2021-22,13449,1854,11595,86.2,83,45,54.2
8,All Students,2022-23,12745,1892,10853,85.2,82,41,50.0
9,All Students,2018-19,16152,3053,13099,81.1,113,62,54.9
9,All Students,2019-20,12453,1755,10698,85.9,117,53,45.3
9,All Students,2020-21,21931,2700,19231,87.7,126,45,35.7
9,All Students,2021-22,15513,2934,12579,81.1,95,59,62.1
9,All Students,2022-23,20846,2886,17960,86.2,138,57,41.3
10,All Students,2018-19,17731,2702,15029,84.8,115,46,40.0
10,All Students,2019-20,10051,1412,8639,86.0,104,46,44.2
10,All Students,2020-21,17818,2321,15497,87.0,110,48,43.6
10,All Students,2021-22,18133,3765,14368,79.2,112,74,66.1
10,All Students,2022-23,14888,2353,12535,84.2,96,53,55.2
11,All Students,2018-19,14060,2114,11946,85.0,90,45,50.0
11,All Students,2019-20,10070,1008,9062,90.0,97,37,38.1
11,All Students,2020-21,15170,2612,12558,82.8,90,45,50.0
11,All Students,2021-22,14313,2454,11859,82.9,86,48,55.8
11,All Students,2022-23,16743,3238,13505,80.7,109,70,64.2
12,All Students,2018-19,16657,2909,13748,82.5,102,53,52.0
12,All Students,2019-20,9069,1600,7469,82.4,83,39,47.0
12,All Students,2020-21,16177,2680,13497,83.4,94,49,52.1
12,All Students,2021-22,13859,2942,10917,78.8,84,59,70.2
12,All Students,2022-23,12537,1554,10983,87.6,80,35,43.8
All Grades,All Students,2018-19,38298,4125,34173,89.2,225,98,43.6
All Grades,All Students,2019-20,21119,1656,19463,92.2,197,54,27.4
All Grades,All Students,2020-21,35705,3033,32672,91.5,205,59,28.8
All Grades,All Students,2021-22,40913,4276,36637,89.5,245,104,42.4
All Grades,All Students,2022-23,41276,4850,36426,88.2,255,107,42.0
6,All Students,2018-19,10817,s,s,s,s,s,s
6,All Students,2019-20,6443,s,s,s,s,s,s
6,All Students,2020-21,15657,1385,14272,91.2,90,25,27.8
6,All Students,2021-22,14626,1566,13060,89.3,89,38,42.7
6,All Students,2022-23,12251,1275,10976,89.6,78,29,37.2
7,All Students,2018-19,11969,1192,10777,90.0,70,29,41.4
7,All Students,2019-20,6914,584,6330,91.6,63,19,30.2
7,All Students,2020-21,9378,754,8624,92.0,54,14,25.9
7,All Students,2021-22,16405,1654,14751,89.9,98,39,39.8
7,All Students,2022-23,13332,1587,11745,88.1,78,37,47.4
8,All Students,2018-19,15508,1652,13856,89.3,91,40,44.0
8,All Students,2019-20,7710,512,7198,93.4,73,14,19.2
8,All Students,2020-21,10670,894,9776,91.6,61,20,32.8
8,All Students,2021-22,9882,1056,8826,89.3,58,27,46.6
8,All Students,2022-23,15693,1988,13705,87.3,99,41,41.4
9,All Students,2018-19,4,s,s,s,s,s,s
9,All Students,2019-20,52,s,s,s,s,s,s
All Grades,All Students,2018-19,49445,3886,45559,92.1,304,78,25.7
All Grades,All Students,2019-20,32547,2013,30534,93.8,292,54,18.5
All Grades,All Students,2020-21,48136,3810,44326,92.1,281,74,26.3
All Grades,All Students,2021-22,46698,5384,41314,88.5,294,137,46.6
All Grades,All Students,2022-23,44053,4988,39065,88.7,281,128,45.6
6,All Students,2018-19,16778,1097,15681,93.5,101,22,21.8
6,All Students,2019-20,10398,523,9875,95.0,95,16,16.8
6,All Students,2020-21,15575,1423,14152,90.9,93,30,32.3
6,All Students,2021-22,16106,1620,14486,89.9,103,43,41.7
6,All Students,2022-23,11284,1021,10263,91.0,77,31,40.3
7,All Students,2018-19,16569,1656,14913,90.0,103,32,31.1
7,All Students,2019-20,10666,548,10118,94.9,93,11,11.8
7,All Students,2020-21,16168,1283,14885,92.1,93,24,25.8
7,All Students,2021-22,15177,2029,13148,86.6,95,52,54.7
7,All Students,2022-23,15944,1765,14179,88.9,99,44,44.4
8,All Students,2018-19,16098,1133,14965,93.0,100,24,24.0
8,All Students,2019-20,11483,942,10541,91.8,104,27,26.0
8,All Students,2020-21,16393,1104,15289,93.3,95,20,21.1
8,All Students,2021-22,15415,1735,13680,88.7,96,42,43.8
8,All Students,2022-23,16825,2202,14623,86.9,105,53,50.5
All Grades,All Students,2018-19,107271,10235,97036,90.5,661,250,37.8
All Grades,All Students,2019-20,64218,5945,58273,90.7,595,219,36.8
All Grades,All Students,2020-21,89232,12880,76352,85.6,530,232,43.8
All Grades,All Students,2021-22,81495,11784,69711,85.5,505,285,56.4
All Grades,All Students,2022-23,82591,10376,72215,87.4,502,254,50.6
PK in K-12 Schools,All Students,2018-19,3070,230,2840,92.5,19,6,31.6
PK in K-12 Schools,All Students,2019-20,1960,171,1789,91.3,19,9,47.4
PK in K-12 Schools,All Students,2020-21,3096,407,2689,86.9,20,8,40.0
PK in K-12 Schools,All Students,2021-22,5761,709,5052,87.7,34,15,44.1
PK in K-12 Schools,All Students,2022-23,5638,703,4935,87.5,34,20,58.8
0K,All Students,2018-19,12756,1269,11487,90.1,80,31,38.8
0K,All Students,2019-20,8744,1060,7684,87.9,84,43,51.2
0K,All Students,2020-21,9811,1922,7889,80.4,58,37,63.8
0K,All Students,2021-22,8987,1230,7757,86.3,61,32,52.5
0K,All Students,2022-23,9468,1374,8094,85.5,60,39,65.0
1,All Students,2018-19,18324,1789,16535,90.2,113,44,38.9
1,All Students,2019-20,8106,731,7375,91.0,78,27,34.6
1,All Students,2020-21,14271,2603,11668,81.8,84,40,47.6
1,All Students,2021-22,10292,1402,8890,86.4,65,37,56.9
1,All Students,2022-23,10786,1517,9269,85.9,68,36,52.9
2,All Students,2018-19,16387,1792,14595,89.1,101,52,51.5
2,All Students,2019-20,12555,1212,11343,90.3,114,49,43.0
2,All Students,2020-21,12564,2202,10362,82.5,76,35,46.1
2,All Students,2021-22,13270,2190,11080,83.5,86,56,65.1
2,All Students,2022-23,11193,1341,9852,88.0,68,32,47.1
3,All Students,2018-19,18150,1800,16350,90.1,115,44,38.3
3,All Students,2019-20,9389,892,8497,90.5,85,30,35.3
3,All Students,2020-21,17890,2087,15803,88.3,104,38,36.5
3,All Students,2021-22,12504,1555,10949,87.6,74,34,45.9
3,All Students,2022-23,13947,1743,12204,87.5,83,43,51.8
4,All Students,2018-19,17719,1582,16137,91.1,108,34,31.5
4,All Students,2019-20,12089,1058,11031,91.2,110,37,33.6
4,All Students,2020-21,13814,1701,12113,87.7,83,35,42.2
4,All Students,2021-22,17047,2681,14366,84.3,102,59,57.8
4,All Students,2022-23,13238,1481,11757,88.8,79,36,45.6
5,All Students,2018-19,20865,1773,19092,91.5,125,39,31.2
5,All Students,2019-20,11375,821,10554,92.8,105,24,22.9
5,All Students,2020-21,17786,1958,15828,89.0,105,39,37.1
5,All Students,2021-22,13634,2017,11617,85.2,83,52,62.7
5,All Students,2022-23,18321,2217,16104,87.9,110,48,43.6
All Grades,All Students,2018-19,54158,4789,49369,91.2,329,113,34.3
All Grades,All Students,2019-20,31955,2582,29373,91.9,296,97,32.8
All Grades,All Students,2020-21,42112,4832,37280,88.5,251,105,41.8
All Grades,All Students,2021-22,39079,5114,33965,86.9,247,139,56.3
All Grades,All Students,2022-23,40833,4642,36191,88.6,251,116,46.2
PK in K-12 Schools,All Students,2018-19,5526,658,4868,88.1,36,18,50.0
PK in K-12 Schools,All Students,2019-20,4023,397,3626,90.1,37,17,45.9
PK in K-12 Schools,All Students,2020-21,3595,81,3514,97.7,22,2,9.1
PK in K-12 Schools,All Students,2021-22,6942,953,5989,86.3,48,29,60.4
PK in K-12 Schools,All Students,2022-23,7959,1126,6833,85.9,50,33,66.0
0K,All Students,2018-19,7576,799,6777,89.5,47,22,46.8
0K,All Students,2019-20,4400,373,4027,91.5,42,18,42.9
0K,All Students,2020-21,7740,972,6768,87.4,47,21,44.7
0K,All Students,2021-22,4076,638,3438,84.3,26,15,57.7
0K,All Students,2022-23,4469,664,3805,85.1,29,18,62.1
1,All Students,2018-19,7647,692,6955,91.0,47,17,36.2
1,All Students,2019-20,5422,541,4881,90.0,53,23,43.4
1,All Students,2020-21,6098,936,5162,84.7,36,20,55.6
1,All Students,2021-22,7750,976,6774,87.4,50,32,64.0
1,All Students,2022-23,4830,562,4268,88.4,32,16,50.0
2,All Students,2018-19,6611,495,6116,92.5,38,8,21.1
2,All Students,2019-20,3595,246,3349,93.2,32,9,28.1
2,All Students,2020-21,7333,994,6339,86.4,45,23,51.1
2,All Students,2021-22,5672,600,5072,89.4,35,15,42.9
2,All Students,2022-23,6321,719,5602,88.6,39,16,41.0
3,All Students,2018-19,7986,535,7451,93.3,49,8,16.3
3,All Students,2019-20,3999,272,3727,93.2,37,8,21.6
3,All Students,2020-21,5154,350,4804,93.2,30,5,16.7
3,All Students,2021-22,6314,1042,5272,83.5,39,26,66.7
3,All Students,2022-23,6882,470,6412,93.2,42,11,26.2
4,All Students,2018-19,8373,664,7709,92.1,51,18,35.3
4,All Students,2019-20,5332,368,4964,93.1,47,10,21.3
4,All Students,2020-21,4747,655,4092,86.2,28,15,53.6
4,All Students,2021-22,4340,511,3829,88.2,26,13,50.0
4,All Students,2022-23,6153,738,5415,88.0,35,16,45.7
5,All Students,2018-19,10439,946,9493,90.9,61,22,36.1
5,All Students,2019-20,5184,385,4799,92.6,48,12,25.0
5,All Students,2020-21,7445,844,6601,88.7,43,19,44.2
5,All Students,2021-22,3985,394,3591,90.1,23,9,39.1
5,All Students,2022-23,4219,363,3856,91.4,24,6,25.0
All Grades,All Students,2018-19,68328,5022,63306,92.7,396,105,26.5
All Grades,All Students,2019-20,41585,2627,38958,93.7,377,81,21.5
All Grades,All Students,2020-21,62661,7076,55585,88.7,364,125,34.3
All Grades,All Students,2021-22,55328,6293,49035,88.6,331,141,42.6
All Grades,All Students,2022-23,49584,4778,44806,90.4,297,115,38.7
6,All Students,2018-19,22559,1620,20939,92.8,135,34,25.2
6,All Students,2019-20,13628,975,12653,92.8,124,28,22.6
6,All Students,2020-21,22963,1973,20990,91.4,133,35,26.3
6,All Students,2021-22,17218,s,s,s,s,s,s
6,All Students,2022-23,14416,1262,13154,91.2,85,29,34.1
7,All Students,2018-19,22602,1527,21075,93.2,130,31,23.8
7,All Students,2019-20,13767,923,12844,93.3,126,33,26.2
7,All Students,2020-21,20044,3005,17039,85.0,116,52,44.8
7,All Students,2021-22,19324,1766,17558,90.9,118,39,33.1
7,All Students,2022-23,16686,1683,15003,89.9,102,44,43.1
8,All Students,2018-19,23167,1875,21292,91.9,131,40,30.5
8,All Students,2019-20,14190,729,13461,94.9,127,20,15.7
8,All Students,2020-21,19654,2098,17556,89.3,115,38,33.0
8,All Students,2021-22,18784,2539,16245,86.5,111,56,50.5
8,All Students,2022-23,18482,1833,16649,90.1,110,42,38.2
9,All Students,2021-22,2,s,s,s,s,s,s
All Grades,All Students,2018-19,44289,4400,39889,90.1,276,109,39.5
All Grades,All Students,2019-20,25510,2404,23106,90.6,236,87,36.9
All Grades,All Students,2020-21,32649,2388,30261,92.7,193,39,20.2
All Grades,All Students,2021-22,29462,3579,25883,87.9,181,89,49.2
All Grades,All Students,2022-23,53815,5684,48131,89.4,334,141,42.2
6,All Students,2018-19,14282,1579,12703,88.9,91,44,48.4
6,All Students,2019-20,8477,778,7699,90.8,76,29,38.2
6,All Students,2020-21,8104,s,s,s,s,s,s
6,All Students,2021-22,6928,883,6045,87.3,43,23,53.5
6,All Students,2022-23,18278,1915,16363,89.5,113,46,40.7
7,All Students,2018-19,13466,1222,12244,90.9,86,33,38.4
7,All Students,2019-20,8542,853,7689,90.0,80,31,38.8
7,All Students,2020-21,12380,953,11427,92.3,73,15,20.5
7,All Students,2021-22,9095,1108,7987,87.8,59,24,40.7
7,All Students,2022-23,15168,1700,13468,88.8,93,44,47.3
8,All Students,2018-19,16541,1599,14942,90.3,99,32,32.3
8,All Students,2019-20,8491,773,7718,90.9,80,27,33.8
8,All Students,2020-21,12148,622,11526,94.9,71,11,15.5
8,All Students,2021-22,13439,1588,11851,88.2,79,42,53.2
8,All Students,2022-23,20369,2069,18300,89.8,128,51,39.8
9,All Students,2020-21,17,s,s,s,s,s,s
All Grades,All Students,2018-19,70605,6432,64173,90.9,436,148,33.9
All Grades,All Students,2019-20,44461,3249,41212,92.7,411,93,22.6
All Grades,All Students,2020-21,54028,3324,50704,93.8,317,54,17.0
All Grades,All Students,2021-22,50895,6749,44146,86.7,329,163,49.5
All Grades,All Students,2022-23,42805,4765,38040,88.9,270,116,43.0
6,All Students,2018-19,15598,s,s,s,s,s,s
6,All Students,2019-20,14142,864,13278,93.9,135,28,20.7
6,All Students,2020-21,17163,1127,16036,93.4,102,21,20.6
6,All Students,2021-22,14260,1794,12466,87.4,92,46,50.0
6,All Students,2022-23,11058,s,s,s,s,s,s
7,All Students,2018-19,27602,2388,25214,91.3,167,53,31.7
7,All Students,2019-20,11031,s,s,s,s,s,s
7,All Students,2020-21,20449,1251,19198,93.9,119,20,16.8
7,All Students,2021-22,17082,2386,14696,86.0,113,54,47.8
7,All Students,2022-23,12653,1355,11298,89.3,81,39,48.1
8,All Students,2018-19,27373,2723,24650,90.1,167,59,35.3
8,All Students,2019-20,19286,1565,17721,91.9,173,40,23.1
8,All Students,2020-21,16416,946,15470,94.2,96,13,13.5
8,All Students,2021-22,19553,2569,16984,86.9,124,63,50.8
8,All Students,2022-23,18959,2369,16590,87.5,119,52,43.7
9,All Students,2018-19,32,s,s,s,s,s,s
9,All Students,2019-20,2,s,s,s,s,s,s
10,All Students,2022-23,135,s,s,s,s,s,s
All Grades,All Students,2018-19,57944,6414,51530,88.9,339,131,38.6
All Grades,All Students,2019-20,40012,2927,37085,92.7,361,85,23.5
All Grades,All Students,2020-21,65861,2809,63052,95.7,385,49,12.7
All Grades,All Students,2021-22,64755,7443,57312,88.5,391,187,47.8
All Grades,All Students,2022-23,66632,6374,60258,90.4,396,163,41.2
6,All Students,2018-19,22524,2072,20452,90.8,132,41,31.1
6,All Students,2019-20,13058,1067,11991,91.8,123,31,25.2
6,All Students,2020-21,21626,1015,20611,95.3,127,20,15.7
6,All Students,2021-22,22512,2517,19995,88.8,135,65,48.1
6,All Students,2022-23,21366,1786,19580,91.6,129,40,31.0
7,All Students,2018-19,16943,2065,14878,87.8,101,45,44.6
7,All Students,2019-20,15563,915,14648,94.1,138,28,20.3
7,All Students,2020-21,21119,1209,19910,94.3,123,21,17.1
7,All Students,2021-22,22262,2574,19688,88.4,134,65,48.5
7,All Students,2022-23,22089,2215,19874,90.0,131,59,45.0
8,All Students,2018-19,18477,2277,16200,87.7,106,45,42.5
8,All Students,2019-20,11391,945,10446,91.7,100,26,26.0
8,All Students,2020-21,23116,585,22531,97.5,135,8,5.9
8,All Students,2021-22,19981,2352,17629,88.2,122,57,46.7
8,All Students,2022-23,23177,2373,20804,89.8,136,64,47.1
All Grades,All Students,2018-19,75725,9579,66146,87.4,532,230,43.2
All Grades,All Students,2019-20,46046,5413,40633,88.2,452,182,40.3
All Grades,All Students,2020-21,63949,11119,52830,82.6,400,202,50.5
All Grades,All Students,2021-22,54327,8398,45929,84.5,380,196,51.6
All Grades,All Students,2022-23,51489,7026,44463,86.4,374,165,44.1
9,All Students,2018-19,24079,2126,21953,91.2,204,64,31.4
9,All Students,2019-20,14261,1414,12847,90.1,152,50,32.9
9,All Students,2020-21,16287,2315,13972,85.8,114,50,43.9
9,All Students,2021-22,18183,2004,16179,89.0,154,64,41.6
9,All Students,2022-23,23623,2823,20800,88.0,201,73,36.3
10,All Students,2018-19,16992,1617,15375,90.5,111,33,29.7
10,All Students,2019-20,11552,1010,10542,91.3,112,37,33.0
10,All Students,2020-21,14085,1583,12502,88.8,86,33,38.4
10,All Students,2021-22,6015,572,5443,90.5,38,13,34.2
10,All Students,2022-23,5284,395,4889,92.5,33,8,24.2
11,All Students,2018-19,19972,3238,16734,83.8,128,75,58.6
11,All Students,2019-20,9736,1267,8469,87.0,92,41,44.6
11,All Students,2020-21,19539,4076,15463,79.1,119,75,63.0
11,All Students,2021-22,13995,1965,12030,86.0,90,50,55.6
11,All Students,2022-23,10845,1491,9354,86.3,69,38,55.1
12,All Students,2018-19,14682,2598,12084,82.3,89,58,65.2
12,All Students,2019-20,10497,1722,8775,83.6,96,54,56.3
12,All Students,2020-21,14038,3145,10893,77.6,81,44,54.3
12,All Students,2021-22,16134,3857,12277,76.1,98,69,70.4
12,All Students,2022-23,11737,2317,9420,80.3,71,46,64.8
All Grades,All Students,2018-19,43524,2631,40893,94.0,257,27,10.5
All Grades,All Students,2019-20,32462,2110,30352,93.5,296,62,20.9
All Grades,All Students,2020-21,47702,2222,45480,95.3,280,28,10.0
All Grades,All Students,2021-22,44719,3738,40981,91.6,259,74,28.6
All Grades,All Students,2022-23,52679,4185,48494,92.1,308,80,26.0
PK in K-12 Schools,All Students,2018-19,5618,391,5227,93.0,34,5,14.7
PK in K-12 Schools,All Students,2019-20,3351,323,3028,90.4,32,11,34.4
PK in K-12 Schools,All Students,2020-21,4987,260,4727,94.8,31,5,16.1
PK in K-12 Schools,All Students,2021-22,6089,571,5518,90.6,35,12,34.3
PK in K-12 Schools,All Students,2022-23,5895,684,5211,88.4,34,16,47.1
0K,All Students,2018-19,7411,433,6978,94.2,43,6,14.0
0K,All Students,2019-20,5160,377,4783,92.7,46,13,28.3
0K,All Students,2020-21,7833,471,7362,94.0,46,6,13.0
0K,All Students,2021-22,7078,654,6424,90.8,41,14,34.1
0K,All Students,2022-23,12014,1068,10946,91.1,70,25,35.7
1,All Students,2018-19,7527,495,7032,93.4,43,6,14.0
1,All Students,2019-20,4794,325,4469,93.2,43,10,23.3
1,All Students,2020-21,6514,386,6128,94.1,38,7,18.4
1,All Students,2021-22,6142,506,5636,91.8,36,12,33.3
1,All Students,2022-23,7617,597,7020,92.2,46,15,32.6
2,All Students,2018-19,7726,463,7263,94.0,47,5,10.6
2,All Students,2019-20,5016,287,4729,94.3,47,6,12.8
2,All Students,2020-21,7412,242,7170,96.7,43,1,2.3
2,All Students,2021-22,6716,633,6083,90.6,38,13,34.2
2,All Students,2022-23,6922,482,6440,93.0,40,5,12.5
3,All Students,2018-19,7919,470,7449,94.1,46,5,10.9
3,All Students,2019-20,4841,286,4555,94.1,44,7,15.9
3,All Students,2020-21,7421,316,7105,95.7,43,4,9.3
3,All Students,2021-22,5953,418,5535,93.0,34,8,23.5
3,All Students,2022-23,6458,529,5929,91.8,38,7,18.4
4,All Students,2018-19,7323,379,6944,94.8,44,0,0.0
4,All Students,2019-20,4843,299,4544,93.8,44,10,22.7
4,All Students,2020-21,6369,197,6172,96.9,37,1,2.7
4,All Students,2021-22,6981,567,6414,91.9,42,10,23.8
4,All Students,2022-23,6574,425,6149,93.5,38,7,18.4
5,All Students,2019-20,4457,213,4244,95.2,40,5,12.5
5,All Students,2020-21,7166,350,6816,95.1,42,4,9.5
5,All Students,2021-22,5760,389,5371,93.2,33,5,15.2
5,All Students,2022-23,7199,400,6799,94.4,42,5,11.9
All Grades,All Students,2018-19,53754,3809,49945,92.9,334,93,27.8
All Grades,All Students,2019-20,33606,2150,31456,93.6,314,67,21.3
All Grades,All Students,2020-21,68362,8963,59399,86.9,408,178,43.6
All Grades,All Students,2021-22,61683,8164,53519,86.8,383,223,58.2
All Grades,All Students,2022-23,58848,5559,53289,90.6,370,147,39.7
PK in K-12 Schools,All Students,2018-19,5950,557,5393,90.6,39,18,46.2
PK in K-12 Schools,All Students,2019-20,3057,299,2758,90.2,29,10,34.5
PK in K-12 Schools,All Students,2020-21,3863,498,3365,87.1,26,14,53.8
PK in K-12 Schools,All Students,2021-22,4744,656,4088,86.2,33,24,72.7
PK in K-12 Schools,All Students,2022-23,4670,564,4106,87.9,36,19,52.8
0K,All Students,2018-19,8051,651,7400,91.9,50,17,34.0
0K,All Students,2019-20,4556,241,4315,94.7,43,7,16.3
0K,All Students,2020-21,7152,1337,5815,81.3,43,26,60.5
0K,All Students,2021-22,8723,1160,7563,86.7,57,33,57.9
0K,All Students,2022-23,8560,1019,7541,88.1,55,26,47.3
1,All Students,2018-19,7815,588,7227,92.5,51,15,29.4
1,All Students,2019-20,4965,388,4577,92.2,50,15,30.0
1,All Students,2020-21,10960,1460,9500,86.7,66,30,45.5
1,All Students,2021-22,6686,911,5775,86.4,41,22,53.7
1,All Students,2022-23,8853,869,7984,90.2,54,26,48.1
2,All Students,2018-19,7019,522,6497,92.6,42,14,33.3
2,All Students,2019-20,4591,205,4386,95.5,42,4,9.5
2,All Students,2020-21,10872,1209,9663,88.9,65,22,33.8
2,All Students,2021-22,9255,1121,8134,87.9,58,29,50.0
2,All Students,2022-23,6780,655,6125,90.3,43,19,44.2
3,All Students,2018-19,7035,502,6533,92.9,45,13,28.9
3,All Students,2019-20,4590,360,4230,92.2,41,10,24.4
3,All Students,2020-21,11035,1231,9804,88.8,65,25,38.5
3,All Students,2021-22,11598,1538,10060,86.7,70,43,61.4
3,All Students,2022-23,8918,669,8249,92.5,55,16,29.1
4,All Students,2018-19,9396,601,8795,93.6,57,11,19.3
4,All Students,2019-20,5493,342,5151,93.8,53,12,22.6
4,All Students,2020-21,10446,1134,9312,89.1,62,22,35.5
4,All Students,2021-22,10681,1270,9411,88.1,64,33,51.6
4,All Students,2022-23,10420,925,9495,91.1,63,24,38.1
5,All Students,2018-19,8488,388,8100,95.4,50,5,10.0
5,All Students,2019-20,6354,315,6039,95.0,56,9,16.1
5,All Students,2020-21,14034,2094,11940,85.1,81,39,48.1
5,All Students,2021-22,9996,1508,8488,84.9,60,39,65.0
5,All Students,2022-23,10647,858,9789,91.9,64,17,26.6
All Grades,All Students,2018-19,52519,5705,46814,89.1,327,123,37.6
All Grades,All Students,2019-20,38184,3718,34466,90.3,360,117,32.5
All Grades,All Students,2020-21,62559,9258,53301,85.2,366,197,53.8
All Grades,All Students,2021-22,59378,7616,51762,87.2,375,179,47.7
All Grades,All Students,2022-23,58126,6399,51727,89.0,369,142,38.5
9,All Students,2018-19,15774,1133,14641,92.8,98,21,21.4
9,All Students,2019-20,13195,1039,12156,92.1,126,27,21.4
9,All Students,2020-21,14727,1744,12983,88.2,87,33,37.9
9,All Students,2021-22,13828,1739,12089,87.4,94,43,45.7
9,All Students,2022-23,13870,1519,12351,89.0,90,34,37.8
10,All Students,2018-19,13469,1442,12027,89.3,84,29,34.5
10,All Students,2019-20,8770,718,8052,91.8,82,24,29.3
10,All Students,2020-21,20611,3366,17245,83.7,121,71,58.7
10,All Students,2021-22,14618,1619,12999,88.9,92,40,43.5
10,All Students,2022-23,14405,1692,12713,88.3,91,36,39.6
11,All Students,2018-19,11944,1437,10507,88.0,75,31,41.3
11,All Students,2019-20,8976,873,8103,90.3,83,26,31.3
11,All Students,2020-21,13303,1989,11314,85.0,77,36,46.8
11,All Students,2021-22,18322,2253,16069,87.7,112,51,45.5
11,All Students,2022-23,14056,1525,12531,89.2,90,34,37.8
12,All Students,2018-19,11332,1693,9639,85.1,70,42,60.0
12,All Students,2019-20,7243,1088,6155,85.0,69,40,58.0
12,All Students,2020-21,13918,2159,11759,84.5,81,57,70.4
12,All Students,2021-22,12610,2005,10605,84.1,77,45,58.4
12,All Students,2022-23,15795,1663,14132,89.5,98,38,38.8
All Grades,All Students,2018-19,43447,8371,35076,80.7,273,152,55.7
All Grades,All Students,2019-20,30038,5980,24058,80.1,284,153,53.9
All Grades,All Students,2020-21,45566,8484,37082,81.4,277,137,49.5
All Grades,All Students,2021-22,44187,10112,34075,77.1,287,191,66.6
All Grades,All Students,2022-23,31221,5971,25250,80.9,212,119,56.1
8,All Students,2020-21,29,s,s,s,s,s,s
9,All Students,2018-19,15702,4067,11635,74.1,97,60,61.9
9,All Students,2019-20,9506,2121,7385,77.7,92,46,50.0
9,All Students,2020-21,9397,1544,7853,83.6,55,26,47.3
9,All Students,2021-22,10739,2193,8546,79.6,75,44,58.7
9,All Students,2022-23,8774,1710,7064,80.5,58,36,62.1
10,All Students,2018-19,9864,1680,8184,83.0,66,37,56.1
10,All Students,2019-20,10666,2371,8295,77.8,98,58,59.2
10,All Students,2020-21,14813,3421,11392,76.9,90,51,56.7
10,All Students,2021-22,11203,2866,8337,74.4,73,53,72.6
10,All Students,2022-23,9647,2050,7597,78.7,68,37,54.4
11,All Students,2018-19,8131,993,7138,87.8,52,24,46.2
11,All Students,2019-20,5694,783,4911,86.2,54,27,50.0
11,All Students,2020-21,12068,2133,9935,82.3,74,33,44.6
11,All Students,2021-22,12220,2612,9608,78.6,76,50,65.8
11,All Students,2022-23,6368,1206,5162,81.1,43,25,58.1
12,All Students,2018-19,9750,1631,8119,83.3,58,31,53.4
12,All Students,2019-20,4172,705,3467,83.1,40,22,55.0
12,All Students,2020-21,9259,s,s,s,s,s,s
12,All Students,2021-22,10025,2441,7584,75.7,63,44,69.8
12,All Students,2022-23,6432,1005,5427,84.4,43,21,48.8
All Grades,All Students,2018-19,67661,10174,57487,85.0,449,219,48.8
All Grades,All Students,2019-20,43404,6673,36731,84.6,422,195,46.2
All Grades,All Students,2020-21,65198,11747,53451,82.0,391,167,42.7
All Grades,All Students,2021-22,56426,11242,45184,80.1,370,220,59.5
All Grades,All Students,2022-23,49895,8336,41559,83.3,336,173,51.5
8,All Students,2021-22,21,s,s,s,s,s,s
9,All Students,2018-19,17493,3145,14348,82.0,123,67,54.5
9,All Students,2019-20,12542,2054,10488,83.6,129,62,48.1
9,All Students,2020-21,17663,4746,12917,73.1,104,57,54.8
9,All Students,2021-22,16767,3567,13200,78.7,103,58,56.3
9,All Students,2022-23,13193,2491,10702,81.1,88,50,56.8
10,All Students,2018-19,19287,2648,16639,86.3,128,52,40.6
10,All Students,2019-20,10491,1653,8838,84.2,105,51,48.6
10,All Students,2020-21,18912,3822,15090,79.8,116,57,49.1
10,All Students,2021-22,16152,3740,12412,76.8,114,72,63.2
10,All Students,2022-23,13128,2341,10787,82.2,92,45,48.9
11,All Students,2018-19,15707,2507,13200,84.0,100,55,55.0
11,All Students,2019-20,12378,1627,10751,86.9,112,35,31.3
11,All Students,2020-21,13132,1703,11429,87.0,78,32,41.0
11,All Students,2021-22,11978,1757,10221,85.3,78,42,53.8
11,All Students,2022-23,11147,1681,9466,84.9,77,36,46.8
12,All Students,2018-19,15174,1874,13300,87.6,98,45,45.9
12,All Students,2019-20,7993,1339,6654,83.2,76,47,61.8
12,All Students,2020-21,15491,1476,14015,90.5,93,21,22.6
12,All Students,2021-22,11508,s,s,s,s,s,s
12,All Students,2022-23,12427,1823,10604,85.3,79,42,53.2
All Grades,All Students,2018-19,68155,12356,55799,81.9,440,248,56.4
All Grades,All Students,2019-20,46987,8355,38632,82.2,448,253,56.5
All Grades,All Students,2020-21,77200,7786,69414,89.9,458,142,31.0
All Grades,All Students,2021-22,73264,9916,63348,86.5,462,164,35.5
All Grades,All Students,2022-23,63071,6528,56543,89.6,425,142,33.4
9,All Students,2018-19,21350,3200,18150,85.0,141,66,46.8
9,All Students,2019-20,13753,2159,11594,84.3,133,64,48.1
9,All Students,2020-21,19843,2047,17796,89.7,119,32,26.9
9,All Students,2021-22,18849,2625,16224,86.1,121,37,30.6
9,All Students,2022-23,16400,1612,14788,90.2,114,36,31.6
10,All Students,2018-19,18143,3835,14308,78.9,117,72,61.5
10,All Students,2019-20,13490,2123,11367,84.3,128,67,52.3
10,All Students,2020-21,19792,1764,18028,91.1,117,36,30.8
10,All Students,2021-22,17981,2474,15507,86.2,117,41,35.0
10,All Students,2022-23,16173,1921,14252,88.1,110,33,30.0
11,All Students,2018-19,13746,2166,11580,84.2,87,48,55.2
11,All Students,2019-20,12362,2691,9671,78.2,118,75,63.6
11,All Students,2020-21,21937,2444,19493,88.9,130,45,34.6
11,All Students,2021-22,17965,2242,15723,87.5,112,39,34.8
11,All Students,2022-23,14532,1368,13164,90.6,100,35,35.0
12,All Students,2018-19,14916,3155,11761,78.8,95,62,65.3
12,All Students,2019-20,7382,1382,6000,81.3,69,47,68.1
12,All Students,2020-21,15628,1531,14097,90.2,92,29,31.5
12,All Students,2021-22,18469,2575,15894,86.1,112,47,42.0
12,All Students,2022-23,15966,1627,14339,89.8,101,38,37.6
All Grades,All Students,2018-19,85928,8750,77178,89.8,524,202,38.5
All Grades,All Students,2019-20,49910,4431,45479,91.1,456,146,32.0
All Grades,All Students,2020-21,68630,5286,63344,92.3,403,112,27.8
All Grades,All Students,2021-22,61539,7465,54074,87.9,378,192,50.8
All Grades,All Students,2022-23,55908,5692,50216,89.8,344,153,44.5
PK in K-12 Schools,All Students,2018-19,3204,s,s,s,s,s,s
PK in K-12 Schools,All Students,2019-20,2022,131,1891,93.5,19,4,21.1
PK in K-12 Schools,All Students,2020-21,2974,87,2887,97.1,17,1,5.9
PK in K-12 Schools,All Students,2021-22,5741,791,4950,86.2,33,19,57.6
PK in K-12 Schools,All Students,2022-23,5540,683,4857,87.7,34,18,52.9
0K,All Students,2018-19,14402,1652,12750,88.5,90,45,50.0
0K,All Students,2019-20,6883,682,6201,90.1,61,24,39.3
0K,All Students,2020-21,10326,970,9356,90.6,63,19,30.2
0K,All Students,2021-22,9790,1366,8424,86.0,59,35,59.3
0K,All Students,2022-23,8977,954,8023,89.4,57,26,45.6
1,All Students,2018-19,13966,1712,12254,87.7,86,38,44.2
1,All Students,2019-20,7197,703,6494,90.2,68,26,38.2
1,All Students,2020-21,10168,684,9484,93.3,59,15,25.4
1,All Students,2021-22,9463,1140,8323,88.0,62,30,48.4
1,All Students,2022-23,7909,892,7017,88.7,52,24,46.2
2,All Students,2018-19,13748,1426,12322,89.6,82,34,41.5
2,All Students,2019-20,7956,749,7207,90.6,74,24,32.4
2,All Students,2020-21,10290,944,9346,90.8,60,21,35.0
2,All Students,2021-22,9531,1046,8485,89.0,62,29,46.8
2,All Students,2022-23,9408,878,8530,90.7,56,19,33.9
3,All Students,2018-19,13413,1367,12046,89.8,82,31,37.8
3,All Students,2019-20,8925,843,8082,90.6,82,24,29.3
3,All Students,2020-21,10450,1039,9411,90.1,61,22,36.1
3,All Students,2021-22,8871,1157,7714,87.0,55,31,56.4
3,All Students,2022-23,8152,695,7457,91.5,49,18,36.7
4,All Students,2018-19,12959,1292,11667,90.0,79,27,34.2
4,All Students,2019-20,8563,619,7944,92.8,78,19,24.4
4,All Students,2020-21,11612,780,10832,93.3,69,19,27.5
4,All Students,2021-22,9298,986,8312,89.4,55,25,45.5
4,All Students,2022-23,7780,833,6947,89.3,46,25,54.3
5,All Students,2018-19,14235,1111,13124,92.2,87,24,27.6
5,All Students,2019-20,8364,704,7660,91.6,74,25,33.8
5,All Students,2020-21,12810,782,12028,93.9,74,15,20.3
5,All Students,2021-22,8845,979,7866,88.9,52,23,44.2
5,All Students,2022-23,8142,757,7385,90.7,50,23,46.0
6,All Students,2018-19,1,s,s,s,s,s,s
All Grades,All Students,2018-19,74126,6555,67571,91.2,457,168,36.8
All Grades,All Students,2019-20,45382,2973,42409,93.4,426,96,22.5
All Grades,All Students,2020-21,61128,5252,55876,91.4,361,105,29.1
All Grades,All Students,2021-22,55281,5131,50150,90.7,343,120,35.0
All Grades,All Students,2022-23,48760,4103,44657,91.6,306,87,28.4
PK in K-12 Schools,All Students,2018-19,3034,347,2687,88.6,21,12,57.1
PK in K-12 Schools,All Students,2019-20,2047,150,1897,92.7,20,7,35.0
PK in K-12 Schools,All Students,2020-21,3121,87,3034,97.2,18,2,11.1
PK in K-12 Schools,All Students,2021-22,3156,283,2873,91.0,19,6,31.6
PK in K-12 Schools,All Students,2022-23,3164,312,2852,90.1,21,9,42.9
0K,All Students,2018-19,12747,1444,11303,88.7,81,37,45.7
0K,All Students,2019-20,6995,629,6366,91.0,73,29,39.7
0K,All Students,2020-21,6929,268,6661,96.1,44,5,11.4
0K,All Students,2021-22,7669,820,6849,89.3,50,23,46.0
0K,All Students,2022-23,7003,780,6223,88.9,45,20,44.4
1,All Students,2018-19,11421,917,10504,92.0,72,23,31.9
1,All Students,2019-20,7551,471,7080,93.8,68,12,17.6
1,All Students,2020-21,9771,1104,8667,88.7,59,18,30.5
1,All Students,2021-22,6575,751,5824,88.6,42,17,40.5
1,All Students,2022-23,8509,764,7745,91.0,55,21,38.2
2,All Students,2018-19,12174,1025,11149,91.6,76,26,34.2
2,All Students,2019-20,7226,481,6745,93.3,66,13,19.7
2,All Students,2020-21,10111,1363,8748,86.5,59,27,45.8
2,All Students,2021-22,9188,709,8479,92.3,56,15,26.8
2,All Students,2022-23,5829,434,5395,92.6,36,7,19.4
3,All Students,2018-19,13003,1106,11897,91.5,78,30,38.5
3,All Students,2019-20,6493,366,6127,94.4,61,8,13.1
3,All Students,2020-21,10959,808,10151,92.6,64,17,26.6
3,All Students,2021-22,9316,971,8345,89.6,59,24,40.7
3,All Students,2022-23,7284,429,6855,94.1,46,7,15.2
4,All Students,2018-19,12060,902,11158,92.5,72,25,34.7
4,All Students,2019-20,7706,469,7237,93.9,70,14,20.0
4,All Students,2020-21,8982,545,8437,93.9,52,12,23.1
4,All Students,2021-22,10297,934,9363,90.9,64,22,34.4
4,All Students,2022-23,8315,652,7663,92.2,51,11,21.6
5,All Students,2018-19,9687,814,8873,91.6,57,15,26.3
5,All Students,2019-20,7364,407,6957,94.5,68,13,19.1
5,All Students,2020-21,11255,1077,10178,90.4,65,24,36.9
5,All Students,2021-22,9080,663,8417,92.7,53,13,24.5
5,All Students,2022-23,8656,732,7924,91.5,52,12,23.1
All Grades,All Students,2018-19,73091,10603,62488,85.5,469,200,42.6
All Grades,All Students,2019-20,45062,5955,39107,86.8,430,163,37.9
All Grades,All Students,2020-21,52321,7215,45106,86.2,327,131,40.1
All Grades,All Students,2021-22,51851,7026,44825,86.4,359,147,40.9
All Grades,All Students,2022-23,61583,6324,55259,89.7,422,132,31.3
8,All Students,2021-22,22,s,s,s,s,s,s
9,All Students,2018-19,28905,3816,25089,86.8,189,80,42.3
9,All Students,2019-20,8358,718,7640,91.4,80,19,23.8
9,All Students,2020-21,5325,924,4401,82.6,42,14,33.3
9,All Students,2021-22,15989,1612,14377,89.9,118,37,31.4
9,All Students,2022-23,20272,1941,18331,90.4,149,39,26.2
10,All Students,2018-19,19746,2631,17115,86.7,121,52,43.0
10,All Students,2019-20,13315,2253,11062,83.1,129,59,45.7
10,All Students,2020-21,13231,2138,11093,83.8,84,41,48.8
10,All Students,2021-22,14806,2080,12726,86.0,105,39,37.1
10,All Students,2022-23,19578,2284,17294,88.3,134,49,36.6
11,All Students,2018-19,13541,2200,11341,83.8,91,38,41.8
11,All Students,2019-20,11846,1010,10836,91.5,109,30,27.5
11,All Students,2020-21,14284,1533,12751,89.3,86,24,27.9
11,All Students,2021-22,8535,s,s,s,s,s,s
11,All Students,2022-23,11785,1199,10586,89.8,79,24,30.4
12,All Students,2018-19,10899,1956,8943,82.1,68,30,44.1
12,All Students,2019-20,11543,1974,9569,82.9,112,55,49.1
12,All Students,2020-21,19481,2620,16861,86.6,115,52,45.2
12,All Students,2021-22,12499,2005,10494,84.0,80,43,53.8
12,All Students,2022-23,9948,900,9048,91.0,60,20,33.3
All Grades,All Students,2018-19,27152,3756,23396,86.2,177,114,64.4
All Grades,All Students,2019-20,22090,2066,20024,90.6,211,77,36.5
All Grades,All Students,2020-21,38964,3831,35133,90.2,242,83,34.3
All Grades,All Students,2021-22,48836,6399,42437,86.9,300,160,53.3
All Grades,All Students,2022-23,44707,5149,39558,88.5,286,147,51.4
PK in K-12 Schools,All Students,2018-19,5443,941,4502,82.7,38,30,78.9
PK in K-12 Schools,All Students,2019-20,2870,335,2535,88.3,29,15,51.7
PK in K-12 Schools,All Students,2020-21,2597,282,2315,89.1,17,8,47.1
PK in K-12 Schools,All Students,2021-22,5633,831,4802,85.2,34,19,55.9
PK in K-12 Schools,All Students,2022-23,5034,683,4351,86.4,30,21,70.0
0K,All Students,2018-19,5819,930,4889,84.0,41,28,68.3
0K,All Students,2019-20,4629,449,4180,90.3,48,21,43.8
0K,All Students,2020-21,6470,772,5698,88.1,41,17,41.5
0K,All Students,2021-22,6963,981,5982,85.9,45,27,60.0
0K,All Students,2022-23,5534,794,4740,85.7,39,27,69.2
1,All Students,2018-19,7300,859,6441,88.2,44,26,59.1
1,All Students,2019-20,4114,387,3727,90.6,38,16,42.1
1,All Students,2020-21,7848,902,6946,88.5,47,18,38.3
1,All Students,2021-22,7491,1090,6401,85.4,48,26,54.2
1,All Students,2022-23,7423,978,6445,86.8,47,27,57.4
2,All Students,2018-19,8590,1026,7564,88.1,54,30,55.6
2,All Students,2019-20,4846,383,4463,92.1,43,10,23.3
2,All Students,2020-21,6493,727,5766,88.8,40,14,35.0
2,All Students,2021-22,8521,1211,7310,85.8,50,28,56.0
2,All Students,2022-23,6830,740,6090,89.2,44,23,52.3
3,All Students,2019-20,5631,512,5119,90.9,53,15,28.3
3,All Students,2020-21,7135,525,6610,92.6,47,14,29.8
3,All Students,2021-22,6630,774,5856,88.3,42,22,52.4
3,All Students,2022-23,7238,757,6481,89.5,46,19,41.3
4,All Students,2020-21,8421,623,7798,92.6,50,12,24.0
4,All Students,2021-22,6980,748,6232,89.3,40,16,40.0
4,All Students,2022-23,6474,703,5771,89.1,43,21,48.8
5,All Students,2021-22,6618,764,5854,88.5,41,22,53.7
5,All Students,2022-23,6174,494,5680,92.0,37,9,24.3
All Grades,All Students,2020-21,1283,249,1034,80.6,11,8,72.7
All Grades,All Students,2021-22,13175,2660,10515,79.8,90,70,77.8
All Grades,All Students,2022-23,18519,3731,14788,79.9,130,103,79.2
PK in K-12 Schools,All Students,2020-21,1283,249,1034,80.6,11,8,72.7
PK in K-12 Schools,All Students,2021-22,13174,s,s,s,s,s,s
PK in K-12 Schools,All Students,2022-23,18519,3731,14788,79.9,130,103,79.2
0K,All Students,2021-22,1,s,s,s,s,s,s
All Grades,All Students,2018-19,76560,15914,60646,79.2,490,311,63.5
All Grades,All Students,2019-20,50200,9826,40374,80.4,472,295,62.5
All Grades,All Students,2020-21,80795,24896,55899,69.2,483,420,87.0
All Grades,All Students,2021-22,76640,22048,54592,71.2,474,378,79.7
All Grades,All Students,2022-23,74654,18023,56631,75.9,491,355,72.3
9,All Students,2018-19,20924,4758,16166,77.3,136,91,66.9
9,All Students,2019-20,14764,2394,12370,83.8,140,72,51.4
9,All Students,2020-21,20790,4456,16334,78.6,123,95,77.2
9,All Students,2021-22,22422,5486,16936,75.5,138,102,73.9
9,All Students,2022-23,18880,4808,14072,74.5,138,103,74.6
10,All Students,2018-19,19480,4523,14957,76.8,127,87,68.5
10,All Students,2019-20,13578,2905,10673,78.6,127,87,68.5
10,All Students,2020-21,24535,6315,18220,74.3,144,116,80.6
10,All Students,2021-22,18023,4281,13742,76.2,111,82,73.9
10,All Students,2022-23,20853,4395,16458,78.9,134,89,66.4
11,All Students,2018-19,16950,2890,14060,82.9,104,63,60.6
11,All Students,2019-20,10830,2118,8712,80.4,100,65,65.0
11,All Students,2020-21,18090,6268,11822,65.4,105,102,97.1
11,All Students,2021-22,19604,5860,13744,70.1,121,98,81.0
11,All Students,2022-23,17363,3220,14143,81.5,109,73,67.0
12,All Students,2018-19,19206,3743,15463,80.5,123,70,56.9
12,All Students,2019-20,11028,2409,8619,78.2,105,71,67.6
12,All Students,2020-21,17380,7857,9523,54.8,111,107,96.4
12,All Students,2021-22,16591,6421,10170,61.3,104,96,92.3
12,All Students,2022-23,17558,5600,11958,68.1,110,90,81.8
All Grades,All Students,2018-19,74229,16300,57929,78.0,506,321,63.4
All Grades,All Students,2019-20,42533,9320,33213,78.1,399,232,58.1
All Grades,All Students,2020-21,56434,9782,46652,82.7,343,145,42.3
All Grades,All Students,2021-22,45659,9187,36472,79.9,297,189,63.6
All Grades,All Students,2022-23,42362,7858,34504,81.5,289,177,61.2
8,All Students,2022-23,5,s,s,s,s,s,s
9,All Students,2018-19,21541,5692,15849,73.6,158,106,67.1
9,All Students,2019-20,11735,2809,8926,76.1,111,56,50.5
9,All Students,2020-21,13273,2663,10610,79.9,83,42,50.6
9,All Students,2021-22,10491,1683,8808,84.0,70,36,51.4
9,All Students,2022-23,12030,2782,9248,76.9,89,58,65.2
10,All Students,2018-19,21396,4810,16586,77.5,147,96,65.3
10,All Students,2019-20,10793,2627,8166,75.7,100,61,61.0
10,All Students,2020-21,15165,2422,12743,84.0,91,34,37.4
10,All Students,2021-22,11232,2465,8767,78.1,77,50,64.9
10,All Students,2022-23,10608,1660,8948,84.4,72,41,56.9
11,All Students,2018-19,17152,2740,14412,84.0,110,62,56.4
11,All Students,2019-20,9439,1664,7775,82.4,89,55,61.8
11,All Students,2020-21,12715,1960,10755,84.6,77,26,33.8
11,All Students,2021-22,12883,2177,10706,83.1,79,49,62.0
11,All Students,2022-23,8214,s,s,s,s,s,s
12,All Students,2018-19,14140,3058,11082,78.4,91,57,62.6
12,All Students,2019-20,10566,2220,8346,79.0,99,60,60.6
12,All Students,2020-21,15281,2737,12544,82.1,92,43,46.7
12,All Students,2021-22,11053,2862,8191,74.1,71,54,76.1
12,All Students,2022-23,11505,1907,9598,83.4,73,48,65.8
All Grades,All Students,2018-19,55179,3985,51194,92.8,340,86,25.3
All Grades,All Students,2019-20,36055,2023,34032,94.4,344,63,18.3
All Grades,All Students,2020-21,53591,2844,50747,94.7,330,56,17.0
All Grades,All Students,2021-22,54582,4367,50215,92.0,333,94,28.2
All Grades,All Students,2022-23,55363,4282,51081,92.3,347,101,29.1
PK in K-12 Schools,All Students,2018-19,3181,333,2848,89.5,18,8,44.4
PK in K-12 Schools,All Students,2019-20,2020,s,s,s,s,s,s
PK in K-12 Schools,All Students,2020-21,3122,167,2955,94.7,21,4,19.0
PK in K-12 Schools,All Students,2021-22,5731,537,5194,90.6,33,11,33.3
PK in K-12 Schools,All Students,2022-23,5662,s,s,s,s,s,s
0K,All Students,2018-19,8286,686,7600,91.7,55,18,32.7
0K,All Students,2019-20,5361,368,4993,93.1,51,13,25.5
0K,All Students,2020-21,8607,665,7942,92.3,53,17,32.1
0K,All Students,2021-22,8142,672,7470,91.7,54,18,33.3
0K,All Students,2022-23,8379,659,7720,92.1,53,13,24.5
1,All Students,2018-19,9929,725,9204,92.7,61,17,27.9
1,All Students,2019-20,5582,300,5282,94.6,53,9,17.0
1,All Students,2020-21,9079,721,8358,92.1,57,16,28.1
1,All Students,2021-22,8679,756,7923,91.3,51,16,31.4
1,All Students,2022-23,8762,783,7979,91.1,54,23,42.6
2,All Students,2018-19,7375,569,6806,92.3,47,14,29.8
2,All Students,2019-20,6393,341,6052,94.7,58,8,13.8
2,All Students,2020-21,7791,466,7325,94.0,47,8,17.0
2,All Students,2021-22,8247,691,7556,91.6,49,14,28.6
2,All Students,2022-23,8559,619,7940,92.8,55,13,23.6
3,All Students,2018-19,9076,653,8423,92.8,54,12,22.2
3,All Students,2019-20,4759,255,4504,94.6,49,9,18.4
3,All Students,2020-21,8679,211,8468,97.6,53,5,9.4
3,All Students,2021-22,8249,569,7680,93.1,51,10,19.6
3,All Students,2022-23,7587,505,7082,93.3,48,13,27.1
4,All Students,2018-19,8554,601,7953,93.0,54,13,24.1
4,All Students,2019-20,6230,256,5974,95.9,57,5,8.8
4,All Students,2020-21,7696,120,7576,98.4,47,0,0.0
4,All Students,2021-22,8857,654,8203,92.6,53,14,26.4
4,All Students,2022-23,8312,605,7707,92.7,49,12,24.5
5,All Students,2018-19,8778,418,8360,95.2,51,4,7.8
5,All Students,2019-20,5703,332,5371,94.2,53,12,22.6
5,All Students,2020-21,8617,494,8123,94.3,52,6,11.5
5,All Students,2021-22,6677,488,6189,92.7,42,11,26.2
5,All Students,2022-23,7933,508,7425,93.6,49,8,16.3
6,All Students,2019-20,7,s,s,s,s,s,s
6,All Students,2022-23,169,s,s,s,s,s,s
All Grades,All Students,2018-19,64576,6887,57689,89.3,398,174,43.7
All Grades,All Students,2019-20,34479,3446,31033,90.0,315,123,39.0
All Grades,All Students,2020-21,45373,7591,37782,83.3,271,146,53.9
All Grades,All Students,2021-22,44340,6280,38060,85.8,271,157,57.9
All Grades,All Students,2022-23,40235,5648,34587,86.0,245,148,60.4
PK in K-12 Schools,All Students,2018-19,8359,987,7372,88.2,52,25,48.1
PK in K-12 Schools,All Students,2019-20,3797,373,3424,90.2,35,16,45.7
PK in K-12 Schools,All Students,2020-21,4629,s,s,s,s,s,s
PK in K-12 Schools,All Students,2021-22,7535,1351,6184,82.1,46,36,78.3
PK in K-12 Schools,All Students,2022-23,7673,1324,6349,82.7,50,38,76.0
0K,All Students,2018-19,8609,1028,7581,88.1,58,31,53.4
0K,All Students,2019-20,4416,447,3969,89.9,40,19,47.5
0K,All Students,2020-21,5212,923,4289,82.3,32,20,62.5
0K,All Students,2021-22,5427,1005,4422,81.5,33,21,63.6
0K,All Students,2022-23,5422,854,4568,84.2,32,23,71.9
1,All Students,2018-19,11425,1232,10193,89.2,72,32,44.4
1,All Students,2019-20,4955,615,4340,87.6,48,18,37.5
1,All Students,2020-21,6332,1028,5304,83.8,37,22,59.5
1,All Students,2021-22,5185,s,s,s,s,s,s
1,All Students,2022-23,5051,682,4369,86.5,30,19,63.3
2,All Students,2018-19,9900,893,9007,91.0,60,25,41.7
2,All Students,2019-20,6055,570,5485,90.6,55,23,41.8
2,All Students,2020-21,7245,1270,5975,82.5,43,23,53.5
2,All Students,2021-22,5201,581,4620,88.8,33,16,48.5
2,All Students,2022-23,4635,743,3892,84.0,28,18,64.3
3,All Students,2018-19,8404,814,7590,90.3,51,18,35.3
3,All Students,2019-20,5564,559,5005,90.0,48,15,31.3
3,All Students,2020-21,8070,1315,6755,83.7,49,26,53.1
3,All Students,2021-22,6915,932,5983,86.5,41,24,58.5
3,All Students,2022-23,5102,515,4587,89.9,30,13,43.3
4,All Students,2018-19,8714,1065,7649,87.8,53,25,47.2
4,All Students,2019-20,4489,349,4140,92.2,41,11,26.8
4,All Students,2020-21,7721,770,6951,90.0,44,13,29.5
4,All Students,2021-22,6690,823,5867,87.7,40,18,45.0
4,All Students,2022-23,6153,700,5453,88.6,38,22,57.9
5,All Students,2018-19,9165,868,8297,90.5,52,18,34.6
5,All Students,2019-20,5203,533,4670,89.8,48,21,43.8
5,All Students,2020-21,5830,935,4895,84.0,35,18,51.4
5,All Students,2021-22,7210,836,6374,88.4,44,23,52.3
5,All Students,2022-23,6199,830,5369,86.6,37,15,40.5
6,All Students,2020-21,334,s,s,s,s,s,s
6,All Students,2021-22,177,s,s,s,s,s,s
All Grades,All Students,2018-19,160825,8086,152739,95.0,924,98,10.6
All Grades,All Students,2019-20,79017,4054,74963,94.9,699,71,10.2
All Grades,All Students,2020-21,105367,3759,101608,96.4,630,53,8.4
All Grades,All Students,2021-22,102072,6414,95658,93.7,585,78,13.3
All Grades,All Students,2022-23,101731,6954,94777,93.2,581,92,15.8
0K,All Students,2018-19,21813,1148,20665,94.7,128,17,13.3
0K,All Students,2019-20,13215,798,12417,94.0,121,18,14.9
0K,All Students,2020-21,23188,929,22259,96.0,135,11,8.1
0K,All Students,2021-22,20581,1218,19363,94.1,119,14,11.8
0K,All Students,2022-23,20606,1764,18842,91.4,118,34,28.8
1,All Students,2018-19,23604,1056,22548,95.5,135,10,7.4
1,All Students,2019-20,14880,729,14151,95.1,132,10,7.6
1,All Students,2020-21,14646,524,14122,96.4,94,13,13.8
1,All Students,2021-22,20467,1480,18987,92.8,117,22,18.8
1,All Students,2022-23,19777,1280,18497,93.5,112,14,12.5
2,All Students,2018-19,19401,960,18441,95.1,112,10,8.9
2,All Students,2019-20,15569,795,14774,94.9,136,12,8.8
2,All Students,2020-21,17656,465,17191,97.4,106,6,5.7
2,All Students,2021-22,13251,s,s,s,s,s,s
2,All Students,2022-23,19203,1284,17919,93.3,110,18,16.4
3,All Students,2018-19,16199,766,15433,95.3,92,8,8.7
3,All Students,2019-20,12354,699,11655,94.3,108,11,10.2
3,All Students,2020-21,21159,771,20388,96.4,123,6,4.9
3,All Students,2021-22,15139,793,14346,94.8,87,9,10.3
3,All Students,2022-23,12550,s,s,s,s,s,s
4,All Students,2018-19,20578,919,19659,95.5,116,9,7.8
4,All Students,2019-20,10387,407,9980,96.1,92,9,9.8
4,All Students,2020-21,14955,523,14432,96.5,91,10,11.0
4,All Students,2021-22,18960,1044,17916,94.5,107,9,8.4
4,All Students,2022-23,14373,729,13644,94.9,82,3,3.7
5,All Students,2018-19,16527,687,15840,95.8,94,4,4.3
5,All Students,2019-20,12580,594,11986,95.3,110,11,10.0
5,All Students,2020-21,13679,s,s,s,s,s,s
5,All Students,2021-22,13545,939,12606,93.1,78,14,17.9
5,All Students,2022-23,15164,892,14272,94.1,87,11,12.6
6,All Students,2018-19,13982,741,13241,94.7,81,11,13.6
6,All Students,2020-21,73,s,s,s,s,s,s
6,All Students,2021-22,129,s,s,s,s,s,s
6,All Students,2022-23,58,s,s,s,s,s,s
7,All Students,2018-19,12584,866,11718,93.1,75,17,22.7
8,All Students,2018-19,16137,943,15194,94.2,91,12,13.2
8,All Students,2019-20,18,s,s,s,s,s,s
9,All Students,2019-20,14,s,s,s,s,s,s
All Grades,All Students,2018-19,166865,9463,157402,94.3,966,168,17.4
All Grades,All Students,2019-20,107625,7440,100185,93.1,974,215,22.1
All Grades,All Students,2020-21,145266,8493,136773,94.2,879,141,16.0
All Grades,All Students,2021-22,127392,11054,116338,91.3,750,223,29.7
All Grades,All Students,2022-23,131096,2173,128923,98.3,795,22,2.8
PK in K-12 Schools,All Students,2018-19,22932,1884,21048,91.8,133,44,33.1
PK in K-12 Schools,All Students,2019-20,14369,1231,13138,91.4,128,44,34.4
PK in K-12 Schools,All Students,2020-21,18551,1152,17399,93.8,111,21,18.9
PK in K-12 Schools,All Students,2021-22,17425,1865,15560,89.3,104,46,44.2
PK in K-12 Schools,All Students,2022-23,21425,720,20705,96.6,131,10,7.6
0K,All Students,2018-19,27794,1870,25924,93.3,161,34,21.1
0K,All Students,2019-20,16438,1500,14938,90.9,154,49,31.8
0K,All Students,2020-21,20811,1308,19503,93.7,130,24,18.5
0K,All Students,2021-22,19934,1926,18008,90.3,121,44,36.4
0K,All Students,2022-23,19896,371,19525,98.1,123,2,1.6
1,All Students,2018-19,24748,1454,23294,94.1,143,27,18.9
1,All Students,2019-20,17584,1241,16343,92.9,161,33,20.5
1,All Students,2020-21,20723,1539,19184,92.6,130,24,18.5
1,All Students,2021-22,18606,1579,17027,91.5,108,26,24.1
1,All Students,2022-23,18200,259,17941,98.6,111,6,5.4
2,All Students,2018-19,25005,1308,23697,94.8,148,21,14.2
2,All Students,2019-20,15259,872,14387,94.3,136,21,15.4
2,All Students,2020-21,22423,1287,21136,94.3,133,27,20.3
2,All Students,2021-22,16859,1874,14985,88.9,99,37,37.4
2,All Students,2022-23,18634,163,18471,99.1,111,0,0.0
3,All Students,2018-19,23325,1445,21880,93.8,135,27,20.0
3,All Students,2019-20,15811,964,14847,93.9,145,27,18.6
3,All Students,2020-21,20862,1356,19506,93.5,129,20,15.5
3,All Students,2021-22,18813,1601,17212,91.5,112,32,28.6
3,All Students,2022-23,17723,304,17419,98.3,108,4,3.7
4,All Students,2018-19,22367,571,21796,97.4,128,4,3.1
4,All Students,2019-20,14503,889,13614,93.9,127,23,18.1
4,All Students,2020-21,20736,1022,19714,95.1,124,14,11.3
4,All Students,2021-22,18095,561,17534,96.9,104,10,9.6
4,All Students,2022-23,17662,115,17547,99.3,106,0,0.0
5,All Students,2018-19,20683,s,s,s,s,s,s
5,All Students,2019-20,13661,743,12918,94.6,123,18,14.6
5,All Students,2020-21,21160,829,20331,96.1,122,11,9.0
5,All Students,2021-22,17660,1648,16012,90.7,102,28,27.5
5,All Students,2022-23,17534,s,s,s,s,s,s
6,All Students,2018-19,11,s,s,s,s,s,s
6,All Students,2022-23,22,s,s,s,s,s,s
All Grades,All Students,2018-19,159086,8775,150311,94.5,922,141,15.3
All Grades,All Students,2019-20,108771,5641,103130,94.8,976,129,13.2
All Grades,All Students,2020-21,147753,7394,140359,95.0,878,135,15.4
All Grades,All Students,2021-22,144619,12248,132371,91.5,845,240,28.4
All Grades,All Students,2022-23,147256,11848,135408,92.0,857,229,26.7
PK in K-12 Schools,All Students,2018-19,12811,731,12080,94.3,72,12,16.7
PK in K-12 Schools,All Students,2019-20,8274,457,7817,94.5,74,10,13.5
PK in K-12 Schools,All Students,2020-21,11095,s,s,s,s,s,s
PK in K-12 Schools,All Students,2021-22,12263,1127,11136,90.8,72,23,31.9
PK in K-12 Schools,All Students,2022-23,18999,1731,17268,90.9,110,36,32.7
0K,All Students,2018-19,22117,1215,20902,94.5,131,17,13.0
0K,All Students,2019-20,16826,922,15904,94.5,153,21,13.7
0K,All Students,2020-21,21557,1385,20172,93.6,132,29,22.0
0K,All Students,2021-22,24271,2124,22147,91.2,142,39,27.5
0K,All Students,2022-23,25824,2161,23663,91.6,149,40,26.8
1,All Students,2018-19,26565,1543,25022,94.2,158,27,17.1
1,All Students,2019-20,16704,843,15861,95.0,152,19,12.5
1,All Students,2020-21,21910,1165,20745,94.7,133,24,18.0
1,All Students,2021-22,21129,1718,19411,91.9,125,30,24.0
1,All Students,2022-23,22275,1749,20526,92.1,130,30,23.1
2,All Students,2018-19,24801,1338,23463,94.6,143,22,15.4
2,All Students,2019-20,17477,997,16480,94.3,157,26,16.6
2,All Students,2020-21,22242,974,21268,95.6,132,14,10.6
2,All Students,2021-22,20525,1750,18775,91.5,118,37,31.4
2,All Students,2022-23,20095,1513,18582,92.5,121,30,24.8
3,All Students,2018-19,24201,1511,22690,93.8,141,29,20.6
3,All Students,2019-20,17156,876,16280,94.9,154,20,13.0
3,All Students,2020-21,24323,1202,23121,95.1,143,23,16.1
3,All Students,2021-22,20337,1670,18667,91.8,119,36,30.3
3,All Students,2022-23,19327,1490,17837,92.3,113,31,27.4
4,All Students,2018-19,26697,1131,25566,95.8,152,12,7.9
4,All Students,2019-20,15630,796,14834,94.9,138,20,14.5
4,All Students,2020-21,24639,976,23663,96.0,143,13,9.1
4,All Students,2021-22,22882,1896,20986,91.7,132,34,25.8
4,All Students,2022-23,19456,1465,17991,92.5,113,25,22.1
5,All Students,2018-19,21894,1306,20588,94.0,125,22,17.6
5,All Students,2019-20,16704,750,15954,95.5,148,13,8.8
5,All Students,2020-21,21984,945,21039,95.7,128,16,12.5
5,All Students,2021-22,23212,1963,21249,91.5,137,41,29.9
5,All Students,2022-23,21280,1739,19541,91.8,121,37,30.6
6,All Students,2020-21,3,s,s,s,s,s,s
All Grades,All Students,2018-19,86000,7163,78837,91.7,504,157,31.2
All Grades,All Students,2019-20,61607,5123,56484,91.7,558,172,30.8
All Grades,All Students,2020-21,90107,6970,83137,92.3,535,127,23.7
All Grades,All Students,2021-22,106408,12137,94271,88.6,631,256,40.6
All Grades,All Students,2022-23,110178,12095,98083,89.0,642,261,40.7
PK in K-12 Schools,All Students,2018-19,9515,640,8875,93.3,56,13,23.2
PK in K-12 Schools,All Students,2019-20,6198,s,s,s,s,s,s
PK in K-12 Schools,All Students,2020-21,9137,s,s,s,s,s,s
PK in K-12 Schools,All Students,2021-22,17099,2172,14927,87.3,107,57,53.3
PK in K-12 Schools,All Students,2022-23,17506,2417,15089,86.2,100,53,53.0
0K,All Students,2018-19,16208,1431,14777,91.2,95,31,32.6
0K,All Students,2019-20,9678,944,8734,90.2,89,33,37.1
0K,All Students,2020-21,16018,1096,14922,93.2,97,23,23.7
0K,All Students,2021-22,19762,2345,17417,88.1,116,51,44.0
0K,All Students,2022-23,16395,1686,14709,89.7,96,37,38.5
1,All Students,2018-19,15523,1377,14146,91.1,89,33,37.1
1,All Students,2019-20,10762,908,9854,91.6,99,36,36.4
1,All Students,2020-21,11858,1010,10848,91.5,71,17,23.9
1,All Students,2021-22,16404,1305,15099,92.0,95,22,23.2
1,All Students,2022-23,20818,2346,18472,88.7,123,51,41.5
2,All Students,2018-19,11781,992,10789,91.6,68,20,29.4
2,All Students,2019-20,10208,812,9396,92.0,91,25,27.5
2,All Students,2020-21,14578,1042,13536,92.9,85,15,17.6
2,All Students,2021-22,11673,1202,10471,89.7,70,26,37.1
2,All Students,2022-23,15540,1344,14196,91.4,91,32,35.2
3,All Students,2018-19,12532,1066,11466,91.5,75,22,29.3
3,All Students,2019-20,8004,565,7439,92.9,73,14,19.2
3,All Students,2020-21,14472,1338,13134,90.8,84,24,28.6
3,All Students,2021-22,15448,1775,13673,88.5,90,36,40.0
3,All Students,2022-23,11972,1275,10697,89.4,71,26,36.6
4,All Students,2018-19,13007,1156,11851,91.1,78,28,35.9
4,All Students,2019-20,7974,708,7266,91.1,73,27,37.0
4,All Students,2020-21,12156,907,11249,92.5,72,18,25.0
4,All Students,2021-22,14056,1905,12151,86.4,81,37,45.7
4,All Students,2022-23,14344,1630,12714,88.6,81,33,40.7
5,All Students,2018-19,7434,501,6933,93.3,43,10,23.3
5,All Students,2019-20,8678,678,8000,92.2,78,23,29.5
5,All Students,2020-21,11873,1099,10774,90.7,69,23,33.3
5,All Students,2021-22,11966,1433,10533,88.0,72,27,37.5
5,All Students,2022-23,13603,1397,12206,89.7,80,29,36.3
6,All Students,2019-20,105,s,s,s,s,s,s
6,All Students,2020-21,6,s,s,s,s,s,s
All Grades,All Students,2018-19,21159,2614,18545,87.6,134,64,47.8
All Grades,All Students,2019-20,14230,1674,12556,88.2,132,69,52.3
All Grades,All Students,2020-21,22610,2260,20350,90.0,146,61,41.8
All Grades,All Students,2021-22,22844,4585,18259,79.9,155,111,71.6
All Grades,All Students,2022-23,22773,4009,18764,82.4,152,98,64.5
PK in K-12 Schools,All Students,2018-19,2050,314,1736,84.7,14,10,71.4
PK in K-12 Schools,All Students,2019-20,1855,308,1547,83.4,20,15,75.0
PK in K-12 Schools,All Students,2020-21,2250,230,2020,89.8,15,8,53.3
PK in K-12 Schools,All Students,2021-22,4601,1296,3305,71.8,35,28,80.0
PK in K-12 Schools,All Students,2022-23,4834,1116,3718,76.9,33,26,78.8
0K,All Students,2018-19,3032,486,2546,84.0,21,14,66.7
0K,All Students,2019-20,1502,154,1348,89.7,14,7,50.0
0K,All Students,2020-21,3572,228,3344,93.6,22,4,18.2
0K,All Students,2021-22,3259,696,2563,78.6,22,17,77.3
0K,All Students,2022-23,2084,s,s,s,s,s,s
1,All Students,2018-19,4669,587,4082,87.4,29,14,48.3
1,All Students,2019-20,1801,213,1588,88.2,16,8,50.0
1,All Students,2020-21,2406,324,2082,86.5,17,11,64.7
1,All Students,2021-22,2879,480,2399,83.3,21,17,81.0
1,All Students,2022-23,2978,547,2431,81.6,20,13,65.0
2,All Students,2018-19,3552,499,3053,86.0,23,9,39.1
2,All Students,2019-20,3055,338,2717,88.9,27,12,44.4
2,All Students,2020-21,2748,267,2481,90.3,17,7,41.2
2,All Students,2021-22,2190,322,1868,85.3,14,10,71.4
2,All Students,2022-23,2482,378,2104,84.8,18,12,66.7
3,All Students,2018-19,2681,293,2388,89.1,18,9,50.0
3,All Students,2019-20,2671,363,2308,86.4,24,12,50.0
3,All Students,2020-21,4559,413,4146,90.9,29,10,34.5
3,All Students,2021-22,3046,567,2479,81.4,19,11,57.9
3,All Students,2022-23,2701,351,2350,87.0,16,9,56.3
4,All Students,2018-19,2149,176,1973,91.8,12,3,25.0
4,All Students,2019-20,2025,189,1836,90.7,19,10,52.6
4,All Students,2020-21,3970,468,3502,88.2,26,10,38.5
4,All Students,2021-22,4066,571,3495,86.0,26,14,53.8
4,All Students,2022-23,3878,626,3252,83.9,26,14,53.8
5,All Students,2018-19,3026,259,2767,91.4,17,5,29.4
5,All Students,2019-20,1321,109,1212,91.7,12,5,41.7
5,All Students,2020-21,3105,330,2775,89.4,20,11,55.0
5,All Students,2021-22,2803,653,2150,76.7,18,14,77.8
5,All Students,2022-23,3812,533,3279,86.0,23,13,56.5
6,All Students,2022-23,4,s,s,s,s,s,s
All Grades,All Students,2018-19,46776,6085,40691,87.0,291,145,49.8
All Grades,All Students,2019-20,28606,3500,25106,87.8,269,134,49.8
All Grades,All Students,2020-21,38444,6478,31966,83.1,233,135,57.9
All Grades,All Students,2021-22,41313,7673,33640,81.4,260,178,68.5
All Grades,All Students,2022-23,40911,6629,34282,83.8,252,174,69.0
PK in K-12 Schools,All Students,2018-19,8013,1609,6404,79.9,50,31,62.0
PK in K-12 Schools,All Students,2019-20,5929,729,5200,87.7,55,22,40.0
PK in K-12 Schools,All Students,2020-21,3621,895,2726,75.3,28,20,71.4
PK in K-12 Schools,All Students,2021-22,9690,1793,7897,81.5,59,44,74.6
PK in K-12 Schools,All Students,2022-23,10137,1700,8437,83.2,63,40,63.5
0K,All Students,2018-19,5404,779,4625,85.6,35,20,57.1
0K,All Students,2019-20,3073,482,2591,84.3,31,22,71.0
0K,All Students,2020-21,6816,1140,5676,83.3,40,24,60.0
0K,All Students,2021-22,4712,1224,3488,74.0,31,22,71.0
0K,All Students,2022-23,5420,893,4527,83.5,32,22,68.8
1,All Students,2018-19,5183,662,4521,87.2,33,19,57.6
1,All Students,2019-20,3331,408,2923,87.8,32,20,62.5
1,All Students,2020-21,4382,1169,3213,73.3,26,19,73.1
1,All Students,2021-22,6344,1140,5204,82.0,41,26,63.4
1,All Students,2022-23,5253,1015,4238,80.7,34,28,82.4
2,All Students,2018-19,4924,656,4268,86.7,31,14,45.2
2,All Students,2019-20,3646,434,3212,88.1,35,18,51.4
2,All Students,2020-21,4454,667,3787,85.0,26,15,57.7
2,All Students,2021-22,4755,844,3911,82.3,32,23,71.9
2,All Students,2022-23,5776,781,4995,86.5,34,22,64.7
3,All Students,2018-19,7765,830,6935,89.3,49,22,44.9
3,All Students,2019-20,3344,306,3038,90.8,31,12,38.7
3,All Students,2020-21,6212,1144,5068,81.6,36,19,52.8
3,All Students,2021-22,4301,815,3486,81.1,27,19,70.4
3,All Students,2022-23,4733,770,3963,83.7,31,23,74.2
4,All Students,2018-19,6891,823,6068,88.1,41,19,46.3
4,All Students,2019-20,4843,573,4270,88.2,46,22,47.8
4,All Students,2020-21,4884,354,4530,92.8,28,8,28.6
4,All Students,2021-22,5677,1020,4657,82.0,34,23,67.6
4,All Students,2022-23,3988,651,3337,83.7,24,15,62.5
5,All Students,2018-19,8596,726,7870,91.6,52,20,38.5
5,All Students,2019-20,4440,568,3872,87.2,40,19,47.5
5,All Students,2020-21,8075,1109,6966,86.3,49,30,61.2
5,All Students,2021-22,5834,837,4997,85.7,36,21,58.3
5,All Students,2022-23,5604,819,4785,85.4,34,24,70.6
All Grades,All Students,2018-19,39628,4440,35188,88.8,238,101,42.4
All Grades,All Students,2019-20,23274,2368,20906,89.8,216,90,41.7
All Grades,All Students,2020-21,31214,3289,27925,89.5,189,68,36.0
All Grades,All Students,2021-22,29399,4958,24441,83.1,186,115,61.8
All Grades,All Students,2022-23,28220,3532,24688,87.5,172,80,46.5
PK in K-12 Schools,All Students,2018-19,8873,1261,7612,85.8,54,23,42.6
PK in K-12 Schools,All Students,2019-20,3859,392,3467,89.8,36,13,36.1
PK in K-12 Schools,All Students,2020-21,3157,144,3013,95.4,20,3,15.0
PK in K-12 Schools,All Students,2021-22,6696,933,5763,86.1,43,18,41.9
PK in K-12 Schools,All Students,2022-23,6528,928,5600,85.8,44,20,45.5
0K,All Students,2018-19,5582,654,4928,88.3,34,14,41.2
0K,All Students,2019-20,4661,521,4140,88.8,44,19,43.2
0K,All Students,2020-21,5232,585,4647,88.8,33,12,36.4
0K,All Students,2021-22,2643,379,2264,85.7,15,9,60.0
0K,All Students,2022-23,3800,420,3380,88.9,22,8,36.4
1,All Students,2018-19,4014,514,3500,87.2,23,12,52.2
1,All Students,2019-20,3282,353,2929,89.2,31,15,48.4
1,All Students,2020-21,5527,639,4888,88.4,35,12,34.3
1,All Students,2021-22,3764,642,3122,82.9,28,18,64.3
1,All Students,2022-23,2963,328,2635,88.9,18,9,50.0
2,All Students,2018-19,6026,662,5364,89.0,37,20,54.1
2,All Students,2019-20,2423,259,2164,89.3,23,11,47.8
2,All Students,2020-21,4900,666,4234,86.4,28,13,46.4
2,All Students,2021-22,4232,648,3584,84.7,26,18,69.2
2,All Students,2022-23,3745,466,3279,87.6,21,11,52.4
3,All Students,2018-19,5097,352,4745,93.1,30,8,26.7
3,All Students,2019-20,3310,396,2914,88.0,30,17,56.7
3,All Students,2020-21,3026,257,2769,91.5,19,8,42.1
3,All Students,2021-22,4938,970,3968,80.4,30,22,73.3
3,All Students,2022-23,3789,493,3296,87.0,24,12,50.0
4,All Students,2018-19,4663,461,4202,90.1,28,11,39.3
4,All Students,2019-20,3209,265,2944,91.7,30,7,23.3
4,All Students,2020-21,4378,520,3858,88.1,25,10,40.0
4,All Students,2021-22,2488,367,2121,85.2,16,10,62.5
4,All Students,2022-23,4560,654,3906,85.7,26,12,46.2
5,All Students,2018-19,5373,536,4837,90.0,32,13,40.6
5,All Students,2019-20,2530,182,2348,92.8,22,8,36.4
5,All Students,2020-21,4994,478,4516,90.4,29,10,34.5
5,All Students,2021-22,4638,1019,3619,78.0,28,20,71.4
5,All Students,2022-23,2835,243,2592,91.4,17,8,47.1
All Grades,All Students,2018-19,47986,4158,43828,91.3,289,86,29.8
All Grades,All Students,2019-20,32021,2517,29504,92.1,297,78,26.3
All Grades,All Students,2020-21,47373,4854,42519,89.8,281,82,29.2
All Grades,All Students,2021-22,44335,4465,39870,89.9,259,84,32.4
All Grades,All Students,2022-23,46122,4854,41268,89.5,272,103,37.9
PK in K-12 Schools,All Students,2018-19,6361,477,5884,92.5,36,10,27.8
PK in K-12 Schools,All Students,2019-20,4098,259,3839,93.7,36,6,16.7
PK in K-12 Schools,All Students,2020-21,5928,524,5404,91.2,38,11,28.9
PK in K-12 Schools,All Students,2021-22,6346,419,5927,93.4,36,6,16.7
PK in K-12 Schools,All Students,2022-23,6336,616,5720,90.3,36,13,36.1
0K,All Students,2018-19,8882,773,8109,91.3,56,14,25.0
0K,All Students,2019-20,5192,453,4739,91.3,49,13,26.5
0K,All Students,2020-21,5974,481,5493,91.9,36,8,22.2
0K,All Students,2021-22,5313,609,4704,88.5,34,12,35.3
0K,All Students,2022-23,6485,800,5685,87.7,39,18,46.2
1,All Students,2018-19,8719,637,8082,92.7,50,12,24.0
1,All Students,2019-20,5838,409,5429,93.0,56,16,28.6
1,All Students,2020-21,7029,678,6351,90.4,42,12,28.6
1,All Students,2021-22,5143,483,4660,90.6,30,11,36.7
1,All Students,2022-23,5429,532,4897,90.2,33,13,39.4
2,All Students,2018-19,5506,461,5045,91.6,35,12,34.3
2,All Students,2019-20,5632,396,5236,93.0,50,12,24.0
2,All Students,2020-21,8650,968,7682,88.8,50,15,30.0
2,All Students,2021-22,6240,691,5549,88.9,36,11,30.6
2,All Students,2022-23,5255,649,4606,87.6,31,14,45.2
3,All Students,2018-19,6275,576,5699,90.8,38,12,31.6
3,All Students,2019-20,3611,343,3268,90.5,34,13,38.2
3,All Students,2020-21,8586,531,8055,93.8,50,10,20.0
3,All Students,2021-22,8120,811,7309,90.0,47,15,31.9
3,All Students,2022-23,6511,688,5823,89.4,39,10,25.6
4,All Students,2018-19,6158,683,5475,88.9,38,17,44.7
4,All Students,2019-20,4064,342,3722,91.6,38,8,21.1
4,All Students,2020-21,5078,752,4326,85.2,29,11,37.9
4,All Students,2021-22,8388,756,7632,91.0,48,15,31.3
4,All Students,2022-23,7919,725,7194,90.8,46,18,39.1
5,All Students,2018-19,6085,551,5534,90.9,36,9,25.0
5,All Students,2019-20,3586,315,3271,91.2,34,10,29.4
5,All Students,2020-21,6128,920,5208,85.0,36,15,41.7
5,All Students,2021-22,4785,696,4089,85.5,28,14,50.0
5,All Students,2022-23,8187,844,7343,89.7,48,17,35.4
All Grades,All Students,2018-19,39257,3756,35501,90.4,242,94,38.8
All Grades,All Students,2019-20,25326,2459,22867,90.3,239,93,38.9
All Grades,All Students,2020-21,37435,5620,31815,85.0,222,102,45.9
All Grades,All Students,2021-22,34759,5499,29260,84.2,216,141,65.3
All Grades,All Students,2022-23,33577,4695,28882,86.0,202,111,55.0
PK in K-12 Schools,All Students,2018-19,3143,48,3095,98.5,18,0,0.0
PK in K-12 Schools,All Students,2019-20,2009,s,s,s,s,s,s
PK in K-12 Schools,All Students,2020-21,2848,671,2177,76.4,18,13,72.2
PK in K-12 Schools,All Students,2021-22,3098,615,2483,80.1,19,14,73.7
PK in K-12 Schools,All Students,2022-23,2670,524,2146,80.4,16,13,81.3
0K,All Students,2018-19,6881,872,6009,87.3,42,24,57.1
0K,All Students,2019-20,3431,426,3005,87.6,32,18,56.3
0K,All Students,2020-21,5602,1110,4492,80.2,34,22,64.7
0K,All Students,2021-22,4143,806,3337,80.5,26,19,73.1
0K,All Students,2022-23,4389,763,3626,82.6,28,21,75.0
1,All Students,2018-19,6075,747,5328,87.7,37,17,45.9
1,All Students,2019-20,4664,484,4180,89.6,45,19,42.2
1,All Students,2020-21,6081,958,5123,84.2,35,18,51.4
1,All Students,2021-22,5784,733,5051,87.3,36,20,55.6
1,All Students,2022-23,4814,544,4270,88.7,28,12,42.9
2,All Students,2018-19,5339,615,4724,88.5,33,17,51.5
2,All Students,2019-20,3556,273,3283,92.3,32,6,18.8
2,All Students,2020-21,6343,573,5770,91.0,38,11,28.9
2,All Students,2021-22,5545,859,4686,84.5,36,23,63.9
2,All Students,2022-23,6076,740,5336,87.8,36,16,44.4
3,All Students,2018-19,5577,615,4962,89.0,35,14,40.0
3,All Students,2019-20,3450,285,3165,91.7,33,12,36.4
3,All Students,2020-21,5555,659,4896,88.1,32,8,25.0
3,All Students,2021-22,6258,859,5399,86.3,38,23,60.5
3,All Students,2022-23,4928,771,4157,84.4,30,18,60.0
4,All Students,2018-19,6097,472,5625,92.3,39,12,30.8
4,All Students,2019-20,3737,426,3311,88.6,37,19,51.4
4,All Students,2020-21,4909,696,4213,85.8,28,11,39.3
4,All Students,2021-22,4802,781,4021,83.7,29,18,62.1
4,All Students,2022-23,6029,831,5198,86.2,36,19,52.8
5,All Students,2018-19,6145,387,5758,93.7,38,10,26.3
5,All Students,2019-20,4474,276,4198,93.8,40,8,20.0
5,All Students,2020-21,6097,953,5144,84.4,37,19,51.4
5,All Students,2021-22,5129,846,4283,83.5,32,24,75.0
5,All Students,2022-23,4671,522,4149,88.8,28,12,42.9
6,All Students,2019-20,5,s,s,s,s,s,s
All Grades,All Students,2018-19,39612,5566,34046,85.9,254,139,54.7
All Grades,All Students,2019-20,21347,2966,18381,86.1,207,104,50.2
All Grades,All Students,2020-21,30707,3833,26874,87.5,184,80,43.5
All Grades,All Students,2021-22,29559,5516,24043,81.3,184,120,65.2
All Grades,All Students,2022-23,31719,5377,26342,83.0,209,136,65.1
PK in K-12 Schools,All Students,2018-19,3708,638,3070,82.8,24,14,58.3
PK in K-12 Schools,All Students,2019-20,2230,348,1882,84.4,22,10,45.5
PK in K-12 Schools,All Students,2020-21,3216,530,2686,83.5,19,12,63.2
PK in K-12 Schools,All Students,2021-22,6068,1208,4860,80.1,40,27,67.5
PK in K-12 Schools,All Students,2022-23,7383,1718,5665,76.7,52,41,78.8
0K,All Students,2018-19,5856,919,4937,84.3,38,25,65.8
0K,All Students,2019-20,1852,314,1538,83.0,19,12,63.2
0K,All Students,2020-21,4729,481,4248,89.8,28,9,32.1
0K,All Students,2021-22,4227,775,3452,81.7,25,17,68.0
0K,All Students,2022-23,4150,675,3475,83.7,25,17,68.0
1,All Students,2018-19,5928,891,5037,85.0,40,19,47.5
1,All Students,2019-20,3082,483,2599,84.3,32,20,62.5
1,All Students,2020-21,3290,389,2901,88.2,20,10,50.0
1,All Students,2021-22,3146,s,s,s,s,s,s
1,All Students,2022-23,4690,720,3970,84.6,31,22,71.0
2,All Students,2018-19,5594,557,5037,90.0,34,14,41.2
2,All Students,2019-20,3454,635,2819,81.6,35,20,57.1
2,All Students,2020-21,4334,736,3598,83.0,27,14,51.9
2,All Students,2021-22,3421,661,2760,80.7,20,15,75.0
2,All Students,2022-23,2818,486,2332,82.8,18,12,66.7
3,All Students,2018-19,6539,985,5554,84.9,43,30,69.8
3,All Students,2019-20,3305,404,2901,87.8,30,15,50.0
3,All Students,2020-21,4221,513,3708,87.8,25,10,40.0
3,All Students,2021-22,3921,961,2960,75.5,26,22,84.6
3,All Students,2022-23,2783,367,2416,86.8,20,11,55.0
4,All Students,2018-19,6330,824,5506,87.0,40,20,50.0
4,All Students,2019-20,3772,410,3362,89.1,37,16,43.2
4,All Students,2020-21,5150,344,4806,93.3,32,9,28.1
4,All Students,2021-22,4053,628,3425,84.5,25,11,44.0
4,All Students,2022-23,4409,665,3744,84.9,29,17,58.6
5,All Students,2018-19,5657,752,4905,86.7,35,17,48.6
5,All Students,2019-20,3652,372,3280,89.8,32,11,34.4
5,All Students,2020-21,5767,840,4927,85.4,33,16,48.5
5,All Students,2021-22,4716,720,3996,84.7,27,14,51.9
5,All Students,2022-23,5486,746,4740,86.4,34,16,47.1
6,All Students,2021-22,7,s,s,s,s,s,s
All Grades,All Students,2018-19,61266,5151,56115,91.6,360,111,30.8
All Grades,All Students,2019-20,38158,3116,35042,91.8,338,100,29.6
All Grades,All Students,2020-21,56773,13179,43594,76.8,330,216,65.5
All Grades,All Students,2021-22,47317,7666,39651,83.8,283,173,61.1
All Grades,All Students,2022-23,41747,5528,36219,86.8,253,123,48.6
6,All Students,2018-19,24359,2174,22185,91.1,143,43,30.1
6,All Students,2019-20,11467,973,10494,91.5,103,29,28.2
6,All Students,2020-21,17797,4413,13384,75.2,105,68,64.8
6,All Students,2021-22,14621,2420,12201,83.4,88,59,67.0
6,All Students,2022-23,12548,1527,11021,87.8,78,33,42.3
7,All Students,2018-19,19311,1674,17637,91.3,115,35,30.4
7,All Students,2019-20,14564,1221,13343,91.6,128,42,32.8
7,All Students,2020-21,17002,3773,13229,77.8,98,62,63.3
7,All Students,2021-22,16645,2779,13866,83.3,100,56,56.0
7,All Students,2022-23,13330,1993,11337,85.0,79,43,54.4
8,All Students,2018-19,17590,s,s,s,s,s,s
8,All Students,2019-20,12127,922,11205,92.4,107,29,27.1
8,All Students,2020-21,21974,4993,16981,77.3,127,86,67.7
8,All Students,2021-22,16051,2467,13584,84.6,95,58,61.1
8,All Students,2022-23,15869,2008,13861,87.3,96,47,49.0
9,All Students,2018-19,6,s,s,s,s,s,s
All Grades,All Students,2018-19,133118,8230,124888,93.8,769,141,18.3
All Grades,All Students,2019-20,82724,5649,77075,93.2,731,162,22.2
All Grades,All Students,2020-21,115017,5014,110003,95.6,673,90,13.4
All Grades,All Students,2021-22,106004,10268,95736,90.3,624,217,34.8
All Grades,All Students,2022-23,108141,9759,98382,91.0,627,195,31.1
PK in K-12 Schools,All Students,2018-19,9459,805,8654,91.5,55,14,25.5
PK in K-12 Schools,All Students,2019-20,5663,379,5284,93.3,50,11,22.0
PK in K-12 Schools,All Students,2020-21,7614,537,7077,92.9,46,9,19.6
PK in K-12 Schools,All Students,2021-22,6774,873,5901,87.1,41,24,58.5
PK in K-12 Schools,All Students,2022-23,8570,1148,7422,86.6,49,25,51.0
0K,All Students,2018-19,21803,1412,20391,93.5,127,26,20.5
0K,All Students,2019-20,13390,1106,12284,91.7,118,34,28.8
0K,All Students,2020-21,20352,948,19404,95.3,120,14,11.7
0K,All Students,2021-22,18022,1959,16063,89.1,107,43,40.2
0K,All Students,2022-23,16250,1575,14675,90.3,98,38,38.8
1,All Students,2018-19,20484,1496,18988,92.7,121,29,24.0
1,All Students,2019-20,14547,1162,13385,92.0,130,35,26.9
1,All Students,2020-21,18867,553,18314,97.1,111,10,9.0
1,All Students,2021-22,18902,1746,17156,90.8,110,34,30.9
1,All Students,2022-23,19144,1855,17289,90.3,110,37,33.6
2,All Students,2018-19,22292,1556,20736,93.0,129,24,18.6
2,All Students,2019-20,11933,827,11106,93.1,104,26,25.0
2,All Students,2020-21,19566,940,18626,95.2,115,17,14.8
2,All Students,2021-22,17740,1694,16046,90.5,104,33,31.7
2,All Students,2022-23,18126,1633,16493,91.0,105,32,30.5
3,All Students,2018-19,18644,953,17691,94.9,106,14,13.2
3,All Students,2019-20,12264,816,11448,93.3,110,23,20.9
3,All Students,2020-21,15814,822,14992,94.8,92,18,19.6
3,All Students,2021-22,16554,1451,15103,91.2,97,30,30.9
3,All Students,2022-23,16416,1375,15041,91.6,94,22,23.4
4,All Students,2018-19,21277,1025,20252,95.2,120,17,14.2
4,All Students,2019-20,11824,712,11112,94.0,104,18,17.3
4,All Students,2020-21,15961,818,15143,94.9,92,17,18.5
4,All Students,2021-22,13897,1203,12694,91.3,82,23,28.0
4,All Students,2022-23,16546,1252,15294,92.4,96,22,22.9
5,All Students,2018-19,19159,983,18176,94.9,111,17,15.3
5,All Students,2019-20,13103,647,12456,95.1,115,15,13.0
5,All Students,2020-21,16843,396,16447,97.6,97,5,5.2
5,All Students,2021-22,14115,1342,12773,90.5,83,30,36.1
5,All Students,2022-23,13089,921,12168,93.0,75,19,25.3
All Grades,All Students,2018-19,43133,5245,37888,87.8,268,136,50.7
All Grades,All Students,2019-20,24398,3076,21322,87.4,225,112,49.8
All Grades,All Students,2020-21,34444,8154,26290,76.3,202,155,76.7
All Grades,All Students,2021-22,38447,7154,31293,81.4,240,167,69.6
All Grades,All Students,2022-23,37401,6781,30620,81.9,230,156,67.8
PK in K-12 Schools,All Students,2018-19,3326,504,2822,84.8,23,14,60.9
PK in K-12 Schools,All Students,2019-20,2133,368,1765,82.7,20,14,70.0
PK in K-12 Schools,All Students,2020-21,2263,731,1532,67.7,13,11,84.6
PK in K-12 Schools,All Students,2021-22,5347,1133,4214,78.8,35,29,82.9
PK in K-12 Schools,All Students,2022-23,5137,1101,4036,78.6,31,25,80.6
0K,All Students,2018-19,7802,1094,6708,86.0,46,26,56.5
0K,All Students,2019-20,3996,563,3433,85.9,36,19,52.8
0K,All Students,2020-21,5080,1492,3588,70.6,29,23,79.3
0K,All Students,2021-22,6289,1229,5060,80.5,42,29,69.0
0K,All Students,2022-23,4012,652,3360,83.7,25,19,76.0
1,All Students,2018-19,5826,531,5295,90.9,39,15,38.5
1,All Students,2019-20,4774,592,4182,87.6,45,28,62.2
1,All Students,2020-21,6348,1439,4909,77.3,37,28,75.7
1,All Students,2021-22,5674,1243,4431,78.1,35,25,71.4
1,All Students,2022-23,6984,1391,5593,80.1,44,31,70.5
2,All Students,2018-19,5462,818,4644,85.0,35,22,62.9
2,All Students,2019-20,3310,338,2972,89.8,31,11,35.5
2,All Students,2020-21,6423,1093,5330,83.0,38,26,68.4
2,All Students,2021-22,7188,1218,5970,83.1,44,29,65.9
2,All Students,2022-23,5512,1080,4432,80.4,33,21,63.6
3,All Students,2018-19,7134,946,6188,86.7,44,26,59.1
3,All Students,2019-20,2879,447,2432,84.5,25,16,64.0
3,All Students,2020-21,4409,929,3480,78.9,26,19,73.1
3,All Students,2021-22,5425,901,4524,83.4,32,19,59.4
3,All Students,2022-23,6651,1200,5451,82.0,44,31,70.5
4,All Students,2018-19,6232,597,5635,90.4,37,15,40.5
4,All Students,2019-20,4232,474,3758,88.8,39,14,35.9
4,All Students,2020-21,4005,1103,2902,72.5,24,23,95.8
4,All Students,2021-22,4241,704,3537,83.4,25,17,68.0
4,All Students,2022-23,4978,686,4292,86.2,29,14,48.3
5,All Students,2018-19,7351,755,6596,89.7,44,18,40.9
5,All Students,2019-20,3074,294,2780,90.4,29,10,34.5
5,All Students,2020-21,5916,1367,4549,76.9,35,25,71.4
5,All Students,2021-22,4283,726,3557,83.0,27,19,70.4
5,All Students,2022-23,4127,671,3456,83.7,24,15,62.5
All Grades,All Students,2018-19,52707,9695,43012,81.6,314,152,48.4
All Grades,All Students,2019-20,33905,5854,28051,82.7,317,143,45.1
All Grades,All Students,2020-21,55101,5669,49432,89.7,332,77,23.2
All Grades,All Students,2021-22,48712,12154,36558,75.0,316,234,74.1
All Grades,All Students,2022-23,39418,8926,30492,77.4,255,164,64.3
6,All Students,2018-19,4652,571,4081,87.7,27,13,48.1
6,All Students,2019-20,3983,479,3504,88.0,40,17,42.5
6,All Students,2020-21,5609,369,5240,93.4,34,9,26.5
6,All Students,2021-22,4405,788,3617,82.1,33,26,78.8
6,All Students,2022-23,3130,503,2627,83.9,19,12,63.2
7,All Students,2018-19,5585,526,5059,90.6,32,12,37.5
7,All Students,2019-20,2931,308,2623,89.5,28,12,42.9
7,All Students,2020-21,6091,531,5560,91.3,36,8,22.2
7,All Students,2021-22,5003,785,4218,84.3,31,16,51.6
7,All Students,2022-23,3773,624,3149,83.5,23,18,78.3
8,All Students,2018-19,5429,430,4999,92.1,33,10,30.3
8,All Students,2019-20,3634,305,3329,91.6,33,8,24.2
8,All Students,2020-21,4757,455,4302,90.4,29,7,24.1
8,All Students,2021-22,6192,1323,4869,78.6,39,28,71.8
8,All Students,2022-23,3855,665,3190,82.7,27,15,55.6
9,All Students,2018-19,10187,2158,8029,78.8,60,34,56.7
9,All Students,2019-20,6102,1015,5087,83.4,56,26,46.4
9,All Students,2020-21,11075,848,10227,92.3,66,12,18.2
9,All Students,2021-22,8651,1664,6987,80.8,56,38,67.9
9,All Students,2022-23,7226,1468,5758,79.7,49,30,61.2
10,All Students,2018-19,8190,951,7239,88.4,53,21,39.6
10,All Students,2019-20,6197,1270,4927,79.5,58,31,53.4
10,All Students,2020-21,9208,940,8268,89.8,55,14,25.5
10,All Students,2021-22,9219,2505,6714,72.8,58,40,69.0
10,All Students,2022-23,6852,1318,5534,80.8,45,29,64.4
11,All Students,2018-19,9457,2257,7200,76.1,54,24,44.4
11,All Students,2019-20,5047,534,4513,89.4,46,15,32.6
11,All Students,2020-21,8295,541,7754,93.5,49,8,16.3
11,All Students,2021-22,8341,2573,5768,69.2,50,41,82.0
11,All Students,2022-23,6901,1792,5109,74.0,41,22,53.7
12,All Students,2018-19,9207,2802,6405,69.6,55,38,69.1
12,All Students,2019-20,6011,1943,4068,67.7,56,34,60.7
12,All Students,2020-21,10066,1985,8081,80.3,63,19,30.2
12,All Students,2021-22,6901,2516,4385,63.5,49,45,91.8
12,All Students,2022-23,7681,2556,5125,66.7,51,38,74.5
All Grades,All Students,2018-19,27606,2317,25289,91.6,165,49,29.7
All Grades,All Students,2019-20,18876,1633,17243,91.3,172,48,27.9
All Grades,All Students,2020-21,26039,1857,24182,92.9,152,26,17.1
All Grades,All Students,2021-22,19094,3065,16029,83.9,115,81,70.4
All Grades,All Students,2022-23,12202,1470,10732,88.0,71,38,53.5
6,All Students,2018-19,12734,1146,11588,91.0,76,24,31.6
6,All Students,2019-20,6915,642,6273,90.7,64,18,28.1
6,All Students,2020-21,6310,805,5505,87.2,37,11,29.7
6,All Students,2021-22,4338,567,3771,86.9,25,14,56.0
6,All Students,2022-23,3321,431,2890,87.0,21,10,47.6
7,All Students,2018-19,7669,633,7036,91.7,47,14,29.8
7,All Students,2019-20,6921,535,6386,92.3,62,17,27.4
7,All Students,2020-21,9735,504,9231,94.8,57,7,12.3
7,All Students,2021-22,5636,1020,4616,81.9,35,25,71.4
7,All Students,2022-23,4073,413,3660,89.9,23,12,52.2
8,All Students,2018-19,7203,538,6665,92.5,42,11,26.2
8,All Students,2019-20,5040,456,4584,91.0,46,13,28.3
8,All Students,2020-21,9994,548,9446,94.5,58,8,13.8
8,All Students,2021-22,9120,1478,7642,83.8,55,42,76.4
8,All Students,2022-23,4808,626,4182,87.0,27,16,59.3
All Grades,All Students,2018-19,19812,2305,17507,88.4,131,67,51.1
All Grades,All Students,2019-20,11288,1234,10054,89.1,111,55,49.5
All Grades,All Students,2020-21,16563,1839,14724,88.9,98,28,28.6
All Grades,All Students,2021-22,17733,3076,14657,82.7,112,82,73.2
All Grades,All Students,2022-23,16803,2909,13894,82.7,103,74,71.8
PK in K-12 Schools,All Students,2018-19,2803,429,2374,84.7,18,13,72.2
PK in K-12 Schools,All Students,2019-20,1343,203,1140,84.9,16,11,68.8
PK in K-12 Schools,All Students,2020-21,1928,86,1842,95.5,12,1,8.3
PK in K-12 Schools,All Students,2021-22,4662,837,3825,82.0,30,23,76.7
PK in K-12 Schools,All Students,2022-23,5237,834,4403,84.1,33,23,69.7
0K,All Students,2018-19,1983,323,1660,83.7,14,8,57.1
0K,All Students,2019-20,1388,184,1204,86.7,14,7,50.0
0K,All Students,2020-21,2272,213,2059,90.6,13,2,15.4
0K,All Students,2021-22,1702,337,1365,80.2,11,11,100.0
0K,All Students,2022-23,1436,244,1192,83.0,10,7,70.0
1,All Students,2018-19,2242,231,2011,89.7,17,8,47.1
1,All Students,2019-20,1520,178,1342,88.3,15,9,60.0
1,All Students,2020-21,1701,163,1538,90.4,11,5,45.5
1,All Students,2021-22,1807,305,1502,83.1,11,8,72.7
1,All Students,2022-23,1544,362,1182,76.6,9,9,100.0
2,All Students,2018-19,3718,407,3311,89.1,24,13,54.2
2,All Students,2019-20,1171,s,s,s,s,s,s
2,All Students,2020-21,2601,417,2184,84.0,15,6,40.0
2,All Students,2021-22,1449,320,1129,77.9,11,8,72.7
2,All Students,2022-23,1408,125,1283,91.1,8,3,37.5
3,All Students,2018-19,3336,327,3009,90.2,20,11,55.0
3,All Students,2019-20,2334,221,2113,90.5,22,10,45.5
3,All Students,2020-21,1925,245,1680,87.3,11,3,27.3
3,All Students,2021-22,2428,421,2007,82.7,14,9,64.3
3,All Students,2022-23,1772,395,1377,77.7,11,9,81.8
4,All Students,2018-19,3298,340,2958,89.7,22,7,31.8
4,All Students,2019-20,1866,203,1663,89.1,17,10,58.8
4,All Students,2020-21,3500,255,3245,92.7,20,4,20.0
4,All Students,2021-22,2650,477,2173,82.0,17,14,82.4
4,All Students,2022-23,2939,513,2426,82.5,18,12,66.7
5,All Students,2018-19,2432,248,2184,89.8,16,7,43.8
5,All Students,2019-20,1660,122,1538,92.7,16,4,25.0
5,All Students,2020-21,2636,460,2176,82.5,16,7,43.8
5,All Students,2021-22,3035,379,2656,87.5,18,9,50.0
5,All Students,2022-23,2467,436,2031,82.3,14,11,78.6
6,All Students,2019-20,6,s,s,s,s,s,s
All Grades,All Students,2018-19,114533,9636,104897,91.6,683,200,29.3
All Grades,All Students,2019-20,66594,5349,61245,92.0,595,146,24.5
All Grades,All Students,2020-21,80091,6295,73796,92.1,483,117,24.2
All Grades,All Students,2021-22,84445,8365,76080,90.1,499,191,38.3
All Grades,All Students,2022-23,88722,8162,80560,90.8,523,179,34.2
PK in K-12 Schools,All Students,2018-19,14470,1351,13119,90.7,85,26,30.6
PK in K-12 Schools,All Students,2019-20,9891,801,9090,91.9,90,25,27.8
PK in K-12 Schools,All Students,2020-21,10060,1599,8461,84.1,69,36,52.2
PK in K-12 Schools,All Students,2021-22,14212,1738,12474,87.8,83,39,47.0
PK in K-12 Schools,All Students,2022-23,14635,1428,13207,90.2,86,39,45.3
0K,All Students,2018-19,18597,1409,17188,92.4,114,26,22.8
0K,All Students,2019-20,10246,791,9455,92.3,91,23,25.3
0K,All Students,2020-21,14425,991,13434,93.1,89,16,18.0
0K,All Students,2021-22,13873,1253,12620,91.0,82,33,40.2
0K,All Students,2022-23,14091,1427,12664,89.9,85,24,28.2
1,All Students,2018-19,12200,914,11286,92.5,72,20,27.8
1,All Students,2019-20,10194,858,9336,91.6,93,23,24.7
1,All Students,2020-21,12053,784,11269,93.5,70,11,15.7
1,All Students,2021-22,12668,1064,11604,91.6,75,21,28.0
1,All Students,2022-23,13703,1412,12291,89.7,80,37,46.3
2,All Students,2018-19,13293,1069,12224,92.0,79,24,30.4
2,All Students,2019-20,7524,555,6969,92.6,68,16,23.5
2,All Students,2020-21,14075,821,13254,94.2,83,15,18.1
2,All Students,2021-22,11320,1054,10266,90.7,69,24,34.8
2,All Students,2022-23,12598,1002,11596,92.0,72,17,23.6
3,All Students,2018-19,10795,816,9979,92.4,62,16,25.8
3,All Students,2019-20,7714,702,7012,90.9,70,17,24.3
3,All Students,2020-21,9834,781,9053,92.1,58,16,27.6
3,All Students,2021-22,13088,1137,11951,91.3,77,24,31.2
3,All Students,2022-23,11309,1071,10238,90.5,67,25,37.3
4,All Students,2018-19,13402,728,12674,94.6,82,10,12.2
4,All Students,2019-20,5992,s,s,s,s,s,s
4,All Students,2020-21,10852,768,10084,92.9,62,12,19.4
4,All Students,2021-22,9357,s,s,s,s,s,s
4,All Students,2022-23,13168,1078,12090,91.8,77,21,27.3
5,All Students,2018-19,11821,1211,10610,89.8,72,31,43.1
5,All Students,2019-20,8586,445,8141,94.8,75,8,10.7
5,All Students,2020-21,8783,s,s,s,s,s,s
5,All Students,2021-22,9760,1196,8564,87.7,57,29,50.9
5,All Students,2022-23,9218,744,8474,91.9,56,16,28.6
6,All Students,2019-20,9,s,s,s,s,s,s
6,All Students,2020-21,9,s,s,s,s,s,s
6,All Students,2021-22,167,s,s,s,s,s,s
7,All Students,2018-19,9983,1020,8963,89.8,59,22,37.3
8,All Students,2018-19,9869,s,s,s,s,s,s
8,All Students,2019-20,6438,758,5680,88.2,56,25,44.6
9,All Students,2018-19,103,s,s,s,s,s,s
All Grades,All Students,2018-19,25769,3024,22745,88.3,156,85,54.5
All Grades,All Students,2019-20,13875,1531,12344,89.0,131,56,42.7
All Grades,All Students,2020-21,20683,1808,18875,91.3,126,46,36.5
All Grades,All Students,2021-22,23433,4203,19230,82.1,148,108,73.0
All Grades,All Students,2022-23,23502,3471,20031,85.2,146,86,58.9
PK in K-12 Schools,All Students,2018-19,3147,469,2678,85.1,20,14,70.0
PK in K-12 Schools,All Students,2019-20,1751,226,1525,87.1,17,9,52.9
PK in K-12 Schools,All Students,2020-21,1807,139,1668,92.3,13,4,30.8
PK in K-12 Schools,All Students,2021-22,5570,1167,4403,79.0,36,27,75.0
PK in K-12 Schools,All Students,2022-23,5223,871,4352,83.3,33,21,63.6
0K,All Students,2018-19,1413,222,1191,84.3,9,6,66.7
0K,All Students,2019-20,2458,358,2100,85.4,24,16,66.7
0K,All Students,2020-21,2710,214,2496,92.1,17,5,29.4
0K,All Students,2021-22,3140,463,2677,85.3,21,11,52.4
0K,All Students,2022-23,3455,555,2900,83.9,21,15,71.4
1,All Students,2018-19,4097,486,3611,88.1,23,12,52.2
1,All Students,2019-20,920,145,775,84.2,8,5,62.5
1,All Students,2020-21,3802,446,3356,88.3,23,12,52.2
1,All Students,2021-22,2973,484,2489,83.7,19,15,78.9
1,All Students,2022-23,2347,348,1999,85.2,16,10,62.5
2,All Students,2018-19,5040,557,4483,88.9,30,17,56.7
2,All Students,2019-20,1852,189,1663,89.8,16,8,50.0
2,All Students,2020-21,1645,171,1474,89.6,10,4,40.0
2,All Students,2021-22,3314,713,2601,78.5,22,18,81.8
2,All Students,2022-23,3755,503,3252,86.6,23,14,60.9
3,All Students,2018-19,3190,312,2878,90.2,19,9,47.4
3,All Students,2019-20,3005,277,2728,90.8,29,7,24.1
3,All Students,2020-21,2743,179,2564,93.5,16,3,18.8
3,All Students,2021-22,2039,382,1657,81.3,13,10,76.9
3,All Students,2022-23,3610,535,3075,85.2,23,10,43.5
4,All Students,2018-19,2929,313,2616,89.3,19,9,47.4
4,All Students,2019-20,1935,163,1772,91.6,20,6,30.0
4,All Students,2020-21,4533,405,4128,91.1,27,12,44.4
4,All Students,2021-22,2478,397,2081,84.0,14,10,71.4
4,All Students,2022-23,1745,255,1490,85.4,11,8,72.7
5,All Students,2018-19,5953,665,5288,88.8,36,18,50.0
5,All Students,2019-20,1954,173,1781,91.1,17,5,29.4
5,All Students,2020-21,3443,254,3189,92.6,20,6,30.0
5,All Students,2021-22,3919,597,3322,84.8,23,17,73.9
5,All Students,2022-23,3367,404,2963,88.0,19,8,42.1
All Grades,All Students,2018-19,17003,1898,15105,88.8,104,49,47.1
All Grades,All Students,2019-20,10102,947,9155,90.6,94,37,39.4
All Grades,All Students,2020-21,14436,1445,12991,90.0,86,31,36.0
All Grades,All Students,2021-22,13364,2261,11103,83.1,80,48,60.0
All Grades,All Students,2022-23,16647,2503,14144,85.0,104,69,66.3
6,All Students,2018-19,4920,546,4374,88.9,33,17,51.5
6,All Students,2019-20,3031,s,s,s,s,s,s
6,All Students,2020-21,5470,431,5039,92.1,33,8,24.2
6,All Students,2021-22,4580,816,3764,82.2,26,16,61.5
6,All Students,2022-23,7360,973,6387,86.8,46,28,60.9
7,All Students,2018-19,5651,628,5023,88.9,34,15,44.1
7,All Students,2019-20,3720,376,3344,89.9,34,17,50.0
7,All Students,2020-21,3855,322,3533,91.6,22,7,31.8
7,All Students,2021-22,4733,879,3854,81.4,30,19,63.3
7,All Students,2022-23,4023,683,3340,83.0,25,20,80.0
8,All Students,2018-19,6432,724,5708,88.7,37,17,45.9
8,All Students,2019-20,3342,322,3020,90.4,31,12,38.7
8,All Students,2020-21,5111,692,4419,86.5,31,16,51.6
8,All Students,2021-22,4051,566,3485,86.0,24,13,54.2
8,All Students,2022-23,5264,847,4417,83.9,33,21,63.6
9,All Students,2019-20,9,s,s,s,s,s,s
All Grades,All Students,2018-19,25589,3211,22378,87.5,160,78,48.8
All Grades,All Students,2019-20,12450,1391,11059,88.8,118,56,47.5
PK in K-12 Schools,All Students,2018-19,2534,420,2114,83.4,16,10,62.5
PK in K-12 Schools,All Students,2019-20,1048,151,897,85.6,10,7,70.0
0K,All Students,2018-19,2734,322,2412,88.2,18,9,50.0
0K,All Students,2019-20,1504,189,1315,87.4,14,7,50.0
1,All Students,2018-19,3832,513,3319,86.6,25,16,64.0
1,All Students,2019-20,1353,170,1183,87.4,14,8,57.1
2,All Students,2018-19,3717,537,3180,85.6,23,8,34.8
2,All Students,2019-20,1910,244,1666,87.2,17,12,70.6
3,All Students,2018-19,3607,389,3218,89.2,24,12,50.0
3,All Students,2019-20,1397,116,1281,91.7,14,3,21.4
4,All Students,2018-19,4489,541,3948,87.9,27,10,37.0
4,All Students,2019-20,2131,188,1943,91.2,19,7,36.8
5,All Students,2018-19,4676,489,4187,89.5,27,13,48.1
5,All Students,2019-20,3107,333,2774,89.3,30,12,40.0
All Grades,All Students,2018-19,65642,6500,59142,90.1,407,160,39.3
All Grades,All Students,2019-20,42060,4095,37965,90.3,378,144,38.1
All Grades,All Students,2020-21,56330,8347,47983,85.2,342,143,41.8
All Grades,All Students,2021-22,58641,9432,49209,83.9,354,225,63.6
All Grades,All Students,2022-23,56238,7689,48549,86.3,338,185,54.7
PK in K-12 Schools,All Students,2018-19,8128,924,7204,88.6,52,26,50.0
PK in K-12 Schools,All Students,2019-20,7694,734,6960,90.5,69,23,33.3
PK in K-12 Schools,All Students,2020-21,6996,585,6411,91.6,46,12,26.1
PK in K-12 Schools,All Students,2021-22,9521,1757,7764,81.5,61,48,78.7
PK in K-12 Schools,All Students,2022-23,10288,1475,8813,85.7,61,34,55.7
0K,All Students,2018-19,9280,1130,8150,87.8,62,32,51.6
0K,All Students,2019-20,3998,480,3518,88.0,36,17,47.2
0K,All Students,2020-21,7106,1287,5819,81.9,46,19,41.3
0K,All Students,2021-22,8673,1477,7196,83.0,52,33,63.5
0K,All Students,2022-23,7693,1090,6603,85.8,48,28,58.3
1,All Students,2018-19,10509,987,9522,90.6,63,22,34.9
1,All Students,2019-20,5664,511,5153,91.0,51,19,37.3
1,All Students,2020-21,6459,1204,5255,81.4,39,17,43.6
1,All Students,2021-22,6868,1040,5828,84.9,41,26,63.4
1,All Students,2022-23,6762,934,5828,86.2,41,21,51.2
2,All Students,2018-19,9324,903,8421,90.3,60,23,38.3
2,All Students,2019-20,6814,674,6140,90.1,61,22,36.1
2,All Students,2020-21,9242,1644,7598,82.2,53,29,54.7
2,All Students,2021-22,7114,1208,5906,83.0,45,32,71.1
2,All Students,2022-23,6066,859,5207,85.8,37,20,54.1
3,All Students,2018-19,7997,700,7297,91.2,48,13,27.1
3,All Students,2019-20,5730,478,5252,91.7,53,17,32.1
3,All Students,2020-21,9778,1115,8663,88.6,60,25,41.7
3,All Students,2021-22,9122,1392,7730,84.7,53,30,56.6
3,All Students,2022-23,6536,944,5592,85.6,39,23,59.0
4,All Students,2018-19,10288,979,9309,90.5,63,25,39.7
4,All Students,2019-20,5487,514,4973,90.6,48,19,39.6
4,All Students,2020-21,9041,1332,7709,85.3,53,21,39.6
4,All Students,2021-22,9011,1342,7669,85.1,53,30,56.6
4,All Students,2022-23,9210,1195,8015,87.0,56,29,51.8
5,All Students,2018-19,10116,877,9239,91.3,59,19,32.2
5,All Students,2019-20,6673,704,5969,89.5,60,27,45.0
5,All Students,2020-21,7708,1180,6528,84.7,45,20,44.4
5,All Students,2021-22,8332,1216,7116,85.4,49,26,53.1
5,All Students,2022-23,9683,1192,8491,87.7,56,30,53.6
All Grades,All Students,2018-19,48792,3282,45510,93.3,277,65,23.5
All Grades,All Students,2019-20,32427,2088,30339,93.6,289,67,23.2
All Grades,All Students,2020-21,49336,1425,47911,97.1,283,19,6.7
All Grades,All Students,2021-22,46948,4310,42638,90.8,273,88,32.2
All Grades,All Students,2022-23,48334,4676,43658,90.3,283,106,37.5
6,All Students,2018-19,17637,1108,16529,93.7,100,25,25.0
6,All Students,2019-20,11613,775,10838,93.3,106,26,24.5
6,All Students,2020-21,17057,413,16644,97.6,98,5,5.1
6,All Students,2021-22,16780,1935,14845,88.5,98,44,44.9
6,All Students,2022-23,18264,1717,16547,90.6,108,38,35.2
7,All Students,2018-19,16495,1037,15458,93.7,93,18,19.4
7,All Students,2019-20,10789,656,10133,93.9,95,21,22.1
7,All Students,2020-21,16004,579,15425,96.4,92,9,9.8
7,All Students,2021-22,15527,1082,14445,93.0,89,20,22.5
7,All Students,2022-23,15284,1509,13775,90.1,90,33,36.7
8,All Students,2018-19,14660,1137,13523,92.2,84,22,26.2
8,All Students,2019-20,10025,657,9368,93.4,88,20,22.7
8,All Students,2020-21,16275,433,15842,97.3,93,5,5.4
8,All Students,2021-22,14641,1293,13348,91.2,86,24,27.9
8,All Students,2022-23,14786,1450,13336,90.2,85,35,41.2
All Grades,All Students,2018-19,32982,6231,26751,81.1,213,111,52.1
All Grades,All Students,2019-20,20813,4343,16470,79.1,197,99,50.3
All Grades,All Students,2020-21,28753,5813,22940,79.8,177,91,51.4
All Grades,All Students,2021-22,24476,4631,19845,81.1,180,120,66.7
All Grades,All Students,2022-23,14821,3050,11771,79.4,111,67,60.4
9,All Students,2018-19,11672,2222,9450,81.0,76,35,46.1
9,All Students,2019-20,6366,1337,5029,79.0,61,32,52.5
9,All Students,2020-21,9546,2492,7054,73.9,56,33,58.9
9,All Students,2021-22,8984,1804,7180,79.9,59,37,62.7
9,All Students,2022-23,3434,662,2772,80.7,25,13,52.0
10,All Students,2018-19,6159,1825,4334,70.4,40,31,77.5
10,All Students,2019-20,7094,1221,5873,82.8,68,29,42.6
10,All Students,2020-21,8143,1307,6836,83.9,48,20,41.7
10,All Students,2021-22,4038,935,3103,76.8,28,20,71.4
10,All Students,2022-23,5927,1206,4721,79.7,42,26,61.9
11,All Students,2018-19,7749,1000,6749,87.1,51,22,43.1
11,All Students,2019-20,2289,765,1524,66.6,21,14,66.7
11,All Students,2020-21,9115,1558,7557,82.9,55,26,47.3
11,All Students,2021-22,6496,998,5498,84.6,44,27,61.4
11,All Students,2022-23,3417,722,2695,78.9,22,17,77.3
12,All Students,2018-19,7402,1184,6218,84.0,46,23,50.0
12,All Students,2019-20,5064,1020,4044,79.9,47,24,51.1
12,All Students,2020-21,1949,456,1493,76.6,18,12,66.7
12,All Students,2021-22,4958,894,4064,82.0,49,36,73.5
12,All Students,2022-23,2043,460,1583,77.5,22,11,50.0
All Grades,All Students,2018-19,28957,2828,26129,90.2,170,64,37.6
All Grades,All Students,2019-20,19958,1493,18465,92.5,184,52,28.3
All Grades,All Students,2020-21,32889,1589,31300,95.2,197,31,15.7
All Grades,All Students,2021-22,34540,3981,30559,88.5,203,81,39.9
All Grades,All Students,2022-23,30111,3298,26813,89.0,177,69,39.0
6,All Students,2018-19,9495,948,8547,90.0,58,21,36.2
6,All Students,2019-20,8249,570,7679,93.1,75,18,24.0
6,All Students,2020-21,11133,363,10770,96.7,68,8,11.8
6,All Students,2021-22,11950,1194,10756,90.0,70,23,32.9
6,All Students,2022-23,8461,901,7560,89.4,51,21,41.2
7,All Students,2018-19,9246,875,8371,90.5,53,22,41.5
7,All Students,2019-20,6011,483,5528,92.0,55,17,30.9
7,All Students,2020-21,12845,781,12064,93.9,76,12,15.8
7,All Students,2021-22,10390,940,9450,91.0,63,20,31.7
7,All Students,2022-23,11353,1202,10151,89.4,65,21,32.3
8,All Students,2018-19,10216,1005,9211,90.2,59,21,35.6
8,All Students,2019-20,5698,440,5258,92.3,54,17,31.5
8,All Students,2020-21,8911,445,8466,95.0,53,11,20.8
8,All Students,2021-22,12200,1847,10353,84.9,70,38,54.3
8,All Students,2022-23,10297,1195,9102,88.4,61,27,44.3
All Grades,All Students,2018-19,68550,10721,57829,84.4,440,205,46.6
All Grades,All Students,2019-20,49900,6785,43115,86.4,472,203,43.0
All Grades,All Students,2020-21,94496,23456,71040,75.2,550,294,53.5
All Grades,All Students,2021-22,88763,25790,62973,70.9,541,402,74.3
All Grades,All Students,2022-23,82484,15831,66653,80.8,535,279,52.1
9,All Students,2018-19,16354,3243,13111,80.2,112,58,51.8
9,All Students,2019-20,15922,2146,13776,86.5,153,65,42.5
9,All Students,2020-21,24645,5531,19114,77.6,144,69,47.9
9,All Students,2021-22,20637,4260,16377,79.4,128,81,63.3
9,All Students,2022-23,18285,3255,15030,82.2,124,64,51.6
10,All Students,2018-19,20815,2992,17823,85.6,136,63,46.3
10,All Students,2019-20,10225,1536,8689,85.0,98,46,46.9
10,All Students,2020-21,28067,5868,22199,79.1,164,73,44.5
10,All Students,2021-22,22604,6527,16077,71.1,142,104,73.2
10,All Students,2022-23,20463,3158,17305,84.6,135,63,46.7
11,All Students,2018-19,18115,2648,15467,85.4,113,51,45.1
11,All Students,2019-20,13376,1758,11618,86.9,126,50,39.7
11,All Students,2020-21,19725,6994,12731,64.5,115,86,74.8
11,All Students,2021-22,26350,7635,18715,71.0,159,124,78.0
11,All Students,2022-23,20407,4097,16310,79.9,130,68,52.3
12,All Students,2018-19,13266,1838,11428,86.1,79,33,41.8
12,All Students,2019-20,10377,1345,9032,87.0,95,42,44.2
12,All Students,2020-21,22059,5063,16996,77.0,127,66,52.0
12,All Students,2021-22,19172,7368,11804,61.6,112,93,83.0
12,All Students,2022-23,23329,5321,18008,77.2,146,84,57.5
All Grades,All Students,2018-19,94922,7855,87067,91.7,605,170,28.1
All Grades,All Students,2019-20,64614,4623,59991,92.8,608,140,23.0
All Grades,All Students,2020-21,99533,3773,95760,96.2,595,78,13.1
All Grades,All Students,2021-22,87004,5952,81052,93.2,550,122,22.2
All Grades,All Students,2022-23,81262,5262,76000,93.5,527,109,20.7
8,All Students,2022-23,5,s,s,s,s,s,s
9,All Students,2018-19,28362,1823,26539,93.6,182,35,19.2
9,All Students,2019-20,17784,1011,16773,94.3,167,25,15.0
9,All Students,2020-21,25078,663,24415,97.4,150,11,7.3
9,All Students,2021-22,22786,1212,21574,94.7,147,26,17.7
9,All Students,2022-23,23752,1368,22384,94.2,157,30,19.1
10,All Students,2018-19,28233,2223,26010,92.1,184,49,26.6
10,All Students,2019-20,16888,1137,15751,93.3,160,34,21.3
10,All Students,2020-21,26925,954,25971,96.5,157,24,15.3
10,All Students,2021-22,22479,1374,21105,93.9,140,30,21.4
10,All Students,2022-23,20032,1158,18874,94.2,129,26,20.2
11,All Students,2018-19,20481,1897,18584,90.7,130,42,32.3
11,All Students,2019-20,17603,1245,16358,92.9,163,41,25.2
11,All Students,2020-21,25516,1353,24163,94.7,151,23,15.2
11,All Students,2021-22,24072,1817,22255,92.5,149,33,22.1
11,All Students,2022-23,20605,1326,19279,93.6,132,24,18.2
12,All Students,2018-19,17846,1912,15934,89.3,109,44,40.4
12,All Students,2019-20,12339,1230,11109,90.0,118,40,33.9
12,All Students,2020-21,21991,803,21188,96.3,136,20,14.7
12,All Students,2021-22,17667,1549,16118,91.2,114,33,28.9
12,All Students,2022-23,16868,s,s,s,s,s,s
All Grades,All Students,2018-19,976375,42109,934266,95.7,5938,612,10.3
All Grades,All Students,2019-20,663196,26700,636496,96.0,6043,559,9.3
All Grades,All Students,2020-21,1024625,50640,973985,95.1,5963,625,10.5
All Grades,All Students,2021-22,1006862,73345,933517,92.7,5969,1197,20.1
All Grades,All Students,2022-23,949557,57257,892300,94.0,5949,887,14.9
9,All Students,2018-19,240540,4920,235620,98.0,1465,48,3.3
9,All Students,2019-20,170791,3967,166824,97.7,1557,63,4.0
9,All Students,2020-21,241568,9349,232219,96.1,1415,108,7.6
9,All Students,2021-22,268824,8943,259881,96.7,1589,109,6.9
9,All Students,2022-23,240104,7432,232672,96.9,1505,95,6.3
10,All Students,2018-19,250024,7320,242704,97.1,1522,91,6.0
10,All Students,2019-20,161375,5003,156372,96.9,1472,91,6.2
10,All Students,2020-21,269124,9264,259860,96.6,1562,100,6.4
10,All Students,2021-22,231981,12751,219230,94.5,1373,180,13.1
10,All Students,2022-23,252129,10536,241593,95.8,1576,128,8.1
11,All Students,2018-19,251319,10539,240780,95.8,1527,131,8.6
11,All Students,2019-20,163363,5755,157608,96.5,1487,109,7.3
11,All Students,2020-21,252157,10662,241495,95.8,1457,133,9.1
11,All Students,2021-22,257803,18930,238873,92.7,1527,287,18.8
11,All Students,2022-23,213128,11664,201464,94.5,1334,166,12.4
12,All Students,2018-19,234492,19330,215162,91.8,1424,342,24.0
12,All Students,2019-20,167667,11975,155692,92.9,1527,296,19.4
12,All Students,2020-21,261776,21365,240411,91.8,1529,284,18.6
12,All Students,2021-22,248254,32721,215533,86.8,1480,621,42.0
12,All Students,2022-23,244196,27625,216571,88.7,1534,498,32.5
All Grades,All Students,2018-19,59291,5600,53691,90.6,372,116,31.2
All Grades,All Students,2019-20,36588,3751,32837,89.7,351,128,36.5
All Grades,All Students,2020-21,59867,12941,46926,78.4,355,178,50.1
All Grades,All Students,2021-22,53463,7480,45983,86.0,343,151,44.0
All Grades,All Students,2022-23,49039,6109,42930,87.5,334,135,40.4
9,All Students,2018-19,14683,1230,13453,91.6,97,26,26.8
9,All Students,2019-20,7119,783,6336,89.0,75,29,38.7
9,All Students,2020-21,13973,2252,11721,83.9,87,40,46.0
9,All Students,2021-22,10946,972,9974,91.1,78,21,26.9
9,All Students,2022-23,12504,1587,10917,87.3,101,44,43.6
10,All Students,2018-19,17091,1684,15407,90.1,106,38,35.8
10,All Students,2019-20,11377,1102,10275,90.3,107,38,35.5
10,All Students,2020-21,12353,2995,9358,75.8,74,38,51.4
10,All Students,2021-22,15865,1847,14018,88.4,100,36,36.0
10,All Students,2022-23,14822,1570,13252,89.4,94,34,36.2
11,All Students,2018-19,12495,1175,11320,90.6,78,26,33.3
11,All Students,2019-20,9894,856,9038,91.3,91,29,31.9
11,All Students,2020-21,18786,4422,14364,76.5,109,58,53.2
11,All Students,2021-22,10979,2079,8900,81.1,71,40,56.3
11,All Students,2022-23,13640,1719,11921,87.4,88,36,40.9
12,All Students,2018-19,15022,1511,13511,89.9,91,26,28.6
12,All Students,2019-20,8198,1010,7188,87.7,78,32,41.0
12,All Students,2020-21,14755,3272,11483,77.8,85,42,49.4
12,All Students,2021-22,15673,2582,13091,83.5,94,54,57.4
12,All Students,2022-23,8073,1233,6840,84.7,51,21,41.2
All Grades,All Students,2018-19,72026,8109,63917,88.7,460,178,38.7
All Grades,All Students,2019-20,49181,4277,44904,91.3,463,140,30.2
All Grades,All Students,2020-21,79970,9012,70958,88.7,462,169,36.6
All Grades,All Students,2021-22,75441,13030,62411,82.7,461,290,62.9
All Grades,All Students,2022-23,71105,12504,58601,82.4,459,288,62.7
9,All Students,2018-19,19724,2542,17182,87.1,124,44,35.5
9,All Students,2019-20,13938,1292,12646,90.7,133,35,26.3
9,All Students,2020-21,20601,2780,17821,86.5,119,48,40.3
9,All Students,2021-22,21502,3838,17664,82.2,134,78,58.2
9,All Students,2022-23,16475,2835,13640,82.8,114,67,58.8
10,All Students,2018-19,18804,2152,16652,88.6,126,47,37.3
10,All Students,2019-20,12712,1053,11659,91.7,123,38,30.9
10,All Students,2020-21,22406,2373,20033,89.4,129,42,32.6
10,All Students,2021-22,19158,2869,16289,85.0,118,67,56.8
10,All Students,2022-23,19859,3609,16250,81.8,130,79,60.8
11,All Students,2018-19,17745,1807,15938,89.8,114,42,36.8
11,All Students,2019-20,11106,911,10195,91.8,103,30,29.1
11,All Students,2020-21,18934,1902,17032,90.0,109,37,33.9
11,All Students,2021-22,18948,2696,16252,85.8,113,64,56.6
11,All Students,2022-23,16374,2462,13912,85.0,103,55,53.4
12,All Students,2018-19,15753,1608,14145,89.8,96,45,46.9
12,All Students,2019-20,11425,1021,10404,91.1,104,37,35.6
12,All Students,2020-21,18029,1957,16072,89.1,105,42,40.0
12,All Students,2021-22,15833,3627,12206,77.1,96,81,84.4
12,All Students,2022-23,18397,3598,14799,80.4,112,87,77.7
All Grades,All Students,2018-19,93167,3931,89236,95.8,531,39,7.3
All Grades,All Students,2019-20,59982,2759,57223,95.4,528,51,9.7
All Grades,All Students,2020-21,114035,8542,105493,92.5,671,141,21.0
All Grades,All Students,2021-22,117326,11383,105943,90.3,704,227,32.2
All Grades,All Students,2022-23,125052,11910,113142,90.5,751,244,32.5
PK in K-12 Schools,All Students,2020-21,5971,917,5054,84.6,37,17,45.9
PK in K-12 Schools,All Students,2021-22,5992,750,5242,87.5,36,20,55.6
PK in K-12 Schools,All Students,2022-23,6132,707,5425,88.5,37,17,45.9
0K,All Students,2018-19,8755,474,8281,94.6,50,6,12.0
0K,All Students,2019-20,5751,399,5352,93.1,53,14,26.4
0K,All Students,2020-21,11192,1105,10087,90.1,65,20,30.8
0K,All Students,2021-22,10746,1384,9362,87.1,67,27,40.3
0K,All Students,2022-23,9691,1227,8464,87.3,61,24,39.3
1,All Students,2018-19,9604,422,9182,95.6,54,2,3.7
1,All Students,2019-20,6198,319,5879,94.9,54,5,9.3
1,All Students,2020-21,10908,1274,9634,88.3,65,15,23.1
1,All Students,2021-22,11492,1174,10318,89.8,71,25,35.2
1,All Students,2022-23,12911,1413,11498,89.1,75,26,34.7
2,All Students,2018-19,9787,599,9188,93.9,55,6,10.9
2,All Students,2019-20,6094,354,5740,94.2,53,9,17.0
2,All Students,2020-21,11417,650,10767,94.3,66,8,12.1
2,All Students,2021-22,11282,1122,10160,90.1,65,18,27.7
2,All Students,2022-23,11831,880,10951,92.6,69,16,23.2
3,All Students,2018-19,9419,374,9045,96.0,54,2,3.7
3,All Students,2019-20,6406,342,6064,94.7,57,7,12.3
3,All Students,2020-21,11088,1175,9913,89.4,69,19,27.5
3,All Students,2021-22,12103,1071,11032,91.2,70,16,22.9
3,All Students,2022-23,12878,1229,11649,90.5,75,32,42.7
4,All Students,2018-19,10079,365,9714,96.4,59,4,6.8
4,All Students,2019-20,5970,249,5721,95.8,52,2,3.8
4,All Students,2020-21,11826,681,11145,94.2,69,16,23.2
4,All Students,2021-22,11776,1117,10659,90.5,68,24,35.3
4,All Students,2022-23,13192,896,12296,93.2,77,15,19.5
5,All Students,2018-19,10858,495,10363,95.4,61,6,9.8
5,All Students,2019-20,7015,291,6724,95.9,61,3,4.9
5,All Students,2020-21,12170,602,11568,95.1,71,9,12.7
5,All Students,2021-22,11856,936,10920,92.1,70,17,24.3
5,All Students,2022-23,12798,1139,11659,91.1,74,23,31.1
6,All Students,2018-19,11599,445,11154,96.2,66,4,6.1
6,All Students,2019-20,7499,377,7122,95.0,66,7,10.6
6,All Students,2020-21,17540,1107,16433,93.7,102,20,19.6
6,All Students,2021-22,15696,1391,14305,91.1,100,31,31.0
6,All Students,2022-23,16476,1624,14852,90.1,103,34,33.0
7,All Students,2018-19,11788,286,11502,97.6,67,1,1.5
7,All Students,2019-20,7340,141,7199,98.1,65,1,1.5
7,All Students,2020-21,11162,518,10644,95.4,64,9,14.1
7,All Students,2021-22,16410,1519,14891,90.7,98,28,28.6
7,All Students,2022-23,14029,1207,12822,91.4,88,23,26.1
8,All Students,2018-19,11278,471,10807,95.8,65,8,12.3
8,All Students,2019-20,7709,287,7422,96.3,67,3,4.5
8,All Students,2020-21,10761,513,10248,95.2,63,8,12.7
8,All Students,2021-22,9973,919,9054,90.8,59,21,35.6
8,All Students,2022-23,15114,1588,13526,89.5,92,34,37.0
All Grades,All Students,2018-19,23095,6944,16151,69.9,159,114,71.7
All Grades,All Students,2019-20,11400,4064,7336,64.4,108,84,77.8
9,All Students,2018-19,6820,2828,3992,58.5,48,36,75.0
9,All Students,2019-20,4069,1564,2505,61.6,39,29,74.4
10,All Students,2018-19,4807,1704,3103,64.6,35,30,85.7
10,All Students,2019-20,3459,1343,2116,61.2,31,24,77.4
11,All Students,2018-19,5192,1356,3836,73.9,36,24,66.7
11,All Students,2019-20,1397,453,944,67.6,14,11,78.6
12,All Students,2018-19,6276,1056,5220,83.2,40,24,60.0
12,All Students,2019-20,2475,704,1771,71.6,24,20,83.3
All Grades,All Students,2018-19,84949,10258,74691,87.9,510,222,43.5
All Grades,All Students,2019-20,52930,4962,47968,90.6,490,157,32.0
All Grades,All Students,2020-21,85916,11215,74701,86.9,499,208,41.7
All Grades,All Students,2021-22,80459,13806,66653,82.8,493,319,64.7
All Grades,All Students,2022-23,71561,11619,59942,83.8,454,253,55.7
6,All Students,2018-19,13098,1113,11985,91.5,79,28,35.4
6,All Students,2019-20,5151,335,4816,93.5,50,8,16.0
6,All Students,2020-21,11573,1329,10244,88.5,67,26,38.8
6,All Students,2021-22,6624,986,5638,85.1,39,28,71.8
6,All Students,2022-23,6539,673,5866,89.7,40,18,45.0
7,All Students,2018-19,12673,1050,11623,91.7,73,28,38.4
7,All Students,2019-20,7692,547,7145,92.9,70,17,24.3
7,All Students,2020-21,7786,1058,6728,86.4,45,21,46.7
7,All Students,2021-22,11065,1554,9511,86.0,65,35,53.8
7,All Students,2022-23,6759,1061,5698,84.3,41,24,58.5
8,All Students,2018-19,9979,691,9288,93.1,61,16,26.2
8,All Students,2019-20,8220,550,7670,93.3,74,20,27.0
8,All Students,2020-21,11208,987,10221,91.2,65,18,27.7
8,All Students,2021-22,8307,1163,7144,86.0,53,28,52.8
8,All Students,2022-23,9535,1031,8504,89.2,59,22,37.3
9,All Students,2018-19,11881,1512,10369,87.3,72,27,37.5
9,All Students,2019-20,10022,1077,8945,89.3,96,43,44.8
9,All Students,2020-21,18530,2675,15855,85.6,107,51,47.7
9,All Students,2021-22,12911,2009,10902,84.4,85,48,56.5
9,All Students,2022-23,12391,2006,10385,83.8,82,48,58.5
10,All Students,2018-19,11769,1696,10073,85.6,71,37,52.1
10,All Students,2019-20,7085,682,6403,90.4,66,20,30.3
10,All Students,2020-21,15175,2790,12385,81.6,89,47,52.8
10,All Students,2021-22,17763,2915,14848,83.6,108,68,63.0
10,All Students,2022-23,10565,1876,8689,82.2,69,37,53.6
11,All Students,2018-19,13086,1814,11272,86.1,81,39,48.1
11,All Students,2019-20,7077,865,6212,87.8,65,23,35.4
11,All Students,2020-21,11092,1402,9690,87.4,65,27,41.5
11,All Students,2021-22,13862,3311,10551,76.1,84,65,77.4
11,All Students,2022-23,14548,2373,12175,83.7,93,52,55.9
12,All Students,2018-19,12463,2382,10081,80.9,73,47,64.4
12,All Students,2019-20,7683,906,6777,88.2,69,26,37.7
12,All Students,2020-21,10552,974,9578,90.8,61,18,29.5
12,All Students,2021-22,9927,1868,8059,81.2,59,47,79.7
12,All Students,2022-23,11224,2599,8625,76.8,70,52,74.3
All Grades,All Students,2018-19,28465,5520,22945,80.6,184,109,59.2
All Grades,All Students,2019-20,16669,2789,13880,83.3,164,85,51.8
All Grades,All Students,2020-21,29502,5894,23608,80.0,175,127,72.6
All Grades,All Students,2021-22,34226,9546,24680,72.1,209,171,81.8
All Grades,All Students,2022-23,36795,9223,27572,74.9,231,167,72.3
9,All Students,2018-19,8232,1632,6600,80.2,51,23,45.1
9,All Students,2019-20,3075,315,2760,89.8,32,12,37.5
9,All Students,2020-21,12116,2357,9759,80.5,72,52,72.2
9,All Students,2021-22,14027,2973,11054,78.8,86,61,70.9
9,All Students,2022-23,10605,1921,8684,81.9,68,40,58.8
10,All Students,2018-19,6999,1742,5257,75.1,48,37,77.1
10,All Students,2019-20,4277,661,3616,84.5,40,17,42.5
10,All Students,2020-21,5773,1305,4468,77.4,33,21,63.6
10,All Students,2021-22,9498,2562,6936,73.0,59,49,83.1
10,All Students,2022-23,13100,3058,10042,76.7,80,54,67.5
11,All Students,2018-19,8169,1023,7146,87.5,52,24,46.2
11,All Students,2019-20,3368,650,2718,80.7,34,23,67.6
11,All Students,2020-21,6020,1079,4941,82.1,37,27,73.0
11,All Students,2021-22,5393,1789,3604,66.8,32,29,90.6
11,All Students,2022-23,8386,2586,5800,69.2,54,45,83.3
12,All Students,2018-19,5065,1123,3942,77.8,33,25,75.8
12,All Students,2019-20,5949,1163,4786,80.5,58,33,56.9
12,All Students,2020-21,5593,1153,4440,79.4,33,27,81.8
12,All Students,2021-22,5308,2222,3086,58.1,32,32,100.0
12,All Students,2022-23,4704,1658,3046,64.8,29,28,96.6
All Grades,All Students,2018-19,59388,4683,54705,92.1,377,79,21.0
All Grades,All Students,2019-20,42711,1507,41204,96.5,397,30,7.6
All Grades,All Students,2020-21,67689,4150,63539,93.9,399,83,20.8
All Grades,All Students,2021-22,63540,6192,57348,90.3,394,163,41.4
All Grades,All Students,2022-23,61260,5233,56027,91.5,392,96,24.5
9,All Students,2018-19,16758,1329,15429,92.1,107,17,15.9
9,All Students,2019-20,12646,381,12265,97.0,118,9,7.6
9,All Students,2020-21,17996,866,17130,95.2,104,13,12.5
9,All Students,2021-22,14304,893,13411,93.8,91,21,23.1
9,All Students,2022-23,16144,1150,14994,92.9,101,17,16.8
10,All Students,2018-19,15808,1439,14369,90.9,102,25,24.5
10,All Students,2019-20,11158,378,10780,96.6,104,7,6.7
10,All Students,2020-21,19250,958,18292,95.0,114,20,17.5
10,All Students,2021-22,16196,1476,14720,90.9,100,40,40.0
10,All Students,2022-23,15122,1041,14081,93.1,94,13,13.8
11,All Students,2018-19,14153,682,13471,95.2,87,10,11.5
11,All Students,2019-20,9449,313,9136,96.7,88,7,8.0
11,All Students,2020-21,16982,1005,15977,94.1,98,21,21.4
11,All Students,2021-22,17622,1689,15933,90.4,106,40,37.7
11,All Students,2022-23,14700,866,13834,94.1,92,10,10.9
12,All Students,2018-19,12669,1233,11436,90.3,81,27,33.3
12,All Students,2019-20,9458,435,9023,95.4,87,7,8.0
12,All Students,2020-21,13461,1321,12140,90.2,83,29,34.9
12,All Students,2021-22,15418,2134,13284,86.2,97,62,63.9
12,All Students,2022-23,15294,2176,13118,85.8,105,56,53.3
All Grades,All Students,2018-19,129454,14737,114717,88.6,823,298,36.2
All Grades,All Students,2019-20,82607,9446,73161,88.6,789,294,37.3
All Grades,All Students,2020-21,123932,20008,103924,83.9,725,266,36.7
All Grades,All Students,2021-22,107230,19535,87695,81.8,670,370,55.2
All Grades,All Students,2022-23,90948,12633,78315,86.1,603,242,40.1
9,All Students,2018-19,37596,3728,33868,90.1,246,85,34.6
9,All Students,2019-20,20951,2131,18820,89.8,206,74,35.9
9,All Students,2020-21,28676,4655,24021,83.8,172,67,39.0
9,All Students,2021-22,28011,3914,24097,86.0,175,84,48.0
9,All Students,2022-23,23063,2480,20583,89.2,156,53,34.0
10,All Students,2018-19,35589,4806,30783,86.5,231,82,35.5
10,All Students,2019-20,22141,2663,19478,88.0,212,76,35.8
10,All Students,2020-21,31889,6076,25813,80.9,186,71,38.2
10,All Students,2021-22,25059,4572,20487,81.8,159,81,50.9
10,All Students,2022-23,24376,3030,21346,87.6,165,66,40.0
11,All Students,2018-19,32066,2911,29155,90.9,198,61,30.8
11,All Students,2019-20,20360,2350,18010,88.5,193,62,32.1
11,All Students,2020-21,32416,4529,27887,86.0,189,67,35.4
11,All Students,2021-22,26536,6053,20483,77.2,171,107,62.6
11,All Students,2022-23,22819,3549,19270,84.4,148,65,43.9
12,All Students,2018-19,24203,3292,20911,86.4,148,70,47.3
12,All Students,2019-20,19155,2302,16853,88.0,179,83,46.4
12,All Students,2020-21,30951,4748,26203,84.7,178,61,34.3
12,All Students,2021-22,27624,4996,22628,81.9,165,98,59.4
12,All Students,2022-23,20690,3574,17116,82.7,134,58,43.3
All Grades,All Students,2018-19,133541,14434,119107,89.2,822,304,37.0
All Grades,All Students,2019-20,88592,9017,79575,89.8,828,275,33.2
All Grades,All Students,2020-21,149976,14883,135093,90.1,886,294,33.2
All Grades,All Students,2021-22,136356,20652,115704,84.9,845,453,53.6
All Grades,All Students,2022-23,118269,18927,99342,84.0,772,386,50.0
8,All Students,2018-19,2,s,s,s,s,s,s
9,All Students,2018-19,37260,2583,34677,93.1,228,43,18.9
9,All Students,2019-20,26155,1945,24210,92.6,242,54,22.3
9,All Students,2020-21,40419,4400,36019,89.1,240,85,35.4
9,All Students,2021-22,30587,3330,27257,89.1,189,79,41.8
9,All Students,2022-23,28856,3221,25635,88.8,185,62,33.5
10,All Students,2018-19,37031,4147,32884,88.8,232,77,33.2
10,All Students,2019-20,23693,1818,21875,92.3,222,50,22.5
10,All Students,2020-21,41753,4009,37744,90.4,246,84,34.1
10,All Students,2021-22,36949,5236,31713,85.8,229,110,48.0
10,All Students,2022-23,25305,3741,21564,85.2,161,70,43.5
11,All Students,2018-19,28726,s,s,s,s,s,s
11,All Students,2019-20,22504,2634,19870,88.3,208,79,38.0
11,All Students,2020-21,36174,2941,33233,91.9,210,51,24.3
11,All Students,2021-22,38795,6849,31946,82.3,234,137,58.5
11,All Students,2022-23,32341,6090,26251,81.2,206,116,56.3
12,All Students,2018-19,30522,4229,26293,86.1,185,114,61.6
12,All Students,2019-20,16240,2620,13620,83.9,156,92,59.0
12,All Students,2020-21,31630,3533,28097,88.8,190,74,38.9
12,All Students,2021-22,30025,5237,24788,82.6,193,127,65.8
12,All Students,2022-23,31767,5875,25892,81.5,220,138,62.7
All Grades,All Students,2018-19,69822,6204,63618,91.1,434,120,27.6
All Grades,All Students,2019-20,47131,3188,43943,93.2,448,85,19.0
All Grades,All Students,2020-21,80336,12098,68238,84.9,468,204,43.6
All Grades,All Students,2021-22,78373,11901,66472,84.8,490,248,50.6
All Grades,All Students,2022-23,69861,8483,61378,87.9,440,173,39.3
9,All Students,2018-19,22096,1869,20227,91.5,135,28,20.7
9,All Students,2019-20,11942,970,10972,91.9,117,28,23.9
9,All Students,2020-21,24114,4092,20022,83.0,139,69,49.6
9,All Students,2021-22,20828,2680,18148,87.1,132,61,46.2
9,All Students,2022-23,16024,1354,14670,91.6,101,26,25.7
10,All Students,2018-19,19370,1907,17463,90.2,123,37,30.1
10,All Students,2019-20,12788,945,11843,92.6,122,22,18.0
10,All Students,2020-21,17909,3108,14801,82.6,104,50,48.1
10,All Students,2021-22,21402,3445,17957,83.9,132,66,50.0
10,All Students,2022-23,19449,2591,16858,86.7,126,54,42.9
11,All Students,2018-19,11166,583,10583,94.8,68,9,13.2
11,All Students,2019-20,8857,555,8302,93.7,82,16,19.5
11,All Students,2020-21,17951,2045,15906,88.6,105,42,40.0
11,All Students,2021-22,16522,2783,13739,83.2,105,51,48.6
11,All Students,2022-23,19275,2444,16831,87.3,119,45,37.8
12,All Students,2018-19,17190,1845,15345,89.3,108,46,42.6
12,All Students,2019-20,13544,718,12826,94.7,128,19,14.8
12,All Students,2020-21,20362,2853,17509,86.0,120,43,35.8
12,All Students,2021-22,19621,2993,16628,84.7,121,70,57.9
12,All Students,2022-23,15113,2094,13019,86.1,94,48,51.1
All Grades,All Students,2018-19,38722,5052,33670,87.0,228,106,46.5
All Grades,All Students,2019-20,24080,2572,21508,89.3,219,79,36.1
All Grades,All Students,2020-21,33117,3733,29384,88.7,195,77,39.5
All Grades,All Students,2021-22,28962,4781,24181,83.5,172,107,62.2
All Grades,All Students,2022-23,31436,3988,27448,87.3,189,88,46.6
6,All Students,2018-19,12958,1458,11500,88.7,77,35,45.5
6,All Students,2019-20,6981,848,6133,87.9,65,26,40.0
6,All Students,2020-21,10526,936,9590,91.1,63,23,36.5
6,All Students,2021-22,11304,1837,9467,83.7,68,39,57.4
6,All Students,2022-23,11392,1492,9900,86.9,70,30,42.9
7,All Students,2018-19,12936,1328,11608,89.7,75,26,34.7
7,All Students,2019-20,8704,825,7879,90.5,78,26,33.3
7,All Students,2020-21,9545,s,s,s,s,s,s
7,All Students,2021-22,8399,1237,7162,85.3,50,31,62.0
7,All Students,2022-23,11277,1360,9917,87.9,69,33,47.8
8,All Students,2018-19,12828,2266,10562,82.3,76,45,59.2
8,All Students,2019-20,8395,899,7496,89.3,76,27,35.5
8,All Students,2020-21,13030,1634,11396,87.5,75,31,41.3
8,All Students,2021-22,9259,1707,7552,81.6,54,37,68.5
8,All Students,2022-23,8592,s,s,s,s,s,s
9,All Students,2020-21,16,s,s,s,s,s,s
9,All Students,2022-23,175,s,s,s,s,s,s
All Grades,All Students,2022-23,8409,844,7565,90.0,52,20,38.5
PK in K-12 Schools,All Students,2022-23,8409,844,7565,90.0,52,20,38.5
All Grades,All Students,2019-20,32140,1541,30599,95.2,292,40,13.7
All Grades,All Students,2020-21,51503,2499,49004,95.1,302,37,12.3
All Grades,All Students,2021-22,51523,4144,47379,92.0,305,87,28.5
All Grades,All Students,2022-23,45817,4613,41204,89.9,275,105,38.2
6,All Students,2019-20,14989,681,14308,95.5,138,16,11.6
6,All Students,2020-21,15233,730,14503,95.2,91,11,12.1
6,All Students,2021-22,16147,1299,14848,92.0,97,27,27.8
6,All Students,2022-23,15578,1683,13895,89.2,93,38,40.9
7,All Students,2019-20,8859,414,8445,95.3,80,9,11.3
7,All Students,2020-21,21748,968,20780,95.5,126,14,11.1
7,All Students,2021-22,14669,1159,13510,92.1,85,24,28.2
7,All Students,2022-23,15944,1517,14427,90.5,97,31,32.0
8,All Students,2019-20,8292,446,7846,94.6,74,15,20.3
8,All Students,2020-21,14480,799,13681,94.5,84,12,14.3
8,All Students,2021-22,20707,1686,19021,91.9,123,36,29.3
8,All Students,2022-23,14295,1413,12882,90.1,85,36,42.4
All Grades,All Students,2018-19,39717,3897,35820,90.2,244,103,42.2
All Grades,All Students,2019-20,22130,2120,20010,90.4,210,77,36.7
All Grades,All Students,2020-21,31648,3319,28329,89.5,196,80,40.8
All Grades,All Students,2021-22,33025,4948,28077,85.0,203,129,63.5
All Grades,All Students,2022-23,28187,3302,24885,88.3,179,82,45.8
PK in K-12 Schools,All Students,2018-19,2064,357,1707,82.7,14,11,78.6
PK in K-12 Schools,All Students,2019-20,1275,251,1024,80.3,14,11,78.6
PK in K-12 Schools,All Students,2020-21,170,s,s,s,s,s,s
PK in K-12 Schools,All Students,2021-22,3297,689,2608,79.1,22,17,77.3
PK in K-12 Schools,All Students,2022-23,3863,656,3207,83.0,28,16,57.1
0K,All Students,2018-19,6383,683,5700,89.3,41,21,51.2
0K,All Students,2019-20,3805,553,3252,85.5,37,25,67.6
0K,All Students,2020-21,4971,679,4292,86.3,32,21,65.6
0K,All Students,2021-22,4534,813,3721,82.1,28,21,75.0
0K,All Students,2022-23,3724,464,3260,87.5,23,11,47.8
1,All Students,2018-19,6415,547,5868,91.5,38,12,31.6
1,All Students,2019-20,2659,209,2450,92.1,24,7,29.2
1,All Students,2020-21,4366,572,3794,86.9,30,15,50.0
1,All Students,2021-22,5878,986,4892,83.2,37,26,70.3
1,All Students,2022-23,3780,431,3349,88.6,22,11,50.0
2,All Students,2018-19,7215,684,6531,90.5,44,16,36.4
2,All Students,2019-20,3357,261,3096,92.2,33,12,36.4
2,All Students,2020-21,4256,s,s,s,s,s,s
2,All Students,2021-22,4149,643,3506,84.5,26,18,69.2
2,All Students,2022-23,5253,618,4635,88.2,34,19,55.9
3,All Students,2018-19,6714,601,6113,91.0,42,16,38.1
3,All Students,2019-20,4647,398,4249,91.4,43,12,27.9
3,All Students,2020-21,5421,477,4944,91.2,33,9,27.3
3,All Students,2021-22,3834,461,3373,88.0,23,14,60.9
3,All Students,2022-23,3329,325,3004,90.2,20,5,25.0
4,All Students,2018-19,4611,443,4168,90.4,28,12,42.9
4,All Students,2019-20,3718,260,3458,93.0,33,6,18.2
4,All Students,2020-21,6871,661,6210,90.4,40,11,27.5
4,All Students,2021-22,5402,763,4639,85.9,32,19,59.4
4,All Students,2022-23,3493,353,3140,89.9,23,10,43.5
5,All Students,2018-19,6315,582,5733,90.8,37,15,40.5
5,All Students,2019-20,2669,188,2481,93.0,26,4,15.4
5,All Students,2020-21,5593,580,5013,89.6,34,14,41.2
5,All Students,2021-22,5931,593,5338,90.0,35,14,40.0
5,All Students,2022-23,4745,455,4290,90.4,29,10,34.5
All Grades,All Students,2018-19,53858,4938,48920,90.8,325,116,35.7
All Grades,All Students,2019-20,34433,2916,31517,91.5,318,102,32.1
All Grades,All Students,2020-21,45841,5250,40591,88.5,271,112,41.3
All Grades,All Students,2021-22,37819,4422,33397,88.3,230,111,48.3
All Grades,All Students,2022-23,36165,4108,32057,88.6,220,109,49.5
PK in K-12 Schools,All Students,2018-19,4603,648,3955,85.9,29,17,58.6
PK in K-12 Schools,All Students,2019-20,3773,444,3329,88.2,36,18,50.0
PK in K-12 Schools,All Students,2020-21,4252,557,3695,86.9,27,14,51.9
PK in K-12 Schools,All Students,2021-22,3461,670,2791,80.6,22,18,81.8
PK in K-12 Schools,All Students,2022-23,3622,585,3037,83.8,26,18,69.2
0K,All Students,2018-19,8310,868,7442,89.6,51,23,45.1
0K,All Students,2019-20,4995,505,4490,89.9,47,16,34.0
0K,All Students,2020-21,6779,751,6028,88.9,41,16,39.0
0K,All Students,2021-22,4297,453,3844,89.5,28,13,46.4
0K,All Students,2022-23,4872,671,4201,86.2,30,18,60.0
1,All Students,2018-19,8688,909,7779,89.5,53,20,37.7
1,All Students,2019-20,5293,445,4848,91.6,49,16,32.7
1,All Students,2020-21,6322,854,5468,86.5,38,18,47.4
1,All Students,2021-22,6242,788,5454,87.4,36,21,58.3
1,All Students,2022-23,4348,455,3893,89.5,26,10,38.5
2,All Students,2018-19,7241,609,6632,91.6,44,14,31.8
2,All Students,2019-20,5105,426,4679,91.7,48,18,37.5
2,All Students,2020-21,7342,1052,6290,85.7,42,21,50.0
2,All Students,2021-22,5339,618,4721,88.4,32,15,46.9
2,All Students,2022-23,6141,560,5581,90.9,38,16,42.1
3,All Students,2018-19,8226,637,7589,92.3,48,14,29.2
3,All Students,2019-20,4272,299,3973,93.0,39,11,28.2
3,All Students,2020-21,7175,869,6306,87.9,41,19,46.3
3,All Students,2021-22,6288,584,5704,90.7,38,16,42.1
3,All Students,2022-23,4205,549,3656,86.9,25,17,68.0
4,All Students,2018-19,8706,616,8090,92.9,51,13,25.5
4,All Students,2019-20,5306,408,4898,92.3,47,10,21.3
4,All Students,2020-21,5806,652,5154,88.8,34,15,44.1
4,All Students,2021-22,6495,820,5675,87.4,38,17,44.7
4,All Students,2022-23,6525,670,5855,89.7,37,16,43.2
5,All Students,2018-19,8084,651,7433,91.9,49,15,30.6
5,All Students,2019-20,5689,389,5300,93.2,52,13,25.0
5,All Students,2020-21,8165,515,7650,93.7,48,9,18.8
5,All Students,2021-22,5697,489,5208,91.4,36,11,30.6
5,All Students,2022-23,6452,618,5834,90.4,38,14,36.8
All Grades,All Students,2018-19,34510,3540,30970,89.7,207,80,38.6
All Grades,All Students,2019-20,21570,2230,19340,89.7,205,85,41.5
All Grades,All Students,2020-21,33368,5752,27616,82.8,203,104,51.2
All Grades,All Students,2021-22,34696,5725,28971,83.5,217,136,62.7
All Grades,All Students,2022-23,31672,4037,27635,87.3,193,98,50.8
PK in K-12 Schools,All Students,2018-19,2838,337,2501,88.1,18,9,50.0
PK in K-12 Schools,All Students,2019-20,1662,283,1379,83.0,15,9,60.0
PK in K-12 Schools,All Students,2020-21,2003,490,1513,75.5,12,9,75.0
PK in K-12 Schools,All Students,2021-22,5337,1070,4267,80.0,36,24,66.7
PK in K-12 Schools,All Students,2022-23,5356,861,4495,83.9,35,24,68.6
0K,All Students,2018-19,5888,664,5224,88.7,37,17,45.9
0K,All Students,2019-20,2492,242,2250,90.3,26,12,46.2
0K,All Students,2020-21,5647,1114,4533,80.3,36,17,47.2
0K,All Students,2021-22,3521,588,2933,83.3,23,16,69.6
0K,All Students,2022-23,4245,564,3681,86.7,25,14,56.0
1,All Students,2018-19,6783,703,6080,89.6,40,17,42.5
1,All Students,2019-20,3875,378,3497,90.2,37,18,48.6
1,All Students,2020-21,3456,544,2912,84.3,21,12,57.1
1,All Students,2021-22,5895,924,4971,84.3,38,21,55.3
1,All Students,2022-23,3470,365,3105,89.5,21,7,33.3
2,All Students,2018-19,5873,768,5105,86.9,35,17,48.6
2,All Students,2019-20,4053,369,3684,90.9,39,12,30.8
2,All Students,2020-21,5600,948,4652,83.1,34,17,50.0
2,All Students,2021-22,3164,533,2631,83.2,19,13,68.4
2,All Students,2022-23,5340,623,4717,88.3,31,12,38.7
3,All Students,2018-19,4787,406,4381,91.5,29,8,27.6
3,All Students,2019-20,3471,384,3087,88.9,33,14,42.4
3,All Students,2020-21,6353,1049,5304,83.5,38,21,55.3
3,All Students,2021-22,4900,634,4266,87.1,30,16,53.3
3,All Students,2022-23,3503,362,3141,89.7,22,8,36.4
4,All Students,2018-19,4127,316,3811,92.3,24,4,16.7
4,All Students,2019-20,3019,267,2752,91.2,27,8,29.6
4,All Students,2020-21,5801,868,4933,85.0,36,17,47.2
4,All Students,2021-22,6368,1149,5219,82.0,39,28,71.8
4,All Students,2022-23,3666,356,3310,90.3,22,9,40.9
5,All Students,2018-19,4214,346,3868,91.8,24,8,33.3
5,All Students,2019-20,2998,307,2691,89.8,28,12,42.9
5,All Students,2020-21,4500,731,3769,83.8,26,11,42.3
5,All Students,2021-22,5511,827,4684,85.0,32,18,56.3
5,All Students,2022-23,6092,906,5186,85.1,37,24,64.9
All Grades,All Students,2018-19,51856,6490,45366,87.5,320,162,50.6
All Grades,All Students,2019-20,31350,3488,27862,88.9,298,144,48.3
All Grades,All Students,2020-21,41580,7095,34485,82.9,250,139,55.6
All Grades,All Students,2021-22,45473,7624,37849,83.2,295,196,66.4
All Grades,All Students,2022-23,41046,5789,35257,85.9,256,147,57.4
PK in K-12 Schools,All Students,2018-19,5829,850,4979,85.4,38,20,52.6
PK in K-12 Schools,All Students,2019-20,3500,526,2974,85.0,36,22,61.1
PK in K-12 Schools,All Students,2020-21,2769,556,2213,79.9,21,13,61.9
PK in K-12 Schools,All Students,2021-22,9764,1921,7843,80.3,69,49,71.0
PK in K-12 Schools,All Students,2022-23,9158,1829,7329,80.0,59,45,76.3
0K,All Students,2018-19,6806,892,5914,86.9,44,26,59.1
0K,All Students,2019-20,4047,473,3574,88.3,38,19,50.0
0K,All Students,2020-21,5269,1143,4126,78.3,33,21,63.6
0K,All Students,2021-22,4557,707,3850,84.5,32,23,71.9
0K,All Students,2022-23,5804,731,5073,87.4,37,17,45.9
1,All Students,2018-19,8394,1140,7254,86.4,52,27,51.9
1,All Students,2019-20,4539,438,4101,90.4,45,20,44.4
1,All Students,2020-21,6246,998,5248,84.0,38,21,55.3
1,All Students,2021-22,4826,894,3932,81.5,33,23,69.7
1,All Students,2022-23,4487,427,4060,90.5,28,14,50.0
2,All Students,2018-19,7370,845,6525,88.5,47,23,48.9
2,All Students,2019-20,4832,602,4230,87.5,45,26,57.8
2,All Students,2020-21,7382,1290,6092,82.5,43,23,53.5
2,All Students,2021-22,6401,1037,5364,83.8,41,29,70.7
2,All Students,2022-23,4351,608,3743,86.0,29,15,51.7
3,All Students,2018-19,8018,1128,6890,85.9,49,28,57.1
3,All Students,2019-20,4483,501,3982,88.8,43,24,55.8
3,All Students,2020-21,6158,978,5180,84.1,35,20,57.1
3,All Students,2021-22,6619,1076,5543,83.7,40,24,60.0
3,All Students,2022-23,5353,625,4728,88.3,34,16,47.1
4,All Students,2018-19,8720,857,7863,90.2,51,21,41.2
4,All Students,2019-20,4665,553,4112,88.1,43,20,46.5
4,All Students,2020-21,7334,1160,6174,84.2,43,23,53.5
4,All Students,2021-22,6172,1007,5165,83.7,38,22,57.9
4,All Students,2022-23,6467,890,5577,86.2,38,22,57.9
5,All Students,2018-19,6719,778,5941,88.4,39,17,43.6
5,All Students,2019-20,5284,395,4889,92.5,48,13,27.1
5,All Students,2020-21,6422,970,5452,84.9,37,18,48.6
5,All Students,2021-22,7134,982,6152,86.2,42,26,61.9
5,All Students,2022-23,5426,679,4747,87.5,31,18,58.1
All Grades,All Students,2018-19,109395,6881,102514,93.7,645,129,20.0
All Grades,All Students,2019-20,70719,3880,66839,94.5,635,93,14.6
All Grades,All Students,2020-21,98772,2537,96235,97.4,590,40,6.8
All Grades,All Students,2021-22,95417,5368,90049,94.4,562,84,14.9
All Grades,All Students,2022-23,92953,5752,87201,93.8,541,92,17.0
PK in K-12 Schools,All Students,2018-19,15477,1399,14078,91.0,92,32,34.8
PK in K-12 Schools,All Students,2019-20,9855,796,9059,91.9,88,29,33.0
PK in K-12 Schools,All Students,2020-21,12658,681,11977,94.6,78,14,17.9
PK in K-12 Schools,All Students,2021-22,13506,882,12624,93.5,80,16,20.0
PK in K-12 Schools,All Students,2022-23,11583,920,10663,92.1,71,23,32.4
0K,All Students,2018-19,15653,958,14695,93.9,94,18,19.1
0K,All Students,2019-20,10325,654,9671,93.7,96,13,13.5
0K,All Students,2020-21,14697,349,14348,97.6,90,4,4.4
0K,All Students,2021-22,14998,1007,13991,93.3,91,23,25.3
0K,All Students,2022-23,16555,1079,15476,93.5,97,18,18.6
1,All Students,2018-19,16219,1150,15069,92.9,100,28,28.0
1,All Students,2019-20,9807,535,9272,94.5,88,14,15.9
1,All Students,2020-21,14307,481,13826,96.6,86,8,9.3
1,All Students,2021-22,14447,875,13572,93.9,86,12,14.0
1,All Students,2022-23,14704,953,13751,93.5,85,14,16.5
2,All Students,2018-19,16986,927,16059,94.5,99,14,14.1
2,All Students,2019-20,10040,550,9490,94.5,89,11,12.4
2,All Students,2020-21,13042,213,12829,98.4,77,1,1.3
2,All Students,2021-22,12695,687,12008,94.6,74,6,8.1
2,All Students,2022-23,12962,756,12206,94.2,74,9,12.2
3,All Students,2018-19,17474,974,16500,94.4,101,15,14.9
3,All Students,2019-20,10548,503,10045,95.2,93,11,11.8
3,All Students,2020-21,13212,408,12804,96.9,79,6,7.6
3,All Students,2021-22,12042,522,11520,95.7,71,6,8.5
3,All Students,2022-23,12742,774,11968,93.9,75,12,16.0
4,All Students,2018-19,14948,906,14042,93.9,88,15,17.0
4,All Students,2019-20,10809,440,10369,95.9,97,10,10.3
4,All Students,2020-21,15106,140,14966,99.1,88,3,3.4
4,All Students,2021-22,12607,649,11958,94.9,73,10,13.7
4,All Students,2022-23,11935,533,11402,95.5,68,6,8.8
5,All Students,2018-19,12638,567,12071,95.5,71,7,9.9
5,All Students,2019-20,9335,402,8933,95.7,84,5,6.0
5,All Students,2020-21,15750,265,15485,98.3,92,4,4.3
5,All Students,2021-22,15122,746,14376,95.1,87,11,12.6
5,All Students,2022-23,12472,737,11735,94.1,71,10,14.1
All Grades,All Students,2018-19,83045,4843,78202,94.2,486,74,15.2
All Grades,All Students,2019-20,54672,3400,51272,93.8,485,85,17.5
All Grades,All Students,2020-21,74104,3309,70795,95.5,458,60,13.1
All Grades,All Students,2021-22,71181,5453,65728,92.3,411,100,24.3
All Grades,All Students,2022-23,71121,5622,65499,92.1,407,109,26.8
PK in K-12 Schools,All Students,2018-19,9408,767,8641,91.8,55,16,29.1
PK in K-12 Schools,All Students,2019-20,6094,427,5667,93.0,54,12,22.2
PK in K-12 Schools,All Students,2020-21,7473,553,6920,92.6,50,14,28.0
PK in K-12 Schools,All Students,2021-22,8725,919,7806,89.5,51,25,49.0
PK in K-12 Schools,All Students,2022-23,8957,827,8130,90.8,51,21,41.2
0K,All Students,2018-19,11844,894,10950,92.5,69,15,21.7
0K,All Students,2019-20,9658,861,8797,91.1,87,28,32.2
0K,All Students,2020-21,12392,534,11858,95.7,78,9,11.5
0K,All Students,2021-22,12436,1038,11398,91.7,71,22,31.0
0K,All Students,2022-23,14458,1379,13079,90.5,82,29,35.4
1,All Students,2018-19,12043,727,11316,94.0,70,10,14.3
1,All Students,2019-20,7705,462,7243,94.0,67,6,9.0
1,All Students,2020-21,11259,502,10757,95.5,68,7,10.3
1,All Students,2021-22,10639,885,9754,91.7,62,14,22.6
1,All Students,2022-23,12220,955,11265,92.2,70,19,27.1
2,All Students,2018-19,12452,581,11871,95.3,73,5,6.8
2,All Students,2019-20,7864,512,7352,93.5,69,14,20.3
2,All Students,2020-21,10538,531,10007,95.0,65,8,12.3
2,All Students,2021-22,10411,742,9669,92.9,60,10,16.7
2,All Students,2022-23,9454,772,8682,91.8,54,14,25.9
3,All Students,2018-19,13708,779,12929,94.3,79,11,13.9
3,All Students,2019-20,7960,363,7597,95.4,70,6,8.6
3,All Students,2020-21,9581,461,9120,95.2,61,10,16.4
3,All Students,2021-22,9622,625,8997,93.5,55,10,18.2
3,All Students,2022-23,9925,621,9304,93.7,58,7,12.1
4,All Students,2018-19,11918,547,11371,95.4,73,7,9.6
4,All Students,2019-20,8583,438,8145,94.9,77,9,11.7
4,All Students,2020-21,11563,320,11243,97.2,69,6,8.7
4,All Students,2021-22,8383,610,7773,92.7,49,9,18.4
4,All Students,2022-23,8512,553,7959,93.5,49,11,22.4
5,All Students,2018-19,11672,548,11124,95.3,67,10,14.9
5,All Students,2019-20,6808,337,6471,95.0,61,10,16.4
5,All Students,2020-21,11298,408,10890,96.4,67,6,9.0
5,All Students,2021-22,10965,634,10331,94.2,63,10,15.9
5,All Students,2022-23,7595,515,7080,93.2,43,8,18.6
All Grades,All Students,2018-19,57231,4490,52741,92.2,341,101,29.6
All Grades,All Students,2019-20,37743,2783,34960,92.6,337,87,25.8
All Grades,All Students,2020-21,58710,3563,55147,93.9,342,58,17.0
All Grades,All Students,2021-22,55609,6474,49135,88.4,330,142,43.0
All Grades,All Students,2022-23,63841,6471,57370,89.9,387,145,37.5
6,All Students,2018-19,19212,1540,17672,92.0,116,35,30.2
6,All Students,2019-20,11550,s,s,s,s,s,s
6,All Students,2020-21,20268,1181,19087,94.2,120,18,15.0
6,All Students,2021-22,18078,2107,15971,88.3,107,47,43.9
6,All Students,2022-23,23685,1979,21706,91.6,145,40,27.6
7,All Students,2018-19,18580,1458,17122,92.2,111,33,29.7
7,All Students,2019-20,12920,1050,11870,91.9,116,38,32.8
7,All Students,2020-21,17805,1084,16721,93.9,103,20,19.4
7,All Students,2021-22,20270,2396,17874,88.2,118,53,44.9
7,All Students,2022-23,19853,2186,17667,89.0,120,53,44.2
8,All Students,2018-19,19439,1492,17947,92.3,114,33,28.9
8,All Students,2019-20,13264,892,12372,93.3,118,26,22.0
8,All Students,2020-21,20637,1298,19339,93.7,119,20,16.8
8,All Students,2021-22,17246,s,s,s,s,s,s
8,All Students,2022-23,20303,2306,17997,88.6,122,52,42.6
9,All Students,2019-20,9,s,s,s,s,s,s
9,All Students,2021-22,15,s,s,s,s,s,s
All Grades,All Students,2018-19,59545,6879,52666,88.4,372,171,46.0
All Grades,All Students,2019-20,37683,4006,33677,89.4,351,146,41.6
All Grades,All Students,2020-21,52097,6326,45771,87.9,309,111,35.9
All Grades,All Students,2021-22,51629,8397,43232,83.7,324,192,59.3
All Grades,All Students,2022-23,54520,7537,46983,86.2,339,186,54.9
PK in K-12 Schools,All Students,2018-19,6268,867,5401,86.2,39,25,64.1
PK in K-12 Schools,All Students,2019-20,3974,497,3477,87.5,38,15,39.5
PK in K-12 Schools,All Students,2020-21,3474,405,3069,88.3,22,8,36.4
PK in K-12 Schools,All Students,2021-22,5018,1006,4012,80.0,35,24,68.6
PK in K-12 Schools,All Students,2022-23,7596,1403,6193,81.5,49,33,67.3
0K,All Students,2018-19,9142,1420,7722,84.5,57,33,57.9
0K,All Students,2019-20,4596,551,4045,88.0,43,24,55.8
0K,All Students,2020-21,8235,1111,7124,86.5,49,19,38.8
0K,All Students,2021-22,7030,1270,5760,81.9,47,29,61.7
0K,All Students,2022-23,6785,1149,5636,83.1,47,32,68.1
1,All Students,2018-19,8052,903,7149,88.8,51,20,39.2
1,All Students,2019-20,6248,768,5480,87.7,58,25,43.1
1,All Students,2020-21,6665,885,5780,86.7,40,15,37.5
1,All Students,2021-22,8084,1256,6828,84.5,50,33,66.0
1,All Students,2022-23,8425,1113,7312,86.8,50,23,46.0
2,All Students,2018-19,9303,1097,8206,88.2,62,32,51.6
2,All Students,2019-20,4813,391,4422,91.9,44,16,36.4
2,All Students,2020-21,8995,1442,7553,84.0,53,27,50.9
2,All Students,2021-22,6844,1265,5579,81.5,40,27,67.5
2,All Students,2022-23,8872,1222,7650,86.2,53,32,60.4
3,All Students,2018-19,8978,986,7992,89.0,54,26,48.1
3,All Students,2019-20,5675,587,5088,89.7,53,26,49.1
3,All Students,2020-21,7662,822,6840,89.3,46,14,30.4
3,All Students,2021-22,9744,1517,8227,84.4,60,34,56.7
3,All Students,2022-23,7643,968,6675,87.3,50,26,52.0
4,All Students,2018-19,9702,929,8773,90.4,61,24,39.3
4,All Students,2019-20,6048,643,5405,89.4,58,23,39.7
4,All Students,2020-21,7635,739,6896,90.3,44,12,27.3
4,All Students,2021-22,7262,1033,6229,85.8,45,20,44.4
4,All Students,2022-23,8328,1042,7286,87.5,48,26,54.2
5,All Students,2018-19,8100,677,7423,91.6,48,11,22.9
5,All Students,2019-20,6329,569,5760,91.0,58,17,29.3
5,All Students,2020-21,9431,922,8509,90.2,55,16,29.1
5,All Students,2021-22,7647,1050,6597,86.3,47,25,53.2
5,All Students,2022-23,6871,640,6231,90.7,42,14,33.3
All Grades,All Students,2018-19,84395,9910,74485,88.3,531,212,39.9
All Grades,All Students,2019-20,53367,6399,46968,88.0,499,170,34.1
All Grades,All Students,2020-21,86639,16850,69789,80.6,505,271,53.7
All Grades,All Students,2021-22,84226,13812,70414,83.6,525,301,57.3
All Grades,All Students,2022-23,77538,11054,66484,85.7,496,233,47.0
6,All Students,2018-19,10615,998,9617,90.6,63,23,36.5
6,All Students,2019-20,7247,599,6648,91.7,69,22,31.9
6,All Students,2020-21,10573,1206,9367,88.6,63,26,41.3
6,All Students,2021-22,8871,1185,7686,86.6,52,30,57.7
6,All Students,2022-23,5498,584,4914,89.4,33,10,30.3
7,All Students,2018-19,10729,1215,9514,88.7,62,31,50.0
7,All Students,2019-20,6503,686,5817,89.5,61,21,34.4
7,All Students,2020-21,12048,2264,9784,81.2,71,41,57.7
7,All Students,2021-22,10162,1385,8777,86.4,62,36,58.1
7,All Students,2022-23,9431,941,8490,90.0,61,21,34.4
8,All Students,2018-19,11436,773,10663,93.2,69,15,21.7
8,All Students,2019-20,6896,882,6014,87.2,62,25,40.3
8,All Students,2020-21,10028,1433,8595,85.7,58,26,44.8
8,All Students,2021-22,11989,1346,10643,88.8,71,31,43.7
8,All Students,2022-23,9570,1032,8538,89.2,57,21,36.8
9,All Students,2018-19,15961,2417,13544,84.9,99,40,40.4
9,All Students,2019-20,10822,1481,9341,86.3,103,31,30.1
9,All Students,2020-21,15471,2994,12477,80.6,90,55,61.1
9,All Students,2021-22,15127,2838,12289,81.2,97,61,62.9
9,All Students,2022-23,15910,2460,13450,84.5,103,50,48.5
10,All Students,2018-19,12318,1940,10378,84.3,87,43,49.4
10,All Students,2019-20,9231,1194,8037,87.1,86,30,34.9
10,All Students,2020-21,16614,4105,12509,75.3,94,46,48.9
10,All Students,2021-22,15545,2315,13230,85.1,102,61,59.8
10,All Students,2022-23,13677,2574,11103,81.2,91,51,56.0
11,All Students,2018-19,11237,1027,10210,90.9,71,22,31.0
11,All Students,2019-20,5134,462,4672,91.0,50,17,34.0
11,All Students,2020-21,12546,2866,9680,77.2,73,42,57.5
11,All Students,2021-22,11086,2528,8558,77.2,65,34,52.3
11,All Students,2022-23,12161,1899,10262,84.4,82,49,59.8
12,All Students,2018-19,12099,1540,10559,87.3,80,38,47.5
12,All Students,2019-20,7534,1095,6439,85.5,68,24,35.3
12,All Students,2020-21,9359,1982,7377,78.8,56,35,62.5
12,All Students,2021-22,11446,2215,9231,80.6,76,48,63.2
12,All Students,2022-23,11291,1564,9727,86.1,69,31,44.9
All Grades,All Students,2018-19,137251,10052,127199,92.7,804,203,25.2
All Grades,All Students,2019-20,83478,6116,77362,92.7,754,200,26.5
All Grades,All Students,2020-21,120264,11143,109121,90.7,713,214,30.0
All Grades,All Students,2021-22,108555,11936,96619,89.0,648,250,38.6
All Grades,All Students,2022-23,110054,11377,98677,89.7,655,252,38.5
PK in K-12 Schools,All Students,2018-19,9297,847,8450,90.9,54,19,35.2
PK in K-12 Schools,All Students,2019-20,5983,474,5509,92.1,56,17,30.4
PK in K-12 Schools,All Students,2020-21,6868,s,s,s,s,s,s
PK in K-12 Schools,All Students,2021-22,9434,993,8441,89.5,56,20,35.7
PK in K-12 Schools,All Students,2022-23,9662,1294,8368,86.6,61,35,57.4
0K,All Students,2018-19,12001,754,11247,93.7,70,16,22.9
0K,All Students,2019-20,8182,654,7528,92.0,73,24,32.9
0K,All Students,2020-21,12070,929,11141,92.3,72,20,27.8
0K,All Students,2021-22,9614,902,8712,90.6,57,20,35.1
0K,All Students,2022-23,12349,1439,10910,88.3,74,37,50.0
1,All Students,2018-19,13540,946,12594,93.0,81,14,17.3
1,All Students,2019-20,7421,530,6891,92.9,67,17,25.4
1,All Students,2020-21,10407,848,9559,91.9,67,19,28.4
1,All Students,2021-22,11407,1143,10264,90.0,70,22,31.4
1,All Students,2022-23,9464,804,8660,91.5,57,20,35.1
2,All Students,2018-19,12971,802,12169,93.8,76,14,18.4
2,All Students,2019-20,8127,479,7648,94.1,75,10,13.3
2,All Students,2020-21,9874,431,9443,95.6,57,6,10.5
2,All Students,2021-22,10645,1165,9480,89.1,64,26,40.6
2,All Students,2022-23,11648,1091,10557,90.6,69,23,33.3
3,All Students,2018-19,15696,1110,14586,92.9,92,21,22.8
3,All Students,2019-20,7893,511,7382,93.5,73,18,24.7
3,All Students,2020-21,10942,704,10238,93.6,66,16,24.2
3,All Students,2021-22,8824,690,8134,92.2,52,14,26.9
3,All Students,2022-23,12370,1240,11130,90.0,72,28,38.9
4,All Students,2018-19,14640,1004,13636,93.1,85,18,21.2
4,All Students,2019-20,8917,421,8496,95.3,80,11,13.8
4,All Students,2020-21,11175,673,10502,94.0,65,9,13.8
4,All Students,2021-22,10177,1044,9133,89.7,60,21,35.0
4,All Students,2022-23,9587,692,8895,92.8,60,15,25.0
5,All Students,2018-19,20037,1049,18988,94.8,117,17,14.5
5,All Students,2019-20,9432,630,8802,93.3,85,20,23.5
5,All Students,2020-21,13126,793,12333,94.0,77,14,18.2
5,All Students,2021-22,10713,908,9805,91.5,63,19,30.2
5,All Students,2022-23,10811,933,9878,91.4,62,15,24.2
6,All Students,2018-19,14918,1150,13768,92.3,87,27,31.0
6,All Students,2019-20,9873,693,9180,93.0,88,22,25.0
6,All Students,2020-21,16036,2446,13590,84.7,96,44,45.8
6,All Students,2021-22,10388,1240,9148,88.1,62,24,38.7
6,All Students,2022-23,9700,854,8846,91.2,59,19,32.2
7,All Students,2018-19,11385,1148,10237,89.9,68,27,39.7
7,All Students,2019-20,10096,895,9201,91.1,90,33,36.7
7,All Students,2020-21,14588,2053,12535,85.9,85,43,50.6
7,All Students,2021-22,13928,2069,11859,85.1,85,41,48.2
7,All Students,2022-23,10387,1301,9086,87.5,60,26,43.3
8,All Students,2018-19,12766,1242,11524,90.3,74,30,40.5
8,All Students,2019-20,7554,829,6725,89.0,67,28,41.8
8,All Students,2020-21,15011,1695,13316,88.7,87,32,36.8
8,All Students,2021-22,13425,1782,11643,86.7,79,43,54.4
8,All Students,2022-23,14076,1729,12347,87.7,81,34,42.0
9,All Students,2020-21,167,s,s,s,s,s,s
All Grades,All Students,2018-19,98783,5440,93343,94.5,573,84,14.7
All Grades,All Students,2019-20,68170,4082,64088,94.0,610,110,18.0
All Grades,All Students,2020-21,91003,4906,86097,94.6,554,77,13.9
All Grades,All Students,2021-22,85071,7945,77126,90.7,500,172,34.4
All Grades,All Students,2022-23,87401,6712,80689,92.3,509,138,27.1
PK in K-12 Schools,All Students,2018-19,15626,1049,14577,93.3,93,21,22.6
PK in K-12 Schools,All Students,2019-20,9440,703,8737,92.6,87,24,27.6
PK in K-12 Schools,All Students,2020-21,11860,605,11255,94.9,73,9,12.3
PK in K-12 Schools,All Students,2021-22,12022,1648,10374,86.3,72,38,52.8
PK in K-12 Schools,All Students,2022-23,14184,1402,12782,90.1,85,35,41.2
0K,All Students,2018-19,16245,956,15289,94.1,94,16,17.0
0K,All Students,2019-20,11699,765,10934,93.5,103,23,22.3
0K,All Students,2020-21,14894,887,14007,94.0,90,13,14.4
0K,All Students,2021-22,16009,1452,14557,90.9,93,31,33.3
0K,All Students,2022-23,14088,1253,12835,91.1,81,31,38.3
1,All Students,2018-19,16932,831,16101,95.1,98,12,12.2
1,All Students,2019-20,10113,570,9543,94.4,90,13,14.4
1,All Students,2020-21,13810,843,12967,93.9,90,17,18.9
1,All Students,2021-22,12982,1042,11940,92.0,76,22,28.9
1,All Students,2022-23,15434,1103,14331,92.9,89,14,15.7
2,All Students,2018-19,14639,743,13896,94.9,85,14,16.5
2,All Students,2019-20,10575,535,10040,94.9,94,12,12.8
2,All Students,2020-21,12992,790,12202,93.9,78,9,11.5
2,All Students,2021-22,11031,899,10132,91.9,66,23,34.8
2,All Students,2022-23,12205,788,11417,93.5,72,15,20.8
3,All Students,2018-19,15004,806,14198,94.6,88,9,10.2
3,All Students,2019-20,9429,518,8911,94.5,85,12,14.1
3,All Students,2020-21,12976,444,12532,96.6,76,6,7.9
3,All Students,2021-22,10674,1092,9582,89.8,63,22,34.9
3,All Students,2022-23,10396,709,9687,93.2,60,13,21.7
4,All Students,2018-19,12861,594,12267,95.4,73,6,8.2
4,All Students,2019-20,8854,503,8351,94.3,80,12,15.0
4,All Students,2020-21,12231,695,11536,94.3,73,13,17.8
4,All Students,2021-22,12061,978,11083,91.9,71,19,26.8
4,All Students,2022-23,9511,739,8772,92.2,56,16,28.6
5,All Students,2018-19,7476,461,7015,93.8,42,6,14.3
5,All Students,2019-20,8060,488,7572,93.9,71,14,19.7
5,All Students,2020-21,12240,642,11598,94.8,74,10,13.5
5,All Students,2021-22,10292,834,9458,91.9,59,17,28.8
5,All Students,2022-23,11583,718,10865,93.8,66,14,21.2
All Grades,All Students,2018-19,67776,5853,61923,91.4,416,141,33.9
All Grades,All Students,2019-20,42513,3494,39019,91.8,391,130,33.2
All Grades,All Students,2020-21,60616,7894,52722,87.0,360,168,46.7
All Grades,All Students,2021-22,58079,8035,50044,86.2,345,208,60.3
All Grades,All Students,2022-23,53608,6921,46687,87.1,330,157,47.6
PK in K-12 Schools,All Students,2018-19,5882,711,5171,87.9,40,21,52.5
PK in K-12 Schools,All Students,2019-20,4435,529,3906,88.1,42,26,61.9
PK in K-12 Schools,All Students,2020-21,4398,606,3792,86.2,28,11,39.3
PK in K-12 Schools,All Students,2021-22,9215,1819,7396,80.3,58,46,79.3
PK in K-12 Schools,All Students,2022-23,10186,1865,8321,81.7,66,44,66.7
0K,All Students,2018-19,9142,899,8243,90.2,57,21,36.8
0K,All Students,2019-20,5340,531,4809,90.1,50,21,42.0
0K,All Students,2020-21,9065,1500,7565,83.5,57,34,59.6
0K,All Students,2021-22,7110,1095,6015,84.6,41,27,65.9
0K,All Students,2022-23,5363,911,4452,83.0,34,20,58.8
1,All Students,2018-19,10446,986,9460,90.6,65,22,33.8
1,All Students,2019-20,5499,540,4959,90.2,52,20,38.5
1,All Students,2020-21,7052,1345,5707,80.9,42,30,71.4
1,All Students,2021-22,8001,1264,6737,84.2,48,37,77.1
1,All Students,2022-23,7132,819,6313,88.5,44,19,43.2
2,All Students,2018-19,9961,734,9227,92.6,64,21,32.8
2,All Students,2019-20,6696,622,6074,90.7,63,21,33.3
2,All Students,2020-21,9297,1375,7922,85.2,54,27,50.0
2,All Students,2021-22,7220,820,6400,88.6,43,22,51.2
2,All Students,2022-23,7512,926,6586,87.7,46,21,45.7
3,All Students,2018-19,11511,1048,10463,90.9,68,25,36.8
3,All Students,2019-20,6870,383,6487,94.4,61,10,16.4
3,All Students,2020-21,9401,1112,8289,88.2,55,25,45.5
3,All Students,2021-22,8712,1050,7662,87.9,50,26,52.0
3,All Students,2022-23,7132,723,6409,89.9,41,13,31.7
4,All Students,2018-19,11400,854,10546,92.5,68,19,27.9
4,All Students,2019-20,7057,508,6549,92.8,63,19,30.2
4,All Students,2020-21,10203,857,9346,91.6,60,21,35.0
4,All Students,2021-22,8719,1180,7539,86.5,52,29,55.8
4,All Students,2022-23,8799,988,7811,88.8,53,25,47.2
5,All Students,2018-19,9434,621,8813,93.4,54,12,22.2
5,All Students,2019-20,6616,381,6235,94.2,60,13,21.7
5,All Students,2020-21,11200,1099,10101,90.2,64,20,31.3
5,All Students,2021-22,9102,807,8295,91.1,53,21,39.6
5,All Students,2022-23,7484,689,6795,90.8,46,15,32.6
All Grades,All Students,2018-19,64462,5744,58718,91.1,385,134,34.8
All Grades,All Students,2019-20,37265,2737,34528,92.7,335,92,27.5
All Grades,All Students,2020-21,47382,3284,44098,93.1,277,63,22.7
All Grades,All Students,2021-22,39476,5136,34340,87.0,235,117,49.8
All Grades,All Students,2022-23,31226,3326,27900,89.3,190,90,47.4
6,All Students,2018-19,22080,1970,20110,91.1,136,44,32.4
6,All Students,2019-20,9957,s,s,s,s,s,s
6,All Students,2020-21,14159,1093,13066,92.3,82,22,26.8
6,All Students,2021-22,9867,s,s,s,s,s,s
6,All Students,2022-23,8376,821,7555,90.2,51,20,39.2
7,All Students,2018-19,23499,2001,21498,91.5,139,50,36.0
7,All Students,2019-20,13085,971,12114,92.6,118,31,26.3
7,All Students,2020-21,14776,1075,13701,92.7,87,19,21.8
7,All Students,2021-22,14081,1915,12166,86.4,83,45,54.2
7,All Students,2022-23,9784,1052,8732,89.2,61,29,47.5
8,All Students,2018-19,18883,1773,17110,90.6,110,40,36.4
8,All Students,2019-20,14195,982,13213,93.1,125,32,25.6
8,All Students,2020-21,18447,1116,17331,94.0,108,22,20.4
8,All Students,2021-22,15517,1834,13683,88.2,93,43,46.2
8,All Students,2022-23,13066,1453,11613,88.9,78,41,52.6
9,All Students,2019-20,28,s,s,s,s,s,s
9,All Students,2021-22,11,s,s,s,s,s,s
All Grades,All Students,2018-19,132648,8496,124152,93.6,769,171,22.2
All Grades,All Students,2019-20,81382,5017,76365,93.8,729,151,20.7
All Grades,All Students,2020-21,118125,5733,112392,95.1,692,93,13.4
All Grades,All Students,2021-22,107751,10196,97555,90.5,633,227,35.9
All Grades,All Students,2022-23,102229,8570,93659,91.6,592,190,32.1
PK in K-12 Schools,All Students,2018-19,12569,903,11666,92.8,76,23,30.3
PK in K-12 Schools,All Students,2019-20,8191,522,7669,93.6,73,13,17.8
PK in K-12 Schools,All Students,2020-21,11088,s,s,s,s,s,s
PK in K-12 Schools,All Students,2021-22,12554,1645,10909,86.9,74,37,50.0
PK in K-12 Schools,All Students,2022-23,8240,1096,7144,86.7,50,31,62.0
0K,All Students,2018-19,23183,1565,21618,93.2,135,35,25.9
0K,All Students,2019-20,13149,1039,12110,92.1,122,40,32.8
0K,All Students,2020-21,20078,1119,18959,94.4,121,19,15.7
0K,All Students,2021-22,17016,1545,15471,90.9,101,40,39.6
0K,All Students,2022-23,16628,1783,14845,89.3,97,48,49.5
1,All Students,2018-19,21908,1583,20325,92.8,129,29,22.5
1,All Students,2019-20,13716,879,12837,93.6,121,30,24.8
1,All Students,2020-21,17312,906,16406,94.8,104,16,15.4
1,All Students,2021-22,15099,1276,13823,91.5,92,32,34.8
1,All Students,2022-23,16704,1258,15446,92.5,96,25,26.0
2,All Students,2018-19,21123,1349,19774,93.6,123,26,21.1
2,All Students,2019-20,13725,842,12883,93.9,123,22,17.9
2,All Students,2020-21,19246,1011,18235,94.7,112,11,9.8
2,All Students,2021-22,15069,1190,13879,92.1,87,25,28.7
2,All Students,2022-23,15364,1114,14250,92.7,89,22,24.7
3,All Students,2018-19,17960,885,17075,95.1,104,17,16.3
3,All Students,2019-20,12264,708,11556,94.2,109,17,15.6
3,All Students,2020-21,18139,727,17412,96.0,105,11,10.5
3,All Students,2021-22,16500,1582,14918,90.4,96,33,34.4
3,All Students,2022-23,15650,1080,14570,93.1,89,19,21.3
4,All Students,2018-19,17082,1078,16004,93.7,96,20,20.8
4,All Students,2019-20,10486,474,10012,95.5,95,14,14.7
4,All Students,2020-21,17364,860,16504,95.0,100,16,16.0
4,All Students,2021-22,15258,1458,13800,90.4,88,31,35.2
4,All Students,2022-23,14905,1057,13848,92.9,87,20,23.0
5,All Students,2018-19,18823,1133,17690,94.0,106,21,19.8
5,All Students,2019-20,9851,553,9298,94.4,87,16,18.4
5,All Students,2020-21,14731,523,14208,96.4,84,9,10.7
5,All Students,2021-22,16255,1500,14755,90.8,95,29,30.5
5,All Students,2022-23,14738,1182,13556,92.0,84,25,29.8
6,All Students,2020-21,167,s,s,s,s,s,s
All Grades,All Students,2018-19,64317,6274,58043,90.2,381,137,36.0
All Grades,All Students,2019-20,40924,3520,37404,91.4,363,112,30.9
All Grades,All Students,2020-21,52176,6419,45757,87.7,320,113,35.3
All Grades,All Students,2021-22,37716,4133,33583,89.0,221,103,46.6
All Grades,All Students,2022-23,33611,3674,29937,89.1,206,96,46.6
PK in K-12 Schools,All Students,2018-19,9764,1087,8677,88.9,61,33,54.1
PK in K-12 Schools,All Students,2019-20,6773,766,6007,88.7,60,26,43.3
PK in K-12 Schools,All Students,2020-21,6569,669,5900,89.8,39,13,33.3
PK in K-12 Schools,All Students,2021-22,2946,381,2565,87.1,19,11,57.9
PK in K-12 Schools,All Students,2022-23,3557,498,3059,86.0,22,13,59.1
0K,All Students,2018-19,11125,1110,10015,90.0,65,17,26.2
0K,All Students,2019-20,6686,610,6076,90.9,60,16,26.7
0K,All Students,2020-21,7475,1087,6388,85.5,49,18,36.7
0K,All Students,2021-22,5329,688,4641,87.1,32,22,68.8
0K,All Students,2022-23,4590,506,4084,89.0,30,15,50.0
1,All Students,2018-19,9937,936,9001,90.6,60,21,35.0
1,All Students,2019-20,5525,355,5170,93.6,50,13,26.0
1,All Students,2020-21,7981,760,7221,90.5,47,13,27.7
1,All Students,2021-22,4401,564,3837,87.2,25,13,52.0
1,All Students,2022-23,4488,564,3924,87.4,30,16,53.3
2,All Students,2018-19,9894,1034,8860,89.5,59,21,35.6
2,All Students,2019-20,5971,491,5480,91.8,53,18,34.0
2,All Students,2020-21,7522,816,6706,89.2,47,15,31.9
2,All Students,2021-22,6114,519,5595,91.5,36,11,30.6
2,All Students,2022-23,3328,411,2917,87.7,21,12,57.1
3,All Students,2018-19,7417,700,6717,90.6,43,15,34.9
3,All Students,2019-20,5874,435,5439,92.6,52,15,28.8
3,All Students,2020-21,7116,954,6162,86.6,44,16,36.4
3,All Students,2021-22,5804,565,5239,90.3,34,14,41.2
3,All Students,2022-23,5297,556,4741,89.5,32,15,46.9
4,All Students,2018-19,8162,733,7429,91.0,48,16,33.3
4,All Students,2019-20,4920,459,4461,90.7,43,14,32.6
4,All Students,2020-21,8567,1206,7361,85.9,52,19,36.5
4,All Students,2021-22,6036,630,5406,89.6,35,13,37.1
4,All Students,2022-23,5934,524,5410,91.2,34,11,32.4
5,All Students,2018-19,8018,674,7344,91.6,45,14,31.1
5,All Students,2019-20,5175,404,4771,92.2,45,10,22.2
5,All Students,2020-21,6946,927,6019,86.7,42,19,45.2
5,All Students,2021-22,7086,786,6300,88.9,40,19,47.5
5,All Students,2022-23,6417,615,5802,90.4,37,14,37.8
All Grades,All Students,2018-19,73534,6289,67245,91.4,431,136,31.6
All Grades,All Students,2019-20,45661,4496,41165,90.2,410,142,34.6
All Grades,All Students,2020-21,57310,7555,49755,86.8,344,157,45.6
All Grades,All Students,2021-22,52229,2157,50072,95.9,322,35,10.9
All Grades,All Students,2022-23,48455,6149,42306,87.3,289,145,50.2
PK in K-12 Schools,All Students,2018-19,3468,429,3039,87.6,21,11,52.4
PK in K-12 Schools,All Students,2019-20,2406,s,s,s,s,s,s
PK in K-12 Schools,All Students,2020-21,2760,394,2366,85.7,18,9,50.0
PK in K-12 Schools,All Students,2021-22,5698,432,5266,92.4,41,13,31.7
PK in K-12 Schools,All Students,2022-23,8231,1464,6767,82.2,52,38,73.1
0K,All Students,2018-19,5523,563,4960,89.8,33,11,33.3
0K,All Students,2019-20,3006,377,2629,87.5,26,11,42.3
0K,All Students,2020-21,3573,488,3085,86.3,24,13,54.2
0K,All Students,2021-22,2579,82,2497,96.8,16,0,0.0
0K,All Students,2022-23,1766,185,1581,89.5,11,4,36.4
1,All Students,2018-19,5091,431,4660,91.5,31,10,32.3
1,All Students,2019-20,3565,313,3252,91.2,31,11,35.5
1,All Students,2020-21,4226,629,3597,85.1,26,13,50.0
1,All Students,2021-22,4069,245,3824,94.0,24,5,20.8
1,All Students,2022-23,2494,338,2156,86.4,15,9,60.0
2,All Students,2018-19,6110,504,5606,91.8,35,9,25.7
2,All Students,2019-20,3614,301,3313,91.7,34,11,32.4
2,All Students,2020-21,5164,602,4562,88.3,31,14,45.2
2,All Students,2021-22,4161,112,4049,97.3,25,1,4.0
2,All Students,2022-23,4355,596,3759,86.3,25,14,56.0
3,All Students,2018-19,5759,348,5411,94.0,33,7,21.2
3,All Students,2019-20,3990,327,3663,91.8,35,9,25.7
3,All Students,2020-21,4967,628,4339,87.4,29,11,37.9
3,All Students,2021-22,4720,144,4576,96.9,28,1,3.6
3,All Students,2022-23,3806,411,3395,89.2,22,8,36.4
4,All Students,2018-19,8407,602,7805,92.8,49,16,32.7
4,All Students,2019-20,3775,306,3469,91.9,33,9,27.3
4,All Students,2020-21,5894,870,5024,85.2,35,22,62.9
4,All Students,2021-22,4868,112,4756,97.7,29,0,0.0
4,All Students,2022-23,4779,464,4315,90.3,27,12,44.4
5,All Students,2018-19,7264,531,6733,92.7,42,11,26.2
5,All Students,2019-20,5509,440,5069,92.0,49,15,30.6
5,All Students,2020-21,5936,484,5452,91.8,35,10,28.6
5,All Students,2021-22,5432,162,5270,97.0,34,2,5.9
5,All Students,2022-23,4691,601,4090,87.2,27,12,44.4
6,All Students,2018-19,10675,822,9853,92.3,65,21,32.3
6,All Students,2019-20,5000,485,4515,90.3,46,15,32.6
6,All Students,2020-21,7374,883,6491,88.0,44,18,40.9
6,All Students,2021-22,6230,299,5931,95.2,38,6,15.8
6,All Students,2022-23,5683,685,4998,87.9,32,15,46.9
7,All Students,2018-19,12538,1169,11369,90.7,71,21,29.6
7,All Students,2019-20,6786,759,6027,88.8,62,25,40.3
7,All Students,2020-21,7473,1108,6365,85.2,44,24,54.5
7,All Students,2021-22,6951,254,6697,96.3,42,2,4.8
7,All Students,2022-23,5767,681,5086,88.2,37,18,48.6
8,All Students,2018-19,8699,890,7809,89.8,51,19,37.3
8,All Students,2019-20,7921,800,7121,89.9,71,24,33.8
8,All Students,2020-21,9943,1469,8474,85.2,58,23,39.7
8,All Students,2021-22,7521,315,7206,95.8,45,5,11.1
8,All Students,2022-23,6883,724,6159,89.5,41,15,36.6
9,All Students,2019-20,89,s,s,s,s,s,s
All Grades,All Students,2018-19,58837,5246,53591,91.1,351,123,35.0
All Grades,All Students,2019-20,35471,2995,32476,91.6,317,102,32.2
All Grades,All Students,2020-21,51057,6688,44369,86.9,308,137,44.5
All Grades,All Students,2021-22,56300,8671,47629,84.6,336,214,63.7
All Grades,All Students,2022-23,52504,6930,45574,86.8,318,177,55.7
PK in K-12 Schools,All Students,2018-19,6604,851,5753,87.1,41,24,58.5
PK in K-12 Schools,All Students,2019-20,4522,424,4098,90.6,40,16,40.0
PK in K-12 Schools,All Students,2020-21,5848,659,5189,88.7,38,17,44.7
PK in K-12 Schools,All Students,2021-22,9811,1732,8079,82.3,61,50,82.0
PK in K-12 Schools,All Students,2022-23,8661,1463,7198,83.1,56,40,71.4
0K,All Students,2018-19,6346,631,5715,90.1,37,15,40.5
0K,All Students,2019-20,5898,638,5260,89.2,52,19,36.5
0K,All Students,2020-21,7777,1040,6737,86.6,48,18,37.5
0K,All Students,2021-22,7676,1279,6397,83.3,48,33,68.8
0K,All Students,2022-23,6291,798,5493,87.3,39,24,61.5
1,All Students,2018-19,8885,969,7916,89.1,53,23,43.4
1,All Students,2019-20,3793,400,3393,89.5,34,15,44.1
1,All Students,2020-21,8886,1378,7508,84.5,56,33,58.9
1,All Students,2021-22,8197,1300,6897,84.1,48,28,58.3
1,All Students,2022-23,7857,996,6861,87.3,46,24,52.2
2,All Students,2018-19,9279,591,8688,93.6,55,13,23.6
2,All Students,2019-20,4868,407,4461,91.6,45,15,33.3
2,All Students,2020-21,5475,797,4678,85.4,32,17,53.1
2,All Students,2021-22,8605,1178,7427,86.3,51,29,56.9
2,All Students,2022-23,8782,1156,7626,86.8,52,29,55.8
3,All Students,2018-19,6715,497,6218,92.6,43,10,23.3
3,All Students,2019-20,5842,364,5478,93.8,51,11,21.6
3,All Students,2020-21,7522,874,6648,88.4,43,16,37.2
3,All Students,2021-22,5511,762,4749,86.2,32,23,71.9
3,All Students,2022-23,6863,807,6056,88.2,43,21,48.8
4,All Students,2018-19,10274,823,9451,92.0,60,18,30.0
4,All Students,2019-20,4304,313,3991,92.7,38,9,23.7
4,All Students,2020-21,8804,1255,7549,85.7,52,20,38.5
4,All Students,2021-22,8065,1348,6717,83.3,48,32,66.7
4,All Students,2022-23,5406,593,4813,89.0,32,15,46.9
5,All Students,2018-19,10734,884,9850,91.8,62,20,32.3
5,All Students,2019-20,6244,449,5795,92.8,57,17,29.8
5,All Students,2020-21,6745,685,6060,89.8,39,16,41.0
5,All Students,2021-22,8435,1072,7363,87.3,48,19,39.6
5,All Students,2022-23,8644,1117,7527,87.1,50,24,48.0
All Grades,All Students,2018-19,81374,6600,74774,91.9,486,166,34.2
All Grades,All Students,2019-20,46803,3884,42919,91.7,426,132,31.0
All Grades,All Students,2020-21,63144,6530,56614,89.7,370,127,34.3
All Grades,All Students,2021-22,55192,7466,47726,86.5,342,187,54.7
All Grades,All Students,2022-23,51189,7296,43893,85.7,310,173,55.8
PK in K-12 Schools,All Students,2018-19,6055,626,5429,89.7,38,18,47.4
PK in K-12 Schools,All Students,2019-20,3596,503,3093,86.0,35,20,57.1
PK in K-12 Schools,All Students,2020-21,4457,430,4027,90.4,26,9,34.6
PK in K-12 Schools,All Students,2021-22,6659,1016,5643,84.7,42,28,66.7
PK in K-12 Schools,All Students,2022-23,8200,1469,6731,82.1,53,38,71.7
0K,All Students,2018-19,9677,956,8721,90.1,61,28,45.9
0K,All Students,2019-20,6259,631,5628,89.9,58,21,36.2
0K,All Students,2020-21,7745,1323,6422,82.9,47,24,51.1
0K,All Students,2021-22,6239,1148,5091,81.6,42,29,69.0
0K,All Students,2022-23,5844,869,4975,85.1,35,25,71.4
1,All Students,2018-19,10571,774,9797,92.7,61,21,34.4
1,All Students,2019-20,6078,455,5623,92.5,55,16,29.1
1,All Students,2020-21,9377,1084,8293,88.4,55,19,34.5
1,All Students,2021-22,6529,1043,5486,84.0,41,29,70.7
1,All Students,2022-23,6150,966,5184,84.3,38,21,55.3
2,All Students,2018-19,12402,932,11470,92.5,73,19,26.0
2,All Students,2019-20,7756,587,7169,92.4,71,22,31.0
2,All Students,2020-21,8931,588,8343,93.4,52,12,23.1
2,All Students,2021-22,7641,948,6693,87.6,44,21,47.7
2,All Students,2022-23,5928,959,4969,83.8,36,22,61.1
3,All Students,2018-19,12093,802,11291,93.4,73,20,27.4
3,All Students,2019-20,7173,489,6684,93.2,67,18,26.9
3,All Students,2020-21,11546,1353,10193,88.3,66,28,42.4
3,All Students,2021-22,8003,834,7169,89.6,50,19,38.0
3,All Students,2022-23,7807,940,6867,88.0,47,21,44.7
4,All Students,2018-19,14223,1281,12942,91.0,84,30,35.7
4,All Students,2019-20,7113,487,6626,93.2,63,14,22.2
4,All Students,2020-21,10307,831,9476,91.9,61,16,26.2
4,All Students,2021-22,10868,1582,9286,85.4,67,38,56.7
4,All Students,2022-23,7150,582,6568,91.9,41,15,36.6
5,All Students,2018-19,16353,1229,15124,92.5,96,30,31.3
5,All Students,2019-20,8828,732,8096,91.7,77,21,27.3
5,All Students,2020-21,10781,921,9860,91.5,63,19,30.2
5,All Students,2021-22,9253,895,8358,90.3,56,23,41.1
5,All Students,2022-23,10110,1511,8599,85.1,60,31,51.7
All Grades,All Students,2018-19,106583,8362,98221,92.2,625,190,30.4
All Grades,All Students,2019-20,62981,4338,58643,93.1,579,129,22.3
All Grades,All Students,2020-21,91494,8357,83137,90.9,541,179,33.1
All Grades,All Students,2021-22,83642,10374,73268,87.6,500,255,51.0
All Grades,All Students,2022-23,85457,10653,74804,87.5,520,290,55.8
PK in K-12 Schools,All Students,2018-19,11116,999,10117,91.0,68,24,35.3
PK in K-12 Schools,All Students,2019-20,6554,580,5974,91.2,63,20,31.7
PK in K-12 Schools,All Students,2020-21,7389,694,6695,90.6,43,16,37.2
PK in K-12 Schools,All Students,2021-22,7171,1246,5925,82.6,47,37,78.7
PK in K-12 Schools,All Students,2022-23,9707,1774,7933,81.7,64,55,85.9
0K,All Students,2018-19,16314,1727,14587,89.4,97,41,42.3
0K,All Students,2019-20,9132,693,8439,92.4,84,25,29.8
0K,All Students,2020-21,14570,1400,13170,90.4,90,33,36.7
0K,All Students,2021-22,9746,1503,8243,84.6,60,42,70.0
0K,All Students,2022-23,9903,1476,8427,85.1,61,41,67.2
1,All Students,2018-19,14686,1206,13480,91.8,87,27,31.0
1,All Students,2019-20,9805,675,9130,93.1,90,19,21.1
1,All Students,2020-21,13471,1468,12003,89.1,81,29,35.8
1,All Students,2021-22,13469,1706,11763,87.3,79,42,53.2
1,All Students,2022-23,11758,1690,10068,85.6,73,47,64.4
2,All Students,2018-19,13981,1049,12932,92.5,81,25,30.9
2,All Students,2019-20,9024,581,8443,93.6,83,15,18.1
2,All Students,2020-21,14382,1134,13248,92.1,86,25,29.1
2,All Students,2021-22,13486,1577,11909,88.3,81,33,40.7
2,All Students,2022-23,13930,1509,12421,89.2,86,40,46.5
3,All Students,2018-19,15339,1063,14276,93.1,89,27,30.3
3,All Students,2019-20,9037,613,8424,93.2,81,18,22.2
3,All Students,2020-21,13781,1137,12644,91.7,80,21,26.3
3,All Students,2021-22,14284,1484,12800,89.6,85,34,40.0
3,All Students,2022-23,13320,1411,11909,89.4,80,40,50.0
4,All Students,2018-19,16197,1181,15016,92.7,93,25,26.9
4,All Students,2019-20,9153,633,8520,93.1,86,18,20.9
4,All Students,2020-21,13564,1163,12401,91.4,78,26,33.3
4,All Students,2021-22,12416,1326,11090,89.3,74,31,41.9
4,All Students,2022-23,13472,1429,12043,89.4,79,35,44.3
5,All Students,2018-19,18950,1137,17813,94.0,110,21,19.1
5,All Students,2019-20,10276,563,9713,94.5,92,14,15.2
5,All Students,2020-21,14337,1361,12976,90.5,83,29,34.9
5,All Students,2021-22,13070,1532,11538,88.3,74,36,48.6
5,All Students,2022-23,13367,1364,12003,89.8,77,32,41.6
All Grades,All Students,2018-19,36499,3921,32578,89.3,215,93,43.3
All Grades,All Students,2019-20,23545,2586,20959,89.0,224,93,41.5
All Grades,All Students,2020-21,34825,4884,29941,86.0,205,81,39.5
All Grades,All Students,2021-22,36503,5209,31294,85.7,221,129,58.4
All Grades,All Students,2022-23,37053,4697,32356,87.3,228,116,50.9
PK in K-12 Schools,All Students,2018-19,3095,469,2626,84.8,18,12,66.7
PK in K-12 Schools,All Students,2019-20,2075,293,1782,85.9,20,11,55.0
PK in K-12 Schools,All Students,2020-21,1997,94,1903,95.3,12,2,16.7
PK in K-12 Schools,All Students,2021-22,3025,501,2524,83.4,18,14,77.8
PK in K-12 Schools,All Students,2022-23,2748,636,2112,76.9,19,14,73.7
0K,All Students,2018-19,5285,706,4579,86.6,32,19,59.4
0K,All Students,2019-20,4155,536,3619,87.1,41,21,51.2
0K,All Students,2020-21,6876,1272,5604,81.5,42,22,52.4
0K,All Students,2021-22,6013,937,5076,84.4,37,23,62.2
0K,All Students,2022-23,4724,729,3995,84.6,31,19,61.3
1,All Students,2018-19,6192,630,5562,89.8,38,15,39.5
1,All Students,2019-20,3231,415,2816,87.2,32,18,56.3
1,All Students,2020-21,5930,783,5147,86.8,35,14,40.0
1,All Students,2021-22,5884,959,4925,83.7,35,23,65.7
1,All Students,2022-23,6297,810,5487,87.1,37,21,56.8
2,All Students,2018-19,5907,610,5297,89.7,37,13,35.1
2,All Students,2019-20,4267,492,3775,88.5,38,12,31.6
2,All Students,2020-21,4757,839,3918,82.4,28,17,60.7
2,All Students,2021-22,6052,813,5239,86.6,35,18,51.4
2,All Students,2022-23,6189,753,5436,87.8,39,19,48.7
3,All Students,2018-19,4806,507,4299,89.5,27,11,40.7
3,All Students,2019-20,3050,251,2799,91.8,30,9,30.0
3,All Students,2020-21,6650,1024,5626,84.6,38,14,36.8
3,All Students,2021-22,4906,769,4137,84.3,31,19,61.3
3,All Students,2022-23,6264,628,5636,90.0,37,11,29.7
4,All Students,2018-19,5873,505,5368,91.4,33,12,36.4
4,All Students,2019-20,3169,318,2851,90.0,30,10,33.3
4,All Students,2020-21,4249,456,3793,89.3,25,5,20.0
4,All Students,2021-22,6175,709,5466,88.5,38,19,50.0
4,All Students,2022-23,4813,530,4283,89.0,29,15,51.7
5,All Students,2018-19,5341,494,4847,90.8,30,11,36.7
5,All Students,2019-20,3598,281,3317,92.2,33,12,36.4
5,All Students,2020-21,4366,416,3950,90.5,25,7,28.0
5,All Students,2021-22,4448,521,3927,88.3,27,13,48.1
5,All Students,2022-23,6018,611,5407,89.8,36,17,47.2
All Grades,All Students,2018-19,213928,11633,202295,94.6,1222,195,16.0
All Grades,All Students,2019-20,145340,8688,136652,94.0,1276,227,17.8
All Grades,All Students,2020-21,220715,20301,200414,90.8,1276,345,27.0
All Grades,All Students,2021-22,204987,22401,182586,89.1,1191,458,38.5
All Grades,All Students,2022-23,188670,18173,170497,90.4,1105,370,33.5
6,All Students,2018-19,79859,3815,76044,95.2,456,59,12.9
6,All Students,2019-20,49739,3220,46519,93.5,438,87,19.9
6,All Students,2020-21,71691,6397,65294,91.1,418,103,24.6
6,All Students,2021-22,66464,7005,59459,89.5,390,150,38.5
6,All Students,2022-23,59213,5965,53248,89.9,351,124,35.3
7,All Students,2018-19,71423,4040,67383,94.3,407,72,17.7
7,All Students,2019-20,49925,2733,47192,94.5,439,71,16.2
7,All Students,2020-21,73965,7017,66948,90.5,426,108,25.4
7,All Students,2021-22,67718,7007,60711,89.7,395,136,34.4
7,All Students,2022-23,63086,5640,57446,91.1,368,118,32.1
8,All Students,2018-19,62646,3778,58868,94.0,359,64,17.8
8,All Students,2019-20,45669,s,s,s,s,s,s
8,All Students,2020-21,74994,6864,68130,90.8,431,133,30.9
8,All Students,2021-22,70805,8389,62416,88.2,406,172,42.4
8,All Students,2022-23,66371,6568,59803,90.1,386,128,33.2
9,All Students,2019-20,7,s,s,s,s,s,s
All Grades,All Students,2018-19,20449,1702,18747,91.7,127,42,33.1
All Grades,All Students,2019-20,13993,1177,12816,91.6,128,41,32.0
All Grades,All Students,2020-21,19412,1535,17877,92.1,118,36,30.5
All Grades,All Students,2021-22,20089,2230,17859,88.9,120,59,49.2
All Grades,All Students,2022-23,17829,1961,15868,89.0,112,49,43.8
PK in K-12 Schools,All Students,2018-19,6735,719,6016,89.3,47,20,42.6
PK in K-12 Schools,All Students,2019-20,4525,353,4172,92.2,44,13,29.5
PK in K-12 Schools,All Students,2020-21,5667,s,s,s,s,s,s
PK in K-12 Schools,All Students,2021-22,8600,1106,7494,87.1,53,33,62.3
PK in K-12 Schools,All Students,2022-23,7136,903,6233,87.3,49,28,57.1
0K,All Students,2018-19,7503,593,6910,92.1,45,14,31.1
0K,All Students,2019-20,5001,486,4515,90.3,44,17,38.6
0K,All Students,2020-21,7027,519,6508,92.6,42,10,23.8
0K,All Students,2021-22,5799,692,5107,88.1,34,18,52.9
0K,All Students,2022-23,6394,587,5807,90.8,38,12,31.6
1,All Students,2018-19,6211,390,5821,93.7,35,8,22.9
1,All Students,2019-20,4467,338,4129,92.4,40,11,27.5
1,All Students,2020-21,6694,582,6112,91.3,40,16,40.0
1,All Students,2021-22,5690,432,5258,92.4,33,8,24.2
1,All Students,2022-23,4299,471,3828,89.0,25,9,36.0
2,All Students,2020-21,24,s,s,s,s,s,s
All Grades,All Students,2018-19,101898,7480,94418,92.7,593,161,27.2
All Grades,All Students,2019-20,61037,4885,56152,92.0,543,188,34.6
All Grades,All Students,2020-21,84208,4969,79239,94.1,491,109,22.2
All Grades,All Students,2021-22,74035,9130,64905,87.7,434,219,50.5
All Grades,All Students,2022-23,70126,7634,62492,89.1,423,213,50.4
PK in K-12 Schools,All Students,2018-19,9085,947,8138,89.6,54,19,35.2
PK in K-12 Schools,All Students,2019-20,4785,515,4270,89.2,46,24,52.2
PK in K-12 Schools,All Students,2020-21,7235,536,6699,92.6,43,15,34.9
PK in K-12 Schools,All Students,2021-22,10313,1687,8626,83.6,63,43,68.3
PK in K-12 Schools,All Students,2022-23,10259,1584,8675,84.6,66,49,74.2
0K,All Students,2018-19,13976,1192,12784,91.5,82,30,36.6
0K,All Students,2019-20,7725,713,7012,90.8,69,30,43.5
0K,All Students,2020-21,10765,630,10135,94.1,63,16,25.4
0K,All Students,2021-22,9616,1159,8457,87.9,57,32,56.1
0K,All Students,2022-23,11148,1139,10009,89.8,70,37,52.9
1,All Students,2018-19,14903,1246,13657,91.6,86,29,33.7
1,All Students,2019-20,9453,860,8593,90.9,84,30,35.7
1,All Students,2020-21,11582,812,10770,93.0,69,19,27.5
1,All Students,2021-22,9926,1185,8741,88.1,59,30,50.8
1,All Students,2022-23,9485,1046,8439,89.0,55,27,49.1
2,All Students,2018-19,15463,1233,14230,92.0,91,26,28.6
2,All Students,2019-20,9051,799,8252,91.2,80,28,35.0
2,All Students,2020-21,13459,747,12712,94.4,78,15,19.2
2,All Students,2021-22,9959,1216,8743,87.8,60,27,45.0
2,All Students,2022-23,9217,930,8287,89.9,57,24,42.1
3,All Students,2018-19,15338,972,14366,93.7,91,21,23.1
3,All Students,2019-20,9874,768,9106,92.2,87,28,32.2
3,All Students,2020-21,12669,1027,11642,91.9,73,26,35.6
3,All Students,2021-22,10194,1177,9017,88.5,59,25,42.4
3,All Students,2022-23,9797,920,8877,90.6,57,23,40.4
4,All Students,2018-19,16727,925,15802,94.5,95,20,21.1
4,All Students,2019-20,9559,638,8921,93.3,84,29,34.5
4,All Students,2020-21,14899,684,14215,95.4,87,11,12.6
4,All Students,2021-22,10933,1217,9716,88.9,62,28,45.2
4,All Students,2022-23,9503,930,8573,90.2,56,24,42.9
5,All Students,2018-19,16406,965,15441,94.1,94,16,17.0
5,All Students,2019-20,10590,592,9998,94.4,93,19,20.4
5,All Students,2020-21,13599,533,13066,96.1,78,7,9.0
5,All Students,2021-22,13094,1489,11605,88.6,74,34,45.9
5,All Students,2022-23,10717,1085,9632,89.9,62,29,46.8
All Grades,All Students,2018-19,108557,6160,102397,94.3,625,92,14.7
All Grades,All Students,2019-20,70194,4288,65906,93.9,620,103,16.6
All Grades,All Students,2020-21,99408,5905,93503,94.1,574,115,20.0
All Grades,All Students,2021-22,95939,7643,88296,92.0,562,163,29.0
All Grades,All Students,2022-23,96848,6952,89896,92.8,562,132,23.5
PK in K-12 Schools,All Students,2018-19,6333,514,5819,91.9,36,8,22.2
PK in K-12 Schools,All Students,2019-20,4022,312,3710,92.2,36,9,25.0
PK in K-12 Schools,All Students,2020-21,6062,455,5607,92.5,36,10,27.8
PK in K-12 Schools,All Students,2021-22,6372,454,5918,92.9,36,6,16.7
PK in K-12 Schools,All Students,2022-23,6360,549,5811,91.4,37,13,35.1
0K,All Students,2018-19,11053,630,10423,94.3,64,10,15.6
0K,All Students,2019-20,8211,544,7667,93.4,74,17,23.0
0K,All Students,2020-21,10419,749,9670,92.8,60,16,26.7
0K,All Students,2021-22,10523,942,9581,91.0,63,22,34.9
0K,All Students,2022-23,10576,820,9756,92.2,64,17,26.6
1,All Students,2018-19,17249,978,16271,94.3,100,14,14.0
1,All Students,2019-20,8760,613,8147,93.0,78,18,23.1
1,All Students,2020-21,12117,558,11559,95.4,70,9,12.9
1,All Students,2021-22,13428,940,12488,93.0,79,15,19.0
1,All Students,2022-23,13732,991,12741,92.8,81,17,21.0
2,All Students,2018-19,17345,916,16429,94.7,101,11,10.9
2,All Students,2019-20,13491,784,12707,94.2,120,16,13.3
2,All Students,2020-21,17475,1314,16161,92.5,101,28,27.7
2,All Students,2021-22,16636,1353,15283,91.9,96,31,32.3
2,All Students,2022-23,16861,1158,15703,93.1,98,20,20.4
3,All Students,2018-19,21857,1265,20592,94.2,124,17,13.7
3,All Students,2019-20,11257,672,10585,94.0,99,19,19.2
3,All Students,2020-21,18865,864,18001,95.4,108,13,12.0
3,All Students,2021-22,17184,1447,15737,91.6,102,32,31.4
3,All Students,2022-23,16808,1251,15557,92.6,95,25,26.3
4,All Students,2018-19,17802,913,16889,94.9,102,14,13.7
4,All Students,2019-20,13572,720,12852,94.7,119,13,10.9
4,All Students,2020-21,16591,867,15724,94.8,96,20,20.8
4,All Students,2021-22,16085,1209,14876,92.5,95,29,30.5
4,All Students,2022-23,16577,1226,15351,92.6,97,26,26.8
5,All Students,2018-19,16918,944,15974,94.4,98,18,18.4
5,All Students,2019-20,10881,643,10238,94.1,95,12,12.6
5,All Students,2020-21,17879,1098,16781,93.9,103,19,18.4
5,All Students,2021-22,15711,1298,14413,91.7,91,28,30.8
5,All Students,2022-23,15934,957,14977,94.0,90,14,15.6
All Grades,All Students,2018-19,117021,7159,109862,93.9,701,173,24.7
All Grades,All Students,2019-20,86128,3896,82232,95.5,787,98,12.5
All Grades,All Students,2020-21,140807,7138,133669,94.9,808,110,13.6
All Grades,All Students,2021-22,142683,12317,130366,91.4,844,274,32.5
All Grades,All Students,2022-23,131619,8985,122634,93.2,800,189,23.6
9,All Students,2018-19,36735,1246,35489,96.6,221,18,8.1
9,All Students,2019-20,25451,716,24735,97.2,233,15,6.4
9,All Students,2020-21,35396,1296,34100,96.3,203,12,5.9
9,All Students,2021-22,36129,1181,34948,96.7,214,11,5.1
9,All Students,2022-23,33503,1403,32100,95.8,205,24,11.7
10,All Students,2018-19,28053,859,27194,96.9,168,11,6.5
10,All Students,2019-20,25711,1059,24652,95.9,236,24,10.2
10,All Students,2020-21,36663,1567,35096,95.7,211,19,9.0
10,All Students,2021-22,33693,1941,31752,94.2,200,40,20.0
10,All Students,2022-23,33156,1272,31884,96.2,202,21,10.4
11,All Students,2018-19,26244,1079,25165,95.9,157,15,9.6
11,All Students,2019-20,18152,626,17526,96.6,165,14,8.5
11,All Students,2020-21,40081,1864,38217,95.3,230,29,12.6
11,All Students,2021-22,34271,2128,32143,93.8,203,37,18.2
11,All Students,2022-23,31746,1917,29829,94.0,193,39,20.2
12,All Students,2018-19,25989,3975,22014,84.7,155,129,83.2
12,All Students,2019-20,16814,1495,15319,91.1,153,45,29.4
12,All Students,2020-21,28667,2411,26256,91.6,164,50,30.5
12,All Students,2021-22,38590,7067,31523,81.7,227,186,81.9
12,All Students,2022-23,33214,4393,28821,86.8,200,105,52.5
All Grades,All Students,2018-19,47701,7004,40697,85.3,309,146,47.2
All Grades,All Students,2019-20,33871,3980,29891,88.2,316,123,38.9
All Grades,All Students,2020-21,65225,5910,59315,90.9,383,118,30.8
All Grades,All Students,2021-22,64145,8922,55223,86.1,410,194,47.3
All Grades,All Students,2022-23,63345,10582,52763,83.3,425,205,48.2
9,All Students,2018-19,17013,1369,15644,92.0,108,27,25.0
9,All Students,2019-20,11092,952,10140,91.4,102,34,33.3
9,All Students,2020-21,22564,1242,21322,94.5,131,22,16.8
9,All Students,2021-22,18611,2759,15852,85.2,113,63,55.8
9,All Students,2022-23,18867,2831,16036,85.0,123,60,48.8
10,All Students,2018-19,13078,1673,11405,87.2,84,39,46.4
10,All Students,2019-20,10507,825,9682,92.1,99,25,25.3
10,All Students,2020-21,18060,1567,16493,91.3,103,22,21.4
10,All Students,2021-22,19048,1932,17116,89.9,116,41,35.3
10,All Students,2022-23,17117,2085,15032,87.8,109,42,38.5
11,All Students,2018-19,8961,1989,6972,77.8,57,37,64.9
11,All Students,2019-20,6841,947,5894,86.2,63,30,47.6
11,All Students,2020-21,15584,1514,14070,90.3,90,34,37.8
11,All Students,2021-22,15537,2312,13225,85.1,97,43,44.3
11,All Students,2022-23,17294,2678,14616,84.5,106,45,42.5
12,All Students,2018-19,8649,1973,6676,77.2,60,43,71.7
12,All Students,2019-20,5431,1256,4175,76.9,52,34,65.4
12,All Students,2020-21,9017,1587,7430,82.4,59,40,67.8
12,All Students,2021-22,10949,1919,9030,82.5,84,47,56.0
12,All Students,2022-23,10067,2988,7079,70.3,87,58,66.7
All Grades,All Students,2018-19,111098,23973,87125,78.4,708,366,51.7
All Grades,All Students,2019-20,68119,14273,53846,79.0,621,290,46.7
All Grades,All Students,2020-21,85765,18541,67224,78.4,540,295,54.6
All Grades,All Students,2021-22,67859,11935,55924,82.4,451,229,50.8
All Grades,All Students,2022-23,64428,9311,55117,85.5,446,169,37.9
8,All Students,2018-19,12,s,s,s,s,s,s
9,All Students,2018-19,22756,s,s,s,s,s,s
9,All Students,2019-20,15314,1516,13798,90.1,145,49,33.8
9,All Students,2020-21,14681,2888,11793,80.3,89,45,50.6
9,All Students,2021-22,12818,1939,10879,84.9,89,35,39.3
9,All Students,2022-23,17897,1946,15951,89.1,130,36,27.7
10,All Students,2018-19,25747,5333,20414,79.3,171,86,50.3
10,All Students,2019-20,15572,2398,13174,84.6,146,62,42.5
10,All Students,2020-21,26811,5751,21060,78.5,161,91,56.5
10,All Students,2021-22,15508,3258,12250,79.0,105,60,57.1
10,All Students,2022-23,14756,2291,12465,84.5,100,36,36.0
11,All Students,2018-19,29006,6608,22398,77.2,180,103,57.2
11,All Students,2019-20,16907,3835,13072,77.3,155,75,48.4
11,All Students,2020-21,23571,4016,19555,83.0,142,71,50.0
11,All Students,2021-22,19870,2923,16947,85.3,124,59,47.6
11,All Students,2022-23,14627,2590,12037,82.3,98,48,49.0
12,All Students,2018-19,33577,9386,24191,72.0,208,131,63.0
12,All Students,2019-20,20326,6524,13802,67.9,175,104,59.4
12,All Students,2020-21,20702,5886,14816,71.6,148,88,59.5
12,All Students,2021-22,19663,3815,15848,80.6,133,75,56.4
12,All Students,2022-23,17148,2484,14664,85.5,118,49,41.5
All Grades,All Students,2018-19,49126,13248,35878,73.0,320,190,59.4
All Grades,All Students,2019-20,32246,7433,24813,76.9,305,159,52.1
All Grades,All Students,2020-21,53900,9173,44727,83.0,333,148,44.4
All Grades,All Students,2021-22,68158,11226,56932,83.5,467,229,49.0
All Grades,All Students,2022-23,78940,12126,66814,84.6,536,225,42.0
9,All Students,2018-19,13947,3517,10430,74.8,95,47,49.5
9,All Students,2019-20,8536,1684,6852,80.3,89,43,48.3
9,All Students,2020-21,21766,3116,18650,85.7,132,49,37.1
9,All Students,2021-22,30145,4799,25346,84.1,211,97,46.0
9,All Students,2022-23,25657,4514,21143,82.4,184,81,44.0
10,All Students,2018-19,11859,4382,7477,63.0,75,53,70.7
10,All Students,2019-20,9493,2144,7349,77.4,86,40,46.5
10,All Students,2020-21,12075,1730,10345,85.7,74,29,39.2
10,All Students,2021-22,17770,2349,15421,86.8,126,60,47.6
10,All Students,2022-23,22529,3589,18940,84.1,152,71,46.7
11,All Students,2018-19,12205,2236,9969,81.7,79,37,46.8
11,All Students,2019-20,6383,1776,4607,72.2,60,39,65.0
11,All Students,2020-21,12154,2405,9749,80.2,76,40,52.6
11,All Students,2021-22,8540,1432,7108,83.2,53,26,49.1
11,All Students,2022-23,19961,2260,17701,88.7,130,41,31.5
12,All Students,2018-19,11115,3113,8002,72.0,71,53,74.6
12,All Students,2019-20,7834,1829,6005,76.7,70,37,52.9
12,All Students,2020-21,7905,1922,5983,75.7,51,30,58.8
12,All Students,2021-22,11703,2646,9057,77.4,77,46,59.7
12,All Students,2022-23,10793,1763,9030,83.7,70,32,45.7
All Grades,All Students,2018-19,135636,20007,115629,85.2,877,382,43.6
All Grades,All Students,2019-20,83956,13697,70259,83.7,805,362,45.0
All Grades,All Students,2020-21,118279,18783,99496,84.1,697,273,39.2
All Grades,All Students,2021-22,91143,15094,76049,83.4,599,328,54.8
All Grades,All Students,2022-23,89469,15225,74244,83.0,597,305,51.1
8,All Students,2018-19,1,s,s,s,s,s,s
9,All Students,2018-19,35537,6396,29141,82.0,237,103,43.5
9,All Students,2019-20,21999,3971,18028,81.9,218,105,48.2
9,All Students,2020-21,31069,4848,26221,84.4,184,63,34.2
9,All Students,2021-22,26103,4619,21484,82.3,180,97,53.9
9,All Students,2022-23,26527,4936,21591,81.4,184,94,51.1
10,All Students,2018-19,39642,5995,33647,84.9,260,119,45.8
10,All Students,2019-20,20162,3185,16977,84.2,196,86,43.9
10,All Students,2020-21,30743,6580,24163,78.6,184,90,48.9
10,All Students,2021-22,26577,4277,22300,83.9,172,91,52.9
10,All Students,2022-23,26268,5086,21182,80.6,180,101,56.1
11,All Students,2018-19,34820,4023,30797,88.4,220,86,39.1
11,All Students,2019-20,19741,2310,17431,88.3,187,70,37.4
11,All Students,2020-21,24852,2467,22385,90.1,144,37,25.7
11,All Students,2021-22,17729,3084,14645,82.6,120,74,61.7
11,All Students,2022-23,20081,2504,17577,87.5,128,54,42.2
12,All Students,2018-19,25636,s,s,s,s,s,s
12,All Students,2019-20,22054,4231,17823,80.8,204,101,49.5
12,All Students,2020-21,31615,4888,26727,84.5,185,83,44.9
12,All Students,2021-22,20734,3114,17620,85.0,127,66,52.0
12,All Students,2022-23,16593,2699,13894,83.7,105,56,53.3
All Grades,All Students,2018-19,87047,13509,73538,84.5,541,247,45.7
All Grades,All Students,2019-20,58435,9739,48696,83.3,545,254,46.6
All Grades,All Students,2020-21,83853,29743,54110,64.5,533,473,88.7
All Grades,All Students,2021-22,89626,11115,78511,87.6,561,245,43.7
All Grades,All Students,2022-23,91024,5847,85177,93.6,575,107,18.6
9,All Students,2018-19,22172,2863,19309,87.1,135,48,35.6
9,All Students,2019-20,18024,2376,15648,86.8,168,58,34.5
9,All Students,2020-21,25318,7883,17435,68.9,160,132,82.5
9,All Students,2021-22,25278,2409,22869,90.5,162,52,32.1
9,All Students,2022-23,25644,1206,24438,95.3,164,14,8.5
10,All Students,2018-19,20516,3045,17471,85.2,132,55,41.7
10,All Students,2019-20,13447,2151,11296,84.0,126,57,45.2
10,All Students,2020-21,23484,7840,15644,66.6,149,129,86.6
10,All Students,2021-22,23983,2501,21482,89.6,147,50,34.0
10,All Students,2022-23,24340,1108,23232,95.4,152,21,13.8
11,All Students,2018-19,22637,3373,19264,85.1,140,62,44.3
11,All Students,2019-20,12155,2032,10123,83.3,113,57,50.4
11,All Students,2020-21,18230,6238,11992,65.8,113,104,92.0
11,All Students,2021-22,22683,2624,20059,88.4,138,60,43.5
11,All Students,2022-23,21819,1455,20364,93.3,136,28,20.6
12,All Students,2018-19,21722,4228,17494,80.5,134,82,61.2
12,All Students,2019-20,14809,3180,11629,78.5,138,82,59.4
12,All Students,2020-21,16821,7782,9039,53.7,111,108,97.3
12,All Students,2021-22,17682,3581,14101,79.7,114,83,72.8
12,All Students,2022-23,19221,2078,17143,89.2,123,44,35.8
All Grades,All Students,2018-19,95598,7185,88413,92.5,581,100,17.2
All Grades,All Students,2019-20,64465,5113,59352,92.1,597,139,23.3
All Grades,All Students,2020-21,105907,7232,98675,93.2,607,101,16.6
All Grades,All Students,2021-22,99143,10653,88490,89.3,600,181,30.2
All Grades,All Students,2022-23,97582,9224,88358,90.5,607,175,28.8
9,All Students,2018-19,25641,1717,23924,93.3,157,29,18.5
9,All Students,2019-20,17622,1103,16519,93.7,166,32,19.3
9,All Students,2020-21,29613,2307,27306,92.2,170,33,19.4
9,All Students,2021-22,27024,2132,24892,92.1,164,42,25.6
9,All Students,2022-23,27091,1914,25177,92.9,170,42,24.7
10,All Students,2018-19,24733,1941,22792,92.2,153,31,20.3
10,All Students,2019-20,15810,1084,14726,93.1,149,35,23.5
10,All Students,2020-21,26145,1620,24525,93.8,149,15,10.1
10,All Students,2021-22,25943,3136,22807,87.9,162,62,38.3
10,All Students,2022-23,25761,2086,23675,91.9,162,43,26.5
11,All Students,2018-19,24749,2307,22442,90.7,149,25,16.8
11,All Students,2019-20,16656,1167,15489,93.0,152,41,27.0
11,All Students,2020-21,24526,1708,22818,93.0,141,23,16.3
11,All Students,2021-22,24349,3249,21100,86.7,143,41,28.7
11,All Students,2022-23,23476,2964,20512,87.4,147,56,38.1
12,All Students,2018-19,20475,1220,19255,94.0,122,15,12.3
12,All Students,2019-20,14377,1759,12618,87.8,130,31,23.8
12,All Students,2020-21,25623,1597,24026,93.8,147,30,20.4
12,All Students,2021-22,21827,2136,19691,90.2,131,36,27.5
12,All Students,2022-23,21254,2260,18994,89.4,128,34,26.6
All Grades,All Students,2018-19,112602,10465,102137,90.7,694,205,29.5
All Grades,All Students,2019-20,75553,7010,68543,90.7,708,232,32.8
All Grades,All Students,2020-21,119725,10397,109328,91.3,719,175,24.3
All Grades,All Students,2021-22,115150,16003,99147,86.1,716,357,49.9
All Grades,All Students,2022-23,113027,15436,97591,86.3,711,318,44.7
9,All Students,2018-19,29642,1899,27743,93.6,181,29,16.0
9,All Students,2019-20,19410,1308,18102,93.3,182,47,25.8
9,All Students,2020-21,31248,2016,29232,93.5,180,32,17.8
9,All Students,2021-22,30721,3174,27547,89.7,189,75,39.7
9,All Students,2022-23,27939,3399,24540,87.8,181,75,41.4
10,All Students,2018-19,30264,2139,28125,92.9,187,47,25.1
10,All Students,2019-20,19739,1390,18349,93.0,184,48,26.1
10,All Students,2020-21,32583,2758,29825,91.5,189,38,20.1
10,All Students,2021-22,30795,3961,26834,87.1,188,71,37.8
10,All Students,2022-23,29870,3774,26096,87.4,192,84,43.8
11,All Students,2018-19,28014,3307,24707,88.2,173,75,43.4
11,All Students,2019-20,19449,1803,17646,90.7,183,64,35.0
11,All Students,2020-21,30039,3231,26808,89.2,173,58,33.5
11,All Students,2021-22,28092,4331,23761,84.6,170,92,54.1
11,All Students,2022-23,28990,3476,25514,88.0,178,64,36.0
12,All Students,2018-19,24682,3120,21562,87.4,153,54,35.3
12,All Students,2019-20,16955,2509,14446,85.2,159,73,45.9
12,All Students,2020-21,25855,2392,23463,90.7,177,47,26.6
12,All Students,2021-22,25542,4537,21005,82.2,169,119,70.4
12,All Students,2022-23,26228,4787,21441,81.7,160,95,59.4
All Grades,All Students,2018-19,87147,4090,83057,95.3,495,58,11.7
All Grades,All Students,2019-20,54641,2516,52125,95.4,481,58,12.1
All Grades,All Students,2020-21,82500,2071,80429,97.5,475,16,3.4
All Grades,All Students,2021-22,77349,5926,71423,92.3,449,118,26.3
All Grades,All Students,2022-23,75583,5419,70164,92.8,441,102,23.1
5,All Students,2022-23,127,s,s,s,s,s,s
6,All Students,2018-19,28083,1324,26759,95.3,159,16,10.1
6,All Students,2019-20,19580,980,18600,95.0,174,23,13.2
6,All Students,2020-21,26951,626,26325,97.7,156,4,2.6
6,All Students,2021-22,24859,1848,23011,92.6,147,38,25.9
6,All Students,2022-23,26527,1973,24554,92.6,157,38,24.2
7,All Students,2018-19,27469,1220,26249,95.6,157,17,10.8
7,All Students,2019-20,17820,769,17051,95.7,157,20,12.7
7,All Students,2020-21,29187,770,28417,97.4,167,6,3.6
7,All Students,2021-22,24860,1821,23039,92.7,145,34,23.4
7,All Students,2022-23,23638,s,s,s,s,s,s
8,All Students,2018-19,31595,1546,30049,95.1,179,25,14.0
8,All Students,2019-20,17241,767,16474,95.6,150,15,10.0
8,All Students,2020-21,26362,675,25687,97.4,152,6,3.9
8,All Students,2021-22,27630,2257,25373,91.8,157,46,29.3
8,All Students,2022-23,25291,1776,23515,93.0,145,29,20.0
All Grades,All Students,2018-19,52601,4739,47862,91.0,314,120,38.2
All Grades,All Students,2019-20,37659,2817,34842,92.5,340,93,27.4
All Grades,All Students,2020-21,61893,7882,54011,87.3,362,151,41.7
All Grades,All Students,2021-22,57279,6971,50308,87.8,343,155,45.2
All Grades,All Students,2022-23,55791,6058,49733,89.1,334,144,43.1
6,All Students,2018-19,21263,1927,19336,90.9,126,50,39.7
6,All Students,2019-20,14600,853,13747,94.2,133,25,18.8
6,All Students,2020-21,21282,2459,18823,88.4,124,49,39.5
6,All Students,2021-22,17527,1913,15614,89.1,104,43,41.3
6,All Students,2022-23,21367,2201,19166,89.7,128,52,40.6
7,All Students,2018-19,16147,1516,14631,90.6,98,36,36.7
7,All Students,2019-20,12506,872,11634,93.0,111,30,27.0
7,All Students,2020-21,21814,2872,18942,86.8,128,48,37.5
7,All Students,2021-22,18951,2395,16556,87.4,118,55,46.6
7,All Students,2022-23,17117,1941,15176,88.7,104,50,48.1
8,All Students,2018-19,15191,1296,13895,91.5,90,34,37.8
8,All Students,2019-20,10553,1092,9461,89.7,96,38,39.6
8,All Students,2020-21,18797,2551,16246,86.4,110,54,49.1
8,All Students,2021-22,20801,2663,18138,87.2,121,57,47.1
8,All Students,2022-23,17307,1916,15391,88.9,102,42,41.2
All Grades,All Students,2018-19,78919,14021,64898,82.2,489,238,48.7
All Grades,All Students,2019-20,47969,7809,40160,83.7,445,206,46.3
All Grades,All Students,2020-21,70622,19991,50631,71.7,415,323,77.8
All Grades,All Students,2021-22,66881,19438,47443,70.9,408,307,75.2
All Grades,All Students,2022-23,64799,17788,47011,72.5,412,293,71.1
6,All Students,2018-19,11066,1215,9851,89.0,66,25,37.9
6,All Students,2019-20,4747,476,4271,90.0,46,20,43.5
6,All Students,2020-21,5306,1121,4185,78.9,31,17,54.8
6,All Students,2021-22,5205,882,4323,83.1,31,20,64.5
6,All Students,2022-23,6057,927,5130,84.7,38,24,63.2
7,All Students,2018-19,8144,1233,6911,84.9,51,18,35.3
7,All Students,2019-20,6710,655,6055,90.2,62,25,40.3
7,All Students,2020-21,7791,1659,6132,78.7,46,23,50.0
7,All Students,2021-22,5503,1188,4315,78.4,35,28,80.0
7,All Students,2022-23,6416,1030,5386,83.9,42,23,54.8
8,All Students,2018-19,10100,1179,8921,88.3,61,25,41.0
8,All Students,2019-20,4867,613,4254,87.4,46,15,32.6
8,All Students,2020-21,10200,1792,8408,82.4,60,33,55.0
8,All Students,2021-22,8917,2220,6697,75.1,55,41,74.5
8,All Students,2022-23,6532,1429,5103,78.1,42,29,69.0
9,All Students,2018-19,13061,2135,10926,83.7,82,36,43.9
9,All Students,2019-20,8514,1390,7124,83.7,80,41,51.3
9,All Students,2020-21,11803,3816,7987,67.7,70,64,91.4
9,All Students,2021-22,14846,4189,10657,71.8,90,62,68.9
9,All Students,2022-23,13786,3910,9876,71.6,89,64,71.9
10,All Students,2018-19,12931,2820,10111,78.2,82,43,52.4
10,All Students,2019-20,8524,1930,6594,77.4,77,36,46.8
10,All Students,2020-21,13491,4750,8741,64.8,80,66,82.5
10,All Students,2021-22,10242,3808,6434,62.8,66,57,86.4
10,All Students,2022-23,13132,3963,9169,69.8,85,60,70.6
11,All Students,2018-19,12506,2747,9759,78.0,78,42,53.8
11,All Students,2019-20,7669,1325,6344,82.7,72,29,40.3
11,All Students,2020-21,10600,3166,7434,70.1,62,56,90.3
11,All Students,2021-22,12153,3486,8667,71.3,75,54,72.0
11,All Students,2022-23,7401,2578,4823,65.2,49,43,87.8
12,All Students,2018-19,11111,2692,8419,75.8,69,49,71.0
12,All Students,2019-20,6938,1420,5518,79.5,62,40,64.5
12,All Students,2020-21,11431,3687,7744,67.7,66,64,97.0
12,All Students,2021-22,10015,3665,6350,63.4,56,45,80.4
12,All Students,2022-23,11475,3951,7524,65.6,67,50,74.6
All Grades,All Students,2018-19,53105,8699,44406,83.6,340,163,47.9
All Grades,All Students,2019-20,33653,5612,28041,83.3,318,143,45.0
All Grades,All Students,2020-21,54726,9154,45572,83.3,338,169,50.0
All Grades,All Students,2021-22,58481,8361,50120,85.7,365,114,31.2
All Grades,All Students,2022-23,59352,7001,52351,88.2,390,131,33.6
9,All Students,2018-19,13248,1288,11960,90.3,86,25,29.1
9,All Students,2019-20,7693,1273,6420,83.5,76,34,44.7
9,All Students,2020-21,19330,3164,16166,83.6,121,58,47.9
9,All Students,2021-22,17611,1990,15621,88.7,114,29,25.4
9,All Students,2022-23,22694,2609,20085,88.5,155,55,35.5
10,All Students,2018-19,13618,2433,11185,82.1,91,46,50.5
10,All Students,2019-20,9015,1176,7839,87.0,87,36,41.4
10,All Students,2020-21,10989,2114,8875,80.8,68,33,48.5
10,All Students,2021-22,17466,1824,15642,89.6,111,31,27.9
10,All Students,2022-23,14062,1531,12531,89.1,93,30,32.3
11,All Students,2018-19,13423,2027,11396,84.9,84,43,51.2
11,All Students,2019-20,7947,1068,6879,86.6,72,29,40.3
11,All Students,2020-21,12725,2270,10455,82.2,78,46,59.0
11,All Students,2021-22,10529,1998,8531,81.0,62,24,38.7
11,All Students,2022-23,14155,1708,12447,87.9,88,29,33.0
12,All Students,2018-19,12816,2951,9865,77.0,79,49,62.0
12,All Students,2019-20,8998,2095,6903,76.7,83,44,53.0
12,All Students,2020-21,11682,1606,10076,86.3,71,32,45.1
12,All Students,2021-22,12875,2549,10326,80.2,78,30,38.5
12,All Students,2022-23,8441,1153,7288,86.3,54,17,31.5
All Grades,All Students,2018-19,65470,7449,58021,88.6,392,144,36.7
All Grades,All Students,2019-20,42389,4862,37527,88.5,393,140,35.6
All Grades,All Students,2020-21,64270,10160,54110,84.2,384,196,51.0
All Grades,All Students,2021-22,58774,12327,46447,79.0,354,259,73.2
All Grades,All Students,2022-23,45441,7494,37947,83.5,283,171,60.4
6,All Students,2018-19,7987,874,7113,89.1,47,19,40.4
6,All Students,2019-20,4749,468,4281,90.1,43,13,30.2
6,All Students,2020-21,5518,661,4857,88.0,34,15,44.1
6,All Students,2021-22,5752,1164,4588,79.8,35,27,77.1
6,All Students,2022-23,4115,498,3617,87.9,27,15,55.6
7,All Students,2018-19,9457,953,8504,89.9,57,21,36.8
7,All Students,2019-20,4378,357,4021,91.8,40,13,32.5
7,All Students,2020-21,7004,994,6010,85.8,43,20,46.5
7,All Students,2021-22,4293,1012,3281,76.4,26,19,73.1
7,All Students,2022-23,4919,632,4287,87.2,31,16,51.6
8,All Students,2018-19,9757,430,9327,95.6,57,5,8.8
8,All Students,2019-20,4911,501,4410,89.8,46,15,32.6
8,All Students,2020-21,6649,1317,5332,80.2,39,21,53.8
8,All Students,2021-22,6943,1495,5448,78.5,40,30,75.0
8,All Students,2022-23,3910,647,3263,83.5,24,15,62.5
9,All Students,2018-19,14283,1752,12531,87.7,86,35,40.7
9,All Students,2019-20,10211,1238,8973,87.9,97,38,39.2
9,All Students,2020-21,11438,1789,9649,84.4,71,42,59.2
9,All Students,2021-22,11382,2127,9255,81.3,68,45,66.2
9,All Students,2022-23,5963,1155,4808,80.6,39,27,69.2
10,All Students,2018-19,10876,1338,9538,87.7,67,26,38.8
10,All Students,2019-20,7024,674,6350,90.4,65,17,26.2
10,All Students,2020-21,13410,2399,11011,82.1,79,43,54.4
10,All Students,2021-22,9141,1740,7401,81.0,58,40,69.0
10,All Students,2022-23,8387,1296,7091,84.5,51,25,49.0
11,All Students,2018-19,8063,1531,6532,81.0,48,21,43.8
11,All Students,2019-20,6487,999,5488,84.6,60,25,41.7
11,All Students,2020-21,10957,1437,9520,86.9,63,24,38.1
11,All Students,2021-22,11267,2447,8820,78.3,68,52,76.5
11,All Students,2022-23,8436,1374,7062,83.7,52,33,63.5
12,All Students,2018-19,5047,571,4476,88.7,30,17,56.7
12,All Students,2019-20,4629,625,4004,86.5,42,19,45.2
12,All Students,2020-21,9294,1563,7731,83.2,55,31,56.4
12,All Students,2021-22,9996,2342,7654,76.6,59,46,78.0
12,All Students,2022-23,9711,1892,7819,80.5,59,40,67.8
All Grades,All Students,2018-19,38195,6811,31384,82.2,231,147,63.6
All Grades,All Students,2019-20,25126,3425,21701,86.4,225,63,28.0
All Grades,All Students,2020-21,30429,4360,26069,85.7,223,73,32.7
All Grades,All Students,2021-22,32851,9413,23438,71.3,221,164,74.2
All Grades,All Students,2022-23,26144,6866,19278,73.7,181,127,70.2
9,All Students,2018-19,11688,2269,9419,80.6,71,45,63.4
9,All Students,2019-20,7905,1509,6396,80.9,71,27,38.0
9,All Students,2020-21,10414,1779,8635,82.9,76,28,36.8
9,All Students,2021-22,11716,4399,7317,62.5,81,64,79.0
9,All Students,2022-23,7030,2583,4447,63.3,51,40,78.4
10,All Students,2018-19,8746,1358,7388,84.5,52,30,57.7
10,All Students,2019-20,6426,676,5750,89.5,58,14,24.1
10,All Students,2020-21,6938,1120,5818,83.9,51,16,31.4
10,All Students,2021-22,7574,1233,6341,83.7,51,29,56.9
10,All Students,2022-23,5972,1247,4725,79.1,42,27,64.3
11,All Students,2018-19,7764,1433,6331,81.5,47,31,66.0
11,All Students,2019-20,5428,605,4823,88.9,48,9,18.8
11,All Students,2020-21,6696,756,5940,88.7,49,15,30.6
11,All Students,2021-22,6622,1413,5209,78.7,45,30,66.7
11,All Students,2022-23,6530,1008,5522,84.6,44,22,50.0
12,All Students,2018-19,9997,1751,8246,82.5,61,41,67.2
12,All Students,2019-20,5367,635,4732,88.2,48,13,27.1
12,All Students,2020-21,6381,705,5676,89.0,47,14,29.8
12,All Students,2021-22,6939,2368,4571,65.9,44,41,93.2
12,All Students,2022-23,6612,2028,4584,69.3,44,38,86.4
All Grades,All Students,2018-19,212999,11836,201163,94.4,1252,222,17.7
All Grades,All Students,2019-20,124613,7505,117108,94.0,1122,218,19.4
All Grades,All Students,2020-21,166019,14699,151320,91.1,977,318,32.5
All Grades,All Students,2021-22,149951,14906,135045,90.1,889,356,40.0
All Grades,All Students,2022-23,135311,12128,123183,91.0,813,292,35.9
PK in K-12 Schools,All Students,2018-19,22787,2060,20727,91.0,139,48,34.5
PK in K-12 Schools,All Students,2019-20,12420,1280,11140,89.7,118,47,39.8
PK in K-12 Schools,All Students,2020-21,13097,1576,11521,88.0,81,39,48.1
PK in K-12 Schools,All Students,2021-22,12043,1652,10391,86.3,73,39,53.4
PK in K-12 Schools,All Students,2022-23,12465,1628,10837,86.9,74,46,62.2
0K,All Students,2018-19,29183,1987,27196,93.2,175,42,24.0
0K,All Students,2019-20,14404,1156,13248,92.0,130,37,28.5
0K,All Students,2020-21,19592,1881,17711,90.4,115,41,35.7
0K,All Students,2021-22,18962,2116,16846,88.8,111,49,44.1
0K,All Students,2022-23,17853,2063,15790,88.4,112,54,48.2
1,All Students,2018-19,31811,1740,30071,94.5,186,33,17.7
1,All Students,2019-20,18470,1172,17298,93.7,169,34,20.1
1,All Students,2020-21,19980,1759,18221,91.2,118,43,36.4
1,All Students,2021-22,19043,2420,16623,87.3,117,64,54.7
1,All Students,2022-23,19106,1818,17288,90.5,112,46,41.1
2,All Students,2018-19,33386,1660,31726,95.0,195,35,17.9
2,All Students,2019-20,19615,1142,18473,94.2,176,32,18.2
2,All Students,2020-21,26973,2497,24476,90.7,160,57,35.6
2,All Students,2021-22,18696,1886,16810,89.9,113,46,40.7
2,All Students,2022-23,17166,1716,15450,90.0,106,44,41.5
3,All Students,2018-19,30815,1648,29167,94.7,178,26,14.6
3,All Students,2019-20,19453,843,18610,95.7,172,16,9.3
3,All Students,2020-21,28373,2228,26145,92.1,166,43,25.9
3,All Students,2021-22,25617,2134,23483,91.7,149,51,34.2
3,All Students,2022-23,18434,1444,16990,92.2,109,30,27.5
4,All Students,2018-19,32492,1269,31223,96.1,189,19,10.1
4,All Students,2019-20,19920,1076,18844,94.6,177,30,16.9
4,All Students,2020-21,28699,2334,26365,91.9,167,46,27.5
4,All Students,2021-22,27158,2402,24756,91.2,159,55,34.6
4,All Students,2022-23,24414,1611,22803,93.4,146,34,23.3
5,All Students,2018-19,32525,1472,31053,95.5,190,19,10.0
5,All Students,2019-20,20331,836,19495,95.9,180,22,12.2
5,All Students,2020-21,29305,2424,26881,91.7,170,49,28.8
5,All Students,2021-22,28432,2296,26136,91.9,167,52,31.1
5,All Students,2022-23,25873,1848,24025,92.9,154,38,24.7
All Grades,All Students,2018-19,168995,7992,161003,95.3,976,88,9.0
All Grades,All Students,2019-20,110082,5851,104231,94.7,972,119,12.2
All Grades,All Students,2020-21,149790,8569,141221,94.3,879,151,17.2
All Grades,All Students,2021-22,146528,9606,136922,93.4,849,148,17.4
All Grades,All Students,2022-23,145514,10526,134988,92.8,843,177,21.0
0K,All Students,2018-19,30348,1601,28747,94.7,179,22,12.3
0K,All Students,2019-20,19969,1266,18703,93.7,176,31,17.6
0K,All Students,2020-21,23109,1650,21459,92.9,140,32,22.9
0K,All Students,2021-22,26232,2079,24153,92.1,153,37,24.2
0K,All Students,2022-23,27499,2316,25183,91.6,160,45,28.1
1,All Students,2018-19,28998,1524,27474,94.7,168,14,8.3
1,All Students,2019-20,19417,1035,18382,94.7,172,19,11.0
1,All Students,2020-21,25508,1465,24043,94.3,153,20,13.1
1,All Students,2021-22,22906,1490,21416,93.5,134,23,17.2
1,All Students,2022-23,25634,2050,23584,92.0,148,40,27.0
2,All Students,2018-19,28213,1282,26931,95.5,161,13,8.1
2,All Students,2019-20,18936,1089,17847,94.2,166,24,14.5
2,All Students,2020-21,25985,1269,24716,95.1,149,22,14.8
2,All Students,2021-22,24096,1496,22600,93.8,140,24,17.1
2,All Students,2022-23,22544,1442,21102,93.6,132,24,18.2
3,All Students,2018-19,28543,1330,27213,95.3,163,16,9.8
3,All Students,2019-20,17759,852,16907,95.2,159,15,9.4
3,All Students,2020-21,26709,1361,25348,94.9,157,22,14.0
3,All Students,2021-22,23793,1541,22252,93.5,139,25,18.0
3,All Students,2022-23,22292,1651,20641,92.6,130,28,21.5
4,All Students,2018-19,26144,992,25152,96.2,150,13,8.7
4,All Students,2019-20,17688,869,16819,95.1,155,17,11.0
4,All Students,2020-21,25057,1556,23501,93.8,144,31,21.5
4,All Students,2021-22,25524,1479,24045,94.2,146,21,14.4
4,All Students,2022-23,22505,1404,21101,93.8,129,17,13.2
5,All Students,2018-19,26749,1263,25486,95.3,155,10,6.5
5,All Students,2019-20,16313,740,15573,95.5,144,13,9.0
5,All Students,2020-21,23422,1268,22154,94.6,136,24,17.6
5,All Students,2021-22,23977,1521,22456,93.7,137,18,13.1
5,All Students,2022-23,25040,1663,23377,93.4,144,23,16.0
All Grades,All Students,2018-19,85751,7337,78414,91.4,507,163,32.1
All Grades,All Students,2019-20,53828,4680,49148,91.3,485,162,33.4
All Grades,All Students,2020-21,74281,4485,69796,94.0,437,91,20.8
All Grades,All Students,2021-22,68814,7508,61306,89.1,413,175,42.4
All Grades,All Students,2022-23,69546,8623,60923,87.6,411,212,51.6
PK in K-12 Schools,All Students,2018-19,14371,1488,12883,89.6,84,36,42.9
PK in K-12 Schools,All Students,2019-20,8585,847,7738,90.1,81,31,38.3
PK in K-12 Schools,All Students,2020-21,7674,621,7053,91.9,49,16,32.7
PK in K-12 Schools,All Students,2021-22,10090,1233,8857,87.8,62,29,46.8
PK in K-12 Schools,All Students,2022-23,9736,1286,8450,86.8,58,31,53.4
0K,All Students,2018-19,12315,1149,11166,90.7,73,27,37.0
0K,All Students,2019-20,9744,975,8769,90.0,86,32,37.2
0K,All Students,2020-21,11262,1058,10204,90.6,67,24,35.8
0K,All Students,2021-22,8603,1101,7502,87.2,54,28,51.9
0K,All Students,2022-23,11017,1663,9354,84.9,67,45,67.2
1,All Students,2018-19,11417,867,10550,92.4,68,20,29.4
1,All Students,2019-20,7430,614,6816,91.7,69,22,31.9
1,All Students,2020-21,13934,827,13107,94.1,80,20,25.0
1,All Students,2021-22,10161,1248,8913,87.7,60,29,48.3
1,All Students,2022-23,8047,1068,6979,86.7,48,28,58.3
2,All Students,2018-19,11436,888,10548,92.2,69,16,23.2
2,All Students,2019-20,7055,555,6500,92.1,63,19,30.2
2,All Students,2020-21,10365,418,9947,96.0,60,6,10.0
2,All Students,2021-22,11031,1108,9923,90.0,65,26,40.0
2,All Students,2022-23,9206,1216,7990,86.8,55,28,50.9
3,All Students,2018-19,12241,989,11252,91.9,74,22,29.7
3,All Students,2019-20,6925,500,6425,92.8,62,15,24.2
3,All Students,2020-21,9976,589,9387,94.1,58,9,15.5
3,All Students,2021-22,10003,948,9055,90.5,60,18,30.0
3,All Students,2022-23,10416,1044,9372,90.0,62,23,37.1
4,All Students,2018-19,10233,718,9515,93.0,60,14,23.3
4,All Students,2019-20,7649,609,7040,92.0,67,22,32.8
4,All Students,2020-21,9893,413,9480,95.8,58,6,10.3
4,All Students,2021-22,9480,908,8572,90.4,56,22,39.3
4,All Students,2022-23,10739,1268,9471,88.2,61,30,49.2
5,All Students,2018-19,13738,1238,12500,91.0,79,28,35.4
5,All Students,2019-20,6440,580,5860,91.0,57,21,36.8
5,All Students,2020-21,11177,559,10618,95.0,65,10,15.4
5,All Students,2021-22,9446,962,8484,89.8,56,23,41.1
5,All Students,2022-23,10385,1078,9307,89.6,60,27,45.0
All Grades,All Students,2018-19,108740,6655,102085,93.9,648,137,21.1
All Grades,All Students,2019-20,67699,4318,63381,93.6,609,116,19.0
All Grades,All Students,2020-21,95130,6305,88825,93.4,562,123,21.9
All Grades,All Students,2021-22,91643,8597,83046,90.6,549,195,35.5
All Grades,All Students,2022-23,97423,8390,89033,91.4,602,206,34.2
PK in K-12 Schools,All Students,2018-19,8541,686,7855,92.0,51,12,23.5
PK in K-12 Schools,All Students,2019-20,6073,459,5614,92.4,54,15,27.8
PK in K-12 Schools,All Students,2020-21,8414,776,7638,90.8,52,19,36.5
PK in K-12 Schools,All Students,2021-22,8953,1139,7814,87.3,56,31,55.4
PK in K-12 Schools,All Students,2022-23,9079,1004,8075,88.9,57,26,45.6
0K,All Students,2018-19,13037,1100,11937,91.6,79,24,30.4
0K,All Students,2019-20,8899,736,8163,91.7,83,26,31.3
0K,All Students,2020-21,12364,1124,11240,90.9,76,22,28.9
0K,All Students,2021-22,13092,1480,11612,88.7,78,36,46.2
0K,All Students,2022-23,15066,1591,13475,89.4,97,44,45.4
1,All Students,2018-19,19683,1266,18417,93.6,119,28,23.5
1,All Students,2019-20,8540,724,7816,91.5,79,20,25.3
1,All Students,2020-21,14327,900,13427,93.7,85,16,18.8
1,All Students,2021-22,12335,1150,11185,90.7,76,28,36.8
1,All Students,2022-23,15759,1563,14196,90.1,97,39,40.2
2,All Students,2018-19,16664,955,15709,94.3,99,18,18.2
2,All Students,2019-20,11514,653,10861,94.3,103,13,12.6
2,All Students,2020-21,12379,940,11439,92.4,74,19,25.7
2,All Students,2021-22,13560,1164,12396,91.4,82,24,29.3
2,All Students,2022-23,13268,1044,12224,92.1,81,25,30.9
3,All Students,2018-19,16299,950,15349,94.2,96,21,21.9
3,All Students,2019-20,11106,584,10522,94.7,97,14,14.4
3,All Students,2020-21,16002,845,15157,94.7,92,13,14.1
3,All Students,2021-22,11254,909,10345,91.9,68,21,30.9
3,All Students,2022-23,15648,1094,14554,93.0,100,25,25.0
4,All Students,2018-19,17134,895,16239,94.8,102,21,20.6
4,All Students,2019-20,10421,634,9787,93.9,95,15,15.8
4,All Students,2020-21,16708,1083,15625,93.5,97,24,24.7
4,All Students,2021-22,15676,1333,14343,91.5,92,27,29.3
4,All Students,2022-23,11862,891,10971,92.5,72,19,26.4
5,All Students,2018-19,17382,803,16579,95.4,102,13,12.7
5,All Students,2019-20,11146,528,10618,95.3,98,13,13.3
5,All Students,2020-21,14936,637,14299,95.7,86,10,11.6
5,All Students,2021-22,16773,1422,15351,91.5,97,28,28.9
5,All Students,2022-23,16741,1203,15538,92.8,98,28,28.6
All Grades,All Students,2018-19,168876,6482,162394,96.2,965,46,4.8
All Grades,All Students,2019-20,106792,5112,101680,95.2,937,78,8.3
All Grades,All Students,2020-21,139432,3445,135987,97.5,819,33,4.0
All Grades,All Students,2021-22,128887,6052,122835,95.3,736,47,6.4
All Grades,All Students,2022-23,127383,6810,120573,94.7,729,80,11.0
PK in K-12 Schools,All Students,2018-19,6759,237,6522,96.5,39,1,2.6
PK in K-12 Schools,All Students,2019-20,4350,195,4155,95.5,38,3,7.9
PK in K-12 Schools,All Students,2020-21,6042,s,s,s,s,s,s
PK in K-12 Schools,All Students,2021-22,6369,369,6000,94.2,36,4,11.1
PK in K-12 Schools,All Students,2022-23,6340,439,5901,93.1,36,10,27.8
0K,All Students,2018-19,26147,1330,24817,94.9,151,11,7.3
0K,All Students,2019-20,17266,924,16342,94.6,150,14,9.3
0K,All Students,2020-21,20644,539,20105,97.4,121,7,5.8
0K,All Students,2021-22,21446,1048,20398,95.1,123,9,7.3
0K,All Students,2022-23,20542,1410,19132,93.1,118,23,19.5
1,All Students,2018-19,32416,1185,31231,96.3,185,6,3.2
1,All Students,2019-20,17206,900,16306,94.8,151,14,9.3
1,All Students,2020-21,23262,692,22570,97.0,133,3,2.3
1,All Students,2021-22,19729,799,18930,96.0,113,6,5.3
1,All Students,2022-23,21788,1206,20582,94.5,126,9,7.1
2,All Students,2018-19,24290,874,23416,96.4,140,6,4.3
2,All Students,2019-20,20590,1043,19547,94.9,182,19,10.4
2,All Students,2020-21,19513,374,19139,98.1,116,3,2.6
2,All Students,2021-22,21956,974,20982,95.6,127,5,3.9
2,All Students,2022-23,19293,869,18424,95.5,109,10,9.2
3,All Students,2018-19,28706,1098,27608,96.2,163,9,5.5
3,All Students,2019-20,14954,691,14263,95.4,131,12,9.2
3,All Students,2020-21,26465,619,25846,97.7,157,7,4.5
3,All Students,2021-22,17746,884,16862,95.0,101,4,4.0
3,All Students,2022-23,21315,1012,20303,95.3,121,8,6.6
4,All Students,2018-19,24231,829,23402,96.6,138,7,5.1
4,All Students,2019-20,17685,721,16964,95.9,155,10,6.5
4,All Students,2020-21,19684,389,19295,98.0,115,4,3.5
4,All Students,2021-22,22658,1099,21559,95.1,128,9,7.0
4,All Students,2022-23,17188,924,16264,94.6,98,9,9.2
5,All Students,2018-19,26327,929,25398,96.5,149,6,4.0
5,All Students,2019-20,14741,638,14103,95.7,130,6,4.6
5,All Students,2020-21,23655,650,23005,97.3,140,7,5.0
5,All Students,2021-22,18983,879,18104,95.4,108,10,9.3
5,All Students,2022-23,20917,950,19967,95.5,121,11,9.1
6,All Students,2020-21,167,s,s,s,s,s,s
All Grades,All Students,2018-19,86371,5475,80896,93.7,510,106,20.8
All Grades,All Students,2019-20,51226,3449,47777,93.3,463,92,19.9
All Grades,All Students,2020-21,79808,6615,73193,91.7,469,90,19.2
All Grades,All Students,2021-22,80476,6873,73603,91.5,464,141,30.4
All Grades,All Students,2022-23,79395,7448,71947,90.6,461,163,35.4
PK in K-12 Schools,All Students,2018-19,6082,476,5606,92.2,36,12,33.3
PK in K-12 Schools,All Students,2019-20,1613,192,1421,88.1,17,6,35.3
PK in K-12 Schools,All Students,2020-21,9538,795,8743,91.7,62,11,17.7
PK in K-12 Schools,All Students,2021-22,13237,1469,11768,88.9,78,35,44.9
PK in K-12 Schools,All Students,2022-23,14080,1672,12408,88.1,83,40,48.2
0K,All Students,2018-19,11504,681,10823,94.1,67,7,10.4
0K,All Students,2019-20,10174,865,9309,91.5,91,25,27.5
0K,All Students,2020-21,12774,1426,11348,88.8,77,18,23.4
0K,All Students,2021-22,13830,1369,12461,90.1,80,29,36.3
0K,All Students,2022-23,12467,1295,11172,89.6,73,33,45.2
1,All Students,2018-19,12155,871,11284,92.8,74,20,27.0
1,All Students,2019-20,7470,403,7067,94.6,70,9,12.9
1,All Students,2020-21,11702,1545,10157,86.8,67,20,29.9
1,All Students,2021-22,11266,851,10415,92.4,65,17,26.2
1,All Students,2022-23,13024,1176,11848,91.0,74,27,36.5
2,All Students,2018-19,12389,619,11770,95.0,73,13,17.8
2,All Students,2019-20,7054,506,6548,92.8,63,16,25.4
2,All Students,2020-21,11025,904,10121,91.8,63,10,15.9
2,All Students,2021-22,9459,579,8880,93.9,54,11,20.4
2,All Students,2022-23,10742,896,9846,91.7,63,20,31.7
3,All Students,2018-19,13286,836,12450,93.7,78,16,20.5
3,All Students,2019-20,7629,413,7216,94.6,68,9,13.2
3,All Students,2020-21,11149,842,10307,92.4,65,14,21.5
3,All Students,2021-22,10749,766,9983,92.9,62,13,21.0
3,All Students,2022-23,9403,761,8642,91.9,53,13,24.5
4,All Students,2018-19,13739,958,12781,93.0,83,19,22.9
4,All Students,2019-20,7962,459,7503,94.2,72,10,13.9
4,All Students,2020-21,11895,411,11484,96.5,68,6,8.8
4,All Students,2021-22,10253,936,9317,90.9,59,15,25.4
4,All Students,2022-23,10058,646,9412,93.6,60,10,16.7
5,All Students,2018-19,17216,1034,16182,94.0,99,19,19.2
5,All Students,2019-20,9324,611,8713,93.4,82,17,20.7
5,All Students,2020-21,11725,692,11033,94.1,67,11,16.4
5,All Students,2021-22,11682,903,10779,92.3,66,21,31.8
5,All Students,2022-23,9621,1002,8619,89.6,55,20,36.4
All Grades,All Students,2018-19,108383,9171,99212,91.5,634,180,28.4
All Grades,All Students,2019-20,67735,5642,62093,91.7,608,173,28.5
All Grades,All Students,2020-21,93593,6759,86834,92.8,554,122,22.0
All Grades,All Students,2021-22,90687,9794,80893,89.2,532,215,40.4
All Grades,All Students,2022-23,94291,9247,85044,90.2,561,206,36.7
PK in K-12 Schools,All Students,2018-19,16836,1688,15148,90.0,100,39,39.0
PK in K-12 Schools,All Students,2019-20,10767,1226,9541,88.6,102,42,41.2
PK in K-12 Schools,All Students,2020-21,8704,669,8035,92.3,55,18,32.7
PK in K-12 Schools,All Students,2021-22,15195,1918,13277,87.4,95,49,51.6
PK in K-12 Schools,All Students,2022-23,18348,2219,16129,87.9,109,57,52.3
0K,All Students,2018-19,15020,1198,13822,92.0,90,24,26.7
0K,All Students,2019-20,8595,s,s,s,s,s,s
0K,All Students,2020-21,12952,757,12195,94.2,79,14,17.7
0K,All Students,2021-22,11308,1294,10014,88.6,67,27,40.3
0K,All Students,2022-23,13414,1660,11754,87.6,85,46,54.1
1,All Students,2018-19,13970,1173,12797,91.6,81,21,25.9
1,All Students,2019-20,10455,766,9689,92.7,91,19,20.9
1,All Students,2020-21,14364,1152,13212,92.0,86,19,22.1
1,All Students,2021-22,10616,1128,9488,89.4,63,27,42.9
1,All Students,2022-23,11403,1013,10390,91.1,68,18,26.5
2,All Students,2018-19,16681,1386,15295,91.7,97,30,30.9
2,All Students,2019-20,9737,861,8876,91.2,86,31,36.0
2,All Students,2020-21,15508,1474,14034,90.5,90,21,23.3
2,All Students,2021-22,13472,1217,12255,91.0,78,24,30.8
2,All Students,2022-23,10641,885,9756,91.7,64,19,29.7
3,All Students,2018-19,14556,965,13591,93.4,84,17,20.2
3,All Students,2019-20,10011,780,9231,92.2,88,19,21.6
3,All Students,2020-21,14711,954,13757,93.5,85,17,20.0
3,All Students,2021-22,13978,1526,12452,89.1,80,25,31.3
3,All Students,2022-23,14793,1230,13563,91.7,87,22,25.3
4,All Students,2018-19,14844,1187,13657,92.0,88,21,23.9
4,All Students,2019-20,8901,604,8297,93.2,80,19,23.8
4,All Students,2020-21,14651,891,13760,93.9,85,18,21.2
4,All Students,2021-22,13168,1413,11755,89.3,75,34,45.3
4,All Students,2022-23,12785,1024,11761,92.0,74,16,21.6
5,All Students,2018-19,16476,1574,14902,90.4,94,28,29.8
5,All Students,2019-20,9154,663,8491,92.8,81,20,24.7
5,All Students,2020-21,12703,862,11841,93.2,74,15,20.3
5,All Students,2021-22,12950,1298,11652,90.0,74,29,39.2
5,All Students,2022-23,12907,1216,11691,90.6,74,28,37.8
6,All Students,2019-20,115,s,s,s,s,s,s
All Grades,All Students,2018-19,73201,2892,70309,96.0,419,28,6.7
All Grades,All Students,2019-20,48170,2186,45984,95.5,423,35,8.3
All Grades,All Students,2020-21,68133,2788,65345,95.9,412,39,9.5
All Grades,All Students,2021-22,60611,3566,57045,94.1,350,45,12.9
All Grades,All Students,2022-23,60497,3750,56747,93.8,356,54,15.2
0K,All Students,2018-19,13092,608,12484,95.4,77,12,15.6
0K,All Students,2019-20,8625,590,8035,93.2,75,15,20.0
0K,All Students,2020-21,12075,685,11390,94.3,75,12,16.0
0K,All Students,2021-22,11326,697,10629,93.8,67,10,14.9
0K,All Students,2022-23,12808,1041,11767,91.9,78,21,26.9
1,All Students,2018-19,10602,496,10106,95.3,61,7,11.5
1,All Students,2019-20,8210,388,7822,95.3,72,4,5.6
1,All Students,2020-21,12227,779,11448,93.6,75,12,16.0
1,All Students,2021-22,10670,599,10071,94.4,63,7,11.1
1,All Students,2022-23,11079,551,10528,95.0,65,3,4.6
2,All Students,2018-19,14165,549,13616,96.1,81,3,3.7
2,All Students,2019-20,5652,241,5411,95.7,50,4,8.0
2,All Students,2020-21,11078,317,10761,97.1,67,3,4.5
2,All Students,2021-22,11393,799,10594,93.0,64,8,12.5
2,All Students,2022-23,9645,601,9044,93.8,57,10,17.5
3,All Students,2018-19,13371,427,12944,96.8,76,1,1.3
3,All Students,2019-20,9326,364,8962,96.1,83,4,4.8
3,All Students,2020-21,8794,199,8595,97.7,53,2,3.8
3,All Students,2021-22,9996,559,9437,94.4,57,8,14.0
3,All Students,2022-23,10281,651,9630,93.7,60,8,13.3
4,All Students,2018-19,12221,413,11808,96.6,69,3,4.3
4,All Students,2019-20,8766,295,8471,96.6,77,4,5.2
4,All Students,2020-21,11753,350,11403,97.0,70,5,7.1
4,All Students,2021-22,7480,350,7130,95.3,43,5,11.6
4,All Students,2022-23,9428,465,8963,95.1,55,7,12.7
5,All Students,2018-19,9749,s,s,s,s,s,s
5,All Students,2019-20,7591,308,7283,95.9,66,4,6.1
5,All Students,2020-21,12206,458,11748,96.2,72,5,6.9
5,All Students,2021-22,9746,562,9184,94.2,56,7,12.5
5,All Students,2022-23,7256,441,6815,93.9,41,5,12.2
6,All Students,2018-19,1,s,s,s,s,s,s
All Grades,All Students,2018-19,200448,5772,194676,97.1,1149,59,5.1
All Grades,All Students,2019-20,131795,4249,127546,96.8,1161,73,6.3
All Grades,All Students,2020-21,196145,20409,175736,89.6,1156,397,34.3
All Grades,All Students,2021-22,190103,14685,175418,92.3,1097,264,24.1
All Grades,All Students,2022-23,179513,12149,167364,93.2,1042,218,20.9
5,All Students,2021-22,8,s,s,s,s,s,s
6,All Students,2018-19,68757,2146,66611,96.9,397,27,6.8
6,All Students,2019-20,45287,1477,43810,96.7,403,29,7.2
6,All Students,2020-21,63332,7163,56169,88.7,379,142,37.5
6,All Students,2021-22,67546,5301,62245,92.2,389,91,23.4
6,All Students,2022-23,62814,3672,59142,94.2,365,60,16.4
7,All Students,2018-19,66635,1601,65034,97.6,381,17,4.5
7,All Students,2019-20,44235,1376,42859,96.9,387,24,6.2
7,All Students,2020-21,67440,6965,60475,89.7,394,142,36.0
7,All Students,2021-22,58829,s,s,s,s,s,s
7,All Students,2022-23,60777,4121,56656,93.2,355,80,22.5
8,All Students,2018-19,65056,2025,63031,96.9,371,15,4.0
8,All Students,2019-20,42231,s,s,s,s,s,s
8,All Students,2020-21,65373,6281,59092,90.4,383,113,29.5
8,All Students,2021-22,63720,5380,58340,91.6,365,98,26.8
8,All Students,2022-23,55922,4356,51566,92.2,322,78,24.2
9,All Students,2019-20,42,s,s,s,s,s,s
All Grades,All Students,2018-19,177742,7186,170556,96.0,1019,51,5.0
All Grades,All Students,2019-20,114491,4980,109511,95.7,1008,63,6.3
All Grades,All Students,2020-21,145637,2260,143377,98.4,878,12,1.4
All Grades,All Students,2021-22,130644,6299,124345,95.2,759,80,10.5
All Grades,All Students,2022-23,130077,8411,121666,93.5,759,131,17.3
PK in K-12 Schools,All Students,2018-19,9396,442,8954,95.3,55,3,5.5
PK in K-12 Schools,All Students,2019-20,6199,299,5900,95.2,54,3,5.6
PK in K-12 Schools,All Students,2020-21,8539,242,8297,97.2,54,1,1.9
PK in K-12 Schools,All Students,2021-22,9443,601,8842,93.6,55,10,18.2
PK in K-12 Schools,All Students,2022-23,9552,960,8592,89.9,54,20,37.0
0K,All Students,2018-19,31140,1494,29646,95.2,178,11,6.2
0K,All Students,2019-20,17365,901,16464,94.8,153,14,9.2
0K,All Students,2020-21,20025,294,19731,98.5,119,2,1.7
0K,All Students,2021-22,19341,1027,18314,94.7,114,17,14.9
0K,All Students,2022-23,20761,1653,19108,92.0,122,31,25.4
1,All Students,2018-19,27528,1122,26406,95.9,158,8,5.1
1,All Students,2019-20,20653,953,19700,95.4,182,10,5.5
1,All Students,2020-21,21174,349,20825,98.4,131,3,2.3
1,All Students,2021-22,19478,962,18516,95.1,116,13,11.2
1,All Students,2022-23,20959,1348,19611,93.6,124,24,19.4
2,All Students,2018-19,28557,1072,27485,96.2,164,7,4.3
2,All Students,2019-20,17533,579,16954,96.7,154,7,4.5
2,All Students,2020-21,26846,393,26453,98.5,162,3,1.9
2,All Students,2021-22,19629,905,18724,95.4,113,11,9.7
2,All Students,2022-23,18367,1071,17296,94.2,108,15,13.9
3,All Students,2018-19,27403,1112,26291,95.9,157,7,4.5
3,All Students,2019-20,18543,818,17725,95.6,163,8,4.9
3,All Students,2020-21,22593,405,22188,98.2,137,1,0.7
3,All Students,2021-22,24160,1096,23064,95.5,138,10,7.2
3,All Students,2022-23,19012,1134,17878,94.0,110,14,12.7
4,All Students,2018-19,26116,981,25135,96.2,151,6,4.0
4,All Students,2019-20,17525,675,16850,96.1,154,9,5.8
4,All Students,2020-21,22497,314,22183,98.6,134,1,0.7
4,All Students,2021-22,19248,762,18486,96.0,112,8,7.1
4,All Students,2022-23,23779,1412,22367,94.1,138,18,13.0
5,All Students,2018-19,27602,963,26639,96.5,156,9,5.8
5,All Students,2019-20,16673,755,15918,95.5,148,12,8.1
5,All Students,2020-21,23963,263,23700,98.9,141,1,0.7
5,All Students,2021-22,19345,946,18399,95.1,111,11,9.9
5,All Students,2022-23,17647,833,16814,95.3,103,9,8.7
All Grades,All Students,2018-19,254832,16280,238552,93.6,1479,298,20.1
All Grades,All Students,2019-20,162680,10925,151755,93.3,1433,272,19.0
All Grades,All Students,2020-21,242448,35491,206957,85.4,1417,666,47.0
All Grades,All Students,2021-22,201452,18536,182916,90.8,1180,366,31.0
All Grades,All Students,2022-23,180632,15284,165348,91.5,1080,322,29.8
5,All Students,2021-22,2,s,s,s,s,s,s
6,All Students,2018-19,99849,5749,94100,94.2,585,97,16.6
6,All Students,2019-20,55607,3416,52191,93.9,491,71,14.5
6,All Students,2020-21,77820,11724,66096,84.9,467,218,46.7
6,All Students,2021-22,61523,s,s,s,s,s,s
6,All Students,2022-23,53675,4038,49637,92.5,330,94,28.5
7,All Students,2018-19,75838,s,s,s,s,s,s
7,All Students,2019-20,59700,3956,55744,93.4,526,100,19.0
7,All Students,2020-21,76952,10683,66269,86.1,444,203,45.7
7,All Students,2021-22,69223,6403,62820,90.8,404,133,32.9
7,All Students,2022-23,59183,4901,54282,91.7,352,97,27.6
8,All Students,2018-19,79144,5239,73905,93.4,452,93,20.6
8,All Students,2019-20,47268,s,s,s,s,s,s
8,All Students,2020-21,87673,13081,74592,85.1,506,245,48.4
8,All Students,2021-22,70704,6666,64038,90.6,408,127,31.1
8,All Students,2022-23,67774,6345,61429,90.6,398,131,32.9
9,All Students,2018-19,1,s,s,s,s,s,s
9,All Students,2019-20,105,s,s,s,s,s,s
All Grades,All Students,2018-19,229079,6935,222144,97.0,1378,99,7.2
All Grades,All Students,2019-20,139265,5288,133977,96.2,1257,115,9.1
All Grades,All Students,2020-21,198451,6298,192153,96.8,1156,116,10.0
All Grades,All Students,2021-22,179597,9708,169889,94.6,1093,193,17.7
All Grades,All Students,2022-23,172458,7425,165033,95.7,1036,122,11.8
0K,All Students,2018-19,38610,1407,37203,96.4,239,21,8.8
0K,All Students,2019-20,20717,1048,19669,94.9,190,27,14.2
0K,All Students,2020-21,30587,1478,29109,95.2,182,29,15.9
0K,All Students,2021-22,27070,1680,25390,93.8,172,34,19.8
0K,All Students,2022-23,22755,1343,21412,94.1,140,25,17.9
1,All Students,2018-19,39650,1199,38451,97.0,241,19,7.9
1,All Students,2019-20,23000,925,22075,96.0,207,16,7.7
1,All Students,2020-21,30022,915,29107,97.0,178,15,8.4
1,All Students,2021-22,29055,2149,26906,92.6,178,46,25.8
1,All Students,2022-23,29315,1488,27827,94.9,180,23,12.8
2,All Students,2018-19,37180,1073,36107,97.1,226,14,6.2
2,All Students,2019-20,25544,1004,24540,96.1,231,21,9.1
2,All Students,2020-21,33685,839,32846,97.5,194,12,6.2
2,All Students,2021-22,27867,1563,26304,94.4,174,31,17.8
2,All Students,2022-23,27806,1385,26421,95.0,167,26,15.6
3,All Students,2018-19,35886,1131,34755,96.8,215,18,8.4
3,All Students,2019-20,23396,853,22543,96.4,213,21,9.9
3,All Students,2020-21,37922,1066,36856,97.2,219,17,7.8
3,All Students,2021-22,30427,1291,29136,95.8,182,22,12.1
3,All Students,2022-23,27458,1217,26241,95.6,164,22,13.4
4,All Students,2018-19,41351,994,40357,97.6,243,6,2.5
4,All Students,2019-20,21363,734,20629,96.6,190,19,10.0
4,All Students,2020-21,34389,865,33524,97.5,200,20,10.0
4,All Students,2021-22,35033,1600,33433,95.4,210,34,16.2
4,All Students,2022-23,31411,948,30463,97.0,184,11,6.0
5,All Students,2018-19,36402,1131,35271,96.9,214,21,9.8
5,All Students,2019-20,25245,724,24521,97.1,226,11,4.9
5,All Students,2020-21,31846,1135,30711,96.4,183,23,12.6
5,All Students,2021-22,30145,1425,28720,95.3,177,26,14.7
5,All Students,2022-23,33713,1044,32669,96.9,201,15,7.5
All Grades,All Students,2018-19,97709,4379,93330,95.5,557,40,7.2
All Grades,All Students,2019-20,64872,3315,61557,94.9,569,54,9.5
All Grades,All Students,2020-21,85665,2528,83137,97.0,509,30,5.9
All Grades,All Students,2021-22,85363,5588,79775,93.5,500,82,16.4
All Grades,All Students,2022-23,87628,5733,81895,93.5,506,92,18.2
PK in K-12 Schools,All Students,2019-20,2070,139,1931,93.3,18,3,16.7
PK in K-12 Schools,All Students,2020-21,2988,147,2841,95.1,19,3,15.8
PK in K-12 Schools,All Students,2021-22,3186,314,2872,90.1,18,6,33.3
PK in K-12 Schools,All Students,2022-23,3186,225,2961,92.9,18,2,11.1
0K,All Students,2018-19,16690,922,15768,94.5,97,15,15.5
0K,All Students,2019-20,11104,732,10372,93.4,98,19,19.4
0K,All Students,2020-21,14060,515,13545,96.3,86,6,7.0
0K,All Students,2021-22,15864,1076,14788,93.2,93,15,16.1
0K,All Students,2022-23,16861,1339,15522,92.1,99,31,31.3
1,All Students,2018-19,17305,807,16498,95.3,99,5,5.1
1,All Students,2019-20,10896,536,10360,95.1,96,8,8.3
1,All Students,2020-21,14090,480,13610,96.6,82,7,8.5
1,All Students,2021-22,14115,851,13264,94.0,83,10,12.0
1,All Students,2022-23,15935,981,14954,93.8,92,16,17.4
2,All Students,2018-19,15702,825,14877,94.7,91,9,9.9
2,All Students,2019-20,10948,563,10385,94.9,96,9,9.4
2,All Students,2020-21,13203,408,12795,96.9,80,4,5.0
2,All Students,2021-22,13339,930,12409,93.0,76,18,23.7
2,All Students,2022-23,13355,975,12380,92.7,78,14,17.9
3,All Students,2018-19,16355,642,15713,96.1,92,2,2.2
3,All Students,2019-20,10235,520,9715,94.9,90,8,8.9
3,All Students,2020-21,13956,281,13675,98.0,82,2,2.4
3,All Students,2021-22,12585,797,11788,93.7,78,11,14.1
3,All Students,2022-23,12921,749,12172,94.2,73,7,9.6
4,All Students,2018-19,15476,435,15041,97.2,87,0,0.0
4,All Students,2019-20,9890,444,9446,95.5,86,6,7.0
4,All Students,2020-21,14070,438,13632,96.9,82,7,8.5
4,All Students,2021-22,12873,723,12150,94.4,74,9,12.2
4,All Students,2022-23,12881,837,12044,93.5,75,16,21.3
5,All Students,2018-19,16181,748,15433,95.4,91,9,9.9
5,All Students,2019-20,9729,381,9348,96.1,85,1,1.2
5,All Students,2020-21,13298,259,13039,98.1,78,1,1.3
5,All Students,2021-22,13401,897,12504,93.3,78,13,16.7
5,All Students,2022-23,12489,627,11862,95.0,71,6,8.5
All Grades,All Students,2018-19,61091,3095,57996,94.9,348,43,12.4
All Grades,All Students,2019-20,39014,2023,36991,94.8,342,42,12.3
All Grades,All Students,2020-21,46900,1674,45226,96.4,275,22,8.0
All Grades,All Students,2021-22,38718,2042,36676,94.7,222,26,11.7
All Grades,All Students,2022-23,37266,2198,35068,94.1,214,29,13.6
PK in K-12 Schools,All Students,2018-19,3198,193,3005,94.0,18,2,11.1
PK in K-12 Schools,All Students,2019-20,2070,164,1906,92.1,18,6,33.3
0K,All Students,2018-19,13353,778,12575,94.2,76,12,15.8
0K,All Students,2019-20,6554,376,6178,94.3,58,8,13.8
0K,All Students,2020-21,6260,347,5913,94.5,38,8,21.1
0K,All Students,2021-22,3540,190,3350,94.6,20,1,5.0
0K,All Students,2022-23,4339,464,3875,89.3,25,11,44.0
1,All Students,2018-19,10366,508,9858,95.1,60,6,10.0
1,All Students,2019-20,7779,370,7409,95.2,68,7,10.3
1,All Students,2020-21,8745,271,8474,96.9,51,2,3.9
1,All Students,2021-22,5704,326,5378,94.3,34,6,17.6
1,All Students,2022-23,4641,262,4379,94.4,27,2,7.4
2,All Students,2018-19,11271,650,10621,94.2,64,11,17.2
2,All Students,2019-20,6177,350,5827,94.3,55,11,20.0
2,All Students,2020-21,8385,271,8114,96.8,51,4,7.8
2,All Students,2021-22,6820,285,6535,95.8,40,2,5.0
2,All Students,2022-23,5486,353,5133,93.6,31,6,19.4
3,All Students,2018-19,7754,364,7390,95.3,44,5,11.4
3,All Students,2019-20,7234,410,6824,94.3,63,9,14.3
3,All Students,2020-21,7442,322,7120,95.7,43,5,11.6
3,All Students,2021-22,7965,382,7583,95.2,45,5,11.1
3,All Students,2022-23,7213,357,6856,95.1,42,4,9.5
4,All Students,2018-19,7851,319,7532,95.9,45,3,6.7
4,All Students,2019-20,4715,171,4544,96.4,41,1,2.4
4,All Students,2020-21,9213,306,8907,96.7,53,3,5.7
4,All Students,2021-22,6735,324,6411,95.2,38,3,7.9
4,All Students,2022-23,8820,442,8378,95.0,50,5,10.0
5,All Students,2018-19,7298,283,7015,96.1,41,4,9.8
5,All Students,2019-20,4485,182,4303,95.9,39,0,0.0
5,All Students,2020-21,6855,157,6698,97.7,39,0,0.0
5,All Students,2021-22,7954,535,7419,93.3,45,9,20.0
5,All Students,2022-23,6767,320,6447,95.3,39,1,2.6
All Grades,All Students,2018-19,53013,3655,49358,93.1,322,73,22.7
All Grades,All Students,2019-20,32140,2239,29901,93.0,299,67,22.4
All Grades,All Students,2020-21,47760,7053,40707,85.2,293,134,45.7
All Grades,All Students,2021-22,54680,8086,46594,85.2,374,209,55.9
All Grades,All Students,2022-23,57740,7439,50301,87.1,390,207,53.1
PK in K-12 Schools,All Students,2018-19,8453,828,7625,90.2,50,14,28.0
PK in K-12 Schools,All Students,2019-20,5038,362,4676,92.8,51,11,21.6
PK in K-12 Schools,All Students,2020-21,6360,1454,4906,77.1,41,24,58.5
PK in K-12 Schools,All Students,2021-22,11672,2075,9597,82.2,76,53,69.7
PK in K-12 Schools,All Students,2022-23,11481,1683,9798,85.3,75,45,60.0
0K,All Students,2018-19,7684,576,7108,92.5,49,12,24.5
0K,All Students,2019-20,5309,512,4797,90.4,53,22,41.5
0K,All Students,2020-21,6449,1259,5190,80.5,43,22,51.2
0K,All Students,2021-22,6540,1397,5143,78.6,49,36,73.5
0K,All Students,2022-23,8137,1147,6990,85.9,56,34,60.7
1,All Students,2018-19,9791,672,9119,93.1,62,17,27.4
1,All Students,2019-20,4251,200,4051,95.3,38,3,7.9
1,All Students,2020-21,7703,992,6711,87.1,46,23,50.0
1,All Students,2021-22,7468,1289,6179,82.7,54,36,66.7
1,All Students,2022-23,8074,1390,6684,82.8,59,41,69.5
2,All Students,2018-19,8992,564,8428,93.7,53,10,18.9
2,All Students,2019-20,5080,410,4670,91.9,46,13,28.3
2,All Students,2020-21,6259,547,5712,91.3,39,11,28.2
2,All Students,2021-22,7688,1146,6542,85.1,55,30,54.5
2,All Students,2022-23,5855,641,5214,89.1,39,22,56.4
3,All Students,2018-19,6502,451,6051,93.1,40,11,27.5
3,All Students,2019-20,4539,225,4314,95.0,41,3,7.3
3,All Students,2020-21,8041,941,7100,88.3,48,19,39.6
3,All Students,2021-22,6611,748,5863,88.7,44,18,40.9
3,All Students,2022-23,7714,923,6791,88.0,54,26,48.1
4,All Students,2018-19,6362,308,6054,95.2,36,4,11.1
4,All Students,2019-20,3617,285,3332,92.1,32,8,25.0
4,All Students,2020-21,7035,908,6127,87.1,41,15,36.6
4,All Students,2021-22,7444,742,6702,90.0,49,18,36.7
4,All Students,2022-23,6445,559,5886,91.3,44,13,29.5
5,All Students,2018-19,5229,256,4973,95.1,32,5,15.6
5,All Students,2019-20,4306,245,4061,94.3,38,7,18.4
5,All Students,2020-21,5913,952,4961,83.9,35,20,57.1
5,All Students,2021-22,7257,689,6568,90.5,47,18,38.3
5,All Students,2022-23,10034,1096,8938,89.1,63,26,41.3
All Grades,All Students,2018-19,148266,7655,140611,94.8,858,110,12.8
All Grades,All Students,2019-20,99883,5676,94207,94.3,896,136,15.2
All Grades,All Students,2020-21,148150,5868,142282,96.0,884,95,10.7
All Grades,All Students,2021-22,150607,11836,138771,92.1,876,227,25.9
All Grades,All Students,2022-23,147603,11617,135986,92.1,849,234,27.6
PK in K-12 Schools,All Students,2018-19,12608,894,11714,92.9,74,16,21.6
PK in K-12 Schools,All Students,2019-20,8243,521,7722,93.7,74,15,20.3
PK in K-12 Schools,All Students,2020-21,11932,311,11621,97.4,78,7,9.0
PK in K-12 Schools,All Students,2021-22,12732,1515,11217,88.1,73,40,54.8
PK in K-12 Schools,All Students,2022-23,12742,1225,11517,90.4,72,24,33.3
0K,All Students,2018-19,28099,1433,26666,94.9,164,20,12.2
0K,All Students,2019-20,19545,1404,18141,92.8,178,39,21.9
0K,All Students,2020-21,28442,1548,26894,94.6,175,25,14.3
0K,All Students,2021-22,26218,2231,23987,91.5,155,39,25.2
0K,All Students,2022-23,23377,2239,21138,90.4,138,57,41.3
1,All Students,2018-19,23178,1368,21810,94.1,136,22,16.2
1,All Students,2019-20,16315,936,15379,94.3,147,23,15.6
1,All Students,2020-21,24207,1068,23139,95.6,146,18,12.3
1,All Students,2021-22,26639,2339,24300,91.2,155,50,32.3
1,All Students,2022-23,24528,2098,22430,91.4,140,49,35.0
2,All Students,2018-19,24385,1162,23223,95.2,140,14,10.0
2,All Students,2019-20,13637,753,12884,94.5,120,17,14.2
2,All Students,2020-21,22990,778,22212,96.6,134,13,9.7
2,All Students,2021-22,22609,1945,20664,91.4,131,39,29.8
2,All Students,2022-23,26172,2181,23991,91.7,150,43,28.7
3,All Students,2018-19,21740,963,20777,95.6,123,10,8.1
3,All Students,2019-20,15335,721,14614,95.3,140,13,9.3
3,All Students,2020-21,18520,775,17745,95.8,108,12,11.1
3,All Students,2021-22,21539,1147,20392,94.7,126,15,11.9
3,All Students,2022-23,21371,1460,19911,93.2,124,24,19.4
4,All Students,2018-19,20886,976,19910,95.3,120,12,10.0
4,All Students,2019-20,13616,695,12921,94.9,120,16,13.3
4,All Students,2020-21,22771,721,22050,96.8,131,9,6.9
4,All Students,2021-22,18036,1088,16948,94.0,104,16,15.4
4,All Students,2022-23,21222,1339,19883,93.7,121,18,14.9
5,All Students,2018-19,17370,859,16511,95.1,101,16,15.8
5,All Students,2019-20,13192,646,12546,95.1,118,14,11.9
5,All Students,2020-21,19288,667,18621,96.5,112,11,9.8
5,All Students,2021-22,22834,1571,21263,93.1,132,28,21.2
5,All Students,2022-23,18191,1075,17116,94.1,104,19,18.3
All Grades,All Students,2018-19,166110,8384,157726,95.0,973,164,16.9
All Grades,All Students,2019-20,96889,5251,91638,94.6,872,138,15.8
All Grades,All Students,2020-21,129811,10459,119352,91.9,766,216,28.2
All Grades,All Students,2021-22,114943,8934,106009,92.2,684,181,26.5
All Grades,All Students,2022-23,102668,7104,95564,93.1,614,139,22.6
PK in K-12 Schools,All Students,2018-19,6122,485,5637,92.1,35,9,25.7
PK in K-12 Schools,All Students,2019-20,4021,s,s,s,s,s,s
PK in K-12 Schools,All Students,2020-21,4833,405,4428,91.6,28,8,28.6
PK in K-12 Schools,All Students,2021-22,5830,636,5194,89.1,35,18,51.4
PK in K-12 Schools,All Students,2022-23,5733,s,s,s,s,s,s
0K,All Students,2018-19,22387,1437,20950,93.6,133,32,24.1
0K,All Students,2019-20,12384,861,11523,93.0,112,24,21.4
0K,All Students,2020-21,16679,1554,15125,90.7,102,35,34.3
0K,All Students,2021-22,14265,1381,12884,90.3,88,38,43.2
0K,All Students,2022-23,13177,1249,11928,90.5,79,26,32.9
1,All Students,2018-19,26798,1510,25288,94.4,156,34,21.8
1,All Students,2019-20,15088,929,14159,93.8,137,27,19.7
1,All Students,2020-21,18510,1372,17138,92.6,109,25,22.9
1,All Students,2021-22,15127,1068,14059,92.9,92,20,21.7
1,All Students,2022-23,14193,975,13218,93.1,89,24,27.0
2,All Students,2018-19,26589,1393,25196,94.8,157,26,16.6
2,All Students,2019-20,16863,990,15873,94.1,153,32,20.9
2,All Students,2020-21,22019,1365,20654,93.8,129,31,24.0
2,All Students,2021-22,18091,1562,16529,91.4,108,29,26.9
2,All Students,2022-23,13551,789,12762,94.2,81,17,21.0
3,All Students,2018-19,26148,1231,24917,95.3,154,27,17.5
3,All Students,2019-20,14641,721,13920,95.1,132,20,15.2
3,All Students,2020-21,24428,2133,22295,91.3,144,45,31.3
3,All Students,2021-22,21506,1389,20117,93.5,126,22,17.5
3,All Students,2022-23,15960,1045,14915,93.5,96,17,17.7
4,All Students,2018-19,29115,1078,28037,96.3,173,18,10.4
4,All Students,2019-20,15874,824,15050,94.8,141,20,14.2
4,All Students,2020-21,20297,1806,18491,91.1,120,35,29.2
4,All Students,2021-22,21108,1514,19594,92.8,123,28,22.8
4,All Students,2022-23,20482,1037,19445,94.9,120,16,13.3
5,All Students,2018-19,28951,1250,27701,95.7,165,18,10.9
5,All Students,2019-20,18015,659,17356,96.3,160,8,5.0
5,All Students,2020-21,23045,1824,21221,92.1,134,37,27.6
5,All Students,2021-22,19016,1384,17632,92.7,112,26,23.2
5,All Students,2022-23,19493,1239,18254,93.6,113,20,17.7
6,All Students,2019-20,3,s,s,s,s,s,s
6,All Students,2022-23,79,s,s,s,s,s,s
All Grades,All Students,2018-19,91536,5540,85996,93.9,546,104,19.0
All Grades,All Students,2019-20,58526,3535,54991,94.0,525,93,17.7
All Grades,All Students,2020-21,85645,4203,81442,95.1,504,67,13.3
All Grades,All Students,2021-22,88113,7212,80901,91.8,525,156,29.7
All Grades,All Students,2022-23,95311,7895,87416,91.7,563,161,28.6
6,All Students,2018-19,32146,1730,30416,94.6,195,34,17.4
6,All Students,2019-20,17050,1065,15985,93.8,154,26,16.9
6,All Students,2020-21,28139,1164,26975,95.9,167,15,9.0
6,All Students,2021-22,31412,2603,28809,91.7,188,56,29.8
6,All Students,2022-23,32796,2477,30319,92.4,196,50,25.5
7,All Students,2018-19,29576,1808,27768,93.9,174,33,19.0
7,All Students,2019-20,21105,1290,19815,93.9,189,36,19.0
7,All Students,2020-21,26115,s,s,s,s,s,s
7,All Students,2021-22,29567,2183,27384,92.6,176,42,23.9
7,All Students,2022-23,31455,2767,28688,91.2,183,57,31.1
8,All Students,2018-19,29814,2002,27812,93.3,177,37,20.9
8,All Students,2019-20,20371,1180,19191,94.2,182,31,17.0
8,All Students,2020-21,31390,1646,29744,94.8,184,31,16.8
8,All Students,2021-22,27134,2426,24708,91.1,161,58,36.0
8,All Students,2022-23,31060,2651,28409,91.5,184,54,29.3
9,All Students,2020-21,1,s,s,s,s,s,s
All Grades,All Students,2018-19,122145,7140,115005,94.2,709,114,16.1
All Grades,All Students,2019-20,82761,5283,77478,93.6,724,139,19.2
All Grades,All Students,2020-21,123814,6792,117022,94.5,724,104,14.4
All Grades,All Students,2021-22,116383,13130,103253,88.7,667,265,39.7
All Grades,All Students,2022-23,115252,11723,103529,89.8,669,252,37.7
PK in K-12 Schools,All Students,2018-19,9445,922,8523,90.2,58,18,31.0
PK in K-12 Schools,All Students,2019-20,6131,s,s,s,s,s,s
PK in K-12 Schools,All Students,2020-21,9285,1287,7998,86.1,55,21,38.2
PK in K-12 Schools,All Students,2021-22,8952,1578,7374,82.4,53,39,73.6
PK in K-12 Schools,All Students,2022-23,9628,s,s,s,s,s,s
0K,All Students,2018-19,17630,1405,16225,92.0,104,34,32.7
0K,All Students,2019-20,11429,953,10476,91.7,101,28,27.7
0K,All Students,2020-21,16697,1291,15406,92.3,101,25,24.8
0K,All Students,2021-22,16930,2089,14841,87.7,97,42,43.3
0K,All Students,2022-23,16972,1994,14978,88.3,98,45,45.9
1,All Students,2018-19,18726,1247,17479,93.3,109,27,24.8
1,All Students,2019-20,12071,916,11155,92.4,105,26,24.8
1,All Students,2020-21,18105,874,17231,95.2,104,11,10.6
1,All Students,2021-22,16502,2275,14227,86.2,94,45,47.9
1,All Students,2022-23,16308,1639,14669,89.9,95,37,38.9
2,All Students,2018-19,18997,812,18185,95.7,111,7,6.3
2,All Students,2019-20,12440,671,11769,94.6,109,15,13.8
2,All Students,2020-21,18250,1070,17180,94.1,108,16,14.8
2,All Students,2021-22,17085,1843,15242,89.2,97,36,37.1
2,All Students,2022-23,17437,1769,15668,89.9,101,40,39.6
3,All Students,2018-19,20770,1048,19722,95.0,119,11,9.2
3,All Students,2019-20,13305,605,12700,95.5,116,11,9.5
3,All Students,2020-21,21064,611,20453,97.1,121,7,5.8
3,All Students,2021-22,18114,2281,15833,87.4,104,46,44.2
3,All Students,2022-23,17067,1643,15424,90.4,102,33,32.4
4,All Students,2018-19,21080,1054,20026,95.0,120,13,10.8
4,All Students,2019-20,13618,709,12909,94.8,119,16,13.4
4,All Students,2020-21,20913,640,20273,96.9,121,8,6.6
4,All Students,2021-22,19095,1457,17638,92.4,109,22,20.2
4,All Students,2022-23,18476,1866,16610,89.9,107,41,38.3
5,All Students,2018-19,15497,652,14845,95.8,88,4,4.5
5,All Students,2019-20,13766,766,13000,94.4,120,20,16.7
5,All Students,2020-21,19487,1013,18474,94.8,113,15,13.3
5,All Students,2021-22,19705,1607,18098,91.8,113,35,31.0
5,All Students,2022-23,19341,1579,17762,91.8,110,26,23.6
6,All Students,2019-20,1,s,s,s,s,s,s
6,All Students,2022-23,23,s,s,s,s,s,s
All Grades,All Students,2018-19,97774,3650,94124,96.3,561,34,6.1
All Grades,All Students,2019-20,61279,2677,58602,95.6,536,41,7.6
All Grades,All Students,2020-21,75958,860,75098,98.9,451,4,0.9
All Grades,All Students,2021-22,74575,3425,71150,95.4,429,35,8.2
All Grades,All Students,2022-23,73294,4907,68387,93.3,418,86,20.6
0K,All Students,2018-19,20086,971,19115,95.2,116,12,10.3
0K,All Students,2019-20,10351,566,9785,94.5,90,14,15.6
0K,All Students,2020-21,12649,188,12461,98.5,75,2,2.7
0K,All Students,2021-22,16395,874,15521,94.7,94,6,6.4
0K,All Students,2022-23,12074,950,11124,92.1,69,16,23.2
1,All Students,2018-19,13730,428,13302,96.9,80,1,1.3
1,All Students,2019-20,12628,640,11988,94.9,111,13,11.7
1,All Students,2020-21,12459,106,12353,99.1,76,0,0.0
1,All Students,2021-22,11510,611,10899,94.7,66,8,12.1
1,All Students,2022-23,16649,1095,15554,93.4,96,23,24.0
2,All Students,2018-19,17349,673,16676,96.1,100,9,9.0
2,All Students,2019-20,7889,314,7575,96.0,70,4,5.7
2,All Students,2020-21,15927,173,15754,98.9,94,1,1.1
2,All Students,2021-22,11241,464,10777,95.9,66,5,7.6
2,All Students,2022-23,12521,935,11586,92.5,71,19,26.8
3,All Students,2018-19,13920,498,13422,96.4,80,6,7.5
3,All Students,2019-20,10005,394,9611,96.1,87,2,2.3
3,All Students,2020-21,9951,156,9795,98.4,60,0,0.0
3,All Students,2021-22,14169,657,13512,95.4,82,8,9.8
3,All Students,2022-23,10415,575,9840,94.5,59,7,11.9
4,All Students,2018-19,18666,586,18080,96.9,106,2,1.9
4,All Students,2019-20,8970,311,8659,96.5,78,2,2.6
4,All Students,2020-21,13279,105,13174,99.2,77,0,0.0
4,All Students,2021-22,8673,382,8291,95.6,49,4,8.2
4,All Students,2022-23,13624,955,12669,93.0,77,18,23.4
5,All Students,2018-19,14023,494,13529,96.5,79,4,5.1
5,All Students,2019-20,11436,452,10984,96.0,100,6,6.0
5,All Students,2020-21,11693,132,11561,98.9,69,1,1.4
5,All Students,2021-22,12587,437,12150,96.5,72,4,5.6
5,All Students,2022-23,8011,397,7614,95.0,46,3,6.5
All Grades,All Students,2018-19,248335,9677,238658,96.1,1470,173,11.8
All Grades,All Students,2019-20,145437,6374,139063,95.6,1314,146,11.1
All Grades,All Students,2020-21,210804,8705,202099,95.9,1229,154,12.5
All Grades,All Students,2021-22,183271,15855,167416,91.3,1097,320,29.2
All Grades,All Students,2022-23,166476,9812,156664,94.1,1017,198,19.5
0K,All Students,2018-19,37710,2288,35422,93.9,230,43,18.7
0K,All Students,2019-20,19820,s,s,s,s,s,s
0K,All Students,2020-21,34835,1703,33132,95.1,201,30,14.9
0K,All Students,2021-22,25789,2853,22936,88.9,161,74,46.0
0K,All Students,2022-23,25037,2007,23030,92.0,158,47,29.7
1,All Students,2018-19,47636,1773,45863,96.3,286,31,10.8
1,All Students,2019-20,23350,1149,22201,95.1,213,28,13.1
1,All Students,2020-21,31047,1358,29689,95.6,181,24,13.3
1,All Students,2021-22,32398,3315,29083,89.8,196,63,32.1
1,All Students,2022-23,23489,1812,21677,92.3,149,42,28.2
2,All Students,2018-19,39206,1411,37795,96.4,230,26,11.3
2,All Students,2019-20,27710,1237,26473,95.5,250,23,9.2
2,All Students,2020-21,32258,1031,31227,96.8,189,16,8.5
2,All Students,2021-22,24024,2099,21925,91.3,141,38,27.0
2,All Students,2022-23,31240,1754,29486,94.4,189,28,14.8
3,All Students,2018-19,38947,1376,37571,96.5,227,22,9.7
3,All Students,2019-20,24700,944,23756,96.2,223,21,9.4
3,All Students,2020-21,40686,1379,39307,96.6,238,24,10.1
3,All Students,2021-22,30080,2059,28021,93.2,177,37,20.9
3,All Students,2022-23,23355,1244,22111,94.7,140,20,14.3
4,All Students,2018-19,40979,1103,39876,97.3,242,18,7.4
4,All Students,2019-20,24022,904,23118,96.2,214,22,10.3
4,All Students,2020-21,36402,1346,35056,96.3,212,23,10.8
4,All Students,2021-22,37233,2800,34433,92.5,222,55,24.8
4,All Students,2022-23,29252,1282,27970,95.6,175,29,16.6
5,All Students,2018-19,43857,1726,42131,96.1,255,33,12.9
5,All Students,2019-20,25834,799,25035,96.9,229,14,6.1
5,All Students,2020-21,35576,1888,33688,94.7,208,37,17.8
5,All Students,2021-22,33747,2729,31018,91.9,200,53,26.5
5,All Students,2022-23,34103,1713,32390,95.0,206,32,15.5
6,All Students,2019-20,1,s,s,s,s,s,s
All Grades,All Students,2018-19,102660,5326,97334,94.8,586,80,13.7
All Grades,All Students,2019-20,66193,3642,62551,94.5,588,90,15.3
All Grades,All Students,2020-21,98521,4454,94067,95.5,569,64,11.2
All Grades,All Students,2021-22,91915,7233,84682,92.1,534,148,27.7
All Grades,All Students,2022-23,82015,6811,75204,91.7,478,155,32.4
PK in K-12 Schools,All Students,2018-19,7106,s,s,s,s,s,s
PK in K-12 Schools,All Students,2019-20,4479,s,s,s,s,s,s
PK in K-12 Schools,All Students,2020-21,6082,442,5640,92.7,36,8,22.2
PK in K-12 Schools,All Students,2021-22,6348,780,5568,87.7,36,20,55.6
PK in K-12 Schools,All Students,2022-23,6331,596,5735,90.6,37,18,48.6
0K,All Students,2018-19,16850,1168,15682,93.1,96,21,21.9
0K,All Students,2019-20,10997,690,10307,93.7,97,18,18.6
0K,All Students,2020-21,16800,1009,15791,94.0,98,16,16.3
0K,All Students,2021-22,16139,1548,14591,90.4,94,35,37.2
0K,All Students,2022-23,10792,1303,9489,87.9,63,37,58.7
1,All Students,2018-19,15664,982,14682,93.7,92,17,18.5
1,All Students,2019-20,10509,666,9843,93.7,94,15,16.0
1,All Students,2020-21,15737,621,15116,96.1,91,10,11.0
1,All Students,2021-22,13125,1039,12086,92.1,80,22,27.5
1,All Students,2022-23,14259,1141,13118,92.0,84,22,26.2
2,All Students,2018-19,16939,755,16184,95.5,96,9,9.4
2,All Students,2019-20,9568,434,9134,95.5,85,9,10.6
2,All Students,2020-21,15155,706,14449,95.3,87,10,11.5
2,All Students,2021-22,14003,980,13023,93.0,80,16,20.0
2,All Students,2022-23,13170,1006,12164,92.4,77,23,29.9
3,All Students,2018-19,16078,765,15313,95.2,92,14,15.2
3,All Students,2019-20,10803,507,10296,95.3,96,11,11.5
3,All Students,2020-21,13605,565,13040,95.8,78,4,5.1
3,All Students,2021-22,13833,999,12834,92.8,81,18,22.2
3,All Students,2022-23,12234,895,11339,92.7,70,20,28.6
4,All Students,2018-19,15489,620,14869,96.0,87,5,5.7
4,All Students,2019-20,10248,405,9843,96.0,91,9,9.9
4,All Students,2020-21,16439,599,15840,96.4,95,9,9.5
4,All Students,2021-22,13022,844,12178,93.5,75,14,18.7
4,All Students,2022-23,12889,1043,11846,91.9,76,22,28.9
5,All Students,2018-19,14514,601,13913,95.9,82,7,8.5
5,All Students,2019-20,9574,505,9069,94.7,85,12,14.1
5,All Students,2020-21,14703,512,14191,96.5,84,7,8.3
5,All Students,2021-22,15445,1043,14402,93.2,88,23,26.1
5,All Students,2022-23,12340,827,11513,93.3,71,13,18.3
6,All Students,2018-19,20,s,s,s,s,s,s
6,All Students,2019-20,15,s,s,s,s,s,s
All Grades,All Students,2018-19,197719,10618,187101,94.6,1158,202,17.4
All Grades,All Students,2019-20,125981,8688,117293,93.1,1123,281,25.0
All Grades,All Students,2020-21,183106,16026,167080,91.2,1071,286,26.7
All Grades,All Students,2021-22,178994,19457,159537,89.1,1050,434,41.3
All Grades,All Students,2022-23,170972,15684,155288,90.8,1016,360,35.4
PK in K-12 Schools,All Students,2018-19,12605,1313,11292,89.6,78,34,43.6
PK in K-12 Schools,All Students,2019-20,12261,1473,10788,88.0,111,63,56.8
PK in K-12 Schools,All Students,2020-21,17716,1969,15747,88.9,103,39,37.9
PK in K-12 Schools,All Students,2021-22,18777,3253,15524,82.7,111,83,74.8
PK in K-12 Schools,All Students,2022-23,18769,2781,15988,85.2,111,72,64.9
0K,All Students,2018-19,28889,2119,26770,92.7,171,51,29.8
0K,All Students,2019-20,18200,1830,16370,89.9,164,69,42.1
0K,All Students,2020-21,27422,2741,24681,90.0,164,50,30.5
0K,All Students,2021-22,25995,3220,22775,87.6,154,79,51.3
0K,All Students,2022-23,22158,2766,19392,87.5,133,71,53.4
1,All Students,2018-19,30772,1902,28870,93.8,182,30,16.5
1,All Students,2019-20,18943,1340,17603,92.9,167,39,23.4
1,All Students,2020-21,27209,2622,24587,90.4,161,47,29.2
1,All Students,2021-22,27474,3188,24286,88.4,162,74,45.7
1,All Students,2022-23,24162,2164,21998,91.0,146,58,39.7
2,All Students,2018-19,30125,1382,28743,95.4,178,21,11.8
2,All Students,2019-20,18990,1050,17940,94.5,170,30,17.6
2,All Students,2020-21,27349,2008,25341,92.7,158,33,20.9
2,All Students,2021-22,25126,2700,22426,89.3,150,51,34.0
2,All Students,2022-23,28387,2500,25887,91.2,165,46,27.9
3,All Students,2018-19,29508,1310,28198,95.6,171,21,12.3
3,All Students,2019-20,19337,1153,18184,94.0,173,34,19.7
3,All Students,2020-21,27699,2151,25548,92.2,161,44,27.3
3,All Students,2021-22,28856,2515,26341,91.3,166,50,30.1
3,All Students,2022-23,23648,1698,21950,92.8,144,37,25.7
4,All Students,2018-19,31327,1028,30299,96.7,180,15,8.3
4,All Students,2019-20,18141,936,17205,94.8,160,25,15.6
4,All Students,2020-21,28910,2031,26879,93.0,168,32,19.0
4,All Students,2021-22,25469,2317,23152,90.9,150,52,34.7
4,All Students,2022-23,27513,1918,25595,93.0,163,40,24.5
5,All Students,2018-19,34493,1564,32929,95.5,198,30,15.2
5,All Students,2019-20,20109,906,19203,95.5,178,21,11.8
5,All Students,2020-21,26801,2504,24297,90.7,156,41,26.3
5,All Students,2021-22,27297,2264,25033,91.7,157,45,28.7
5,All Students,2022-23,26335,1857,24478,92.9,154,36,23.4
All Grades,All Students,2018-19,140921,8574,132347,93.9,807,120,14.9
All Grades,All Students,2019-20,89641,5453,84188,93.9,797,137,17.2
All Grades,All Students,2020-21,120993,3824,117169,96.8,705,52,7.4
All Grades,All Students,2021-22,109699,10141,99558,90.8,644,205,31.8
All Grades,All Students,2022-23,107300,9621,97679,91.0,620,192,31.0
PK in K-12 Schools,All Students,2018-19,6311,477,5834,92.4,37,7,18.9
PK in K-12 Schools,All Students,2019-20,4058,246,3812,93.9,36,6,16.7
PK in K-12 Schools,All Students,2020-21,6095,286,5809,95.3,36,6,16.7
PK in K-12 Schools,All Students,2021-22,5974,652,5322,89.1,38,16,42.1
PK in K-12 Schools,All Students,2022-23,6370,s,s,s,s,s,s
0K,All Students,2018-19,25498,1624,23874,93.6,145,24,16.6
0K,All Students,2019-20,16114,1056,15058,93.4,144,31,21.5
0K,All Students,2020-21,19265,608,18657,96.8,114,6,5.3
0K,All Students,2021-22,16876,1539,15337,90.9,100,38,38.0
0K,All Students,2022-23,16987,1666,15321,90.2,99,39,39.4
1,All Students,2018-19,21946,1271,20675,94.2,125,19,15.2
1,All Students,2019-20,15055,957,14098,93.6,136,23,16.9
1,All Students,2020-21,20697,845,19852,95.9,120,12,10.0
1,All Students,2021-22,17939,1815,16124,89.9,106,37,34.9
1,All Students,2022-23,16149,1465,14684,90.9,93,30,32.3
2,All Students,2018-19,21097,1262,19835,94.0,120,17,14.2
2,All Students,2019-20,14429,817,13612,94.3,128,16,12.5
2,All Students,2020-21,20238,598,19640,97.0,117,8,6.8
2,All Students,2021-22,18671,1636,17035,91.2,108,34,31.5
2,All Students,2022-23,17281,1720,15561,90.0,100,34,34.0
3,All Students,2018-19,22402,1225,21177,94.5,131,16,12.2
3,All Students,2019-20,12898,690,12208,94.7,113,17,15.0
3,All Students,2020-21,17310,502,16808,97.1,101,7,6.9
3,All Students,2021-22,18131,1721,16410,90.5,104,29,27.9
3,All Students,2022-23,18192,1527,16665,91.6,104,26,25.0
4,All Students,2018-19,21510,1307,20203,93.9,123,17,13.8
4,All Students,2019-20,13443,725,12718,94.6,119,17,14.3
4,All Students,2020-21,18006,414,17592,97.7,104,4,3.8
4,All Students,2021-22,14689,1199,13490,91.8,84,22,26.2
4,All Students,2022-23,17184,1572,15612,90.9,100,29,29.0
5,All Students,2018-19,22157,1408,20749,93.6,126,20,15.9
5,All Students,2019-20,13644,962,12682,92.9,121,27,22.3
5,All Students,2020-21,19382,571,18811,97.1,113,9,8.0
5,All Students,2021-22,17419,1579,15840,90.9,104,29,27.9
5,All Students,2022-23,15120,996,14124,93.4,87,17,19.5
7,All Students,2022-23,17,s,s,s,s,s,s
All Grades,All Students,2018-19,76460,4121,72339,94.6,442,63,14.3
All Grades,All Students,2019-20,50038,3321,46717,93.4,453,92,20.3
All Grades,All Students,2020-21,63314,4762,58552,92.5,375,78,20.8
All Grades,All Students,2021-22,49908,4786,45122,90.4,301,118,39.2
All Grades,All Students,2022-23,42450,3494,38956,91.8,253,75,29.6
PK in K-12 Schools,All Students,2018-19,6292,388,5904,93.8,39,10,25.6
PK in K-12 Schools,All Students,2019-20,4083,471,3612,88.5,38,15,39.5
PK in K-12 Schools,All Students,2020-21,3367,339,3028,89.9,21,6,28.6
PK in K-12 Schools,All Students,2021-22,3954,636,3318,83.9,23,16,69.6
PK in K-12 Schools,All Students,2022-23,2621,383,2238,85.4,18,14,77.8
0K,All Students,2018-19,11611,758,10853,93.5,70,15,21.4
0K,All Students,2019-20,8584,582,8002,93.2,77,16,20.8
0K,All Students,2020-21,8338,1036,7302,87.6,51,14,27.5
0K,All Students,2021-22,6108,794,5314,87.0,40,21,52.5
0K,All Students,2022-23,4232,515,3717,87.8,25,13,52.0
1,All Students,2018-19,13033,676,12357,94.8,76,9,11.8
1,All Students,2019-20,7056,473,6583,93.3,65,15,23.1
1,All Students,2020-21,9436,503,8933,94.7,56,8,14.3
1,All Students,2021-22,7398,749,6649,89.9,44,15,34.1
1,All Students,2022-23,4923,511,4412,89.6,29,12,41.4
2,All Students,2018-19,10976,681,10295,93.8,62,9,14.5
2,All Students,2019-20,8337,521,7816,93.8,78,12,15.4
2,All Students,2020-21,9278,516,8762,94.4,56,9,16.1
2,All Students,2021-22,7869,634,7235,91.9,49,17,34.7
2,All Students,2022-23,7016,513,6503,92.7,43,10,23.3
3,All Students,2018-19,12605,521,12084,95.9,71,4,5.6
3,All Students,2019-20,6502,433,6069,93.3,58,14,24.1
3,All Students,2020-21,10771,651,10120,94.0,62,10,16.1
3,All Students,2021-22,8031,625,7406,92.2,47,15,31.9
3,All Students,2022-23,7543,517,7026,93.1,44,10,22.7
4,All Students,2018-19,10206,488,9718,95.2,58,6,10.3
4,All Students,2019-20,8705,389,8316,95.5,78,9,11.5
4,All Students,2020-21,9353,687,8666,92.7,55,11,20.0
4,All Students,2021-22,8643,536,8107,93.8,51,12,23.5
4,All Students,2022-23,7736,581,7155,92.5,46,12,26.1
5,All Students,2018-19,11737,609,11128,94.8,66,10,15.2
5,All Students,2019-20,6771,452,6319,93.3,59,11,18.6
5,All Students,2020-21,12771,1030,11741,91.9,74,20,27.0
5,All Students,2021-22,7905,812,7093,89.7,47,22,46.8
5,All Students,2022-23,8379,474,7905,94.3,48,4,8.3
All Grades,All Students,2018-19,243150,9588,233562,96.1,1394,79,5.7
All Grades,All Students,2019-20,157968,6920,151048,95.6,1396,99,7.1
All Grades,All Students,2020-21,213300,5720,207580,97.3,1261,45,3.6
All Grades,All Students,2021-22,216254,11669,204585,94.6,1234,134,10.9
All Grades,All Students,2022-23,216231,12991,203240,94.0,1235,179,14.5
0K,All Students,2018-19,41281,2115,39166,94.9,237,23,9.7
0K,All Students,2019-20,28729,1544,27185,94.6,255,29,11.4
0K,All Students,2020-21,36150,1294,34856,96.4,213,13,6.1
0K,All Students,2021-22,39691,2408,37283,93.9,227,25,11.0
0K,All Students,2022-23,40444,3157,37287,92.2,233,64,27.5
1,All Students,2018-19,40865,1815,39050,95.6,233,18,7.7
1,All Students,2019-20,27406,1299,26107,95.3,242,20,8.3
1,All Students,2020-21,38526,875,37651,97.7,228,7,3.1
1,All Students,2021-22,36036,2199,33837,93.9,206,33,16.0
1,All Students,2022-23,37578,2196,35382,94.2,214,25,11.7
2,All Students,2018-19,41974,1745,40229,95.8,245,18,7.3
2,All Students,2019-20,25952,1206,24746,95.4,230,18,7.8
2,All Students,2020-21,36051,1011,35040,97.2,219,10,4.6
2,All Students,2021-22,36814,1852,34962,95.0,209,21,10.0
2,All Students,2022-23,34799,2061,32738,94.1,200,23,11.5
3,All Students,2018-19,39382,1355,38027,96.6,226,7,3.1
3,All Students,2019-20,26479,1075,25404,95.9,232,14,6.0
3,All Students,2020-21,35435,858,34577,97.6,208,4,1.9
3,All Students,2021-22,35900,1865,34035,94.8,204,21,10.3
3,All Students,2022-23,37585,2080,35505,94.5,214,27,12.6
4,All Students,2018-19,40750,1223,39527,97.0,232,5,2.2
4,All Students,2019-20,24407,904,23503,96.3,217,8,3.7
4,All Students,2020-21,34540,875,33665,97.5,200,5,2.5
4,All Students,2021-22,34376,1714,32662,95.0,197,19,9.6
4,All Students,2022-23,33602,1757,31845,94.8,191,21,11.0
5,All Students,2018-19,38898,1335,37563,96.6,221,8,3.6
5,All Students,2019-20,24995,892,24103,96.4,220,10,4.5
5,All Students,2020-21,32598,807,31791,97.5,193,6,3.1
5,All Students,2021-22,33437,1631,31806,95.1,191,15,7.9
5,All Students,2022-23,32223,1740,30483,94.6,183,19,10.4
All Grades,All Students,2018-19,52423,2292,50131,95.6,309,24,7.8
All Grades,All Students,2019-20,34522,1742,32780,95.0,309,35,11.3
All Grades,All Students,2020-21,48150,1298,46852,97.3,291,15,5.2
All Grades,All Students,2021-22,47568,3211,44357,93.2,278,56,20.1
All Grades,All Students,2022-23,45863,3264,42599,92.9,287,67,23.3
PK in K-12 Schools,All Students,2018-19,6275,362,5913,94.2,36,3,8.3
PK in K-12 Schools,All Students,2019-20,3890,278,3612,92.9,36,10,27.8
PK in K-12 Schools,All Students,2020-21,5514,371,5143,93.3,34,8,23.5
PK in K-12 Schools,All Students,2021-22,5166,456,4710,91.2,30,11,36.7
PK in K-12 Schools,All Students,2022-23,6208,729,5479,88.3,38,20,52.6
0K,All Students,2018-19,9014,431,8583,95.2,58,5,8.6
0K,All Students,2019-20,5530,322,5208,94.2,49,8,16.3
0K,All Students,2020-21,6398,219,6179,96.6,44,2,4.5
0K,All Students,2021-22,8590,676,7914,92.1,51,12,23.5
0K,All Students,2022-23,6827,486,6341,92.9,45,9,20.0
1,All Students,2018-19,8388,420,7968,95.0,49,9,18.4
1,All Students,2019-20,5387,272,5115,95.0,48,4,8.3
1,All Students,2020-21,7854,166,7688,97.9,47,3,6.4
1,All Students,2021-22,5347,366,4981,93.2,31,5,16.1
1,All Students,2022-23,7683,563,7120,92.7,48,11,22.9
2,All Students,2018-19,8167,317,7850,96.1,47,2,4.3
2,All Students,2019-20,4905,254,4651,94.8,45,5,11.1
2,All Students,2020-21,7769,155,7614,98.0,46,1,2.2
2,All Students,2021-22,6846,447,6399,93.5,41,8,19.5
2,All Students,2022-23,5635,393,5242,93.0,36,9,25.0
3,All Students,2018-19,7339,252,7087,96.6,44,1,2.3
3,All Students,2019-20,5331,257,5074,95.2,47,3,6.4
3,All Students,2020-21,6524,146,6378,97.8,39,1,2.6
3,All Students,2021-22,7884,344,7540,95.6,46,2,4.3
3,All Students,2022-23,7499,437,7062,94.2,47,9,19.1
4,All Students,2018-19,7544,307,7237,95.9,43,2,4.7
4,All Students,2019-20,4547,118,4429,97.4,41,1,2.4
4,All Students,2020-21,8030,141,7889,98.2,46,0,0.0
4,All Students,2021-22,5770,448,5322,92.2,34,9,26.5
4,All Students,2022-23,6984,354,6630,94.9,42,3,7.1
5,All Students,2018-19,5696,203,5493,96.4,32,2,6.3
5,All Students,2019-20,4932,241,4691,95.1,44,4,9.1
5,All Students,2020-21,6061,100,5961,98.4,35,0,0.0
5,All Students,2021-22,7965,474,7491,94.0,45,9,20.0
5,All Students,2022-23,5027,302,4725,94.0,31,6,19.4
All Grades,All Students,2018-19,40993,3694,37299,91.0,250,77,30.8
All Grades,All Students,2019-20,31136,2314,28822,92.6,290,84,29.0
All Grades,All Students,2020-21,59274,6323,52951,89.3,342,120,35.1
All Grades,All Students,2021-22,55843,7624,48219,86.3,335,169,50.4
All Grades,All Students,2022-23,53864,6246,47618,88.4,330,133,40.3
9,All Students,2018-19,14598,821,13777,94.4,91,13,14.3
9,All Students,2019-20,10826,636,10190,94.1,100,25,25.0
9,All Students,2020-21,17940,1095,16845,93.9,104,22,21.2
9,All Students,2021-22,13191,1214,11977,90.8,80,32,40.0
9,All Students,2022-23,14065,852,13213,93.9,87,13,14.9
10,All Students,2018-19,14299,1260,13039,91.2,87,24,27.6
10,All Students,2019-20,8586,489,8097,94.3,81,18,22.2
10,All Students,2020-21,16100,1922,14178,88.1,92,36,39.1
10,All Students,2021-22,16139,1934,14205,88.0,97,44,45.4
10,All Students,2022-23,12228,1200,11028,90.2,75,24,32.0
11,All Students,2018-19,4872,431,4441,91.2,29,10,34.5
11,All Students,2019-20,7989,662,7327,91.7,75,20,26.7
11,All Students,2020-21,12832,1533,11299,88.1,74,26,35.1
11,All Students,2021-22,14712,2388,12324,83.8,88,48,54.5
11,All Students,2022-23,14121,1677,12444,88.1,88,35,39.8
12,All Students,2018-19,7224,1182,6042,83.6,43,30,69.8
12,All Students,2019-20,3735,527,3208,85.9,34,21,61.8
12,All Students,2020-21,12402,1773,10629,85.7,72,36,50.0
12,All Students,2021-22,11801,2088,9713,82.3,70,45,64.3
12,All Students,2022-23,13450,2517,10933,81.3,80,61,76.3
All Grades,All Students,2018-19,53819,2714,51105,95.0,309,39,12.6
All Grades,All Students,2019-20,38830,1944,36886,95.0,346,42,12.1
All Grades,All Students,2020-21,62115,3074,59041,95.1,357,49,13.7
All Grades,All Students,2021-22,59202,3699,55503,93.8,341,59,17.3
All Grades,All Students,2022-23,60578,3698,56880,93.9,344,60,17.4
6,All Students,2018-19,25494,939,24555,96.3,146,5,3.4
6,All Students,2019-20,12337,654,11683,94.7,111,16,14.4
6,All Students,2020-21,20582,670,19912,96.7,118,7,5.9
6,All Students,2021-22,22417,1438,20979,93.6,128,21,16.4
6,All Students,2022-23,19022,1202,17820,93.7,108,19,17.6
7,All Students,2018-19,15673,606,15067,96.1,90,4,4.4
7,All Students,2019-20,16536,673,15863,95.9,146,12,8.2
7,All Students,2020-21,17769,1138,16631,93.6,103,24,23.3
7,All Students,2021-22,19890,1110,18780,94.4,116,16,13.8
7,All Students,2022-23,21441,1137,20304,94.7,122,17,13.9
8,All Students,2018-19,12652,1169,11483,90.8,73,30,41.1
8,All Students,2019-20,9957,617,9340,93.8,89,14,15.7
8,All Students,2020-21,23764,1266,22498,94.7,136,18,13.2
8,All Students,2021-22,16895,1151,15744,93.2,97,22,22.7
8,All Students,2022-23,20115,1359,18756,93.2,114,24,21.1
All Grades,All Students,2018-19,102777,4732,98045,95.4,583,54,9.3
All Grades,All Students,2019-20,65822,3173,62649,95.2,582,67,11.5
All Grades,All Students,2020-21,99442,8196,91246,91.8,580,169,29.1
All Grades,All Students,2021-22,92473,8366,84107,91.0,537,175,32.6
All Grades,All Students,2022-23,92942,6979,85963,92.5,539,131,24.3
5,All Students,2021-22,13,s,s,s,s,s,s
6,All Students,2018-19,36498,1311,35187,96.4,206,13,6.3
6,All Students,2019-20,22058,1141,20917,94.8,197,30,15.2
6,All Students,2020-21,33570,2517,31053,92.5,198,47,23.7
6,All Students,2021-22,29172,s,s,s,s,s,s
6,All Students,2022-23,34027,2161,31866,93.6,198,41,20.7
7,All Students,2018-19,33276,1360,31916,95.9,191,14,7.3
7,All Students,2019-20,22728,851,21877,96.3,200,13,6.5
7,All Students,2020-21,32030,s,s,s,s,s,s
7,All Students,2021-22,32351,2720,29631,91.6,186,52,28.0
7,All Students,2022-23,27204,1955,25249,92.8,159,37,23.3
8,All Students,2018-19,33003,2061,30942,93.8,186,27,14.5
8,All Students,2019-20,21036,1181,19855,94.4,185,24,13.0
8,All Students,2020-21,33839,3213,30626,90.5,196,69,35.2
8,All Students,2021-22,30937,3009,27928,90.3,180,64,35.6
8,All Students,2022-23,31711,2863,28848,91.0,182,53,29.1
9,All Students,2020-21,3,s,s,s,s,s,s
All Grades,All Students,2018-19,96193,3255,92938,96.6,545,22,4.0
All Grades,All Students,2019-20,62988,2248,60740,96.4,552,35,6.3
All Grades,All Students,2020-21,93375,3535,89840,96.2,547,62,11.3
All Grades,All Students,2021-22,87110,1630,85480,98.1,502,15,3.0
All Grades,All Students,2022-23,91343,2644,88699,97.1,539,36,6.7
6,All Students,2018-19,32560,973,31587,97.0,184,5,2.7
6,All Students,2019-20,20717,856,19861,95.9,182,18,9.9
6,All Students,2020-21,30388,1254,29134,95.9,181,26,14.4
6,All Students,2021-22,28730,353,28377,98.8,166,3,1.8
6,All Students,2022-23,31895,855,31040,97.3,186,12,6.5
7,All Students,2018-19,32059,699,31360,97.8,182,2,1.1
7,All Students,2019-20,21349,597,20752,97.2,186,7,3.8
7,All Students,2020-21,30769,1227,29542,96.0,182,19,10.4
7,All Students,2021-22,29618,701,28917,97.6,172,7,4.1
7,All Students,2022-23,30105,796,29309,97.4,181,12,6.6
8,All Students,2018-19,31574,1583,29991,95.0,179,15,8.4
8,All Students,2019-20,20922,795,20127,96.2,184,10,5.4
8,All Students,2020-21,32218,1054,31164,96.7,184,17,9.2
8,All Students,2021-22,28762,576,28186,98.0,164,5,3.0
8,All Students,2022-23,29343,993,28350,96.6,172,12,7.0
All Grades,All Students,2018-19,115167,13552,101615,88.2,693,275,39.7
All Grades,All Students,2019-20,71436,6953,64483,90.3,662,211,31.9
All Grades,All Students,2020-21,120168,25652,94516,78.7,691,416,60.2
All Grades,All Students,2021-22,116216,17576,98640,84.9,694,365,52.6
All Grades,All Students,2022-23,111183,17605,93578,84.2,688,379,55.1
6,All Students,2018-19,19632,1675,17957,91.5,116,37,31.9
6,All Students,2019-20,10991,628,10363,94.3,99,13,13.1
6,All Students,2020-21,17968,2244,15724,87.5,104,40,38.5
6,All Students,2021-22,16402,1475,14927,91.0,93,30,32.3
6,All Students,2022-23,17028,1570,15458,90.8,100,33,33.0
7,All Students,2018-19,15976,1290,14686,91.9,91,21,23.1
7,All Students,2019-20,10995,788,10207,92.8,97,21,21.6
7,All Students,2020-21,16300,1841,14459,88.7,94,30,31.9
7,All Students,2021-22,16590,1548,15042,90.7,96,31,32.3
7,All Students,2022-23,14939,1535,13404,89.7,90,33,36.7
8,All Students,2018-19,15896,2070,13826,87.0,89,36,40.4
8,All Students,2019-20,9879,746,9133,92.4,87,17,19.5
8,All Students,2020-21,17146,2897,14249,83.1,98,56,57.1
8,All Students,2021-22,14845,1760,13085,88.1,85,37,43.5
8,All Students,2022-23,16052,2146,13906,86.6,95,45,47.4
9,All Students,2018-19,16553,1992,14561,88.0,103,42,40.8
9,All Students,2019-20,11009,1501,9508,86.4,107,42,39.3
9,All Students,2020-21,20862,6158,14704,70.5,119,85,71.4
9,All Students,2021-22,18831,3144,15687,83.3,113,57,50.4
9,All Students,2022-23,16238,2971,13267,81.7,104,58,55.8
10,All Students,2018-19,17251,2073,15178,88.0,110,41,37.3
10,All Students,2019-20,10084,1341,8743,86.7,97,44,45.4
10,All Students,2020-21,17949,5494,12455,69.4,103,81,78.6
10,All Students,2021-22,19582,3010,16572,84.6,120,63,52.5
10,All Students,2022-23,18036,3212,14824,82.2,116,70,60.3
11,All Students,2018-19,14895,2092,12803,86.0,91,40,44.0
11,All Students,2019-20,9023,715,8308,92.1,86,26,30.2
11,All Students,2020-21,14869,3542,11327,76.2,85,59,69.4
11,All Students,2021-22,14333,2667,11666,81.4,91,68,74.7
11,All Students,2022-23,16554,2862,13692,82.7,104,67,64.4
12,All Students,2018-19,14964,2360,12604,84.2,93,58,62.4
12,All Students,2019-20,9455,1234,8221,86.9,89,48,53.9
12,All Students,2020-21,15074,3476,11598,76.9,88,65,73.9
12,All Students,2021-22,15633,3972,11661,74.6,96,79,82.3
12,All Students,2022-23,12336,3309,9027,73.2,79,73,92.4
All Grades,All Students,2018-19,71474,11031,60443,84.6,468,223,47.6
All Grades,All Students,2019-20,48381,7051,41330,85.4,458,209,45.6
All Grades,All Students,2020-21,85434,12672,72762,85.2,494,203,41.1
All Grades,All Students,2021-22,78120,10983,67137,85.9,494,241,48.8
All Grades,All Students,2022-23,73244,14239,59005,80.6,482,275,57.1
7,All Students,2022-23,1,s,s,s,s,s,s
9,All Students,2018-19,20888,3599,17289,82.8,146,75,51.4
9,All Students,2019-20,13011,1614,11397,87.6,127,54,42.5
9,All Students,2020-21,25050,2576,22474,89.7,144,41,28.5
9,All Students,2021-22,21819,2568,19251,88.2,138,56,40.6
9,All Students,2022-23,20906,3522,17384,83.2,142,81,57.0
10,All Students,2018-19,22278,3678,18600,83.5,139,63,45.3
10,All Students,2019-20,12692,2015,10677,84.1,124,70,56.5
10,All Students,2020-21,21219,3997,17222,81.2,123,63,51.2
10,All Students,2021-22,21896,2894,19002,86.8,141,65,46.1
10,All Students,2022-23,19310,3970,15340,79.4,128,66,51.6
11,All Students,2018-19,15923,1867,14056,88.3,107,49,45.8
11,All Students,2019-20,13051,1934,11117,85.2,119,44,37.0
11,All Students,2020-21,19608,3217,16391,83.6,112,50,44.6
11,All Students,2021-22,17404,2679,14725,84.6,110,60,54.5
11,All Students,2022-23,19620,3875,15745,80.2,127,70,55.1
12,All Students,2018-19,12385,1887,10498,84.8,76,36,47.4
12,All Students,2019-20,9627,1488,8139,84.5,88,41,46.6
12,All Students,2020-21,19557,2882,16675,85.3,115,49,42.6
12,All Students,2021-22,17001,2842,14159,83.3,105,60,57.1
12,All Students,2022-23,13407,s,s,s,s,s,s
All Grades,All Students,2018-19,42123,7549,34574,82.1,294,155,52.7
All Grades,All Students,2019-20,29290,6586,22704,77.5,293,174,59.4
All Grades,All Students,2020-21,41455,6890,34565,83.4,266,134,50.4
All Grades,All Students,2021-22,42078,10023,32055,76.2,311,224,72.0
All Grades,All Students,2022-23,48820,10437,38383,78.6,340,219,64.4
9,All Students,2018-19,12971,1805,11166,86.1,87,32,36.8
9,All Students,2019-20,9111,1861,7250,79.6,91,58,63.7
9,All Students,2020-21,5801,836,4965,85.6,45,24,53.3
9,All Students,2021-22,11555,2202,9353,80.9,97,61,62.9
9,All Students,2022-23,13129,2105,11024,84.0,97,53,54.6
10,All Students,2018-19,11805,2668,9137,77.4,86,55,64.0
10,All Students,2019-20,8450,1822,6628,78.4,87,51,58.6
10,All Students,2020-21,14332,2444,11888,82.9,89,49,55.1
10,All Students,2021-22,9497,1730,7767,81.8,69,46,66.7
10,All Students,2022-23,15457,3513,11944,77.3,104,64,61.5
11,All Students,2018-19,9269,1587,7682,82.9,63,33,52.4
11,All Students,2019-20,6436,1815,4621,71.8,65,41,63.1
11,All Students,2020-21,12973,2063,10910,84.1,79,37,46.8
11,All Students,2021-22,12082,3787,8295,68.7,77,62,80.5
11,All Students,2022-23,11338,2640,8698,76.7,79,52,65.8
12,All Students,2018-19,8078,1489,6589,81.6,58,35,60.3
12,All Students,2019-20,5293,1088,4205,79.4,51,25,49.0
12,All Students,2020-21,8349,1547,6802,81.5,53,24,45.3
12,All Students,2021-22,8944,2304,6640,74.2,68,55,80.9
12,All Students,2022-23,8896,2179,6717,75.5,60,50,83.3
All Grades,All Students,2018-19,115958,13755,102203,88.1,711,276,38.8
All Grades,All Students,2019-20,75615,8515,67100,88.7,705,234,33.2
All Grades,All Students,2020-21,118337,25451,92886,78.5,689,329,47.8
All Grades,All Students,2021-22,104734,15093,89641,85.6,627,275,43.9
All Grades,All Students,2022-23,95962,13778,82184,85.6,601,272,45.3
6,All Students,2018-19,16600,1100,15500,93.4,98,24,24.5
6,All Students,2019-20,12535,971,11564,92.3,114,20,17.5
6,All Students,2020-21,18197,976,17221,94.6,107,17,15.9
6,All Students,2021-22,9602,1036,8566,89.2,57,19,33.3
6,All Students,2022-23,12098,1091,11007,91.0,74,23,31.1
7,All Students,2018-19,14656,693,13963,95.3,86,7,8.1
7,All Students,2019-20,10676,717,9959,93.3,98,23,23.5
7,All Students,2020-21,16242,2007,14235,87.6,96,25,26.0
7,All Students,2021-22,16427,1047,15380,93.6,97,19,19.6
7,All Students,2022-23,9371,695,8676,92.6,56,16,28.6
8,All Students,2018-19,12988,975,12013,92.5,80,24,30.0
8,All Students,2019-20,9170,445,8725,95.1,83,9,10.8
8,All Students,2020-21,16168,1742,14426,89.2,93,30,32.3
8,All Students,2021-22,15376,1494,13882,90.3,88,26,29.5
8,All Students,2022-23,15657,993,14664,93.7,94,19,20.2
9,All Students,2018-19,22574,3408,19166,84.9,141,65,46.1
9,All Students,2019-20,11648,1980,9668,83.0,116,49,42.2
9,All Students,2020-21,18967,5508,13459,71.0,110,67,60.9
9,All Students,2021-22,18268,3583,14685,80.4,109,57,52.3
9,All Students,2022-23,16421,2908,13513,82.3,108,52,48.1
10,All Students,2018-19,18006,3765,14241,79.1,116,69,59.5
10,All Students,2019-20,12888,2046,10842,84.1,120,55,45.8
10,All Students,2020-21,17800,5755,12045,67.7,103,60,58.3
10,All Students,2021-22,16635,2873,13762,82.7,103,62,60.2
10,All Students,2022-23,17026,3615,13411,78.8,109,60,55.0
11,All Students,2018-19,15466,1758,13708,88.6,96,37,38.5
11,All Students,2019-20,8384,903,7481,89.2,78,34,43.6
11,All Students,2020-21,16548,4112,12436,75.2,95,58,61.1
11,All Students,2021-22,11389,1399,9990,87.7,68,27,39.7
11,All Students,2022-23,13493,2018,11475,85.0,84,47,56.0
12,All Students,2018-19,15668,2056,13612,86.9,94,50,53.2
12,All Students,2019-20,10314,1453,8861,85.9,96,44,45.8
12,All Students,2020-21,14415,5351,9064,62.9,85,72,84.7
12,All Students,2021-22,17037,3661,13376,78.5,105,65,61.9
12,All Students,2022-23,11896,2458,9438,79.3,76,55,72.4
All Grades,All Students,2018-19,124196,12875,111321,89.6,737,191,25.9
All Grades,All Students,2019-20,91429,8179,83250,91.1,828,213,25.7
All Grades,All Students,2020-21,133777,14261,119516,89.3,795,227,28.6
All Grades,All Students,2021-22,132775,18067,114708,86.4,815,368,45.2
All Grades,All Students,2022-23,132985,15210,117775,88.6,831,308,37.1
6,All Students,2018-19,29504,1680,27824,94.3,172,20,11.6
6,All Students,2019-20,19342,1054,18288,94.6,172,27,15.7
6,All Students,2020-21,20414,1581,18833,92.3,123,34,27.6
6,All Students,2021-22,27394,2527,24867,90.8,165,61,37.0
6,All Students,2022-23,27847,1861,25986,93.3,163,32,19.6
7,All Students,2018-19,28557,1168,27389,95.9,165,13,7.9
7,All Students,2019-20,18232,1049,17183,94.2,165,25,15.2
7,All Students,2020-21,28118,2382,25736,91.5,164,37,22.6
7,All Students,2021-22,19022,1729,17293,90.9,112,34,30.4
7,All Students,2022-23,27935,2670,25265,90.4,166,50,30.1
8,All Students,2018-19,18630,1280,17350,93.1,107,21,19.6
8,All Students,2019-20,17668,889,16779,95.0,157,23,14.6
8,All Students,2020-21,26303,2497,23806,90.5,155,42,27.1
8,All Students,2021-22,26888,3056,23832,88.6,161,58,36.0
8,All Students,2022-23,18810,2002,16808,89.4,114,41,36.0
9,All Students,2018-19,17876,2011,15865,88.8,111,36,32.4
9,All Students,2019-20,11559,964,10595,91.7,107,36,33.6
9,All Students,2020-21,14859,1560,13299,89.5,90,26,28.9
9,All Students,2021-22,16629,2440,14189,85.3,106,52,49.1
9,All Students,2022-23,18727,2162,16565,88.5,126,48,38.1
10,All Students,2018-19,9406,1447,7959,84.6,58,19,32.8
10,All Students,2019-20,11984,1670,10314,86.1,110,41,37.3
10,All Students,2020-21,16425,1800,14625,89.0,97,27,27.8
10,All Students,2021-22,14016,2628,11388,81.3,87,42,48.3
10,All Students,2022-23,13779,1863,11916,86.5,94,42,44.7
11,All Students,2018-19,10724,2540,8184,76.3,65,37,56.9
11,All Students,2019-20,5742,719,5023,87.5,54,25,46.3
11,All Students,2020-21,17905,2653,15252,85.2,106,37,34.9
11,All Students,2021-22,14131,2417,11714,82.9,87,49,56.3
11,All Students,2022-23,12861,1919,10942,85.1,85,43,50.6
12,All Students,2018-19,9499,2749,6750,71.1,59,45,76.3
12,All Students,2019-20,6902,1834,5068,73.4,63,36,57.1
12,All Students,2020-21,9753,1788,7965,81.7,60,24,40.0
12,All Students,2021-22,14695,3270,11425,77.7,97,72,74.2
12,All Students,2022-23,13026,2733,10293,79.0,83,52,62.7
All Grades,All Students,2018-19,88312,4756,83556,94.6,519,85,16.4
All Grades,All Students,2019-20,53381,3054,50327,94.3,478,83,17.4
All Grades,All Students,2020-21,76258,5050,71208,93.4,459,95,20.7
All Grades,All Students,2021-22,69119,6585,62534,90.5,401,154,38.4
All Grades,All Students,2022-23,61020,5538,55482,90.9,372,132,35.5
PK in K-12 Schools,All Students,2018-19,10674,823,9851,92.3,60,20,33.3
PK in K-12 Schools,All Students,2019-20,4588,326,4262,92.9,41,9,22.0
PK in K-12 Schools,All Students,2020-21,6171,718,5453,88.4,37,15,40.5
PK in K-12 Schools,All Students,2021-22,5328,687,4641,87.1,32,15,46.9
PK in K-12 Schools,All Students,2022-23,6209,773,5436,87.6,38,20,52.6
0K,All Students,2018-19,13309,836,12473,93.7,81,15,18.5
0K,All Students,2019-20,7059,508,6551,92.8,65,19,29.2
0K,All Students,2020-21,11386,593,10793,94.8,70,12,17.1
0K,All Students,2021-22,8778,1042,7736,88.1,52,28,53.8
0K,All Students,2022-23,7465,909,6556,87.8,47,22,46.8
1,All Students,2018-19,14556,806,13750,94.5,86,12,14.0
1,All Students,2019-20,7726,488,7238,93.7,70,14,20.0
1,All Students,2020-21,9863,527,9336,94.7,59,9,15.3
1,All Students,2021-22,11519,935,10584,91.9,66,19,28.8
1,All Students,2022-23,7707,719,6988,90.7,47,18,38.3
2,All Students,2018-19,17506,840,16666,95.2,102,14,13.7
2,All Students,2019-20,8167,465,7702,94.3,73,13,17.8
2,All Students,2020-21,10434,861,9573,91.7,66,15,22.7
2,All Students,2021-22,9027,991,8036,89.0,52,23,44.2
2,All Students,2022-23,11115,861,10254,92.3,67,17,25.4
3,All Students,2018-19,13659,618,13041,95.5,81,10,12.3
3,All Students,2019-20,10451,501,9950,95.2,93,13,14.0
3,All Students,2020-21,11087,865,10222,92.2,66,16,24.2
3,All Students,2021-22,10528,890,9638,91.5,61,18,29.5
3,All Students,2022-23,8530,773,7757,90.9,52,18,34.6
4,All Students,2018-19,10874,466,10408,95.7,65,7,10.8
4,All Students,2019-20,8417,378,8039,95.5,75,6,8.0
4,All Students,2020-21,15058,624,14434,95.9,88,10,11.4
4,All Students,2021-22,10614,999,9615,90.6,62,28,45.2
4,All Students,2022-23,9825,689,9136,93.0,60,16,26.7
5,All Students,2018-19,7734,367,7367,95.3,44,7,15.9
5,All Students,2019-20,6973,388,6585,94.4,61,9,14.8
5,All Students,2020-21,12259,862,11397,93.0,73,18,24.7
5,All Students,2021-22,13325,1041,12284,92.2,76,23,30.3
5,All Students,2022-23,10169,814,9355,92.0,61,21,34.4
All Grades,All Students,2018-19,93326,18036,75290,80.7,614,256,41.7
All Grades,All Students,2019-20,55689,13000,42689,76.7,533,259,48.6
All Grades,All Students,2020-21,81976,20640,61336,74.8,486,249,51.2
All Grades,All Students,2021-22,62003,14881,47122,76.0,413,267,64.6
All Grades,All Students,2022-23,53352,8945,44407,83.2,362,167,46.1
9,All Students,2018-19,26580,4053,22527,84.8,188,83,44.1
9,All Students,2019-20,13592,2188,11404,83.9,139,65,46.8
9,All Students,2020-21,13848,1286,12562,90.7,84,24,28.6
9,All Students,2021-22,13257,1951,11306,85.3,104,55,52.9
9,All Students,2022-23,13187,1497,11690,88.6,101,39,38.6
10,All Students,2018-19,21882,4132,17750,81.1,152,75,49.3
10,All Students,2019-20,14677,2951,11726,79.9,153,83,54.2
10,All Students,2020-21,20983,3659,17324,82.6,122,51,41.8
10,All Students,2021-22,14162,2319,11843,83.6,94,50,53.2
10,All Students,2022-23,12539,2593,9946,79.3,84,40,47.6
11,All Students,2018-19,19977,4558,15419,77.2,128,54,42.2
11,All Students,2019-20,13291,2964,10327,77.7,125,60,48.0
11,All Students,2020-21,19414,6454,12960,66.8,117,81,69.2
11,All Students,2021-22,17105,4104,13001,76.0,106,75,70.8
11,All Students,2022-23,11313,1951,9362,82.8,75,41,54.7
12,All Students,2018-19,24887,5293,19594,78.7,146,44,30.1
12,All Students,2019-20,14129,4897,9232,65.3,116,51,44.0
12,All Students,2020-21,27731,9241,18490,66.7,163,93,57.1
12,All Students,2021-22,17479,6507,10972,62.8,109,87,79.8
12,All Students,2022-23,16313,2904,13409,82.2,102,47,46.1
All Grades,All Students,2018-19,36139,6281,29858,82.6,231,120,51.9
All Grades,All Students,2019-20,20324,3457,16867,83.0,209,99,47.4
All Grades,All Students,2020-21,26662,3802,22860,85.7,167,52,31.1
All Grades,All Students,2021-22,25291,3441,21850,86.4,183,90,49.2
All Grades,All Students,2022-23,21943,2711,19232,87.6,152,69,45.4
9,All Students,2018-19,8439,1760,6679,79.1,61,37,60.7
9,All Students,2019-20,3605,678,2927,81.2,40,22,55.0
9,All Students,2020-21,4829,651,4178,86.5,34,8,23.5
9,All Students,2021-22,7756,852,6904,89.0,62,22,35.5
9,All Students,2022-23,6216,903,5313,85.5,45,17,37.8
10,All Students,2018-19,10252,2060,8192,79.9,64,35,54.7
10,All Students,2019-20,5649,1201,4448,78.7,59,25,42.4
10,All Students,2020-21,8110,1517,6593,81.3,49,20,40.8
10,All Students,2021-22,7357,809,6548,89.0,52,25,48.1
10,All Students,2022-23,6888,821,6067,88.1,52,26,50.0
11,All Students,2018-19,7900,749,7151,90.5,49,19,38.8
11,All Students,2019-20,5197,626,4571,88.0,52,22,42.3
11,All Students,2020-21,6115,687,5428,88.8,38,11,28.9
11,All Students,2021-22,2923,529,2394,81.9,22,12,54.5
11,All Students,2022-23,5235,498,4737,90.5,33,13,39.4
12,All Students,2018-19,9548,1712,7836,82.1,57,29,50.9
12,All Students,2019-20,5873,952,4921,83.8,58,30,51.7
12,All Students,2020-21,7608,947,6661,87.6,46,13,28.3
12,All Students,2021-22,7255,1251,6004,82.8,47,31,66.0
12,All Students,2022-23,3604,489,3115,86.4,22,13,59.1
All Grades,All Students,2018-19,153501,16320,137181,89.4,935,314,33.6
All Grades,All Students,2019-20,101892,8902,92990,91.3,938,273,29.1
All Grades,All Students,2020-21,166055,19709,146346,88.1,959,335,34.9
All Grades,All Students,2021-22,162077,22220,139857,86.3,972,454,46.7
All Grades,All Students,2022-23,150010,17343,132667,88.4,941,376,40.0
9,All Students,2018-19,46409,3810,42599,91.8,281,55,19.6
9,All Students,2019-20,30671,2091,28580,93.2,281,56,19.9
9,All Students,2020-21,42400,4666,37734,89.0,247,79,32.0
9,All Students,2021-22,42800,4008,38792,90.6,257,82,31.9
9,All Students,2022-23,38787,3777,35010,90.3,240,78,32.5
10,All Students,2018-19,44407,5045,39362,88.6,274,95,34.7
10,All Students,2019-20,26784,2011,24773,92.5,248,60,24.2
10,All Students,2020-21,45054,5409,39645,88.0,258,85,32.9
10,All Students,2021-22,39633,4717,34916,88.1,238,95,39.9
10,All Students,2022-23,40170,4652,35518,88.4,253,92,36.4
11,All Students,2018-19,31010,3024,27986,90.2,190,67,35.3
11,All Students,2019-20,23604,2321,21283,90.2,219,67,30.6
11,All Students,2020-21,40877,4421,36456,89.2,238,80,33.6
11,All Students,2021-22,40487,5458,35029,86.5,244,119,48.8
11,All Students,2022-23,35483,3872,31611,89.1,218,79,36.2
12,All Students,2018-19,31675,4441,27234,86.0,190,97,51.1
12,All Students,2019-20,20833,2479,18354,88.1,190,90,47.4
12,All Students,2020-21,37724,5213,32511,86.2,216,91,42.1
12,All Students,2021-22,39157,8037,31120,79.5,233,158,67.8
12,All Students,2022-23,35570,5042,30528,85.8,230,127,55.2
All Grades,All Students,2018-19,198899,29145,169754,85.3,1265,545,43.1
All Grades,All Students,2019-20,134977,18342,116635,86.4,1263,497,39.4
All Grades,All Students,2020-21,221077,50769,170308,77.0,1325,851,64.2
All Grades,All Students,2021-22,226764,49411,177353,78.2,1377,867,63.0
All Grades,All Students,2022-23,227901,41007,186894,82.0,1443,834,57.8
9,All Students,2018-19,53473,5835,47638,89.1,343,112,32.7
9,All Students,2019-20,39241,3603,35638,90.8,368,98,26.6
9,All Students,2020-21,60340,10354,49986,82.8,360,160,44.4
9,All Students,2021-22,62933,10409,52524,83.5,385,202,52.5
9,All Students,2022-23,60045,8420,51625,86.0,385,169,43.9
10,All Students,2018-19,50789,7525,43264,85.2,331,135,40.8
10,All Students,2019-20,35537,4498,31039,87.3,340,137,40.3
10,All Students,2020-21,61341,12640,48701,79.4,368,238,64.7
10,All Students,2021-22,58986,10996,47990,81.4,364,208,57.1
10,All Students,2022-23,60838,11618,49220,80.9,385,208,54.0
11,All Students,2018-19,49364,6887,42477,86.0,314,128,40.8
11,All Students,2019-20,31169,4920,26249,84.2,290,124,42.8
11,All Students,2020-21,53701,13695,40006,74.5,317,196,61.8
11,All Students,2021-22,56506,11413,45093,79.8,341,207,60.7
11,All Students,2022-23,55930,9530,46400,83.0,356,212,59.6
12,All Students,2018-19,45273,8898,36375,80.3,277,170,61.4
12,All Students,2019-20,29030,5321,23709,81.7,266,138,51.9
12,All Students,2020-21,45695,14080,31615,69.2,280,257,91.8
12,All Students,2021-22,48339,16593,31746,65.7,287,250,87.1
12,All Students,2022-23,51088,11439,39649,77.6,317,245,77.3
All Grades,All Students,2018-19,22347,3197,19150,85.7,145,78,53.8
All Grades,All Students,2019-20,12707,1807,10900,85.8,126,66,52.4
All Grades,All Students,2020-21,17578,2031,15547,88.4,110,45,40.9
All Grades,All Students,2021-22,16646,3053,13593,81.7,105,73,69.5
All Grades,All Students,2022-23,15076,1627,13449,89.2,94,42,44.7
PK in K-12 Schools,All Students,2018-19,1823,405,1418,77.8,14,10,71.4
PK in K-12 Schools,All Students,2019-20,554,s,s,s,s,s,s
PK in K-12 Schools,All Students,2020-21,2034,70,1964,96.6,14,3,21.4
PK in K-12 Schools,All Students,2021-22,2036,523,1513,74.3,13,12,92.3
0K,All Students,2018-19,2828,440,2388,84.4,19,12,63.2
0K,All Students,2019-20,2181,425,1756,80.5,22,14,63.6
0K,All Students,2020-21,2532,305,2227,88.0,18,11,61.1
0K,All Students,2021-22,3037,574,2463,81.1,21,16,76.2
1,All Students,2018-19,1615,332,1283,79.4,12,9,75.0
1,All Students,2019-20,1927,292,1635,84.8,19,12,63.2
1,All Students,2020-21,3912,539,3373,86.2,23,11,47.8
1,All Students,2021-22,2830,545,2285,80.7,17,13,76.5
1,All Students,2022-23,2178,251,1927,88.5,13,6,46.2
2,All Students,2018-19,2363,411,1952,82.6,15,9,60.0
2,All Students,2019-20,812,s,s,s,s,s,s
2,All Students,2020-21,2967,364,2603,87.7,19,8,42.1
2,All Students,2021-22,3692,554,3138,85.0,22,12,54.5
2,All Students,2022-23,2013,335,1678,83.4,13,9,69.2
3,All Students,2018-19,3075,405,2670,86.8,19,10,52.6
3,All Students,2019-20,1412,174,1238,87.7,13,7,53.8
3,All Students,2020-21,1399,82,1317,94.1,8,2,25.0
3,All Students,2021-22,2304,341,1963,85.2,16,11,68.8
3,All Students,2022-23,2531,308,2223,87.8,16,7,43.8
4,All Students,2018-19,6324,774,5550,87.8,40,19,47.5
4,All Students,2019-20,1908,211,1697,88.9,18,9,50.0
4,All Students,2020-21,2100,347,1753,83.5,12,7,58.3
4,All Students,2021-22,1126,237,889,79.0,7,4,57.1
4,All Students,2022-23,1997,199,1798,90.0,13,7,53.8
5,All Students,2018-19,4319,430,3889,90.0,26,9,34.6
5,All Students,2019-20,3913,495,3418,87.3,35,15,42.9
5,All Students,2020-21,2634,324,2310,87.7,16,3,18.8
5,All Students,2021-22,1621,279,1342,82.8,9,5,55.6
5,All Students,2022-23,1062,103,959,90.3,6,3,50.0
6,All Students,2022-23,5295,431,4864,91.9,33,10,30.3
All Grades,All Students,2018-19,112419,4523,107896,96.0,676,53,7.8
All Grades,All Students,2019-20,75198,2970,72228,96.1,686,66,9.6
All Grades,All Students,2020-21,120508,544,119964,99.5,692,0,0.0
All Grades,All Students,2021-22,113779,8795,104984,92.3,676,172,25.4
All Grades,All Students,2022-23,118599,10120,108479,91.5,724,187,25.8
9,All Students,2018-19,29096,776,28320,97.3,176,7,4.0
9,All Students,2019-20,19629,587,19042,97.0,179,12,6.7
9,All Students,2020-21,30522,189,30333,99.4,175,0,0.0
9,All Students,2021-22,27603,1264,26339,95.4,165,21,12.7
9,All Students,2022-23,33938,2475,31463,92.7,208,41,19.7
10,All Students,2018-19,29730,770,28960,97.4,178,4,2.2
10,All Students,2019-20,19017,650,18367,96.6,174,8,4.6
10,All Students,2020-21,30473,128,30345,99.6,175,0,0.0
10,All Students,2021-22,29001,1589,27412,94.5,172,20,11.6
10,All Students,2022-23,29085,1798,27287,93.8,177,27,15.3
11,All Students,2018-19,27316,1198,26118,95.6,164,16,9.8
11,All Students,2019-20,19370,578,18792,97.0,176,10,5.7
11,All Students,2020-21,29401,91,29310,99.7,169,0,0.0
11,All Students,2021-22,29312,1886,27426,93.6,175,32,18.3
11,All Students,2022-23,27518,1891,25627,93.1,169,31,18.3
12,All Students,2018-19,26277,1779,24498,93.2,158,26,16.5
12,All Students,2019-20,17182,1155,16027,93.3,157,36,22.9
12,All Students,2020-21,30112,136,29976,99.5,173,0,0.0
12,All Students,2021-22,27863,4056,23807,85.4,164,99,60.4
12,All Students,2022-23,28058,3956,24102,85.9,170,88,51.8
All Grades,All Students,2022-23,30187,4929,25258,83.7,184,112,60.9
PK in K-12 Schools,All Students,2022-23,30167,s,s,s,s,s,s
0K,All Students,2022-23,20,s,s,s,s,s,s
All Grades,All Students,2018-19,93978,4191,89787,95.5,538,71,13.2
All Grades,All Students,2019-20,61777,2975,58802,95.2,542,78,14.4
All Grades,All Students,2020-21,88455,2886,85569,96.7,528,48,9.1
All Grades,All Students,2021-22,82143,9388,72755,88.6,478,208,43.5
All Grades,All Students,2022-23,79536,6893,72643,91.3,484,151,31.2
6,All Students,2018-19,33112,1321,31791,96.0,189,20,10.6
6,All Students,2019-20,21041,1156,19885,94.5,185,31,16.8
6,All Students,2020-21,29278,1113,28165,96.2,176,22,12.5
6,All Students,2021-22,23928,3253,20675,86.4,140,75,53.6
6,All Students,2022-23,24363,2163,22200,91.1,151,51,33.8
7,All Students,2018-19,30920,1240,29680,96.0,177,16,9.0
7,All Students,2019-20,20670,849,19821,95.9,182,21,11.5
7,All Students,2020-21,29069,1031,28038,96.5,173,17,9.8
7,All Students,2021-22,28537,3010,25527,89.5,167,65,38.9
7,All Students,2022-23,26042,2186,23856,91.6,158,47,29.7
8,All Students,2018-19,29946,1630,28316,94.6,172,35,20.3
8,All Students,2019-20,20066,970,19096,95.2,175,26,14.9
8,All Students,2020-21,30108,742,29366,97.5,179,9,5.0
8,All Students,2021-22,29678,3125,26553,89.5,171,68,39.8
8,All Students,2022-23,29131,2544,26587,91.3,175,53,30.3
All Grades,All Students,2018-19,60888,2926,57962,95.2,349,41,11.7
All Grades,All Students,2019-20,41919,1996,39923,95.2,370,47,12.7
All Grades,All Students,2020-21,63248,3329,59919,94.7,365,45,12.3
All Grades,All Students,2021-22,63206,6066,57140,90.4,360,117,32.5
All Grades,All Students,2022-23,57927,4513,53414,92.2,340,86,25.3
6,All Students,2018-19,22681,992,21689,95.6,129,9,7.0
6,All Students,2019-20,15022,737,14285,95.1,131,14,10.7
6,All Students,2020-21,22032,1003,21029,95.4,127,13,10.2
6,All Students,2021-22,22057,2139,19918,90.3,126,47,37.3
6,All Students,2022-23,17927,1296,16631,92.8,105,21,20.0
7,All Students,2018-19,19038,804,18234,95.8,111,16,14.4
7,All Students,2019-20,14491,565,13926,96.1,128,14,10.9
7,All Students,2020-21,21161,902,20259,95.7,122,11,9.0
7,All Students,2021-22,20457,1800,18657,91.2,117,30,25.6
7,All Students,2022-23,20178,1479,18699,92.7,119,28,23.5
8,All Students,2018-19,19169,1130,18039,94.1,109,16,14.7
8,All Students,2019-20,12405,s,s,s,s,s,s
8,All Students,2020-21,20055,1424,18631,92.9,116,21,18.1
8,All Students,2021-22,20692,2127,18565,89.7,117,40,34.2
8,All Students,2022-23,19822,1738,18084,91.2,116,37,31.9
9,All Students,2019-20,1,s,s,s,s,s,s
All Grades,All Students,2022-23,77966,9888,68078,87.3,454,253,55.7
PK in K-12 Schools,All Students,2022-23,77957,s,s,s,s,s,s
0K,All Students,2022-23,9,s,s,s,s,s,s
All Grades,All Students,2018-19,7145,555,6590,92.2,55,13,23.6
All Grades,All Students,2019-20,11377,662,10715,94.2,106,17,16.0
All Grades,All Students,2020-21,26123,2816,23307,89.2,154,40,26.0
All Grades,All Students,2021-22,29391,2618,26773,91.1,177,46,26.0
All Grades,All Students,2022-23,35319,2207,33112,93.8,214,44,20.6
PK in K-12 Schools,All Students,2018-19,2073,211,1862,89.8,22,7,31.8
PK in K-12 Schools,All Students,2019-20,1990,130,1860,93.5,19,5,26.3
PK in K-12 Schools,All Students,2020-21,3111,336,2775,89.2,18,6,33.3
PK in K-12 Schools,All Students,2021-22,3114,233,2881,92.5,18,3,16.7
PK in K-12 Schools,All Students,2022-23,3162,303,2859,90.4,18,6,33.3
0K,All Students,2018-19,5072,344,4728,93.2,33,6,18.2
0K,All Students,2019-20,7276,386,6890,94.7,68,8,11.8
0K,All Students,2020-21,10179,1198,8981,88.2,61,21,34.4
0K,All Students,2021-22,7245,853,6392,88.2,44,16,36.4
0K,All Students,2022-23,8831,584,8247,93.4,54,12,22.2
1,All Students,2019-20,2111,146,1965,93.1,19,4,21.1
1,All Students,2020-21,10594,1032,9562,90.3,62,11,17.7
1,All Students,2021-22,9911,962,8949,90.3,61,17,27.9
1,All Students,2022-23,6823,545,6278,92.0,42,16,38.1
2,All Students,2020-21,2239,250,1989,88.8,13,2,15.4
2,All Students,2021-22,7465,445,7020,94.0,43,8,18.6
2,All Students,2022-23,8631,412,8219,95.2,51,6,11.8
3,All Students,2021-22,1656,125,1531,92.5,11,2,18.2
3,All Students,2022-23,6236,273,5963,95.6,39,3,7.7
4,All Students,2022-23,1636,90,1546,94.5,10,1,10.0
All Grades,All Students,2022-23,9790,1022,8768,89.6,60,26,43.3
PK in K-12 Schools,All Students,2022-23,5526,632,4894,88.6,33,18,54.5
0K,All Students,2022-23,4264,390,3874,90.9,27,8,29.6
All Grades,All Students,2018-19,39107,5288,33819,86.5,243,122,50.2
All Grades,All Students,2019-20,27792,3396,24396,87.8,262,122,46.6
All Grades,All Students,2020-21,34527,2185,32342,93.7,218,51,23.4
All Grades,All Students,2021-22,40382,6636,33746,83.6,261,168,64.4
All Grades,All Students,2022-23,40090,5547,34543,86.2,248,124,50.0
PK in K-12 Schools,All Students,2018-19,9397,1636,7761,82.6,56,32,57.1
PK in K-12 Schools,All Students,2019-20,7326,1007,6319,86.3,69,43,62.3
PK in K-12 Schools,All Students,2020-21,6564,346,6218,94.7,46,8,17.4
PK in K-12 Schools,All Students,2021-22,10086,1709,8377,83.1,67,48,71.6
PK in K-12 Schools,All Students,2022-23,8359,1258,7101,85.0,52,29,55.8
0K,All Students,2018-19,5134,685,4449,86.7,35,23,65.7
0K,All Students,2019-20,3279,595,2684,81.9,33,21,63.6
0K,All Students,2020-21,6686,430,6256,93.6,44,9,20.5
0K,All Students,2021-22,5680,1144,4536,79.9,35,26,74.3
0K,All Students,2022-23,6165,846,5319,86.3,42,23,54.8
1,All Students,2018-19,6388,1206,5182,81.1,42,30,71.4
1,All Students,2019-20,2975,342,2633,88.5,29,15,51.7
1,All Students,2020-21,4594,464,4130,89.9,28,13,46.4
1,All Students,2021-22,7235,1001,6234,86.2,44,24,54.5
1,All Students,2022-23,4646,798,3848,82.8,29,16,55.2
2,All Students,2018-19,3135,330,2805,89.5,19,5,26.3
2,All Students,2019-20,3878,577,3301,85.1,36,21,58.3
2,All Students,2020-21,3594,102,3492,97.2,22,3,13.6
2,All Students,2021-22,4228,695,3533,83.6,25,16,64.0
2,All Students,2022-23,6306,837,5469,86.7,37,21,56.8
3,All Students,2018-19,5540,665,4875,88.0,33,16,48.5
3,All Students,2019-20,2128,198,1930,90.7,20,8,40.0
3,All Students,2020-21,5375,439,4936,91.8,32,10,31.3
3,All Students,2021-22,5076,907,4169,82.1,35,24,68.6
3,All Students,2022-23,4971,560,4411,88.7,30,10,33.3
4,All Students,2018-19,5962,442,5520,92.6,37,9,24.3
4,All Students,2019-20,3733,433,3300,88.4,35,11,31.4
4,All Students,2020-21,2979,118,2861,96.0,17,3,17.6
4,All Students,2021-22,4631,830,3801,82.1,30,21,70.0
4,All Students,2022-23,4966,609,4357,87.7,30,13,43.3
5,All Students,2018-19,3551,324,3227,90.9,21,7,33.3
5,All Students,2019-20,4473,244,4229,94.5,40,3,7.5
5,All Students,2020-21,4735,286,4449,94.0,29,5,17.2
5,All Students,2021-22,3446,350,3096,89.8,25,9,36.0
5,All Students,2022-23,4677,639,4038,86.3,28,12,42.9
All Grades,All Students,2018-19,102029,9593,92436,90.6,597,221,37.0
All Grades,All Students,2019-20,65353,5482,59871,91.6,586,197,33.6
All Grades,All Students,2020-21,93124,9554,83570,89.7,554,186,33.6
All Grades,All Students,2021-22,86107,10791,75316,87.5,520,278,53.5
All Grades,All Students,2022-23,83246,10946,72300,86.9,489,263,53.8
PK in K-12 Schools,All Students,2018-19,14497,1842,12655,87.3,88,45,51.1
PK in K-12 Schools,All Students,2019-20,11097,1100,9997,90.1,102,41,40.2
PK in K-12 Schools,All Students,2020-21,15446,2204,13242,85.7,97,45,46.4
PK in K-12 Schools,All Students,2021-22,15351,2438,12913,84.1,97,60,61.9
PK in K-12 Schools,All Students,2022-23,17219,2984,14235,82.7,104,70,67.3
0K,All Students,2018-19,13065,1189,11876,90.9,76,27,35.5
0K,All Students,2019-20,8497,810,7687,90.5,76,34,44.7
0K,All Students,2020-21,12507,952,11555,92.4,77,21,27.3
0K,All Students,2021-22,11870,1688,10182,85.8,73,47,64.4
0K,All Students,2022-23,9662,1316,8346,86.4,55,30,54.5
1,All Students,2018-19,12951,1206,11745,90.7,75,34,45.3
1,All Students,2019-20,8750,699,8051,92.0,79,25,31.6
1,All Students,2020-21,12556,1103,11453,91.2,75,17,22.7
1,All Students,2021-22,10282,1255,9027,87.8,62,29,46.8
1,All Students,2022-23,10766,1481,9285,86.2,62,35,56.5
2,All Students,2018-19,13601,1297,12304,90.5,81,31,38.3
2,All Students,2019-20,8121,631,7490,92.2,73,28,38.4
2,All Students,2020-21,13306,1439,11867,89.2,76,30,39.5
2,All Students,2021-22,10990,1157,9833,89.5,65,31,47.7
2,All Students,2022-23,10959,1207,9752,89.0,65,28,43.1
3,All Students,2018-19,14337,1045,13292,92.7,83,21,25.3
3,All Students,2019-20,9230,763,8467,91.7,83,23,27.7
3,All Students,2020-21,12145,s,s,s,s,s,s
3,All Students,2021-22,11614,1100,10514,90.5,71,26,36.6
3,All Students,2022-23,11295,1345,9950,88.1,65,34,52.3
4,All Students,2018-19,17531,1563,15968,91.1,101,31,30.7
4,All Students,2019-20,8964,593,8371,93.4,80,17,21.3
4,All Students,2020-21,13896,1459,12437,89.5,80,29,36.3
4,All Students,2021-22,11831,1421,10410,88.0,69,36,52.2
4,All Students,2022-23,11935,1236,10699,89.6,71,31,43.7
5,All Students,2018-19,16047,1451,14596,91.0,93,32,34.4
5,All Students,2019-20,10694,886,9808,91.7,93,29,31.2
5,All Students,2020-21,13101,1129,11972,91.4,77,18,23.4
5,All Students,2021-22,14169,1732,12437,87.8,83,49,59.0
5,All Students,2022-23,11410,1377,10033,87.9,67,35,52.2
6,All Students,2020-21,167,s,s,s,s,s,s
All Grades,All Students,2018-19,14053,1959,12094,86.1,100,48,48.0
All Grades,All Students,2019-20,8053,809,7244,90.0,79,32,40.5
All Grades,All Students,2020-21,10311,1275,9036,87.6,67,25,37.3
All Grades,All Students,2021-22,12590,1735,10855,86.2,90,51,56.7
All Grades,All Students,2022-23,11009,1359,9650,87.7,74,37,50.0
PK in K-12 Schools,All Students,2018-19,1265,207,1058,83.6,10,8,80.0
PK in K-12 Schools,All Students,2019-20,1006,74,932,92.6,11,5,45.5
PK in K-12 Schools,All Students,2020-21,1050,s,s,s,s,s,s
PK in K-12 Schools,All Students,2021-22,1113,201,912,81.9,10,7,70.0
PK in K-12 Schools,All Students,2022-23,1884,307,1577,83.7,15,9,60.0
0K,All Students,2018-19,1508,315,1193,79.1,11,8,72.7
0K,All Students,2019-20,1275,170,1105,86.7,12,8,66.7
0K,All Students,2020-21,1576,112,1464,92.9,12,3,25.0
0K,All Students,2021-22,1918,247,1671,87.1,15,10,66.7
0K,All Students,2022-23,1441,256,1185,82.2,10,9,90.0
1,All Students,2018-19,1913,312,1601,83.7,12,6,50.0
1,All Students,2019-20,900,s,s,s,s,s,s
1,All Students,2020-21,2195,235,1960,89.3,15,7,46.7
1,All Students,2021-22,2081,175,1906,91.6,15,7,46.7
1,All Students,2022-23,1352,126,1226,90.7,10,3,30.0
2,All Students,2018-19,2823,354,2469,87.5,23,9,39.1
2,All Students,2019-20,1093,148,945,86.5,10,4,40.0
2,All Students,2020-21,755,s,s,s,s,s,s
2,All Students,2021-22,2775,414,2361,85.1,17,11,64.7
2,All Students,2022-23,1124,66,1058,94.1,8,1,12.5
3,All Students,2018-19,1937,265,1672,86.3,12,6,50.0
3,All Students,2019-20,920,s,s,s,s,s,s
3,All Students,2020-21,1750,370,1380,78.9,10,5,50.0
3,All Students,2021-22,1323,247,1076,81.3,8,4,50.0
3,All Students,2022-23,2604,322,2282,87.6,15,9,60.0
4,All Students,2018-19,2472,223,2249,91.0,18,4,22.2
4,All Students,2019-20,1132,109,1023,90.4,11,4,36.4
4,All Students,2020-21,1540,163,1377,89.4,9,2,22.2
4,All Students,2021-22,1904,227,1677,88.1,15,7,46.7
4,All Students,2022-23,1055,179,876,83.0,6,4,66.7
5,All Students,2018-19,2135,283,1852,86.7,14,7,50.0
5,All Students,2019-20,1727,132,1595,92.4,16,4,25.0
5,All Students,2020-21,1445,152,1293,89.5,9,4,44.4
5,All Students,2021-22,1476,224,1252,84.8,10,5,50.0
5,All Students,2022-23,1549,103,1446,93.4,10,2,20.0
All Grades,All Students,2018-19,46929,5310,41619,88.7,286,122,42.7
All Grades,All Students,2019-20,27024,2720,24304,89.9,256,87,34.0
All Grades,All Students,2020-21,36716,5756,30960,84.3,220,102,46.4
All Grades,All Students,2021-22,33379,4475,28904,86.6,205,111,54.1
All Grades,All Students,2022-23,33622,3503,30119,89.6,213,96,45.1
PK in K-12 Schools,All Students,2018-19,5627,779,4848,86.2,33,16,48.5
PK in K-12 Schools,All Students,2019-20,3315,387,2928,88.3,31,14,45.2
PK in K-12 Schools,All Students,2020-21,5655,1128,4527,80.1,34,19,55.9
PK in K-12 Schools,All Students,2021-22,5673,892,4781,84.3,35,23,65.7
PK in K-12 Schools,All Students,2022-23,5715,568,5147,90.1,35,14,40.0
0K,All Students,2018-19,4983,726,4257,85.4,33,21,63.6
0K,All Students,2019-20,2016,235,1781,88.3,20,9,45.0
0K,All Students,2020-21,4103,822,3281,80.0,26,18,69.2
0K,All Students,2021-22,4418,564,3854,87.2,27,12,44.4
0K,All Students,2022-23,5641,641,5000,88.6,34,18,52.9
1,All Students,2018-19,6026,807,5219,86.6,37,16,43.2
1,All Students,2019-20,3027,300,2727,90.1,31,11,35.5
1,All Students,2020-21,3104,437,2667,85.9,20,9,45.0
1,All Students,2021-22,4076,502,3574,87.7,27,16,59.3
1,All Students,2022-23,4531,490,4041,89.2,31,15,48.4
2,All Students,2018-19,3656,450,3206,87.7,25,12,48.0
2,All Students,2019-20,3616,415,3201,88.5,34,12,35.3
2,All Students,2020-21,4398,837,3561,81.0,28,14,50.0
2,All Students,2021-22,3156,400,2756,87.3,19,8,42.1
2,All Students,2022-23,3637,362,3275,90.0,25,10,40.0
3,All Students,2018-19,9604,882,8722,90.8,56,20,35.7
3,All Students,2019-20,3178,216,2962,93.2,30,6,20.0
3,All Students,2020-21,6228,976,5252,84.3,36,17,47.2
3,All Students,2021-22,4969,633,4336,87.3,30,19,63.3
3,All Students,2022-23,4013,397,3616,90.1,25,10,40.0
4,All Students,2018-19,10054,1003,9051,90.0,61,24,39.3
4,All Students,2019-20,5812,669,5143,88.5,56,19,33.9
4,All Students,2020-21,4387,399,3988,90.9,25,6,24.0
4,All Students,2021-22,5883,967,4916,83.6,36,21,58.3
4,All Students,2022-23,4900,558,4342,88.6,33,18,54.5
5,All Students,2018-19,6979,663,6316,90.5,41,13,31.7
5,All Students,2019-20,6060,498,5562,91.8,54,16,29.6
5,All Students,2020-21,8841,1157,7684,86.9,51,19,37.3
5,All Students,2021-22,5204,517,4687,90.1,31,12,38.7
5,All Students,2022-23,5185,487,4698,90.6,30,11,36.7
All Grades,All Students,2018-19,20468,2358,18110,88.5,136,69,50.7
All Grades,All Students,2019-20,9819,1127,8692,88.5,91,46,50.5
PK in K-12 Schools,All Students,2018-19,1788,226,1562,87.4,13,8,61.5
PK in K-12 Schools,All Students,2019-20,706,s,s,s,s,s,s
0K,All Students,2018-19,2221,329,1892,85.2,15,9,60.0
0K,All Students,2019-20,1106,172,934,84.4,11,8,72.7
1,All Students,2018-19,3209,365,2844,88.6,24,15,62.5
1,All Students,2019-20,1610,289,1321,82.0,14,12,85.7
2,All Students,2018-19,2266,220,2046,90.3,14,7,50.0
2,All Students,2019-20,1506,117,1389,92.2,13,4,30.8
3,All Students,2018-19,1712,217,1495,87.3,13,6,46.2
3,All Students,2019-20,941,78,863,91.7,9,4,44.4
4,All Students,2018-19,5196,572,4624,89.0,33,14,42.4
4,All Students,2019-20,542,s,s,s,s,s,s
5,All Students,2018-19,4076,429,3647,89.5,24,10,41.7
5,All Students,2019-20,3408,298,3110,91.3,31,11,35.5
All Grades,All Students,2018-19,40547,3735,36812,90.8,244,82,33.6
All Grades,All Students,2019-20,22778,2335,20443,89.7,208,70,33.7
All Grades,All Students,2020-21,32867,3133,29734,90.5,191,51,26.7
All Grades,All Students,2021-22,30459,3958,26501,87.0,184,97,52.7
All Grades,All Students,2022-23,33874,3347,30527,90.1,200,82,41.0
6,All Students,2018-19,10411,1139,9272,89.1,64,22,34.4
6,All Students,2019-20,6559,638,5921,90.3,61,20,32.8
6,All Students,2020-21,11362,987,10375,91.3,67,18,26.9
6,All Students,2021-22,9324,1094,8230,88.3,55,30,54.5
6,All Students,2022-23,10909,1066,9843,90.2,63,27,42.9
7,All Students,2018-19,13180,1305,11875,90.1,78,28,35.9
7,All Students,2019-20,7775,870,6905,88.8,72,25,34.7
7,All Students,2020-21,10658,926,9732,91.3,62,14,22.6
7,All Students,2021-22,11410,1467,9943,87.1,69,37,53.6
7,All Students,2022-23,10626,s,s,s,s,s,s
8,All Students,2018-19,16956,1291,15665,92.4,102,32,31.4
8,All Students,2019-20,8444,827,7617,90.2,75,25,33.3
8,All Students,2020-21,10847,1220,9627,88.8,62,19,30.6
8,All Students,2021-22,9725,1397,8328,85.6,60,30,50.0
8,All Students,2022-23,12327,1239,11088,89.9,74,33,44.6
9,All Students,2022-23,12,s,s,s,s,s,s
All Grades,All Students,2018-19,62803,6376,56427,89.8,382,152,39.8
All Grades,All Students,2019-20,44942,4172,40770,90.7,411,144,35.0
All Grades,All Students,2020-21,78734,5817,72917,92.6,472,129,27.3
All Grades,All Students,2021-22,77992,8867,69125,88.6,489,232,47.4
All Grades,All Students,2022-23,76927,8061,68866,89.5,470,166,35.3
PK in K-12 Schools,All Students,2018-19,9600,1416,8184,85.3,62,33,53.2
PK in K-12 Schools,All Students,2019-20,9341,1239,8102,86.7,89,49,55.1
PK in K-12 Schools,All Students,2020-21,14853,323,14530,97.8,89,1,1.1
PK in K-12 Schools,All Students,2021-22,13683,1566,12117,88.6,91,46,50.5
PK in K-12 Schools,All Students,2022-23,13831,1882,11949,86.4,87,45,51.7
0K,All Students,2018-19,8778,1113,7665,87.3,56,30,53.6
0K,All Students,2019-20,6078,553,5525,90.9,56,23,41.1
0K,All Students,2020-21,11381,1225,10156,89.2,70,32,45.7
0K,All Students,2021-22,11568,1470,10098,87.3,74,42,56.8
0K,All Students,2022-23,10172,1254,8918,87.7,64,24,37.5
1,All Students,2018-19,7281,801,6480,89.0,45,22,48.9
1,All Students,2019-20,5615,600,5015,89.3,51,19,37.3
1,All Students,2020-21,10678,883,9795,91.7,66,16,24.2
1,All Students,2021-22,11822,1446,10376,87.8,71,37,52.1
1,All Students,2022-23,12158,1297,10861,89.3,75,25,33.3
2,All Students,2018-19,8520,836,7684,90.2,52,24,46.2
2,All Students,2019-20,5394,504,4890,90.7,49,17,34.7
2,All Students,2020-21,11058,1159,9899,89.5,64,26,40.6
2,All Students,2021-22,10872,1143,9729,89.5,66,27,40.9
2,All Students,2022-23,10186,1135,9051,88.9,60,25,41.7
3,All Students,2018-19,10322,720,9602,93.0,60,15,25.0
3,All Students,2019-20,5758,393,5365,93.2,52,11,21.2
3,All Students,2020-21,10401,873,9528,91.6,63,25,39.7
3,All Students,2021-22,12134,1276,10858,89.5,76,29,38.2
3,All Students,2022-23,10584,941,9643,91.1,64,17,26.6
4,All Students,2018-19,9136,811,8325,91.1,54,15,27.8
4,All Students,2019-20,6407,380,6027,94.1,58,15,25.9
4,All Students,2020-21,9176,742,8434,91.9,54,18,33.3
4,All Students,2021-22,9520,1030,8490,89.2,59,25,42.4
4,All Students,2022-23,11275,952,10323,91.6,67,16,23.9
5,All Students,2018-19,9166,679,8487,92.6,53,13,24.5
5,All Students,2019-20,6349,503,5846,92.1,56,10,17.9
5,All Students,2020-21,11187,612,10575,94.5,66,11,16.7
5,All Students,2021-22,8393,936,7457,88.8,52,26,50.0
5,All Students,2022-23,8721,600,8121,93.1,53,14,26.4
All Grades,All Students,2018-19,28958,3402,25556,88.3,175,85,48.6
All Grades,All Students,2019-20,13688,1409,12279,89.7,131,52,39.7
All Grades,All Students,2020-21,17329,1879,15450,89.2,105,38,36.2
All Grades,All Students,2021-22,18507,3279,15228,82.3,111,66,59.5
All Grades,All Students,2022-23,17465,2735,14730,84.3,116,64,55.2
6,All Students,2018-19,6860,896,5964,86.9,41,22,53.7
6,All Students,2019-20,2873,296,2577,89.7,29,12,41.4
6,All Students,2020-21,6525,521,6004,92.0,39,13,33.3
6,All Students,2021-22,6924,1178,5746,83.0,41,25,61.0
6,All Students,2022-23,2823,408,2415,85.5,19,13,68.4
7,All Students,2018-19,10319,1019,9300,90.1,64,27,42.2
7,All Students,2019-20,4140,541,3599,86.9,39,19,48.7
7,All Students,2020-21,4782,645,4137,86.5,30,10,33.3
7,All Students,2021-22,6939,1231,5708,82.3,42,25,59.5
7,All Students,2022-23,7435,1071,6364,85.6,52,24,46.2
8,All Students,2018-19,11779,1487,10292,87.4,70,36,51.4
8,All Students,2019-20,6675,572,6103,91.4,63,21,33.3
8,All Students,2020-21,6022,713,5309,88.2,36,15,41.7
8,All Students,2021-22,4644,870,3774,81.3,28,16,57.1
8,All Students,2022-23,7207,1256,5951,82.6,45,27,60.0
All Grades,All Students,2018-19,52225,6854,45371,86.9,342,173,50.6
All Grades,All Students,2019-20,33282,3901,29381,88.3,322,142,44.1
All Grades,All Students,2020-21,46992,2996,43996,93.6,296,64,21.6
All Grades,All Students,2021-22,41903,7370,34533,82.4,282,202,71.6
All Grades,All Students,2022-23,37714,5072,32642,86.6,240,146,60.8
PK in K-12 Schools,All Students,2018-19,7805,1468,6337,81.2,52,34,65.4
PK in K-12 Schools,All Students,2019-20,5478,827,4651,84.9,54,34,63.0
PK in K-12 Schools,All Students,2020-21,6993,447,6546,93.6,47,9,19.1
PK in K-12 Schools,All Students,2021-22,8473,1460,7013,82.8,58,42,72.4
PK in K-12 Schools,All Students,2022-23,6131,864,5267,85.9,39,24,61.5
0K,All Students,2018-19,7524,1085,6439,85.6,53,31,58.5
0K,All Students,2019-20,4844,660,4184,86.4,46,21,45.7
0K,All Students,2020-21,5959,306,5653,94.9,39,6,15.4
0K,All Students,2021-22,3983,717,3266,82.0,27,21,77.8
0K,All Students,2022-23,6410,1029,5381,83.9,41,26,63.4
1,All Students,2018-19,7467,852,6615,88.6,49,26,53.1
1,All Students,2019-20,4891,583,4308,88.1,47,19,40.4
1,All Students,2020-21,7157,491,6666,93.1,45,14,31.1
1,All Students,2021-22,5210,993,4217,80.9,40,34,85.0
1,All Students,2022-23,3520,413,3107,88.3,25,15,60.0
2,All Students,2018-19,7507,855,6652,88.6,50,22,44.0
2,All Students,2019-20,4709,466,4243,90.1,45,14,31.1
2,All Students,2020-21,6880,576,6304,91.6,42,11,26.2
2,All Students,2021-22,5935,1384,4551,76.7,40,33,82.5
2,All Students,2022-23,4946,719,4227,85.5,30,20,66.7
3,All Students,2018-19,7181,s,s,s,s,s,s
3,All Students,2019-20,4261,388,3873,90.9,41,17,41.5
3,All Students,2020-21,7582,575,7007,92.4,47,13,27.7
3,All Students,2021-22,6417,1088,5329,83.0,43,27,62.8
3,All Students,2022-23,5122,720,4402,85.9,34,19,55.9
4,All Students,2018-19,7264,740,6524,89.8,47,18,38.3
4,All Students,2019-20,4291,490,3801,88.6,43,17,39.5
4,All Students,2020-21,6318,323,5995,94.9,37,5,13.5
4,All Students,2021-22,6253,875,5378,86.0,39,22,56.4
4,All Students,2022-23,6307,802,5505,87.3,38,24,63.2
5,All Students,2018-19,7473,872,6601,88.3,43,20,46.5
5,All Students,2019-20,4808,487,4321,89.9,46,20,43.5
5,All Students,2020-21,5773,261,5512,95.5,36,6,16.7
5,All Students,2021-22,5632,853,4779,84.9,35,23,65.7
5,All Students,2022-23,5278,525,4753,90.1,33,18,54.5
6,All Students,2018-19,4,s,s,s,s,s,s
6,All Students,2020-21,318,s,s,s,s,s,s
7,All Students,2020-21,12,s,s,s,s,s,s
All Grades,All Students,2018-19,43734,4928,38806,88.7,273,131,48.0
All Grades,All Students,2019-20,24970,2589,22381,89.6,231,94,40.7
All Grades,All Students,2020-21,32868,1190,31678,96.4,204,25,12.3
All Grades,All Students,2021-22,36492,5186,31306,85.8,235,131,55.7
All Grades,All Students,2022-23,31870,4357,27513,86.3,204,121,59.3
PK in K-12 Schools,All Students,2018-19,6098,1009,5089,83.5,39,28,71.8
PK in K-12 Schools,All Students,2019-20,3734,488,3246,86.9,35,20,57.1
PK in K-12 Schools,All Students,2020-21,4675,185,4490,96.0,32,6,18.8
PK in K-12 Schools,All Students,2021-22,6620,1137,5483,82.8,45,30,66.7
PK in K-12 Schools,All Students,2022-23,5464,1026,4438,81.2,38,26,68.4
0K,All Students,2018-19,5346,654,4692,87.8,34,18,52.9
0K,All Students,2019-20,2233,306,1927,86.3,23,14,60.9
0K,All Students,2020-21,3645,226,3419,93.8,25,5,20.0
0K,All Students,2021-22,4874,642,4232,86.8,31,15,48.4
0K,All Students,2022-23,4274,559,3715,86.9,28,15,53.6
1,All Students,2018-19,7245,935,6310,87.1,47,27,57.4
1,All Students,2019-20,3353,403,2950,88.0,30,11,36.7
1,All Students,2020-21,3523,141,3382,96.0,21,2,9.5
1,All Students,2021-22,4732,661,4071,86.0,30,16,53.3
1,All Students,2022-23,4411,609,3802,86.2,29,18,62.1
2,All Students,2018-19,5567,535,5032,90.4,35,15,42.9
2,All Students,2019-20,4226,397,3829,90.6,38,12,31.6
2,All Students,2020-21,5411,183,5228,96.6,33,5,15.2
2,All Students,2021-22,4461,607,3854,86.4,27,14,51.9
2,All Students,2022-23,4242,432,3810,89.8,27,14,51.9
3,All Students,2018-19,6669,746,5923,88.8,40,20,50.0
3,All Students,2019-20,2872,254,2618,91.2,27,9,33.3
3,All Students,2020-21,5565,166,5399,97.0,34,3,8.8
3,All Students,2021-22,4434,728,3706,83.6,31,20,64.5
3,All Students,2022-23,4245,592,3653,86.1,26,17,65.4
4,All Students,2018-19,7213,613,6600,91.5,44,16,36.4
4,All Students,2019-20,3951,359,3592,90.9,36,15,41.7
4,All Students,2020-21,4429,91,4338,97.9,26,1,3.8
4,All Students,2021-22,6696,869,5827,87.0,42,21,50.0
4,All Students,2022-23,3560,515,3045,85.5,23,14,60.9
5,All Students,2018-19,5596,436,5160,92.2,34,7,20.6
5,All Students,2019-20,4601,382,4219,91.7,42,13,31.0
5,All Students,2020-21,5620,198,5422,96.5,33,3,9.1
5,All Students,2021-22,4675,542,4133,88.4,29,15,51.7
5,All Students,2022-23,5674,624,5050,89.0,33,17,51.5
All Grades,All Students,2018-19,31653,3385,28268,89.3,195,83,42.6
All Grades,All Students,2019-20,18420,1888,16532,89.8,168,60,35.7
All Grades,All Students,2020-21,27528,3629,23899,86.8,167,74,44.3
All Grades,All Students,2021-22,28528,3652,24876,87.2,183,104,56.8
All Grades,All Students,2022-23,28561,3077,25484,89.2,176,75,42.6
PK in K-12 Schools,All Students,2018-19,5636,674,4962,88.0,32,16,50.0
PK in K-12 Schools,All Students,2019-20,3724,553,3171,85.2,33,17,51.5
PK in K-12 Schools,All Students,2020-21,5919,764,5155,87.1,38,20,52.6
PK in K-12 Schools,All Students,2021-22,7603,1125,6478,85.2,50,33,66.0
PK in K-12 Schools,All Students,2022-23,6606,743,5863,88.8,41,20,48.8
0K,All Students,2018-19,3698,337,3361,90.9,25,8,32.0
0K,All Students,2019-20,2111,207,1904,90.2,19,7,36.8
0K,All Students,2020-21,4219,684,3535,83.8,25,13,52.0
0K,All Students,2021-22,3507,434,3073,87.6,22,12,54.5
0K,All Students,2022-23,4376,505,3871,88.5,26,11,42.3
1,All Students,2018-19,3219,339,2880,89.5,20,8,40.0
1,All Students,2019-20,2219,171,2048,92.3,20,5,25.0
1,All Students,2020-21,3502,707,2795,79.8,21,15,71.4
1,All Students,2021-22,4220,527,3693,87.5,26,15,57.7
1,All Students,2022-23,3608,394,3214,89.1,23,9,39.1
2,All Students,2018-19,3697,565,3132,84.7,25,11,44.0
2,All Students,2019-20,1882,158,1724,91.6,17,5,29.4
2,All Students,2020-21,3854,462,3392,88.0,23,10,43.5
2,All Students,2021-22,3408,391,3017,88.5,22,10,45.5
2,All Students,2022-23,3690,435,3255,88.2,22,11,50.0
3,All Students,2018-19,3580,428,3152,88.0,23,13,56.5
3,All Students,2019-20,2348,294,2054,87.5,23,8,34.8
3,All Students,2020-21,2836,344,2492,87.9,18,5,27.8
3,All Students,2021-22,3860,436,3424,88.7,25,12,48.0
3,All Students,2022-23,3309,293,3016,91.1,20,8,40.0
4,All Students,2018-19,6130,505,5625,91.8,35,12,34.3
4,All Students,2019-20,2286,212,2074,90.7,22,11,50.0
4,All Students,2020-21,3599,345,3254,90.4,21,6,28.6
4,All Students,2021-22,2517,308,2209,87.8,16,9,56.3
4,All Students,2022-23,4071,304,3767,92.5,25,7,28.0
5,All Students,2018-19,5693,537,5156,90.6,35,15,42.9
5,All Students,2019-20,3850,293,3557,92.4,34,7,20.6
5,All Students,2020-21,3599,323,3276,91.0,21,5,23.8
5,All Students,2021-22,3413,431,2982,87.4,22,13,59.1
5,All Students,2022-23,2901,403,2498,86.1,19,9,47.4
All Grades,All Students,2018-19,42209,5423,36786,87.2,259,134,51.7
All Grades,All Students,2019-20,22919,2858,20061,87.5,210,110,52.4
All Grades,All Students,2020-21,34794,3241,31553,90.7,202,65,32.2
All Grades,All Students,2021-22,30444,4032,26412,86.8,189,100,52.9
All Grades,All Students,2022-23,27858,2977,24881,89.3,169,70,41.4
5,All Students,2021-22,33,s,s,s,s,s,s
6,All Students,2018-19,11415,s,s,s,s,s,s
6,All Students,2019-20,5625,s,s,s,s,s,s
6,All Students,2020-21,13343,1118,12225,91.6,78,24,30.8
6,All Students,2021-22,8781,s,s,s,s,s,s
6,All Students,2022-23,6505,604,5901,90.7,42,16,38.1
7,All Students,2018-19,15249,1988,13261,87.0,93,47,50.5
7,All Students,2019-20,7776,855,6921,89.0,68,34,50.0
7,All Students,2020-21,9184,s,s,s,s,s,s
7,All Students,2021-22,12369,1775,10594,85.6,79,42,53.2
7,All Students,2022-23,8873,867,8006,90.2,53,18,34.0
8,All Students,2018-19,15540,2175,13365,86.0,95,55,57.9
8,All Students,2019-20,9476,1385,8091,85.4,86,45,52.3
8,All Students,2020-21,12100,1627,10473,86.6,70,34,48.6
8,All Students,2021-22,9261,1247,8014,86.5,57,35,61.4
8,All Students,2022-23,12480,1506,10974,87.9,74,36,48.6
9,All Students,2018-19,5,s,s,s,s,s,s
9,All Students,2019-20,42,s,s,s,s,s,s
9,All Students,2020-21,167,s,s,s,s,s,s
All Grades,All Students,2018-19,43954,5361,38593,87.8,275,134,48.7
All Grades,All Students,2019-20,28050,3231,24819,88.5,272,121,44.5
All Grades,All Students,2020-21,44216,3178,41038,92.8,274,69,25.2
All Grades,All Students,2021-22,43122,5536,37586,87.2,277,147,53.1
All Grades,All Students,2022-23,37350,4520,32830,87.9,246,119,48.4
PK in K-12 Schools,All Students,2018-19,4371,721,3650,83.5,27,17,63.0
PK in K-12 Schools,All Students,2019-20,3922,637,3285,83.8,43,27,62.8
PK in K-12 Schools,All Students,2020-21,5725,308,5417,94.6,39,5,12.8
PK in K-12 Schools,All Students,2021-22,7120,859,6261,87.9,47,28,59.6
PK in K-12 Schools,All Students,2022-23,7369,1105,6264,85.0,49,29,59.2
0K,All Students,2018-19,2670,407,2263,84.8,17,11,64.7
0K,All Students,2019-20,2537,313,2224,87.7,22,10,45.5
0K,All Students,2020-21,3398,248,3150,92.7,22,6,27.3
0K,All Students,2021-22,4374,547,3827,87.5,29,14,48.3
0K,All Students,2022-23,2487,238,2249,90.4,15,5,33.3
1,All Students,2018-19,4306,624,3682,85.5,27,14,51.9
1,All Students,2019-20,1810,234,1576,87.1,18,8,44.4
1,All Students,2020-21,3742,309,3433,91.7,24,7,29.2
1,All Students,2021-22,3617,434,3183,88.0,21,11,52.4
1,All Students,2022-23,3679,410,3269,88.9,23,9,39.1
2,All Students,2018-19,4515,511,4004,88.7,31,16,51.6
2,All Students,2019-20,2777,345,2432,87.6,26,14,53.8
2,All Students,2020-21,3652,321,3331,91.2,23,8,34.8
2,All Students,2021-22,3210,s,s,s,s,s,s
2,All Students,2022-23,3035,294,2741,90.3,19,7,36.8
3,All Students,2018-19,3457,335,3122,90.3,21,9,42.9
3,All Students,2019-20,2677,257,2420,90.4,25,9,36.0
3,All Students,2020-21,4647,497,4150,89.3,29,13,44.8
3,All Students,2021-22,3430,613,2817,82.1,23,11,47.8
3,All Students,2022-23,3386,515,2871,84.8,24,14,58.3
4,All Students,2018-19,4900,472,4428,90.4,32,13,40.6
4,All Students,2019-20,2653,256,2397,90.4,24,9,37.5
4,All Students,2020-21,4580,310,4270,93.2,27,6,22.2
4,All Students,2021-22,3887,658,3229,83.1,24,14,58.3
4,All Students,2022-23,2493,268,2225,89.2,17,8,47.1
5,All Students,2018-19,3039,212,2827,93.0,18,4,22.2
5,All Students,2019-20,2973,281,2692,90.5,30,11,36.7
5,All Students,2020-21,4279,224,4055,94.8,25,4,16.0
5,All Students,2021-22,4935,484,4451,90.2,32,13,40.6
5,All Students,2022-23,3683,300,3383,91.9,24,9,37.5
6,All Students,2018-19,5074,517,4557,89.8,31,14,45.2
6,All Students,2019-20,2770,253,2517,90.9,26,10,38.5
6,All Students,2020-21,5169,291,4878,94.4,31,7,22.6
6,All Students,2021-22,4160,399,3761,90.4,27,14,51.9
6,All Students,2022-23,3585,492,3093,86.3,25,14,56.0
7,All Students,2018-19,4821,541,4280,88.8,30,15,50.0
7,All Students,2019-20,3324,320,3004,90.4,32,10,31.3
7,All Students,2020-21,3959,409,3550,89.7,25,8,32.0
7,All Students,2021-22,4904,597,4307,87.8,30,15,50.0
7,All Students,2022-23,3441,415,3026,87.9,21,12,57.1
8,All Students,2018-19,6801,1021,5780,85.0,41,21,51.2
8,All Students,2019-20,2607,335,2272,87.1,27,14,51.9
8,All Students,2020-21,5065,261,4804,94.8,29,5,17.2
8,All Students,2021-22,3470,400,3070,88.5,24,13,54.2
8,All Students,2022-23,4192,483,3709,88.5,29,12,41.4
9,All Students,2021-22,15,s,s,s,s,s,s
All Grades,All Students,2018-19,38386,3697,34689,90.4,251,94,37.5
All Grades,All Students,2019-20,23580,2382,21198,89.9,221,92,41.6
All Grades,All Students,2020-21,29512,3102,26410,89.5,177,56,31.6
All Grades,All Students,2021-22,30706,4812,25894,84.3,190,114,60.0
All Grades,All Students,2022-23,28618,3965,24653,86.1,185,108,58.4
PK in K-12 Schools,All Students,2018-19,8081,1058,7023,86.9,50,22,44.0
PK in K-12 Schools,All Students,2019-20,4982,608,4374,87.8,48,19,39.6
PK in K-12 Schools,All Students,2020-21,7123,494,6629,93.1,45,10,22.2
PK in K-12 Schools,All Students,2021-22,6155,933,5222,84.8,38,19,50.0
PK in K-12 Schools,All Students,2022-23,6715,1301,5414,80.6,43,32,74.4
0K,All Students,2018-19,5043,550,4493,89.1,43,20,46.5
0K,All Students,2019-20,3470,384,3086,88.9,32,16,50.0
0K,All Students,2020-21,3697,450,3247,87.8,23,9,39.1
0K,All Students,2021-22,5699,871,4828,84.7,37,22,59.5
0K,All Students,2022-23,4714,614,4100,87.0,31,19,61.3
1,All Students,2018-19,4148,392,3756,90.5,26,8,30.8
1,All Students,2019-20,2841,353,2488,87.6,26,14,53.8
1,All Students,2020-21,3508,405,3103,88.5,20,5,25.0
1,All Students,2021-22,3879,638,3241,83.6,23,12,52.2
1,All Students,2022-23,4417,493,3924,88.8,27,16,59.3
2,All Students,2018-19,4808,395,4413,91.8,32,10,31.3
2,All Students,2019-20,2777,280,2497,89.9,27,12,44.4
2,All Students,2020-21,3118,495,2623,84.1,18,8,44.4
2,All Students,2021-22,3737,676,3061,81.9,23,17,73.9
2,All Students,2022-23,2809,359,2450,87.2,18,9,50.0
3,All Students,2018-19,5617,494,5123,91.2,33,12,36.4
3,All Students,2019-20,2885,243,2642,91.6,29,12,41.4
3,All Students,2020-21,3771,531,3240,85.9,22,10,45.5
3,All Students,2021-22,3130,505,2625,83.9,20,13,65.0
3,All Students,2022-23,3098,394,2704,87.3,20,10,50.0
4,All Students,2018-19,6540,610,5930,90.7,41,17,41.5
4,All Students,2019-20,3449,310,3139,91.0,30,13,43.3
4,All Students,2020-21,3695,257,3438,93.0,22,5,22.7
4,All Students,2021-22,3836,682,3154,82.2,24,19,79.2
4,All Students,2022-23,3592,518,3074,85.6,25,16,64.0
5,All Students,2018-19,4149,198,3951,95.2,26,5,19.2
5,All Students,2019-20,3176,204,2972,93.6,29,6,20.7
5,All Students,2020-21,4600,470,4130,89.8,27,9,33.3
5,All Students,2021-22,4270,507,3763,88.1,25,12,48.0
5,All Students,2022-23,3273,286,2987,91.3,21,6,28.6
All Grades,All Students,2018-19,38974,3908,35066,90.0,240,104,43.3
All Grades,All Students,2019-20,24437,2414,22023,90.1,229,90,39.3
All Grades,All Students,2020-21,33984,4096,29888,87.9,207,83,40.1
All Grades,All Students,2021-22,33677,5556,28121,83.5,213,140,65.7
All Grades,All Students,2022-23,29565,4824,24741,83.7,183,115,62.8
PK in K-12 Schools,All Students,2018-19,2493,218,2275,91.3,15,7,46.7
PK in K-12 Schools,All Students,2019-20,2368,s,s,s,s,s,s
PK in K-12 Schools,All Students,2020-21,4529,549,3980,87.9,30,12,40.0
PK in K-12 Schools,All Students,2021-22,5046,955,4091,81.1,32,25,78.1
PK in K-12 Schools,All Students,2022-23,5129,1143,3986,77.7,32,25,78.1
0K,All Students,2018-19,4469,663,3806,85.2,27,17,63.0
0K,All Students,2019-20,3496,500,2996,85.7,31,17,54.8
0K,All Students,2020-21,4178,439,3739,89.5,26,10,38.5
0K,All Students,2021-22,4012,746,3266,81.4,26,20,76.9
0K,All Students,2022-23,3902,632,3270,83.8,25,17,68.0
1,All Students,2018-19,5020,542,4478,89.2,33,13,39.4
1,All Students,2019-20,2662,255,2407,90.4,31,12,38.7
1,All Students,2020-21,4927,520,4407,89.4,30,9,30.0
1,All Students,2021-22,4507,898,3609,80.1,29,19,65.5
1,All Students,2022-23,4202,730,3472,82.6,25,15,60.0
2,All Students,2018-19,7687,757,6930,90.2,47,17,36.2
2,All Students,2019-20,3289,307,2982,90.7,30,10,33.3
2,All Students,2020-21,4780,894,3886,81.3,29,18,62.1
2,All Students,2021-22,5270,865,4405,83.6,34,24,70.6
2,All Students,2022-23,4263,525,3738,87.7,27,14,51.9
3,All Students,2018-19,6394,668,5726,89.6,40,24,60.0
3,All Students,2019-20,4445,343,4102,92.3,42,14,33.3
3,All Students,2020-21,3908,488,3420,87.5,23,10,43.5
3,All Students,2021-22,4384,589,3795,86.6,27,16,59.3
3,All Students,2022-23,4150,566,3584,86.4,25,12,48.0
4,All Students,2018-19,6387,661,5726,89.7,39,18,46.2
4,All Students,2019-20,3841,380,3461,90.1,33,13,39.4
4,All Students,2020-21,6489,588,5901,90.9,38,11,28.9
4,All Students,2021-22,4167,818,3349,80.4,25,19,76.0
4,All Students,2022-23,4253,641,3612,84.9,25,15,60.0
5,All Students,2018-19,6524,399,6125,93.9,39,8,20.5
5,All Students,2019-20,4302,341,3961,92.1,39,12,30.8
5,All Students,2020-21,5173,618,4555,88.1,31,13,41.9
5,All Students,2021-22,6291,685,5606,89.1,40,17,42.5
5,All Students,2022-23,3666,587,3079,84.0,24,17,70.8
6,All Students,2019-20,34,s,s,s,s,s,s
All Grades,All Students,2018-19,71072,13044,58028,81.6,458,207,45.2
All Grades,All Students,2019-20,49014,11148,37866,77.3,474,246,51.9
All Grades,All Students,2020-21,77096,18851,58245,75.5,442,200,45.2
All Grades,All Students,2021-22,72272,15847,56425,78.1,467,229,49.0
All Grades,All Students,2022-23,61849,11563,50286,81.3,435,219,50.3
9,All Students,2018-19,20295,3012,17283,85.2,140,60,42.9
9,All Students,2019-20,18427,5181,13246,71.9,177,95,53.7
9,All Students,2020-21,21591,3868,17723,82.1,128,57,44.5
9,All Students,2021-22,22755,5040,17715,77.9,146,77,52.7
9,All Students,2022-23,13422,2570,10852,80.9,101,52,51.5
10,All Students,2018-19,18240,3846,14394,78.9,118,64,54.2
10,All Students,2019-20,11653,1721,9932,85.2,112,48,42.9
10,All Students,2020-21,21727,5912,15815,72.8,128,65,50.8
10,All Students,2021-22,19128,3842,15286,79.9,129,63,48.8
10,All Students,2022-23,20538,4930,15608,76.0,142,87,61.3
11,All Students,2018-19,18126,3448,14678,81.0,113,42,37.2
11,All Students,2019-20,8482,1248,7234,85.3,84,40,47.6
11,All Students,2020-21,17222,3150,14072,81.7,104,44,42.3
11,All Students,2021-22,16088,4021,12067,75.0,105,54,51.4
11,All Students,2022-23,15677,2520,13157,83.9,104,46,44.2
12,All Students,2018-19,14411,2738,11673,81.0,87,41,47.1
12,All Students,2019-20,10452,2998,7454,71.3,101,63,62.4
12,All Students,2020-21,16556,5921,10635,64.2,82,34,41.5
12,All Students,2021-22,14301,2944,11357,79.4,87,35,40.2
12,All Students,2022-23,12212,1543,10669,87.4,88,34,38.6
All Grades,All Students,2018-19,97101,18275,78826,81.2,610,276,45.2
All Grades,All Students,2019-20,62063,10306,51757,83.4,595,261,43.9
All Grades,All Students,2020-21,106207,25165,81042,76.3,609,280,46.0
All Grades,All Students,2021-22,95686,17741,77945,81.5,634,363,57.3
All Grades,All Students,2022-23,86145,13429,72716,84.4,583,301,51.6
9,All Students,2018-19,27336,3216,24120,88.2,173,62,35.8
9,All Students,2019-20,17110,2511,14599,85.3,173,82,47.4
9,All Students,2020-21,32126,6006,26120,81.3,192,84,43.8
9,All Students,2021-22,25185,3619,21566,85.6,174,82,47.1
9,All Students,2022-23,20353,3352,17001,83.5,150,67,44.7
10,All Students,2018-19,23020,2906,20114,87.4,150,53,35.3
10,All Students,2019-20,17884,2755,15129,84.6,174,72,41.4
10,All Students,2020-21,26585,6563,20022,75.3,155,78,50.3
10,All Students,2021-22,28168,4424,23744,84.3,187,91,48.7
10,All Students,2022-23,23159,3200,19959,86.2,157,80,51.0
11,All Students,2018-19,21931,3898,18033,82.2,143,64,44.8
11,All Students,2019-20,13645,1964,11681,85.6,133,49,36.8
11,All Students,2020-21,26168,6637,19531,74.6,151,80,53.0
11,All Students,2021-22,20219,3878,16341,80.8,135,84,62.2
11,All Students,2022-23,25072,3560,21512,85.8,163,77,47.2
12,All Students,2018-19,24814,8255,16559,66.7,144,97,67.4
12,All Students,2019-20,13424,3076,10348,77.1,115,57,49.6
12,All Students,2020-21,21328,5959,15369,72.1,111,38,34.2
12,All Students,2021-22,22114,5820,16294,73.7,138,106,76.8
12,All Students,2022-23,17561,3317,14244,81.1,113,77,68.1
All Grades,All Students,2018-19,57029,5551,51478,90.3,349,133,38.1
All Grades,All Students,2019-20,36463,3338,33125,90.8,337,123,36.5
All Grades,All Students,2020-21,53920,5516,48404,89.8,330,117,35.5
All Grades,All Students,2021-22,50736,5960,44776,88.3,322,137,42.5
All Grades,All Students,2022-23,51198,4784,46414,90.7,323,119,36.8
PK in K-12 Schools,All Students,2018-19,11554,1219,10335,89.4,69,22,31.9
PK in K-12 Schools,All Students,2019-20,7391,714,6677,90.3,67,21,31.3
PK in K-12 Schools,All Students,2020-21,10672,924,9748,91.3,63,15,23.8
PK in K-12 Schools,All Students,2021-22,11131,1241,9890,88.9,68,28,41.2
PK in K-12 Schools,All Students,2022-23,11509,990,10519,91.4,69,23,33.3
0K,All Students,2018-19,8733,795,7938,90.9,57,21,36.8
0K,All Students,2019-20,4798,512,4286,89.3,44,19,43.2
0K,All Students,2020-21,7645,882,6763,88.5,49,18,36.7
0K,All Students,2021-22,6168,713,5455,88.4,42,17,40.5
0K,All Students,2022-23,6725,716,6009,89.4,42,20,47.6
1,All Students,2018-19,6879,533,6346,92.3,43,13,30.2
1,All Students,2019-20,5547,514,5033,90.7,51,20,39.2
1,All Students,2020-21,7221,926,6295,87.2,45,19,42.2
1,All Students,2021-22,6709,839,5870,87.5,47,19,40.4
1,All Students,2022-23,6823,612,6211,91.0,44,16,36.4
2,All Students,2018-19,9161,1057,8104,88.5,56,27,48.2
2,All Students,2019-20,4847,396,4451,91.8,47,15,31.9
2,All Students,2020-21,7435,695,6740,90.7,45,18,40.0
2,All Students,2021-22,6749,796,5953,88.2,42,16,38.1
2,All Students,2022-23,6531,658,5873,89.9,43,16,37.2
3,All Students,2018-19,7723,815,6908,89.4,47,22,46.8
3,All Students,2019-20,4780,421,4359,91.2,43,17,39.5
3,All Students,2020-21,7207,370,6837,94.9,42,9,21.4
3,All Students,2021-22,6844,822,6022,88.0,42,14,33.3
3,All Students,2022-23,5888,477,5411,91.9,38,11,28.9
4,All Students,2018-19,7432,623,6809,91.6,45,14,31.1
4,All Students,2019-20,4506,428,4078,90.5,43,19,44.2
4,All Students,2020-21,7200,686,6514,90.5,46,18,39.1
4,All Students,2021-22,6041,s,s,s,s,s,s
4,All Students,2022-23,7559,790,6769,89.5,48,17,35.4
5,All Students,2018-19,5547,509,5038,90.8,32,14,43.8
5,All Students,2019-20,4594,353,4241,92.3,42,12,28.6
5,All Students,2020-21,6373,s,s,s,s,s,s
5,All Students,2021-22,7064,910,6154,87.1,44,27,61.4
5,All Students,2022-23,6163,541,5622,91.2,39,16,41.0
6,All Students,2020-21,167,s,s,s,s,s,s
6,All Students,2021-22,30,s,s,s,s,s,s
All Grades,All Students,2018-19,49928,3143,46785,93.7,295,54,18.3
All Grades,All Students,2019-20,33287,2027,31260,93.9,297,48,16.2
All Grades,All Students,2020-21,54881,2157,52724,96.1,327,35,10.7
All Grades,All Students,2021-22,53357,4983,48374,90.7,316,111,35.1
All Grades,All Students,2022-23,54744,4660,50084,91.5,320,98,30.6
PK in K-12 Schools,All Students,2018-19,6324,541,5783,91.4,37,10,27.0
PK in K-12 Schools,All Students,2019-20,3953,274,3679,93.1,36,6,16.7
PK in K-12 Schools,All Students,2020-21,5724,171,5553,97.0,35,2,5.7
PK in K-12 Schools,All Students,2021-22,6161,566,5595,90.8,38,13,34.2
PK in K-12 Schools,All Students,2022-23,6317,475,5842,92.5,36,8,22.2
0K,All Students,2018-19,9562,603,8959,93.7,58,11,19.0
0K,All Students,2019-20,6338,455,5883,92.8,58,13,22.4
0K,All Students,2020-21,10459,373,10086,96.4,65,6,9.2
0K,All Students,2021-22,8690,902,7788,89.6,53,19,35.8
0K,All Students,2022-23,10337,857,9480,91.7,63,20,31.7
1,All Students,2018-19,9241,533,8708,94.2,53,7,13.2
1,All Students,2019-20,5500,376,5124,93.2,48,9,18.8
1,All Students,2020-21,8698,598,8100,93.1,52,10,19.2
1,All Students,2021-22,8380,689,7691,91.8,50,14,28.0
1,All Students,2022-23,7859,773,7086,90.2,45,16,35.6
2,All Students,2018-19,9076,570,8506,93.7,52,9,17.3
2,All Students,2019-20,5635,305,5330,94.6,50,7,14.0
2,All Students,2020-21,7219,154,7065,97.9,42,2,4.8
2,All Students,2021-22,7933,830,7103,89.5,46,22,47.8
2,All Students,2022-23,8181,613,7568,92.5,49,13,26.5
3,All Students,2018-19,6980,492,6488,93.0,43,12,27.9
3,All Students,2019-20,5223,276,4947,94.7,46,6,13.0
3,All Students,2020-21,8822,294,8528,96.7,51,4,7.8
3,All Students,2021-22,6915,593,6322,91.4,41,14,34.1
3,All Students,2022-23,7768,723,7045,90.7,44,14,31.8
4,All Students,2018-19,4274,200,4074,95.3,24,3,12.5
4,All Students,2019-20,4108,256,3852,93.8,37,6,16.2
4,All Students,2020-21,7355,287,7068,96.1,43,5,11.6
4,All Students,2021-22,8466,700,7766,91.7,48,11,22.9
4,All Students,2022-23,6573,536,6037,91.8,38,11,28.9
5,All Students,2018-19,4471,204,4267,95.4,28,2,7.1
5,All Students,2019-20,2530,85,2445,96.6,22,1,4.5
5,All Students,2020-21,6604,280,6324,95.8,39,6,15.4
5,All Students,2021-22,6812,703,6109,89.7,40,18,45.0
5,All Students,2022-23,7709,683,7026,91.1,45,16,35.6
All Grades,All Students,2018-19,31621,2723,28898,91.4,192,53,27.6
All Grades,All Students,2019-20,25651,2150,23501,91.6,234,64,27.4
All Grades,All Students,2020-21,40124,3886,36238,90.3,237,79,33.3
All Grades,All Students,2021-22,37663,4747,32916,87.4,233,121,51.9
All Grades,All Students,2022-23,37269,3810,33459,89.8,232,96,41.4
6,All Students,2018-19,12906,1092,11814,91.5,79,21,26.6
6,All Students,2019-20,9453,749,8704,92.1,88,23,26.1
6,All Students,2020-21,13670,1575,12095,88.5,81,30,37.0
6,All Students,2021-22,11189,1602,9587,85.7,68,40,58.8
6,All Students,2022-23,12104,1152,10952,90.5,77,29,37.7
7,All Students,2018-19,12024,1049,10975,91.3,74,25,33.8
7,All Students,2019-20,8228,572,7656,93.0,74,15,20.3
7,All Students,2020-21,14578,1720,12858,88.2,86,38,44.2
7,All Students,2021-22,12601,1503,11098,88.1,79,42,53.2
7,All Students,2022-23,11924,s,s,s,s,s,s
8,All Students,2018-19,6691,582,6109,91.3,39,7,17.9
8,All Students,2019-20,7960,s,s,s,s,s,s
8,All Students,2020-21,11876,591,11285,95.0,70,11,15.7
8,All Students,2021-22,13873,1642,12231,88.2,86,39,45.3
8,All Students,2022-23,13072,1400,11672,89.3,80,34,42.5
9,All Students,2019-20,10,s,s,s,s,s,s
9,All Students,2022-23,169,s,s,s,s,s,s
All Grades,All Students,2018-19,17695,2748,14947,84.5,120,56,46.7
All Grades,All Students,2019-20,13332,1876,11456,85.9,127,46,36.2
All Grades,All Students,2020-21,22422,3150,19272,86.0,137,55,40.1
All Grades,All Students,2021-22,26837,4505,22332,83.2,172,98,57.0
All Grades,All Students,2022-23,30417,4907,25510,83.9,208,115,55.3
9,All Students,2018-19,5823,1344,4479,76.9,40,20,50.0
9,All Students,2019-20,4858,797,4061,83.6,49,19,38.8
9,All Students,2020-21,8400,1580,6820,81.2,51,25,49.0
9,All Students,2021-22,10024,1369,8655,86.3,66,33,50.0
9,All Students,2022-23,10388,1723,8665,83.4,72,38,52.8
10,All Students,2018-19,4010,714,3296,82.2,27,15,55.6
10,All Students,2019-20,2973,365,2608,87.7,28,9,32.1
10,All Students,2020-21,5265,520,4745,90.1,33,11,33.3
10,All Students,2021-22,6779,1254,5525,81.5,42,27,64.3
10,All Students,2022-23,8311,1160,7151,86.0,57,27,47.4
11,All Students,2018-19,5276,452,4824,91.4,35,13,37.1
11,All Students,2019-20,2310,369,1941,84.0,20,9,45.0
11,All Students,2020-21,5827,818,5009,86.0,34,15,44.1
11,All Students,2021-22,5556,999,4557,82.0,35,18,51.4
11,All Students,2022-23,7278,1256,6022,82.7,49,29,59.2
12,All Students,2018-19,2586,238,2348,90.8,18,8,44.4
12,All Students,2019-20,3191,345,2846,89.2,30,9,30.0
12,All Students,2020-21,2930,232,2698,92.1,19,4,21.1
12,All Students,2021-22,4478,883,3595,80.3,29,20,69.0
12,All Students,2022-23,4440,768,3672,82.7,30,21,70.0
All Grades,All Students,2018-19,39963,10665,29298,73.3,264,192,72.7
All Grades,All Students,2019-20,23899,6688,17211,72.0,230,165,71.7
All Grades,All Students,2020-21,29168,5350,23818,81.7,187,92,49.2
All Grades,All Students,2021-22,25197,5552,19645,78.0,165,115,69.7
All Grades,All Students,2022-23,22098,4580,17518,79.3,164,105,64.0
9,All Students,2018-19,9491,2040,7451,78.5,63,39,61.9
9,All Students,2019-20,6383,1448,4935,77.3,67,45,67.2
9,All Students,2020-21,6485,1327,5158,79.5,44,23,52.3
9,All Students,2021-22,6322,1165,5157,81.6,42,29,69.0
9,All Students,2022-23,6611,1391,5220,79.0,54,31,57.4
10,All Students,2018-19,11078,3069,8009,72.3,78,60,76.9
10,All Students,2019-20,7031,2061,4970,70.7,73,58,79.5
10,All Students,2020-21,7496,1603,5893,78.6,48,26,54.2
10,All Students,2021-22,6653,1651,5002,75.2,44,29,65.9
10,All Students,2022-23,5665,1441,4224,74.6,41,27,65.9
11,All Students,2018-19,8262,2117,6145,74.4,55,41,74.5
11,All Students,2019-20,5874,1444,4430,75.4,54,36,66.7
11,All Students,2020-21,8468,1359,7109,84.0,53,24,45.3
11,All Students,2021-22,5821,1390,4431,76.1,39,28,71.8
11,All Students,2022-23,5334,860,4474,83.9,38,23,60.5
12,All Students,2018-19,11132,3439,7693,69.1,68,52,76.5
12,All Students,2019-20,4611,1735,2876,62.4,36,26,72.2
12,All Students,2020-21,6719,1061,5658,84.2,42,19,45.2
12,All Students,2021-22,6401,1346,5055,79.0,40,29,72.5
12,All Students,2022-23,4488,888,3600,80.2,31,24,77.4
All Grades,All Students,2018-19,7859,431,7428,94.5,53,12,22.6
All Grades,All Students,2019-20,9656,494,9162,94.9,89,14,15.7
All Grades,All Students,2020-21,25801,974,24827,96.2,152,18,11.8
All Grades,All Students,2021-22,27678,2784,24894,89.9,167,61,36.5
All Grades,All Students,2022-23,33621,3071,30550,90.9,199,71,35.7
6,All Students,2018-19,7859,431,7428,94.5,53,12,22.6
6,All Students,2019-20,4607,217,4390,95.3,42,3,7.1
6,All Students,2020-21,10836,356,10480,96.7,66,7,10.6
6,All Students,2021-22,9886,1105,8781,88.8,61,25,41.0
6,All Students,2022-23,13495,1351,12144,90.0,81,35,43.2
7,All Students,2019-20,5049,277,4772,94.5,47,11,23.4
7,All Students,2020-21,7440,275,7165,96.3,43,4,9.3
7,All Students,2021-22,10643,981,9662,90.8,65,23,35.4
7,All Students,2022-23,9876,880,8996,91.1,58,21,36.2
8,All Students,2020-21,7525,343,7182,95.4,43,7,16.3
8,All Students,2021-22,7149,698,6451,90.2,41,13,31.7
8,All Students,2022-23,10250,840,9410,91.8,60,15,25.0
All Grades,All Students,2018-19,84480,5067,79413,94.0,496,98,19.8
All Grades,All Students,2019-20,49702,2996,46706,94.0,446,76,17.0
All Grades,All Students,2020-21,72323,11714,60609,83.8,428,237,55.4
All Grades,All Students,2021-22,63110,7688,55422,87.8,372,164,44.1
All Grades,All Students,2022-23,55121,6143,48978,88.9,334,134,40.1
6,All Students,2018-19,26021,1503,24518,94.2,155,27,17.4
6,All Students,2019-20,15486,1064,14422,93.1,139,29,20.9
6,All Students,2020-21,24778,3504,21274,85.9,147,72,49.0
6,All Students,2021-22,15325,s,s,s,s,s,s
6,All Students,2022-23,13601,1444,12157,89.4,85,33,38.8
7,All Students,2018-19,28991,1649,27342,94.3,168,30,17.9
7,All Students,2019-20,16194,1103,15091,93.2,146,24,16.4
7,All Students,2020-21,23384,4150,19234,82.3,137,80,58.4
7,All Students,2021-22,25212,2762,22450,89.0,149,61,40.9
7,All Students,2022-23,16510,1890,14620,88.6,101,42,41.6
8,All Students,2018-19,29468,1915,27553,93.5,173,41,23.7
8,All Students,2019-20,18022,829,17193,95.4,161,23,14.3
8,All Students,2020-21,24161,4060,20101,83.2,144,85,59.0
8,All Students,2021-22,22552,3265,19287,85.5,132,62,47.0
8,All Students,2022-23,25010,2809,22201,88.8,148,59,39.9
9,All Students,2021-22,21,s,s,s,s,s,s
All Grades,All Students,2018-19,115679,9401,106278,91.9,714,217,30.4
All Grades,All Students,2019-20,74495,5785,68710,92.2,711,211,29.7
All Grades,All Students,2020-21,105300,13744,91556,86.9,650,326,50.2
All Grades,All Students,2021-22,112005,16613,95392,85.2,713,443,62.1
All Grades,All Students,2022-23,102590,13408,89182,86.9,656,356,54.3
PK in K-12 Schools,All Students,2019-20,4093,462,3631,88.7,37,17,45.9
PK in K-12 Schools,All Students,2020-21,6766,1261,5505,81.4,51,38,74.5
PK in K-12 Schools,All Students,2021-22,14130,2821,11309,80.0,90,72,80.0
PK in K-12 Schools,All Students,2022-23,16979,2830,14149,83.3,116,79,68.1
0K,All Students,2018-19,13653,1304,12349,90.4,84,36,42.9
0K,All Students,2019-20,12938,1334,11604,89.7,126,55,43.7
0K,All Students,2020-21,11286,1964,9322,82.6,71,46,64.8
0K,All Students,2021-22,13883,2198,11685,84.2,93,62,66.7
0K,All Students,2022-23,13385,2130,11255,84.1,89,62,69.7
1,All Students,2018-19,18822,1450,17372,92.3,123,34,27.6
1,All Students,2019-20,9406,773,8633,91.8,88,30,34.1
1,All Students,2020-21,19591,2956,16635,84.9,117,69,59.0
1,All Students,2021-22,13985,1982,12003,85.8,89,49,55.1
1,All Students,2022-23,13135,1686,11449,87.2,84,46,54.8
2,All Students,2018-19,17187,1573,15614,90.8,112,43,38.4
2,All Students,2019-20,11527,827,10700,92.8,111,29,26.1
2,All Students,2020-21,14676,1954,12722,86.7,89,45,50.6
2,All Students,2021-22,18308,2882,15426,84.3,116,74,63.8
2,All Students,2022-23,12908,1604,11304,87.6,81,40,49.4
3,All Students,2018-19,21898,1748,20150,92.0,135,37,27.4
3,All Students,2019-20,10329,713,9616,93.1,101,25,24.8
3,All Students,2020-21,17852,1598,16254,91.0,108,35,32.4
3,All Students,2021-22,15325,2195,13130,85.7,97,60,61.9
3,All Students,2022-23,16749,1964,14785,88.3,105,44,41.9
4,All Students,2018-19,22405,1617,20788,92.8,134,31,23.1
4,All Students,2019-20,13027,860,12167,93.4,123,31,25.2
4,All Students,2020-21,16015,1825,14190,88.6,100,46,46.0
4,All Students,2021-22,18415,2123,16292,88.5,114,52,45.6
4,All Students,2022-23,12764,s,s,s,s,s,s
5,All Students,2018-19,21714,1709,20005,92.1,126,36,28.6
5,All Students,2019-20,13175,816,12359,93.8,125,24,19.2
5,All Students,2020-21,19053,2185,16868,88.5,113,47,41.6
5,All Students,2021-22,17959,2412,15547,86.6,114,74,64.9
5,All Students,2022-23,16614,1845,14769,88.9,101,42,41.6
6,All Students,2022-23,56,s,s,s,s,s,s
All Grades,All Students,2018-19,48921,5454,43467,88.9,303,146,48.2
All Grades,All Students,2019-20,27286,2830,24456,89.6,249,95,38.2
All Grades,All Students,2020-21,34702,6758,27944,80.5,210,121,57.6
All Grades,All Students,2021-22,34739,5592,29147,83.9,224,129,57.6
All Grades,All Students,2022-23,32838,4481,28357,86.4,210,113,53.8
PK in K-12 Schools,All Students,2018-19,3591,632,2959,82.4,24,16,66.7
PK in K-12 Schools,All Students,2019-20,2108,231,1877,89.0,19,8,42.1
PK in K-12 Schools,All Students,2020-21,2439,473,1966,80.6,16,8,50.0
PK in K-12 Schools,All Students,2021-22,5092,932,4160,81.7,33,19,57.6
PK in K-12 Schools,All Students,2022-23,4269,815,3454,80.9,28,20,71.4
0K,All Students,2018-19,6387,735,5652,88.5,40,19,47.5
0K,All Students,2019-20,2322,421,1901,81.9,21,14,66.7
0K,All Students,2020-21,4652,1104,3548,76.3,29,22,75.9
0K,All Students,2021-22,5649,903,4746,84.0,39,26,66.7
0K,All Students,2022-23,4604,724,3880,84.3,29,17,58.6
1,All Students,2018-19,6899,1013,5886,85.3,44,24,54.5
1,All Students,2019-20,4138,415,3723,90.0,41,15,36.6
1,All Students,2020-21,3360,1133,2227,66.3,20,13,65.0
1,All Students,2021-22,4933,971,3962,80.3,32,22,68.8
1,All Students,2022-23,5582,669,4913,88.0,34,14,41.2
2,All Students,2018-19,7648,770,6878,89.9,49,23,46.9
2,All Students,2019-20,4222,538,3684,87.3,38,17,44.7
2,All Students,2020-21,5155,832,4323,83.9,31,14,45.2
2,All Students,2021-22,2920,607,2313,79.2,20,12,60.0
2,All Students,2022-23,5376,692,4684,87.1,35,19,54.3
3,All Students,2018-19,7494,700,6794,90.7,45,22,48.9
3,All Students,2019-20,4194,429,3765,89.8,38,13,34.2
3,All Students,2020-21,6152,1008,5144,83.6,37,20,54.1
3,All Students,2021-22,4660,589,4071,87.4,29,14,48.3
3,All Students,2022-23,3071,464,2607,84.9,22,14,63.6
4,All Students,2018-19,9068,974,8094,89.3,55,24,43.6
4,All Students,2019-20,4804,394,4410,91.8,42,16,38.1
4,All Students,2020-21,5834,1205,4629,79.3,35,23,65.7
4,All Students,2021-22,5929,884,5045,85.1,37,20,54.1
4,All Students,2022-23,4141,396,3745,90.4,26,10,38.5
5,All Students,2018-19,7834,630,7204,92.0,46,18,39.1
5,All Students,2019-20,5498,402,5096,92.7,50,12,24.0
5,All Students,2020-21,7110,1003,6107,85.9,42,21,50.0
5,All Students,2021-22,5556,706,4850,87.3,34,16,47.1
5,All Students,2022-23,5795,721,5074,87.6,36,19,52.8
All Grades,All Students,2018-19,118307,11358,106949,90.4,689,244,35.4
All Grades,All Students,2019-20,63996,4740,59256,92.6,580,147,25.3
All Grades,All Students,2020-21,86770,10754,76016,87.6,508,206,40.6
All Grades,All Students,2021-22,79541,11144,68397,86.0,474,260,54.9
All Grades,All Students,2022-23,63818,7587,56231,88.1,380,186,48.9
6,All Students,2018-19,37076,3427,33649,90.8,223,79,35.4
6,All Students,2019-20,19938,1419,18519,92.9,180,41,22.8
6,All Students,2020-21,23104,3081,20023,86.7,137,59,43.1
6,All Students,2021-22,24565,3319,21246,86.5,143,70,49.0
6,All Students,2022-23,16709,s,s,s,s,s,s
7,All Students,2018-19,33281,2980,30301,91.0,192,59,30.7
7,All Students,2019-20,23510,1650,21860,93.0,214,53,24.8
7,All Students,2020-21,29989,3883,26106,87.1,175,76,43.4
7,All Students,2021-22,23071,3471,19600,85.0,139,81,58.3
7,All Students,2022-23,23954,2503,21451,89.6,141,57,40.4
8,All Students,2018-19,47950,4951,42999,89.7,274,106,38.7
8,All Students,2019-20,20548,1671,18877,91.9,186,53,28.5
8,All Students,2020-21,33677,3790,29887,88.7,196,71,36.2
8,All Students,2021-22,31905,4354,27551,86.4,192,109,56.8
8,All Students,2022-23,23152,3097,20055,86.6,138,85,61.6
9,All Students,2022-23,3,s,s,s,s,s,s
All Grades,All Students,2018-19,45004,3807,41197,91.5,277,82,29.6
All Grades,All Students,2019-20,25974,2385,23589,90.8,247,81,32.8
All Grades,All Students,2020-21,32724,4571,28153,86.0,197,89,45.2
All Grades,All Students,2021-22,34325,4820,29505,86.0,225,120,53.3
All Grades,All Students,2022-23,29122,3458,25664,88.1,179,82,45.8
PK in K-12 Schools,All Students,2018-19,4435,571,3864,87.1,26,8,30.8
PK in K-12 Schools,All Students,2019-20,2229,214,2015,90.4,22,8,36.4
PK in K-12 Schools,All Students,2020-21,564,s,s,s,s,s,s
PK in K-12 Schools,All Students,2021-22,7891,1413,6478,82.1,55,37,67.3
PK in K-12 Schools,All Students,2022-23,6209,901,5308,85.5,38,21,55.3
0K,All Students,2018-19,4907,461,4446,90.6,32,13,40.6
0K,All Students,2019-20,3452,418,3034,87.9,33,13,39.4
0K,All Students,2020-21,3218,s,s,s,s,s,s
0K,All Students,2021-22,3629,501,3128,86.2,22,12,54.5
0K,All Students,2022-23,4534,748,3786,83.5,27,18,66.7
1,All Students,2018-19,6264,645,5619,89.7,40,15,37.5
1,All Students,2019-20,2925,289,2636,90.1,28,11,39.3
1,All Students,2020-21,4878,777,4101,84.1,30,16,53.3
1,All Students,2021-22,2387,412,1975,82.7,16,9,56.3
1,All Students,2022-23,3949,315,3634,92.0,23,7,30.4
2,All Students,2018-19,8340,682,7658,91.8,51,17,33.3
2,All Students,2019-20,3922,390,3532,90.1,35,13,37.1
2,All Students,2020-21,4097,557,3540,86.4,24,13,54.2
2,All Students,2021-22,4416,622,3794,85.9,30,13,43.3
2,All Students,2022-23,1874,293,1581,84.4,13,7,53.8
3,All Students,2018-19,6096,472,5624,92.3,40,13,32.5
3,All Students,2019-20,4664,399,4265,91.4,45,10,22.2
3,All Students,2020-21,5641,756,4885,86.6,33,12,36.4
3,All Students,2021-22,3116,349,2767,88.8,21,9,42.9
3,All Students,2022-23,3686,284,3402,92.3,23,6,26.1
4,All Students,2018-19,7178,531,6647,92.6,41,9,22.0
4,All Students,2019-20,4214,323,3891,92.3,40,12,30.0
4,All Students,2020-21,7596,916,6680,87.9,45,16,35.6
4,All Students,2021-22,5869,736,5133,87.5,36,19,52.8
4,All Students,2022-23,3405,326,3079,90.4,21,9,42.9
5,All Students,2018-19,7784,445,7339,94.3,47,7,14.9
5,All Students,2019-20,4568,352,4216,92.3,44,14,31.8
5,All Students,2020-21,6730,953,5777,85.8,40,19,47.5
5,All Students,2021-22,7017,787,6230,88.8,45,21,46.7
5,All Students,2022-23,5465,591,4874,89.2,34,14,41.2
All Grades,All Students,2018-19,74248,8149,66099,89.0,465,207,44.5
All Grades,All Students,2019-20,39684,3716,35968,90.6,368,134,36.4
All Grades,All Students,2020-21,54177,10045,44132,81.5,324,194,59.9
All Grades,All Students,2021-22,54350,8043,46307,85.2,349,209,59.9
All Grades,All Students,2022-23,52849,7289,45560,86.2,341,188,55.1
PK in K-12 Schools,All Students,2018-19,9136,1446,7690,84.2,60,41,68.3
PK in K-12 Schools,All Students,2019-20,3796,596,3200,84.3,38,26,68.4
PK in K-12 Schools,All Students,2020-21,4038,804,3234,80.1,27,15,55.6
PK in K-12 Schools,All Students,2021-22,5875,1089,4786,81.5,40,25,62.5
PK in K-12 Schools,All Students,2022-23,5588,995,4593,82.2,37,21,56.8
0K,All Students,2018-19,9306,1226,8080,86.8,57,26,45.6
0K,All Students,2019-20,6165,754,5411,87.8,58,27,46.6
0K,All Students,2020-21,6291,1624,4667,74.2,39,28,71.8
0K,All Students,2021-22,8585,1719,6866,80.0,61,49,80.3
0K,All Students,2022-23,7448,1228,6220,83.5,52,32,61.5
1,All Students,2018-19,9845,1268,8577,87.1,63,35,55.6
1,All Students,2019-20,5688,470,5218,91.7,51,14,27.5
1,All Students,2020-21,9531,2303,7228,75.8,57,47,82.5
1,All Students,2021-22,6627,1196,5431,82.0,41,28,68.3
1,All Students,2022-23,9119,1494,7625,83.6,60,40,66.7
2,All Students,2018-19,9399,944,8455,90.0,60,22,36.7
2,All Students,2019-20,5459,583,4876,89.3,51,21,41.2
2,All Students,2020-21,7885,1370,6515,82.6,45,26,57.8
2,All Students,2021-22,7812,922,6890,88.2,51,30,58.8
2,All Students,2022-23,6146,865,5281,85.9,40,26,65.0
3,All Students,2018-19,11485,1074,10411,90.6,72,27,37.5
3,All Students,2019-20,5311,356,4955,93.3,51,12,23.5
3,All Students,2020-21,8923,1484,7439,83.4,54,36,66.7
3,All Students,2021-22,7175,717,6458,90.0,43,17,39.5
3,All Students,2022-23,6569,652,5917,90.1,41,19,46.3
4,All Students,2018-19,11259,847,10412,92.5,69,21,30.4
4,All Students,2019-20,6843,584,6259,91.5,61,20,32.8
4,All Students,2020-21,7884,1413,6471,82.1,45,24,53.3
4,All Students,2021-22,10121,1338,8783,86.8,64,36,56.3
4,All Students,2022-23,7945,774,7171,90.3,49,20,40.8
5,All Students,2018-19,13818,1344,12474,90.3,84,35,41.7
5,All Students,2019-20,6422,373,6049,94.2,58,14,24.1
5,All Students,2020-21,9625,1047,8578,89.1,57,18,31.6
5,All Students,2021-22,8155,1062,7093,87.0,49,24,49.0
5,All Students,2022-23,10034,1281,8753,87.2,62,30,48.4
All Grades,All Students,2018-19,79906,6877,73029,91.4,502,111,22.1
All Grades,All Students,2019-20,62491,5898,56593,90.6,584,131,22.4
All Grades,All Students,2020-21,93272,19123,74149,79.5,548,273,49.8
All Grades,All Students,2021-22,87103,13092,74011,85.0,539,192,35.6
All Grades,All Students,2022-23,86863,13454,73409,84.5,551,232,42.1
9,All Students,2018-19,18285,733,17552,96.0,114,10,8.8
9,All Students,2019-20,11598,811,10787,93.0,112,20,17.9
9,All Students,2020-21,25249,6111,19138,75.8,147,97,66.0
9,All Students,2021-22,21153,2104,19049,90.1,134,34,25.4
9,All Students,2022-23,22419,2973,19446,86.7,144,54,37.5
10,All Students,2018-19,18963,1533,17430,91.9,118,27,22.9
10,All Students,2019-20,12130,969,11161,92.0,113,18,15.9
10,All Students,2020-21,19048,3415,15633,82.1,110,55,50.0
10,All Students,2021-22,22192,3719,18473,83.2,136,66,48.5
10,All Students,2022-23,25917,5147,20770,80.1,166,91,54.8
11,All Students,2018-19,20320,1779,18541,91.2,125,30,24.0
11,All Students,2019-20,12736,1421,11315,88.8,118,28,23.7
11,All Students,2020-21,14735,2349,12386,84.1,85,37,43.5
11,All Students,2021-22,17213,3069,14144,82.2,106,56,52.8
11,All Students,2022-23,14698,1776,12922,87.9,91,35,38.5
12,All Students,2018-19,22338,2832,19506,87.3,145,44,30.3
12,All Students,2019-20,26027,2697,23330,89.6,241,65,27.0
12,All Students,2020-21,34240,7248,26992,78.8,206,84,40.8
12,All Students,2021-22,26545,4200,22345,84.2,163,36,22.1
12,All Students,2022-23,23829,3558,20271,85.1,150,52,34.7
All Grades,All Students,2018-19,96410,8914,87496,90.8,580,201,34.7
All Grades,All Students,2019-20,60495,5040,55455,91.7,562,179,31.9
All Grades,All Students,2020-21,86353,13959,72394,83.8,520,236,45.4
All Grades,All Students,2021-22,81143,11579,69564,85.7,490,258,52.7
All Grades,All Students,2022-23,74074,9832,64242,86.7,440,231,52.5
PK in K-12 Schools,All Students,2018-19,4612,456,4156,90.1,29,12,41.4
PK in K-12 Schools,All Students,2019-20,4310,515,3795,88.1,42,21,50.0
PK in K-12 Schools,All Students,2020-21,2376,262,2114,89.0,19,8,42.1
PK in K-12 Schools,All Students,2021-22,6953,1333,5620,80.8,48,35,72.9
PK in K-12 Schools,All Students,2022-23,7934,1328,6606,83.3,47,35,74.5
0K,All Students,2018-19,6600,1075,5525,83.7,43,26,60.5
0K,All Students,2019-20,4653,436,4217,90.6,46,17,37.0
0K,All Students,2020-21,9812,1837,7975,81.3,59,31,52.5
0K,All Students,2021-22,7391,1058,6333,85.7,47,29,61.7
0K,All Students,2022-23,6461,888,5573,86.3,38,25,65.8
1,All Students,2018-19,7598,1003,6595,86.8,48,26,54.2
1,All Students,2019-20,3867,453,3414,88.3,35,14,40.0
1,All Students,2020-21,6102,994,5108,83.7,37,19,51.4
1,All Students,2021-22,8691,1133,7558,87.0,51,24,47.1
1,All Students,2022-23,7068,1018,6050,85.6,45,24,53.3
2,All Students,2018-19,6811,762,6049,88.8,44,20,45.5
2,All Students,2019-20,5187,499,4688,90.4,52,22,42.3
2,All Students,2020-21,6097,1140,4957,81.3,36,17,47.2
2,All Students,2021-22,5557,647,4910,88.4,33,15,45.5
2,All Students,2022-23,7825,891,6934,88.6,46,20,43.5
3,All Students,2018-19,9253,952,8301,89.7,54,22,40.7
3,All Students,2019-20,5301,584,4717,89.0,51,24,47.1
3,All Students,2020-21,8366,1950,6416,76.7,51,28,54.9
3,All Students,2021-22,5068,1020,4048,79.9,32,19,59.4
3,All Students,2022-23,5471,626,4845,88.6,34,17,50.0
4,All Students,2018-19,9806,1079,8727,89.0,59,23,39.0
4,All Students,2019-20,5904,496,5408,91.6,53,16,30.2
4,All Students,2020-21,7445,1252,6193,83.2,47,20,42.6
4,All Students,2021-22,6814,1148,5666,83.2,40,24,60.0
4,All Students,2022-23,4504,674,3830,85.0,27,14,51.9
5,All Students,2018-19,10578,782,9796,92.6,62,20,32.3
5,All Students,2019-20,5787,514,5273,91.1,53,21,39.6
5,All Students,2020-21,8914,1372,7542,84.6,53,19,35.8
5,All Students,2021-22,7304,1042,6262,85.7,45,25,55.6
5,All Students,2022-23,7322,1052,6270,85.6,43,23,53.5
6,All Students,2018-19,16046,1122,14924,93.0,94,20,21.3
6,All Students,2019-20,8915,588,8327,93.4,81,13,16.0
6,All Students,2020-21,10116,1383,8733,86.3,61,29,47.5
6,All Students,2021-22,9710,1314,8396,86.5,56,24,42.9
6,All Students,2022-23,8743,1014,7729,88.4,52,25,48.1
7,All Students,2018-19,12075,768,11307,93.6,72,15,20.8
7,All Students,2019-20,9051,551,8500,93.9,80,21,26.3
7,All Students,2020-21,13735,1973,11762,85.6,80,33,41.3
7,All Students,2021-22,10397,1434,8963,86.2,59,28,47.5
7,All Students,2022-23,9022,967,8055,89.3,53,22,41.5
8,All Students,2018-19,13031,915,12116,93.0,75,17,22.7
8,All Students,2019-20,7520,404,7116,94.6,69,10,14.5
8,All Students,2020-21,13390,1796,11594,86.6,77,32,41.6
8,All Students,2021-22,13258,1450,11808,89.1,79,35,44.3
8,All Students,2022-23,9724,1374,8350,85.9,55,26,47.3
All Grades,All Students,2018-19,65561,5803,59758,91.1,414,147,35.5
All Grades,All Students,2019-20,38789,2972,35817,92.3,371,116,31.3
All Grades,All Students,2020-21,54764,7836,46928,85.7,351,170,48.4
All Grades,All Students,2021-22,50930,5953,44977,88.3,324,163,50.3
All Grades,All Students,2022-23,53763,6229,47534,88.4,344,165,48.0
PK in K-12 Schools,All Students,2018-19,6366,707,5659,88.9,39,16,41.0
PK in K-12 Schools,All Students,2019-20,3106,305,2801,90.2,30,14,46.7
PK in K-12 Schools,All Students,2020-21,4186,560,3626,86.6,26,12,46.2
PK in K-12 Schools,All Students,2021-22,4613,477,4136,89.7,30,14,46.7
PK in K-12 Schools,All Students,2022-23,5286,855,4431,83.8,38,27,71.1
0K,All Students,2018-19,8166,833,7333,89.8,54,25,46.3
0K,All Students,2019-20,5633,401,5232,92.9,54,17,31.5
0K,All Students,2020-21,9169,1438,7731,84.3,61,35,57.4
0K,All Students,2021-22,7593,1031,6562,86.4,50,28,56.0
0K,All Students,2022-23,8541,1206,7335,85.9,57,30,52.6
1,All Students,2018-19,8528,881,7647,89.7,59,28,47.5
1,All Students,2019-20,5665,496,5169,91.2,57,18,31.6
1,All Students,2020-21,8810,1499,7311,83.0,61,29,47.5
1,All Students,2021-22,7317,930,6387,87.3,50,31,62.0
1,All Students,2022-23,7884,947,6937,88.0,50,25,50.0
2,All Students,2018-19,10266,1012,9254,90.1,65,28,43.1
2,All Students,2019-20,5090,424,4666,91.7,49,17,34.7
2,All Students,2020-21,7786,994,6792,87.2,49,22,44.9
2,All Students,2021-22,7698,862,6836,88.8,46,20,43.5
2,All Students,2022-23,7688,815,6873,89.4,49,23,46.9
3,All Students,2018-19,9963,674,9289,93.2,63,18,28.6
3,All Students,2019-20,6004,493,5511,91.8,57,18,31.6
3,All Students,2020-21,7725,910,6815,88.2,48,19,39.6
3,All Students,2021-22,7765,827,6938,89.3,48,19,39.6
3,All Students,2022-23,8369,921,7448,89.0,51,22,43.1
4,All Students,2018-19,10101,842,9259,91.7,62,18,29.0
4,All Students,2019-20,5815,370,5445,93.6,55,13,23.6
4,All Students,2020-21,8770,1257,7513,85.7,54,27,50.0
4,All Students,2021-22,7110,803,6307,88.7,47,23,48.9
4,All Students,2022-23,8033,729,7304,90.9,50,21,42.0
5,All Students,2018-19,12171,854,11317,93.0,72,14,19.4
5,All Students,2019-20,7476,483,6993,93.5,69,19,27.5
5,All Students,2020-21,8318,1178,7140,85.8,52,26,50.0
5,All Students,2021-22,8834,1023,7811,88.4,53,28,52.8
5,All Students,2022-23,7962,756,7206,90.5,49,17,34.7
All Grades,All Students,2018-19,113495,10224,103271,91.0,682,228,33.4
All Grades,All Students,2019-20,70299,5358,64941,92.4,644,162,25.2
All Grades,All Students,2020-21,103423,14784,88639,85.7,619,265,42.8
All Grades,All Students,2021-22,102291,13246,89045,87.1,633,322,50.9
All Grades,All Students,2022-23,98922,10791,88131,89.1,611,274,44.8
PK in K-12 Schools,All Students,2018-19,5855,653,5202,88.8,38,14,36.8
PK in K-12 Schools,All Students,2019-20,3883,379,3504,90.2,35,14,40.0
PK in K-12 Schools,All Students,2020-21,5549,719,4830,87.0,35,17,48.6
PK in K-12 Schools,All Students,2021-22,8526,1440,7086,83.1,51,36,70.6
PK in K-12 Schools,All Students,2022-23,9843,1451,8392,85.3,68,46,67.6
0K,All Students,2018-19,8710,1007,7703,88.4,53,31,58.5
0K,All Students,2019-20,5509,599,4910,89.1,52,20,38.5
0K,All Students,2020-21,9025,1160,7865,87.1,56,23,41.1
0K,All Students,2021-22,11353,1722,9631,84.8,74,49,66.2
0K,All Students,2022-23,9276,1044,8232,88.7,60,34,56.7
1,All Students,2018-19,8663,664,7999,92.3,55,14,25.5
1,All Students,2019-20,5634,473,5161,91.6,55,17,30.9
1,All Students,2020-21,7471,1361,6110,81.8,46,25,54.3
1,All Students,2021-22,9093,1254,7839,86.2,58,34,58.6
1,All Students,2022-23,11662,1399,10263,88.0,72,36,50.0
2,All Students,2018-19,11580,1016,10564,91.2,68,17,25.0
2,All Students,2019-20,6231,400,5831,93.6,59,14,23.7
2,All Students,2020-21,8929,816,8113,90.9,52,16,30.8
2,All Students,2021-22,8026,1104,6922,86.2,49,22,44.9
2,All Students,2022-23,8988,1007,7981,88.8,57,29,50.9
3,All Students,2018-19,11422,1075,10347,90.6,72,24,33.3
3,All Students,2019-20,8310,620,7690,92.5,76,19,25.0
3,All Students,2020-21,9737,1376,8361,85.9,60,23,38.3
3,All Students,2021-22,8591,1052,7539,87.8,55,29,52.7
3,All Students,2022-23,8280,962,7318,88.4,53,23,43.4
4,All Students,2018-19,11799,908,10891,92.3,70,20,28.6
4,All Students,2019-20,7096,585,6511,91.8,65,16,24.6
4,All Students,2020-21,12275,1609,10666,86.9,73,29,39.7
4,All Students,2021-22,10165,1352,8813,86.7,64,38,59.4
4,All Students,2022-23,7899,777,7122,90.2,49,20,40.8
5,All Students,2018-19,13023,1034,11989,92.1,80,22,27.5
5,All Students,2019-20,7045,406,6639,94.2,64,13,20.3
5,All Students,2020-21,10761,1093,9668,89.8,65,26,40.0
5,All Students,2021-22,11129,1205,9924,89.2,70,23,32.9
5,All Students,2022-23,10544,1156,9388,89.0,64,28,43.8
6,All Students,2018-19,15758,1380,14378,91.2,92,31,33.7
6,All Students,2019-20,9164,527,8637,94.2,83,12,14.5
6,All Students,2020-21,11885,2207,9678,81.4,72,37,51.4
6,All Students,2021-22,11975,1701,10274,85.8,73,37,50.7
6,All Students,2022-23,11441,1102,10339,90.4,67,21,31.3
7,All Students,2018-19,13438,1124,12314,91.6,78,23,29.5
7,All Students,2019-20,8942,676,8266,92.4,78,20,25.6
7,All Students,2020-21,13444,1703,11741,87.3,77,24,31.2
7,All Students,2021-22,10717,1007,9710,90.6,64,20,31.3
7,All Students,2022-23,10483,977,9506,90.7,61,21,34.4
8,All Students,2018-19,13247,1363,11884,89.7,76,32,42.1
8,All Students,2019-20,8485,693,7792,91.8,77,17,22.1
8,All Students,2020-21,14339,2740,11599,80.9,83,45,54.2
8,All Students,2021-22,12716,1409,11307,88.9,75,34,45.3
8,All Students,2022-23,10506,916,9590,91.3,60,16,26.7
All Grades,All Students,2018-19,191186,13109,178077,93.1,1132,268,23.7
All Grades,All Students,2019-20,114488,6784,107704,94.1,1045,207,19.8
All Grades,All Students,2020-21,164872,12508,152364,92.4,983,234,23.8
All Grades,All Students,2021-22,156965,16606,140359,89.4,960,369,38.4
All Grades,All Students,2022-23,158732,14544,144188,90.8,994,359,36.1
0K,All Students,2018-19,17566,1388,16178,92.1,106,35,33.0
0K,All Students,2019-20,9972,727,9245,92.7,93,25,26.9
0K,All Students,2020-21,11695,1400,10295,88.0,70,27,38.6
0K,All Students,2021-22,13218,1592,11626,88.0,81,38,46.9
0K,All Students,2022-23,12426,s,s,s,s,s,s
1,All Students,2018-19,17992,1474,16518,91.8,111,38,34.2
1,All Students,2019-20,11909,871,11038,92.7,107,31,29.0
1,All Students,2020-21,17399,1676,15723,90.4,105,35,33.3
1,All Students,2021-22,11382,s,s,s,s,s,s
1,All Students,2022-23,14930,1522,13408,89.8,93,38,40.9
2,All Students,2018-19,18958,1508,17450,92.0,114,32,28.1
2,All Students,2019-20,10129,654,9475,93.5,92,21,22.8
2,All Students,2020-21,16716,831,15885,95.0,101,14,13.9
2,All Students,2021-22,17120,2035,15085,88.1,103,46,44.7
2,All Students,2022-23,13524,1437,12087,89.4,88,34,38.6
3,All Students,2018-19,20108,1400,18708,93.0,120,28,23.3
3,All Students,2019-20,12777,742,12035,94.2,119,23,19.3
3,All Students,2020-21,16175,1156,15019,92.9,96,20,20.8
3,All Students,2021-22,15542,1695,13847,89.1,96,42,43.8
3,All Students,2022-23,16616,1433,15183,91.4,106,33,31.1
4,All Students,2018-19,23081,1642,21439,92.9,137,37,27.0
4,All Students,2019-20,13160,764,12396,94.2,122,23,18.9
4,All Students,2020-21,18626,1370,17256,92.6,111,26,23.4
4,All Students,2021-22,16593,1711,14882,89.7,103,39,37.9
4,All Students,2022-23,15287,1475,13812,90.4,99,41,41.4
5,All Students,2018-19,20802,1380,19422,93.4,122,24,19.7
5,All Students,2019-20,13005,708,12297,94.6,119,20,16.8
5,All Students,2020-21,19027,1480,17547,92.2,116,32,27.6
5,All Students,2021-22,17566,1843,15723,89.5,109,40,36.7
5,All Students,2022-23,16900,1378,15522,91.8,103,33,32.0
6,All Students,2018-19,24121,1500,22621,93.8,143,31,21.7
6,All Students,2019-20,16000,949,15051,94.1,146,27,18.5
6,All Students,2020-21,22693,1507,21186,93.4,136,31,22.8
6,All Students,2021-22,20712,2044,18668,90.1,129,45,34.9
6,All Students,2022-23,23603,2025,21578,91.4,144,46,31.9
7,All Students,2018-19,21278,1176,20102,94.5,124,16,12.9
7,All Students,2019-20,14166,721,13445,94.9,129,22,17.1
7,All Students,2020-21,21707,1566,20141,92.8,127,27,21.3
7,All Students,2021-22,23046,1966,21080,91.5,138,45,32.6
7,All Students,2022-23,22130,2101,20029,90.5,138,51,37.0
8,All Students,2018-19,27280,1641,25639,94.0,155,27,17.4
8,All Students,2019-20,13370,648,12722,95.2,118,15,12.7
8,All Students,2020-21,20834,1522,19312,92.7,121,22,18.2
8,All Students,2021-22,21766,2334,19432,89.3,132,47,35.6
8,All Students,2022-23,23304,1768,21536,92.4,140,40,28.6
9,All Students,2021-22,20,s,s,s,s,s,s
9,All Students,2022-23,12,s,s,s,s,s,s
All Grades,All Students,2018-19,29746,3483,26263,88.3,195,95,48.7
All Grades,All Students,2019-20,20287,2117,18170,89.6,196,86,43.9
All Grades,All Students,2020-21,30272,2083,28189,93.1,183,45,24.6
All Grades,All Students,2021-22,26303,4484,21819,83.0,174,111,63.8
All Grades,All Students,2022-23,28111,4321,23790,84.6,189,116,61.4
PK in K-12 Schools,All Students,2018-19,2724,375,2349,86.2,19,12,63.2
PK in K-12 Schools,All Students,2019-20,2007,301,1706,85.0,20,9,45.0
PK in K-12 Schools,All Students,2020-21,2448,227,2221,90.7,15,5,33.3
PK in K-12 Schools,All Students,2021-22,3989,739,3250,81.5,28,18,64.3
PK in K-12 Schools,All Students,2022-23,4746,881,3865,81.4,36,28,77.8
0K,All Students,2018-19,3678,500,3178,86.4,26,14,53.8
0K,All Students,2019-20,3357,409,2948,87.8,34,19,55.9
0K,All Students,2020-21,3790,275,3515,92.7,24,7,29.2
0K,All Students,2021-22,3813,750,3063,80.3,27,19,70.4
0K,All Students,2022-23,3579,597,2982,83.3,24,16,66.7
1,All Students,2018-19,4446,600,3846,86.5,29,15,51.7
1,All Students,2019-20,2208,182,2026,91.8,22,10,45.5
1,All Students,2020-21,5307,402,4905,92.4,33,7,21.2
1,All Students,2021-22,3859,794,3065,79.4,25,20,80.0
1,All Students,2022-23,4070,671,3399,83.5,28,19,67.9
2,All Students,2018-19,3040,304,2736,90.0,21,10,47.6
2,All Students,2019-20,2475,249,2226,89.9,25,11,44.0
2,All Students,2020-21,3787,305,3482,91.9,23,7,30.4
2,All Students,2021-22,4476,701,3775,84.3,29,17,58.6
2,All Students,2022-23,3878,624,3254,83.9,24,13,54.2
3,All Students,2018-19,5431,623,4808,88.5,37,16,43.2
3,All Students,2019-20,2862,298,2564,89.6,26,14,53.8
3,All Students,2020-21,4501,215,4286,95.2,27,3,11.1
3,All Students,2021-22,2462,284,2178,88.5,17,10,58.8
3,All Students,2022-23,4794,617,4177,87.1,30,16,53.3
4,All Students,2018-19,5368,511,4857,90.5,33,15,45.5
4,All Students,2019-20,4044,429,3615,89.4,38,15,39.5
4,All Students,2020-21,4364,218,4146,95.0,25,4,16.0
4,All Students,2021-22,3477,523,2954,85.0,22,9,40.9
4,All Students,2022-23,3895,555,3340,85.8,24,13,54.2
5,All Students,2018-19,5059,570,4489,88.7,30,13,43.3
5,All Students,2019-20,3334,249,3085,92.5,31,8,25.8
5,All Students,2020-21,6075,441,5634,92.7,36,12,33.3
5,All Students,2021-22,4227,693,3534,83.6,26,18,69.2
5,All Students,2022-23,3149,376,2773,88.1,23,11,47.8
All Grades,All Students,2018-19,47569,4736,42833,90.0,291,116,39.9
All Grades,All Students,2019-20,25744,2350,23394,90.9,241,90,37.3
All Grades,All Students,2020-21,32887,4488,28399,86.4,193,90,46.6
All Grades,All Students,2021-22,30079,4201,25878,86.0,190,108,56.8
All Grades,All Students,2022-23,28627,3365,25262,88.2,177,84,47.5
PK in K-12 Schools,All Students,2018-19,3151,472,2679,85.0,19,14,73.7
PK in K-12 Schools,All Students,2019-20,2822,314,2508,88.9,28,13,46.4
PK in K-12 Schools,All Students,2020-21,2425,506,1919,79.1,15,10,66.7
PK in K-12 Schools,All Students,2021-22,6096,880,5216,85.6,40,24,60.0
PK in K-12 Schools,All Students,2022-23,6566,1067,5499,83.7,40,26,65.0
0K,All Students,2018-19,5223,583,4640,88.8,33,13,39.4
0K,All Students,2019-20,2377,259,2118,89.1,24,10,41.7
0K,All Students,2020-21,4927,1152,3775,76.6,29,20,69.0
0K,All Students,2021-22,2469,378,2091,84.7,18,12,66.7
0K,All Students,2022-23,4228,547,3681,87.1,29,18,62.1
1,All Students,2018-19,6028,648,5380,89.3,40,16,40.0
1,All Students,2019-20,2871,249,2622,91.3,27,8,29.6
1,All Students,2020-21,3617,337,3280,90.7,21,7,33.3
1,All Students,2021-22,4098,599,3499,85.4,24,13,54.2
1,All Students,2022-23,2400,204,2196,91.5,14,5,35.7
2,All Students,2018-19,9267,958,8309,89.7,58,29,50.0
2,All Students,2019-20,3023,305,2718,89.9,28,13,46.4
2,All Students,2020-21,4747,578,4169,87.8,28,15,53.6
2,All Students,2021-22,3448,502,2946,85.4,22,13,59.1
2,All Students,2022-23,4658,475,4183,89.8,30,11,36.7
3,All Students,2018-19,7292,812,6480,88.9,43,21,48.8
3,All Students,2019-20,5081,462,4619,90.9,48,21,43.8
3,All Students,2020-21,3944,455,3489,88.5,24,10,41.7
3,All Students,2021-22,4629,606,4023,86.9,27,15,55.6
3,All Students,2022-23,3630,365,3265,89.9,22,7,31.8
4,All Students,2018-19,9499,845,8654,91.1,55,15,27.3
4,All Students,2019-20,4596,409,4187,91.1,42,14,33.3
4,All Students,2020-21,6577,706,5871,89.3,38,15,39.5
4,All Students,2021-22,3286,567,2719,82.7,23,16,69.6
4,All Students,2022-23,4304,397,3907,90.8,25,10,40.0
5,All Students,2018-19,7109,418,6691,94.1,43,8,18.6
5,All Students,2019-20,4974,352,4622,92.9,44,11,25.0
5,All Students,2020-21,6650,754,5896,88.7,38,13,34.2
5,All Students,2021-22,6053,669,5384,88.9,36,15,41.7
5,All Students,2022-23,2841,310,2531,89.1,17,7,41.2
All Grades,All Students,2018-19,83547,6130,77417,92.7,501,132,26.3
All Grades,All Students,2019-20,51519,3458,48061,93.3,471,113,24.0
All Grades,All Students,2020-21,69231,4956,64275,92.8,416,96,23.1
All Grades,All Students,2021-22,67141,7124,60017,89.4,416,172,41.3
All Grades,All Students,2022-23,66232,6620,59612,90.0,407,172,42.3
PK in K-12 Schools,All Students,2018-19,8309,982,7327,88.2,54,24,44.4
PK in K-12 Schools,All Students,2019-20,5691,474,5217,91.7,56,16,28.6
PK in K-12 Schools,All Students,2020-21,7217,315,6902,95.6,46,8,17.4
PK in K-12 Schools,All Students,2021-22,12020,1456,10564,87.9,82,39,47.6
PK in K-12 Schools,All Students,2022-23,13413,1453,11960,89.2,85,44,51.8
0K,All Students,2018-19,11704,1042,10662,91.1,73,26,35.6
0K,All Students,2019-20,7034,603,6431,91.4,67,21,31.3
0K,All Students,2020-21,10628,964,9664,90.9,65,22,33.8
0K,All Students,2021-22,9089,1113,7976,87.8,54,26,48.1
0K,All Students,2022-23,8671,1045,7626,87.9,50,23,46.0
1,All Students,2018-19,12606,967,11639,92.3,75,22,29.3
1,All Students,2019-20,6810,526,6284,92.3,64,18,28.1
1,All Students,2020-21,9467,749,8718,92.1,56,14,25.0
1,All Students,2021-22,8863,1001,7862,88.7,56,24,42.9
1,All Students,2022-23,7518,938,6580,87.5,50,28,56.0
2,All Students,2018-19,11759,787,10972,93.3,67,13,19.4
2,All Students,2019-20,8476,598,7878,92.9,76,22,28.9
2,All Students,2020-21,9418,800,8618,91.5,56,13,23.2
2,All Students,2021-22,8805,1055,7750,88.0,55,27,49.1
2,All Students,2022-23,7671,816,6855,89.4,47,19,40.4
3,All Students,2018-19,11670,828,10842,92.9,71,17,23.9
3,All Students,2019-20,7224,366,6858,94.9,65,8,12.3
3,All Students,2020-21,11623,764,10859,93.4,69,14,20.3
3,All Students,2021-22,7836,716,7120,90.9,48,16,33.3
3,All Students,2022-23,8951,744,8207,91.7,54,19,35.2
4,All Students,2018-19,13638,798,12840,94.1,79,18,22.8
4,All Students,2019-20,7498,402,7096,94.6,66,12,18.2
4,All Students,2020-21,10823,614,10209,94.3,64,9,14.1
4,All Students,2021-22,11582,987,10595,91.5,67,20,29.9
4,All Students,2022-23,8235,580,7655,93.0,51,13,25.5
5,All Students,2018-19,13861,726,13135,94.8,82,12,14.6
5,All Students,2019-20,8786,489,8297,94.4,78,16,20.5
5,All Students,2020-21,10055,750,9305,92.5,60,16,26.7
5,All Students,2021-22,8946,796,8150,91.1,54,20,37.0
5,All Students,2022-23,11773,1044,10729,91.1,70,26,37.1
All Grades,All Students,2018-19,74901,7009,67892,90.6,474,143,30.2
All Grades,All Students,2019-20,47757,4072,43685,91.5,445,125,28.1
All Grades,All Students,2020-21,62453,13209,49244,78.8,372,241,64.8
All Grades,All Students,2021-22,54723,8393,46330,84.7,343,179,52.2
All Grades,All Students,2022-23,57744,6853,50891,88.1,375,145,38.7
5,All Students,2022-23,4,s,s,s,s,s,s
6,All Students,2018-19,23042,1822,21220,92.1,150,34,22.7
6,All Students,2019-20,14778,1148,13630,92.2,140,43,30.7
6,All Students,2020-21,17513,3572,13941,79.6,107,65,60.7
6,All Students,2021-22,16653,2170,14483,87.0,109,53,48.6
6,All Students,2022-23,20711,2237,18474,89.2,133,49,36.8
7,All Students,2018-19,26223,1911,24312,92.7,164,42,25.6
7,All Students,2019-20,15377,1367,14010,91.1,141,38,27.0
7,All Students,2020-21,21938,4767,17171,78.3,130,88,67.7
7,All Students,2021-22,17497,2941,14556,83.2,106,55,51.9
7,All Students,2022-23,19307,2191,17116,88.7,132,48,36.4
8,All Students,2018-19,25636,3276,22360,87.2,160,67,41.9
8,All Students,2019-20,17602,1557,16045,91.2,164,44,26.8
8,All Students,2020-21,23002,4870,18132,78.8,135,88,65.2
8,All Students,2021-22,20573,3282,17291,84.0,128,71,55.5
8,All Students,2022-23,17722,s,s,s,s,s,s
All Grades,All Students,2018-19,154154,8190,145964,94.7,893,116,13.0
All Grades,All Students,2019-20,97658,4429,93229,95.5,872,83,9.5
All Grades,All Students,2020-21,140761,6616,134145,95.3,829,120,14.5
All Grades,All Students,2021-22,131249,10681,120568,91.9,774,203,26.2
All Grades,All Students,2022-23,126046,8578,117468,93.2,738,175,23.7
PK in K-12 Schools,All Students,2018-19,6406,439,5967,93.1,36,12,33.3
PK in K-12 Schools,All Students,2019-20,4102,300,3802,92.7,38,12,31.6
PK in K-12 Schools,All Students,2020-21,6143,s,s,s,s,s,s
PK in K-12 Schools,All Students,2021-22,6205,720,5485,88.4,38,18,47.4
PK in K-12 Schools,All Students,2022-23,6305,495,5810,92.1,37,14,37.8
0K,All Students,2018-19,25467,1762,23705,93.1,149,29,19.5
0K,All Students,2019-20,16739,1043,15696,93.8,152,28,18.4
0K,All Students,2020-21,23129,1304,21825,94.4,135,24,17.8
0K,All Students,2021-22,21841,2200,19641,89.9,127,46,36.2
0K,All Students,2022-23,22111,1919,20192,91.3,131,48,36.6
1,All Students,2018-19,25086,1320,23766,94.7,144,17,11.8
1,All Students,2019-20,15894,673,15221,95.8,141,11,7.8
1,All Students,2020-21,23561,1505,22056,93.6,138,31,22.5
1,All Students,2021-22,21235,1590,19645,92.5,127,31,24.4
1,All Students,2022-23,20613,1474,19139,92.8,121,27,22.3
2,All Students,2018-19,26653,1362,25291,94.9,156,19,12.2
2,All Students,2019-20,15238,595,14643,96.1,134,8,6.0
2,All Students,2020-21,21672,1074,20598,95.0,128,20,15.6
2,All Students,2021-22,20582,2003,18579,90.3,119,41,34.5
2,All Students,2022-23,19878,1284,18594,93.5,116,26,22.4
3,All Students,2018-19,24776,1124,23652,95.5,144,10,6.9
3,All Students,2019-20,15093,661,14432,95.6,136,12,8.8
3,All Students,2020-21,20917,740,20177,96.5,122,16,13.1
3,All Students,2021-22,20579,1198,19381,94.2,122,19,15.6
3,All Students,2022-23,18691,1382,17309,92.6,110,28,25.5
4,All Students,2018-19,23690,1263,22427,94.7,139,20,14.4
4,All Students,2019-20,15798,593,15205,96.2,141,5,3.5
4,All Students,2020-21,21653,986,20667,95.4,128,15,11.7
4,All Students,2021-22,18970,1169,17801,93.8,113,17,15.0
4,All Students,2022-23,20128,1088,19040,94.6,118,19,16.1
5,All Students,2018-19,22076,920,21156,95.8,125,9,7.2
5,All Students,2019-20,14794,564,14230,96.2,131,7,5.3
5,All Students,2020-21,23498,587,22911,97.5,136,4,2.9
5,All Students,2021-22,21837,1801,20036,91.8,128,31,24.2
5,All Students,2022-23,18320,936,17384,94.9,105,13,12.4
6,All Students,2020-21,167,s,s,s,s,s,s
All Grades,All Students,2018-19,63644,8392,55252,86.8,381,197,51.7
All Grades,All Students,2019-20,37073,5084,31989,86.3,365,204,55.9
All Grades,All Students,2020-21,49133,3793,45340,92.3,303,91,30.0
All Grades,All Students,2021-22,48908,6854,42054,86.0,309,184,59.5
All Grades,All Students,2022-23,51189,6247,44942,87.8,324,163,50.3
PK in K-12 Schools,All Students,2018-19,6214,s,s,s,s,s,s
PK in K-12 Schools,All Students,2019-20,4608,s,s,s,s,s,s
PK in K-12 Schools,All Students,2020-21,5345,641,4704,88.0,39,18,46.2
PK in K-12 Schools,All Students,2021-22,7882,1088,6794,86.2,55,36,65.5
PK in K-12 Schools,All Students,2022-23,11036,1546,9490,86.0,70,45,64.3
0K,All Students,2018-19,7539,1168,6371,84.5,45,30,66.7
0K,All Students,2019-20,4754,722,4032,84.8,46,29,63.0
0K,All Students,2020-21,5453,505,4948,90.7,34,11,32.4
0K,All Students,2021-22,7302,1103,6199,84.9,44,31,70.5
0K,All Students,2022-23,5967,889,5078,85.1,41,22,53.7
1,All Students,2018-19,8925,1148,7777,87.1,57,29,50.9
1,All Students,2019-20,5285,778,4507,85.3,47,26,55.3
1,All Students,2020-21,7466,570,6896,92.4,46,12,26.1
1,All Students,2021-22,5051,750,4301,85.2,33,19,57.6
1,All Students,2022-23,7164,824,6340,88.5,46,20,43.5
2,All Students,2018-19,9822,1233,8589,87.4,58,24,41.4
2,All Students,2019-20,4978,720,4258,85.5,46,27,58.7
2,All Students,2020-21,7076,440,6636,93.8,43,9,20.9
2,All Students,2021-22,6061,940,5121,84.5,39,25,64.1
2,All Students,2022-23,5364,535,4829,90.0,34,17,50.0
3,All Students,2018-19,8324,996,7328,88.0,50,27,54.0
3,All Students,2019-20,5831,683,5148,88.3,56,28,50.0
3,All Students,2020-21,7579,590,6989,92.2,45,16,35.6
3,All Students,2021-22,7067,985,6082,86.1,43,23,53.5
3,All Students,2022-23,6244,707,5537,88.7,40,18,45.0
4,All Students,2018-19,10517,1047,9470,90.0,61,22,36.1
4,All Students,2019-20,4836,563,4273,88.4,45,20,44.4
4,All Students,2020-21,8389,494,7895,94.1,50,11,22.0
4,All Students,2021-22,6894,886,6008,87.1,43,25,58.1
4,All Students,2022-23,7976,981,6995,87.7,50,25,50.0
5,All Students,2018-19,12268,1647,10621,86.6,72,40,55.6
5,All Students,2019-20,6676,680,5996,89.8,64,27,42.2
5,All Students,2020-21,7825,553,7272,92.9,46,14,30.4
5,All Students,2021-22,8651,1102,7549,87.3,52,25,48.1
5,All Students,2022-23,7438,765,6673,89.7,43,16,37.2
6,All Students,2018-19,35,s,s,s,s,s,s
6,All Students,2019-20,105,s,s,s,s,s,s
All Grades,All Students,2018-19,101090,6104,94986,94.0,598,105,17.6
All Grades,All Students,2019-20,68404,4151,64253,93.9,610,115,18.9
All Grades,All Students,2020-21,97716,4868,92848,95.0,572,79,13.8
All Grades,All Students,2021-22,96560,10365,86195,89.3,565,240,42.5
All Grades,All Students,2022-23,97029,9408,87621,90.3,563,202,35.9
PK in K-12 Schools,All Students,2018-19,9363,670,8693,92.8,55,14,25.5
PK in K-12 Schools,All Students,2019-20,6797,521,6276,92.3,60,12,20.0
PK in K-12 Schools,All Students,2020-21,7698,s,s,s,s,s,s
PK in K-12 Schools,All Students,2021-22,8955,950,8005,89.4,52,21,40.4
PK in K-12 Schools,All Students,2022-23,9477,888,8589,90.6,54,19,35.2
0K,All Students,2018-19,14705,935,13770,93.6,87,19,21.8
0K,All Students,2019-20,10375,711,9664,93.1,95,20,21.1
0K,All Students,2020-21,14420,906,13514,93.7,86,17,19.8
0K,All Students,2021-22,15786,1627,14159,89.7,93,42,45.2
0K,All Students,2022-23,17214,1768,15446,89.7,101,36,35.6
1,All Students,2018-19,19271,1106,18165,94.3,115,22,19.1
1,All Students,2019-20,9556,600,8956,93.7,86,18,20.9
1,All Students,2020-21,15171,704,14467,95.4,88,11,12.5
1,All Students,2021-22,14546,1710,12836,88.2,87,42,48.3
1,All Students,2022-23,15332,1523,13809,90.1,90,35,38.9
2,All Students,2018-19,14947,933,14014,93.8,91,16,17.6
2,All Students,2019-20,12626,682,11944,94.6,111,18,16.2
2,All Students,2020-21,13721,451,13270,96.7,81,6,7.4
2,All Students,2021-22,14167,1667,12500,88.2,83,42,50.6
2,All Students,2022-23,13624,1294,12330,90.5,79,26,32.9
3,All Students,2018-19,14184,660,13524,95.3,84,9,10.7
3,All Students,2019-20,9506,471,9035,95.0,85,13,15.3
3,All Students,2020-21,19578,719,18859,96.3,114,10,8.8
3,All Students,2021-22,12654,1325,11329,89.5,76,26,34.2
3,All Students,2022-23,13481,1453,12028,89.2,77,29,37.7
4,All Students,2018-19,17426,1176,16250,93.3,101,20,19.8
4,All Students,2019-20,9178,444,8734,95.2,82,10,12.2
4,All Students,2020-21,13505,596,12909,95.6,78,8,10.3
4,All Students,2021-22,17066,1737,15329,89.8,98,38,38.8
4,All Students,2022-23,12698,1136,11562,91.1,75,28,37.3
5,All Students,2018-19,11194,624,10570,94.4,65,5,7.7
5,All Students,2019-20,10366,722,9644,93.0,92,24,26.1
5,All Students,2020-21,13617,671,12946,95.1,79,11,13.9
5,All Students,2021-22,13386,1349,12037,89.9,76,29,38.2
5,All Students,2022-23,15203,1346,13857,91.1,87,29,33.3
6,All Students,2020-21,6,s,s,s,s,s,s
All Grades,All Students,2018-19,36100,2818,33282,92.2,209,53,25.4
All Grades,All Students,2019-20,22641,1266,21375,94.4,201,27,13.4
All Grades,All Students,2020-21,38296,3368,34928,91.2,223,72,32.3
All Grades,All Students,2021-22,32042,3198,28844,90.0,186,75,40.3
All Grades,All Students,2022-23,26526,2526,24000,90.5,153,51,33.3
6,All Students,2018-19,10654,774,9880,92.7,63,16,25.4
6,All Students,2019-20,9635,633,9002,93.4,85,13,15.3
6,All Students,2020-21,12794,1342,11452,89.5,75,28,37.3
6,All Students,2021-22,7195,676,6519,90.6,42,16,38.1
6,All Students,2022-23,8982,783,8199,91.3,52,16,30.8
7,All Students,2018-19,9507,615,8892,93.5,54,11,20.4
7,All Students,2019-20,6803,309,6494,95.5,61,6,9.8
7,All Students,2020-21,15290,1100,14190,92.8,89,23,25.8
7,All Students,2021-22,11391,1130,10261,90.1,65,24,36.9
7,All Students,2022-23,6664,620,6044,90.7,38,15,39.5
8,All Students,2018-19,15939,1429,14510,91.0,92,26,28.3
8,All Students,2019-20,6203,324,5879,94.8,55,8,14.5
8,All Students,2020-21,10212,926,9286,90.9,59,21,35.6
8,All Students,2021-22,13456,1392,12064,89.7,79,35,44.3
8,All Students,2022-23,10880,1123,9757,89.7,63,20,31.7
All Grades,All Students,2018-19,25017,2033,22984,91.9,162,42,25.9
All Grades,All Students,2019-20,14426,994,13432,93.1,136,25,18.4
All Grades,All Students,2020-21,22386,2401,19985,89.3,134,42,31.3
All Grades,All Students,2021-22,22037,2443,19594,88.9,138,59,42.8
All Grades,All Students,2022-23,21962,2093,19869,90.5,137,53,38.7
6,All Students,2018-19,7614,533,7081,93.0,49,13,26.5
6,All Students,2019-20,4615,408,4207,91.2,43,8,18.6
6,All Students,2020-21,6788,630,6158,90.7,41,10,24.4
6,All Students,2021-22,8475,897,7578,89.4,53,22,41.5
6,All Students,2022-23,7027,933,6094,86.7,45,25,55.6
7,All Students,2018-19,7395,627,6768,91.5,49,15,30.6
7,All Students,2019-20,5218,263,4955,95.0,50,8,16.0
7,All Students,2020-21,7014,852,6162,87.9,42,15,35.7
7,All Students,2021-22,5909,539,5370,90.9,37,16,43.2
7,All Students,2022-23,8164,668,7496,91.8,50,16,32.0
8,All Students,2018-19,10008,873,9135,91.3,64,14,21.9
8,All Students,2019-20,4593,323,4270,93.0,43,9,20.9
8,All Students,2020-21,8584,919,7665,89.3,51,17,33.3
8,All Students,2021-22,7653,1007,6646,86.8,48,21,43.8
8,All Students,2022-23,6771,492,6279,92.7,42,12,28.6
All Grades,All Students,2018-19,31238,2809,28429,91.0,187,64,34.2
All Grades,All Students,2019-20,18589,1406,17183,92.4,167,43,25.7
All Grades,All Students,2020-21,25062,2878,22184,88.5,145,54,37.2
All Grades,All Students,2021-22,23861,2570,21291,89.2,145,58,40.0
All Grades,All Students,2022-23,22660,2556,20104,88.7,135,55,40.7
5,All Students,2019-20,5,s,s,s,s,s,s
6,All Students,2018-19,10543,832,9711,92.1,65,18,27.7
6,All Students,2019-20,4834,s,s,s,s,s,s
6,All Students,2020-21,6142,528,5614,91.4,35,11,31.4
6,All Students,2021-22,6657,599,6058,91.0,42,15,35.7
6,All Students,2022-23,6525,745,5780,88.6,39,19,48.7
7,All Students,2018-19,10450,820,9630,92.2,62,19,30.6
7,All Students,2019-20,7228,495,6733,93.2,65,16,24.6
7,All Students,2020-21,8007,1056,6951,86.8,47,19,40.4
7,All Students,2021-22,8304,963,7341,88.4,51,21,41.2
7,All Students,2022-23,7230,725,6505,90.0,43,13,30.2
8,All Students,2018-19,10245,1157,9088,88.7,60,27,45.0
8,All Students,2019-20,6522,575,5947,91.2,58,16,27.6
8,All Students,2020-21,10913,1294,9619,88.1,63,24,38.1
8,All Students,2021-22,8900,1008,7892,88.7,52,22,42.3
8,All Students,2022-23,8905,1086,7819,87.8,53,23,43.4
All Grades,All Students,2018-19,53764,3938,49826,92.7,326,81,24.8
All Grades,All Students,2019-20,42803,2875,39928,93.3,388,84,21.6
All Grades,All Students,2020-21,57081,4838,52243,91.5,333,80,24.0
All Grades,All Students,2021-22,46912,6286,40626,86.6,280,123,43.9
All Grades,All Students,2022-23,36056,4165,31891,88.4,215,90,41.9
6,All Students,2018-19,19716,1207,18509,93.9,120,23,19.2
6,All Students,2019-20,14086,1010,13076,92.8,129,33,25.6
6,All Students,2020-21,14915,1196,13719,92.0,87,17,19.5
6,All Students,2021-22,12542,1787,10755,85.8,75,34,45.3
6,All Students,2022-23,10789,1289,9500,88.1,64,27,42.2
7,All Students,2018-19,23449,1683,21766,92.8,141,33,23.4
7,All Students,2019-20,13371,764,12607,94.3,121,24,19.8
7,All Students,2020-21,21593,1817,19776,91.6,126,36,28.6
7,All Students,2021-22,14083,1725,12358,87.8,86,33,38.4
7,All Students,2022-23,12394,1579,10815,87.3,75,37,49.3
8,All Students,2018-19,10599,1048,9551,90.1,65,25,38.5
8,All Students,2019-20,15346,1101,14245,92.8,138,27,19.6
8,All Students,2020-21,20573,1825,18748,91.1,120,27,22.5
8,All Students,2021-22,20287,2774,17513,86.3,119,56,47.1
8,All Students,2022-23,12873,1297,11576,89.9,76,26,34.2
All Grades,All Students,2018-19,61041,5376,55665,91.2,383,130,33.9
All Grades,All Students,2019-20,33530,2585,30945,92.3,321,92,28.7
All Grades,All Students,2020-21,44180,8408,35772,81.0,267,169,63.3
All Grades,All Students,2021-22,45748,6417,39331,86.0,285,155,54.4
All Grades,All Students,2022-23,47807,6776,41031,85.8,303,168,55.4
PK in K-12 Schools,All Students,2018-19,5984,s,s,s,s,s,s
PK in K-12 Schools,All Students,2019-20,3629,346,3283,90.5,43,15,34.9
PK in K-12 Schools,All Students,2020-21,5193,1210,3983,76.7,34,25,73.5
PK in K-12 Schools,All Students,2021-22,9902,2056,7846,79.2,68,53,77.9
PK in K-12 Schools,All Students,2022-23,10863,2232,8631,79.5,75,58,77.3
0K,All Students,2018-19,7555,796,6759,89.5,51,21,41.2
0K,All Students,2019-20,5704,517,5187,90.9,55,17,30.9
0K,All Students,2020-21,5108,1124,3984,78.0,32,20,62.5
0K,All Students,2021-22,4564,s,s,s,s,s,s
0K,All Students,2022-23,6448,1000,5448,84.5,40,24,60.0
1,All Students,2018-19,8714,864,7850,90.1,57,27,47.4
1,All Students,2019-20,3255,262,2993,92.0,30,9,30.0
1,All Students,2020-21,7969,1326,6643,83.4,46,28,60.9
1,All Students,2021-22,4980,685,4295,86.2,30,18,60.0
1,All Students,2022-23,5668,773,4895,86.4,34,18,52.9
2,All Students,2018-19,8007,739,7268,90.8,49,20,40.8
2,All Students,2019-20,5742,444,5298,92.3,52,14,26.9
2,All Students,2020-21,4528,718,3810,84.1,28,16,57.1
2,All Students,2021-22,7201,836,6365,88.4,42,17,40.5
2,All Students,2022-23,5903,934,4969,84.2,35,25,71.4
3,All Students,2018-19,9713,795,8918,91.8,60,16,26.7
3,All Students,2019-20,4137,313,3824,92.4,38,10,26.3
3,All Students,2020-21,7917,1397,6520,82.4,47,26,55.3
3,All Students,2021-22,5330,422,4908,92.1,33,10,30.3
3,All Students,2022-23,6702,670,6032,90.0,43,14,32.6
4,All Students,2018-19,9074,594,8480,93.5,57,14,24.6
4,All Students,2019-20,5936,426,5510,92.8,56,18,32.1
4,All Students,2020-21,5882,1081,4801,81.6,35,22,62.9
4,All Students,2021-22,7563,1073,6490,85.8,46,23,50.0
4,All Students,2022-23,5430,s,s,s,s,s,s
5,All Students,2018-19,11980,994,10986,91.7,72,23,31.9
5,All Students,2019-20,5127,277,4850,94.6,47,9,19.1
5,All Students,2020-21,7583,1552,6031,79.5,45,32,71.1
5,All Students,2021-22,6191,664,5527,89.3,38,19,50.0
5,All Students,2022-23,6791,642,6149,90.5,41,16,39.0
6,All Students,2018-19,14,s,s,s,s,s,s
6,All Students,2021-22,17,s,s,s,s,s,s
6,All Students,2022-23,2,s,s,s,s,s,s
All Grades,All Students,2018-19,62493,7729,54764,87.6,418,161,38.5
All Grades,All Students,2019-20,37819,4349,33470,88.5,371,130,35.0
All Grades,All Students,2020-21,58372,5103,53269,91.3,342,79,23.1
All Grades,All Students,2021-22,62135,6828,55307,89.0,398,116,29.1
All Grades,All Students,2022-23,67178,5644,61534,91.6,427,95,22.2
6,All Students,2018-19,6308,517,5791,91.8,41,10,24.4
6,All Students,2019-20,4798,224,4574,95.3,43,3,7.0
6,All Students,2020-21,7291,260,7031,96.4,42,3,7.1
6,All Students,2021-22,8998,544,8454,94.0,58,11,19.0
6,All Students,2022-23,9667,613,9054,93.7,60,8,13.3
7,All Students,2018-19,7886,563,7323,92.9,48,11,22.9
7,All Students,2019-20,4793,512,4281,89.3,44,13,29.5
7,All Students,2020-21,7822,548,7274,93.0,46,7,15.2
7,All Students,2021-22,9507,316,9191,96.7,55,5,9.1
7,All Students,2022-23,8406,551,7855,93.4,50,9,18.0
8,All Students,2018-19,9614,815,8799,91.5,59,17,28.8
8,All Students,2019-20,4981,371,4610,92.6,49,11,22.4
8,All Students,2020-21,7525,460,7065,93.9,43,5,11.6
8,All Students,2021-22,9491,625,8866,93.4,58,9,15.5
8,All Students,2022-23,11013,874,10139,92.1,67,13,19.4
9,All Students,2018-19,6024,951,5073,84.2,48,17,35.4
9,All Students,2019-20,6448,899,5549,86.1,62,20,32.3
9,All Students,2020-21,10556,1149,9407,89.1,62,21,33.9
9,All Students,2021-22,12745,2133,10612,83.3,78,35,44.9
9,All Students,2022-23,13989,1446,12543,89.7,96,20,20.8
10,All Students,2018-19,11807,1669,10138,85.9,83,35,42.2
10,All Students,2019-20,6334,953,5381,85.0,64,32,50.0
10,All Students,2020-21,9692,958,8734,90.1,58,16,27.6
10,All Students,2021-22,8931,1096,7835,87.7,59,20,33.9
10,All Students,2022-23,8869,393,8476,95.6,57,8,14.0
11,All Students,2018-19,11775,1589,10186,86.5,80,34,42.5
11,All Students,2019-20,5062,552,4510,89.1,53,25,47.2
11,All Students,2020-21,9087,1186,7901,86.9,53,18,34.0
11,All Students,2021-22,9222,1588,7634,82.8,56,25,44.6
11,All Students,2022-23,7489,783,6706,89.5,48,20,41.7
12,All Students,2018-19,9079,1625,7454,82.1,59,37,62.7
12,All Students,2019-20,5403,838,4565,84.5,56,26,46.4
12,All Students,2020-21,6399,542,5857,91.5,38,9,23.7
12,All Students,2021-22,3241,526,2715,83.8,34,11,32.4
12,All Students,2022-23,7745,984,6761,87.3,49,17,34.7
All Grades,All Students,2018-19,69891,6761,63130,90.3,418,137,32.8
All Grades,All Students,2019-20,38139,3446,34693,91.0,347,126,36.3
All Grades,All Students,2020-21,49527,8179,41348,83.5,296,162,54.7
All Grades,All Students,2021-22,47799,7603,40196,84.1,292,187,64.0
All Grades,All Students,2022-23,43514,6072,37442,86.0,266,144,54.1
PK in K-12 Schools,All Students,2018-19,4765,587,4178,87.7,31,16,51.6
PK in K-12 Schools,All Students,2019-20,2569,311,2258,87.9,24,13,54.2
PK in K-12 Schools,All Students,2020-21,1492,326,1166,78.2,10,8,80.0
PK in K-12 Schools,All Students,2021-22,6133,1008,5125,83.6,39,27,69.2
PK in K-12 Schools,All Students,2022-23,6014,1199,4815,80.1,37,25,67.6
0K,All Students,2018-19,4804,709,4095,85.2,29,14,48.3
0K,All Students,2019-20,3149,308,2841,90.2,29,12,41.4
0K,All Students,2020-21,2732,784,1948,71.3,18,12,66.7
0K,All Students,2021-22,2920,507,2413,82.6,19,14,73.7
0K,All Students,2022-23,3807,678,3129,82.2,26,16,61.5
1,All Students,2018-19,7531,722,6809,90.4,44,17,38.6
1,All Students,2019-20,2633,373,2260,85.8,23,12,52.2
1,All Students,2020-21,4005,695,3310,82.6,27,18,66.7
1,All Students,2021-22,2474,390,2084,84.2,15,11,73.3
1,All Students,2022-23,1990,285,1705,85.7,13,8,61.5
2,All Students,2018-19,7230,687,6543,90.5,45,16,35.6
2,All Students,2019-20,4660,481,4179,89.7,43,21,48.8
2,All Students,2020-21,3751,656,3095,82.5,23,15,65.2
2,All Students,2021-22,3267,542,2725,83.4,21,10,47.6
2,All Students,2022-23,2417,204,2213,91.6,14,4,28.6
3,All Students,2018-19,6695,582,6113,91.3,40,13,32.5
3,All Students,2019-20,4202,316,3886,92.5,38,10,26.3
3,All Students,2020-21,6680,786,5894,88.2,39,17,43.6
3,All Students,2021-22,3507,571,2936,83.7,23,15,65.2
3,All Students,2022-23,3165,368,2797,88.4,19,12,63.2
4,All Students,2018-19,5409,537,4872,90.1,33,8,24.2
4,All Students,2019-20,3188,212,2976,93.4,30,8,26.7
4,All Students,2020-21,6014,947,5067,84.3,35,17,48.6
4,All Students,2021-22,5312,1128,4184,78.8,32,25,78.1
4,All Students,2022-23,3595,537,3058,85.1,23,11,47.8
5,All Students,2018-19,6308,419,5889,93.4,37,5,13.5
5,All Students,2019-20,2570,174,2396,93.2,24,5,20.8
5,All Students,2020-21,5124,939,4185,81.7,29,17,58.6
5,All Students,2021-22,5560,797,4763,85.7,33,17,51.5
5,All Students,2022-23,5030,622,4408,87.6,29,15,51.7
6,All Students,2018-19,9862,828,9034,91.6,59,19,32.2
6,All Students,2019-20,4508,427,4081,90.5,41,17,41.5
6,All Students,2020-21,5299,1110,4189,79.1,31,20,64.5
6,All Students,2021-22,8056,1120,6936,86.1,48,29,60.4
6,All Students,2022-23,5349,586,4763,89.0,32,14,43.8
7,All Students,2018-19,8572,725,7847,91.5,50,14,28.0
7,All Students,2019-20,5561,395,5166,92.9,49,15,30.6
7,All Students,2020-21,5888,672,5216,88.6,34,14,41.2
7,All Students,2021-22,4851,797,4054,83.6,29,21,72.4
7,All Students,2022-23,7508,968,6540,87.1,44,21,47.7
8,All Students,2018-19,8715,965,7750,88.9,50,15,30.0
8,All Students,2019-20,5099,449,4650,91.2,46,13,28.3
8,All Students,2020-21,8542,1264,7278,85.2,50,24,48.0
8,All Students,2021-22,5719,743,4976,87.0,33,18,54.5
8,All Students,2022-23,4639,625,4014,86.5,29,18,62.1
All Grades,All Students,2018-19,33473,2458,31015,92.7,202,59,29.2
All Grades,All Students,2019-20,20097,1305,18792,93.5,184,42,22.8
All Grades,All Students,2020-21,28542,2353,26189,91.8,167,50,29.9
All Grades,All Students,2021-22,29751,3218,26533,89.2,178,78,43.8
All Grades,All Students,2022-23,29270,2838,26432,90.3,177,76,42.9
PK in K-12 Schools,All Students,2018-19,3199,239,2960,92.5,18,5,27.8
PK in K-12 Schools,All Students,2019-20,1424,153,1271,89.3,15,3,20.0
PK in K-12 Schools,All Students,2020-21,2975,445,2530,85.0,17,11,64.7
PK in K-12 Schools,All Students,2021-22,3233,418,2815,87.1,19,8,42.1
PK in K-12 Schools,All Students,2022-23,2945,487,2458,83.5,18,15,83.3
0K,All Students,2018-19,4532,362,4170,92.0,27,10,37.0
0K,All Students,2019-20,2733,216,2517,92.1,24,11,45.8
0K,All Students,2020-21,3548,414,3134,88.3,21,8,38.1
0K,All Students,2021-22,5920,683,5237,88.5,36,20,55.6
0K,All Students,2022-23,5218,475,4743,90.9,32,13,40.6
1,All Students,2018-19,6465,506,5959,92.2,40,13,32.5
1,All Students,2019-20,3197,198,2999,93.8,30,6,20.0
1,All Students,2020-21,4879,413,4466,91.5,29,8,27.6
1,All Students,2021-22,3945,505,3440,87.2,24,10,41.7
1,All Students,2022-23,5600,540,5060,90.4,33,14,42.4
2,All Students,2018-19,4723,285,4438,94.0,28,7,25.0
2,All Students,2019-20,4337,305,4032,93.0,39,9,23.1
2,All Students,2020-21,4006,325,3681,91.9,24,7,29.2
2,All Students,2021-22,4488,469,4019,89.5,26,10,38.5
2,All Students,2022-23,3970,471,3499,88.1,26,13,50.0
3,All Students,2018-19,4299,209,4090,95.1,28,5,17.9
3,All Students,2019-20,2310,105,2205,95.5,23,5,21.7
3,All Students,2020-21,5935,320,5615,94.6,34,7,20.6
3,All Students,2021-22,3198,362,2836,88.7,20,11,55.0
3,All Students,2022-23,2761,192,2569,93.0,17,2,11.8
4,All Students,2018-19,6180,443,5737,92.8,37,10,27.0
4,All Students,2019-20,2645,111,2534,95.8,23,2,8.7
4,All Students,2020-21,3524,236,3288,93.3,21,5,23.8
4,All Students,2021-22,5415,445,4970,91.8,31,11,35.5
4,All Students,2022-23,3113,322,2791,89.7,19,10,52.6
5,All Students,2018-19,4075,414,3661,89.8,24,9,37.5
5,All Students,2019-20,3451,217,3234,93.7,30,6,20.0
5,All Students,2020-21,3675,200,3475,94.6,21,4,19.0
5,All Students,2021-22,3552,336,3216,90.5,22,8,36.4
5,All Students,2022-23,5663,351,5312,93.8,32,9,28.1
All Grades,All Students,2018-19,49869,5014,44855,89.9,305,135,44.3
All Grades,All Students,2019-20,29606,2796,26810,90.6,278,99,35.6
All Grades,All Students,2020-21,35668,7334,28334,79.4,225,141,62.7
All Grades,All Students,2021-22,42907,7510,35397,82.5,284,180,63.4
All Grades,All Students,2022-23,42521,5717,36804,86.6,277,152,54.9
PK in K-12 Schools,All Students,2018-19,4655,833,3822,82.1,32,26,81.3
PK in K-12 Schools,All Students,2019-20,3674,475,3199,87.1,37,19,51.4
PK in K-12 Schools,All Students,2020-21,1540,375,1165,75.6,12,9,75.0
PK in K-12 Schools,All Students,2021-22,5965,1080,4885,81.9,41,27,65.9
PK in K-12 Schools,All Students,2022-23,4241,491,3750,88.4,28,15,53.6
0K,All Students,2018-19,6827,676,6151,90.1,43,14,32.6
0K,All Students,2019-20,3187,s,s,s,s,s,s
0K,All Students,2020-21,6422,1600,4822,75.1,42,29,69.0
0K,All Students,2021-22,5938,1229,4709,79.3,41,30,73.2
0K,All Students,2022-23,6331,763,5568,87.9,42,20,47.6
1,All Students,2018-19,7124,808,6316,88.7,43,21,48.8
1,All Students,2019-20,4453,401,4052,91.0,44,11,25.0
1,All Students,2020-21,4204,1305,2899,69.0,29,24,82.8
1,All Students,2021-22,7162,1337,5825,81.3,48,36,75.0
1,All Students,2022-23,6963,1225,5738,82.4,45,33,73.3
2,All Students,2018-19,6787,547,6240,91.9,41,15,36.6
2,All Students,2019-20,4027,384,3643,90.5,39,17,43.6
2,All Students,2020-21,5760,1133,4627,80.3,37,26,70.3
2,All Students,2021-22,4757,994,3763,79.1,33,25,75.8
2,All Students,2022-23,7013,961,6052,86.3,44,23,52.3
3,All Students,2018-19,7445,698,6747,90.6,45,20,44.4
3,All Students,2019-20,4027,323,3704,92.0,37,11,29.7
3,All Students,2020-21,5685,1021,4664,82.0,34,19,55.9
3,All Students,2021-22,6288,1023,5265,83.7,39,24,61.5
3,All Students,2022-23,6000,959,5041,84.0,39,25,64.1
4,All Students,2018-19,9292,842,8450,90.9,55,23,41.8
4,All Students,2019-20,4439,346,4093,92.2,41,11,26.8
4,All Students,2020-21,5735,930,4805,83.8,34,19,55.9
4,All Students,2021-22,5828,731,5097,87.5,39,14,35.9
4,All Students,2022-23,6129,808,5321,86.8,40,24,60.0
5,All Students,2018-19,7739,610,7129,92.1,46,16,34.8
5,All Students,2019-20,5694,415,5279,92.7,51,14,27.5
5,All Students,2020-21,6322,970,5352,84.7,37,15,40.5
5,All Students,2021-22,6969,1116,5853,84.0,43,24,55.8
5,All Students,2022-23,5844,510,5334,91.3,39,12,30.8
6,All Students,2019-20,105,s,s,s,s,s,s
All Grades,All Students,2018-19,58682,6073,52609,89.7,404,175,43.3
All Grades,All Students,2019-20,32930,2967,29963,91.0,310,104,33.5
All Grades,All Students,2020-21,39847,5469,34378,86.3,239,111,46.4
All Grades,All Students,2021-22,24718,2767,21951,88.8,151,68,45.0
All Grades,All Students,2022-23,24142,2766,21376,88.5,163,77,47.2
0K,All Students,2018-19,7047,961,6086,86.4,53,32,60.4
0K,All Students,2019-20,4718,542,4176,88.5,44,18,40.9
0K,All Students,2020-21,4276,963,3313,77.5,26,18,69.2
0K,All Students,2021-22,2153,219,1934,89.8,13,6,46.2
0K,All Students,2022-23,4195,679,3516,83.8,30,23,76.7
1,All Students,2018-19,7963,926,7037,88.4,62,29,46.8
1,All Students,2019-20,4078,s,s,s,s,s,s
1,All Students,2020-21,6608,1298,5310,80.4,41,25,61.0
1,All Students,2021-22,4396,654,3742,85.1,28,18,64.3
1,All Students,2022-23,3034,244,2790,92.0,21,7,33.3
2,All Students,2018-19,10659,1322,9337,87.6,76,42,55.3
2,All Students,2019-20,5376,537,4839,90.0,53,21,39.6
2,All Students,2020-21,5556,974,4582,82.5,33,19,57.6
2,All Students,2021-22,2850,389,2461,86.4,18,8,44.4
2,All Students,2022-23,4480,580,3900,87.1,29,14,48.3
3,All Students,2018-19,8881,791,8090,91.1,65,26,40.0
3,All Students,2019-20,7248,724,6524,90.0,66,24,36.4
3,All Students,2020-21,6636,892,5744,86.6,40,20,50.0
3,All Students,2021-22,2979,324,2655,89.1,20,10,50.0
3,All Students,2022-23,3544,435,3109,87.7,25,12,48.0
4,All Students,2018-19,11936,956,10980,92.0,73,22,30.1
4,All Students,2019-20,4825,327,4498,93.2,48,13,27.1
4,All Students,2020-21,9477,809,8668,91.5,56,17,30.4
4,All Students,2021-22,5067,521,4546,89.7,30,14,46.7
4,All Students,2022-23,3530,327,3203,90.7,21,6,28.6
5,All Students,2018-19,12196,1117,11079,90.8,75,24,32.0
5,All Students,2019-20,6661,471,6190,92.9,60,14,23.3
5,All Students,2020-21,7294,533,6761,92.7,43,12,27.9
5,All Students,2021-22,7273,660,6613,90.9,42,12,28.6
5,All Students,2022-23,5359,501,4858,90.7,37,15,40.5
8,All Students,2019-20,24,s,s,s,s,s,s
All Grades,All Students,2018-19,32626,5278,27348,83.8,228,92,40.4
All Grades,All Students,2019-20,26091,4459,21632,82.9,256,95,37.1
All Grades,All Students,2020-21,45741,8316,37425,81.8,268,126,47.0
All Grades,All Students,2021-22,53843,10353,43490,80.8,354,173,48.9
All Grades,All Students,2022-23,57143,9623,47520,83.2,383,162,42.3
9,All Students,2018-19,9430,1772,7658,81.2,71,33,46.5
9,All Students,2019-20,8876,1355,7521,84.7,89,29,32.6
9,All Students,2020-21,13303,2010,11293,84.9,78,31,39.7
9,All Students,2021-22,19557,3044,16513,84.4,138,62,44.9
9,All Students,2022-23,14698,2317,12381,84.2,107,44,41.1
10,All Students,2018-19,11547,1965,9582,83.0,75,27,36.0
10,All Students,2019-20,6617,1352,5265,79.6,66,26,39.4
10,All Students,2020-21,13619,2566,11053,81.2,79,36,45.6
10,All Students,2021-22,12510,1891,10619,84.9,82,36,43.9
10,All Students,2022-23,16858,2722,14136,83.9,115,45,39.1
11,All Students,2018-19,5739,634,5105,89.0,42,14,33.3
11,All Students,2019-20,6580,941,5639,85.7,61,19,31.1
11,All Students,2020-21,9496,1670,7826,82.4,55,25,45.5
11,All Students,2021-22,13533,2312,11221,82.9,84,35,41.7
11,All Students,2022-23,12436,2090,10346,83.2,79,35,44.3
12,All Students,2018-19,5910,907,5003,84.7,40,18,45.0
12,All Students,2019-20,4018,811,3207,79.8,40,21,52.5
12,All Students,2020-21,9323,2070,7253,77.8,56,34,60.7
12,All Students,2021-22,8243,3106,5137,62.3,50,40,80.0
12,All Students,2022-23,13151,2494,10657,81.0,82,38,46.3
All Grades,All Students,2018-19,29519,2504,27015,91.5,180,61,33.9
All Grades,All Students,2019-20,19696,1546,18150,92.2,176,49,27.8
All Grades,All Students,2020-21,30722,4374,26348,85.8,183,83,45.4
All Grades,All Students,2021-22,27964,4035,23929,85.6,168,95,56.5
All Grades,All Students,2022-23,23957,2329,21628,90.3,148,55,37.2
6,All Students,2018-19,9989,910,9079,90.9,63,23,36.5
6,All Students,2019-20,7303,559,6744,92.3,66,19,28.8
6,All Students,2020-21,10392,1481,8911,85.7,61,27,44.3
6,All Students,2021-22,8714,981,7733,88.7,57,29,50.9
6,All Students,2022-23,7254,s,s,s,s,s,s
7,All Students,2018-19,9587,812,8775,91.5,59,21,35.6
7,All Students,2019-20,6161,456,5705,92.6,55,12,21.8
7,All Students,2020-21,10677,1497,9180,86.0,65,33,50.8
7,All Students,2021-22,9134,1380,7754,84.9,52,29,55.8
7,All Students,2022-23,7893,669,7224,91.5,47,18,38.3
8,All Students,2018-19,9943,782,9161,92.1,58,17,29.3
8,All Students,2019-20,6232,531,5701,91.5,55,18,32.7
8,All Students,2020-21,9645,s,s,s,s,s,s
8,All Students,2021-22,10116,1674,8442,83.5,59,37,62.7
8,All Students,2022-23,8808,965,7843,89.0,53,16,30.2
9,All Students,2020-21,8,s,s,s,s,s,s
9,All Students,2022-23,2,s,s,s,s,s,s
All Grades,All Students,2018-19,60304,7384,52920,87.8,392,122,31.1
All Grades,All Students,2019-20,39975,5820,34155,85.4,385,134,34.8
All Grades,All Students,2020-21,53950,10176,43774,81.1,330,156,47.3
All Grades,All Students,2021-22,48682,9318,39364,80.9,312,164,52.6
All Grades,All Students,2022-23,44380,7979,36401,82.0,293,162,55.3
8,All Students,2021-22,8,s,s,s,s,s,s
9,All Students,2018-19,13526,1102,12424,91.9,98,24,24.5
9,All Students,2019-20,9902,1287,8615,87.0,100,32,32.0
9,All Students,2020-21,10641,1225,9416,88.5,77,26,33.8
9,All Students,2021-22,15315,1917,13398,87.5,112,57,50.9
9,All Students,2022-23,14158,2119,12039,85.0,104,56,53.8
10,All Students,2018-19,14186,1240,12946,91.3,92,25,27.2
10,All Students,2019-20,8788,930,7858,89.4,87,24,27.6
10,All Students,2020-21,12319,2207,10112,82.1,73,36,49.3
10,All Students,2021-22,9621,s,s,s,s,s,s
10,All Students,2022-23,11231,1758,9473,84.3,73,31,42.5
11,All Students,2018-19,17144,1908,15236,88.9,107,33,30.8
11,All Students,2019-20,9585,1364,8221,85.8,89,23,25.8
11,All Students,2020-21,14700,2676,12024,81.8,86,44,51.2
11,All Students,2021-22,10807,2738,8069,74.7,67,37,55.2
11,All Students,2022-23,9691,1816,7875,81.3,60,35,58.3
12,All Students,2018-19,15448,3134,12314,79.7,95,40,42.1
12,All Students,2019-20,11700,2239,9461,80.9,109,55,50.5
12,All Students,2020-21,16290,4068,12222,75.0,94,50,53.2
12,All Students,2021-22,12931,2622,10309,79.7,76,42,55.3
12,All Students,2022-23,9300,2286,7014,75.4,56,40,71.4
All Grades,All Students,2018-19,36026,4796,31230,86.7,239,103,43.1
All Grades,All Students,2019-20,24824,2789,22035,88.8,248,77,31.0
All Grades,All Students,2020-21,40516,2652,37864,93.5,243,30,12.3
All Grades,All Students,2021-22,38425,3729,34696,90.3,252,76,30.2
All Grades,All Students,2022-23,35811,3216,32595,91.0,249,74,29.7
9,All Students,2018-19,11996,1610,10386,86.6,81,30,37.0
9,All Students,2019-20,6562,581,5981,91.1,66,14,21.2
9,All Students,2020-21,12143,746,11397,93.9,73,9,12.3
9,All Students,2021-22,8322,747,7575,91.0,57,17,29.8
9,All Students,2022-23,9450,1083,8367,88.5,70,30,42.9
10,All Students,2018-19,9582,1514,8068,84.2,62,30,48.4
10,All Students,2019-20,7972,1175,6797,85.3,82,30,36.6
10,All Students,2020-21,10579,1104,9475,89.6,65,13,20.0
10,All Students,2021-22,11245,1546,9699,86.3,76,31,40.8
10,All Students,2022-23,8588,753,7835,91.2,60,18,30.0
11,All Students,2018-19,8394,864,7530,89.7,56,20,35.7
11,All Students,2019-20,5438,512,4926,90.6,55,13,23.6
11,All Students,2020-21,9844,568,9276,94.2,57,6,10.5
11,All Students,2021-22,8307,975,7332,88.3,52,19,36.5
11,All Students,2022-23,10557,1153,9404,89.1,67,21,31.3
12,All Students,2018-19,6054,808,5246,86.7,40,23,57.5
12,All Students,2019-20,4852,521,4331,89.3,45,20,44.4
12,All Students,2020-21,7950,234,7716,97.1,48,2,4.2
12,All Students,2021-22,10551,461,10090,95.6,67,9,13.4
12,All Students,2022-23,7216,227,6989,96.9,52,5,9.6
All Grades,All Students,2018-19,58849,6183,52666,89.5,378,104,27.5
All Grades,All Students,2019-20,36312,4102,32210,88.7,343,99,28.9
All Grades,All Students,2020-21,48450,10433,38017,78.5,285,129,45.3
All Grades,All Students,2021-22,39205,8146,31059,79.2,263,171,65.0
All Grades,All Students,2022-23,29799,4941,24858,83.4,200,110,55.0
8,All Students,2018-19,3990,176,3814,95.6,24,3,12.5
9,All Students,2018-19,12968,1479,11489,88.6,85,21,24.7
9,All Students,2019-20,9984,1111,8873,88.9,96,24,25.0
9,All Students,2020-21,5237,1073,4164,79.5,32,16,50.0
9,All Students,2021-22,5852,1337,4515,77.2,44,31,70.5
9,All Students,2022-23,6227,956,5271,84.6,46,26,56.5
10,All Students,2018-19,12661,1415,11246,88.8,84,26,31.0
10,All Students,2019-20,9390,844,8546,91.0,89,22,24.7
10,All Students,2020-21,15212,3344,11868,78.0,90,38,42.2
10,All Students,2021-22,6090,1538,4552,74.7,46,33,71.7
10,All Students,2022-23,5670,1121,4549,80.2,39,24,61.5
11,All Students,2018-19,12975,1277,11698,90.2,82,21,25.6
11,All Students,2019-20,8797,1059,7738,88.0,83,26,31.3
11,All Students,2020-21,14212,2542,11670,82.1,83,30,36.1
11,All Students,2021-22,13608,2445,11163,82.0,86,48,55.8
11,All Students,2022-23,6010,1263,4747,79.0,38,24,63.2
12,All Students,2018-19,16255,1836,14419,88.7,103,33,32.0
12,All Students,2019-20,8141,1088,7053,86.6,75,27,36.0
12,All Students,2020-21,13789,3474,10315,74.8,80,45,56.3
12,All Students,2021-22,13655,2826,10829,79.3,87,59,67.8
12,All Students,2022-23,11892,1601,10291,86.5,77,36,46.8
All Grades,All Students,2018-19,78691,5585,73106,92.9,466,118,25.3
All Grades,All Students,2019-20,51207,3076,48131,94.0,469,75,16.0
All Grades,All Students,2020-21,74033,7608,66425,89.7,445,164,36.9
All Grades,All Students,2021-22,78161,7614,70547,90.3,470,174,37.0
All Grades,All Students,2022-23,77233,6450,70783,91.6,459,141,30.7
PK in K-12 Schools,All Students,2018-19,10774,1130,9644,89.5,65,27,41.5
PK in K-12 Schools,All Students,2019-20,7768,732,7036,90.6,77,24,31.2
PK in K-12 Schools,All Students,2020-21,6520,925,5595,85.8,41,25,61.0
PK in K-12 Schools,All Students,2021-22,13275,2234,11041,83.2,86,58,67.4
PK in K-12 Schools,All Students,2022-23,13471,1533,11938,88.6,81,31,38.3
0K,All Students,2018-19,13030,941,12089,92.8,75,22,29.3
0K,All Students,2019-20,7522,511,7011,93.2,71,16,22.5
0K,All Students,2020-21,12307,1996,10311,83.8,77,42,54.5
0K,All Students,2021-22,12415,1399,11016,88.7,74,31,41.9
0K,All Students,2022-23,11675,1263,10412,89.2,69,33,47.8
1,All Students,2018-19,10618,792,9826,92.5,66,21,31.8
1,All Students,2019-20,8063,438,7625,94.6,73,8,11.0
1,All Students,2020-21,10827,1067,9760,90.1,65,21,32.3
1,All Students,2021-22,10788,1014,9774,90.6,63,22,34.9
1,All Students,2022-23,11838,985,10853,91.7,72,23,31.9
2,All Students,2018-19,10020,691,9329,93.1,59,13,22.0
2,All Students,2019-20,6111,377,5734,93.8,54,10,18.5
2,All Students,2020-21,11533,1000,10533,91.3,69,21,30.4
2,All Students,2021-22,10452,761,9691,92.7,61,17,27.9
2,All Students,2022-23,9304,684,8620,92.6,55,17,30.9
3,All Students,2018-19,12146,774,11372,93.6,73,13,17.8
3,All Students,2019-20,7078,387,6691,94.5,65,5,7.7
3,All Students,2020-21,10310,870,9440,91.6,61,23,37.7
3,All Students,2021-22,12124,905,11219,92.5,71,20,28.2
3,All Students,2022-23,11540,810,10730,93.0,66,15,22.7
4,All Students,2018-19,12079,696,11383,94.2,70,14,20.0
4,All Students,2019-20,7974,371,7603,95.3,70,9,12.9
4,All Students,2020-21,10935,1018,9917,90.7,65,17,26.2
4,All Students,2021-22,8527,626,7901,92.7,53,13,24.5
4,All Students,2022-23,10678,601,10077,94.4,63,11,17.5
5,All Students,2018-19,10024,561,9463,94.4,58,8,13.8
5,All Students,2019-20,6691,260,6431,96.1,59,3,5.1
5,All Students,2020-21,11601,732,10869,93.7,67,15,22.4
5,All Students,2021-22,10580,675,9905,93.6,62,13,21.0
5,All Students,2022-23,8727,574,8153,93.4,53,11,20.8
All Grades,All Students,2018-19,74707,10353,64354,86.1,486,196,40.3
All Grades,All Students,2019-20,50604,9639,40965,81.0,489,255,52.1
All Grades,All Students,2020-21,77451,11772,65679,84.8,492,235,47.8
All Grades,All Students,2021-22,76374,11896,64478,84.4,506,237,46.8
All Grades,All Students,2022-23,77411,3551,73860,95.4,517,79,15.3
8,All Students,2021-22,54,s,s,s,s,s,s
9,All Students,2018-19,23004,3841,19163,83.3,153,53,34.6
9,All Students,2019-20,13679,2925,10754,78.6,136,64,47.1
9,All Students,2020-21,23127,4197,18930,81.9,153,80,52.3
9,All Students,2021-22,25620,3657,21963,85.7,167,77,46.1
9,All Students,2022-23,19639,1038,18601,94.7,141,24,17.0
10,All Students,2018-19,21070,2171,18899,89.7,136,40,29.4
10,All Students,2019-20,13804,2665,11139,80.7,132,68,51.5
10,All Students,2020-21,19034,3043,15991,84.0,118,62,52.5
10,All Students,2021-22,18552,2710,15842,85.4,120,53,44.2
10,All Students,2022-23,23441,1166,22275,95.0,154,28,18.2
11,All Students,2018-19,16737,2061,14676,87.7,109,49,45.0
11,All Students,2019-20,11955,2058,9897,82.8,114,59,51.8
11,All Students,2020-21,18126,2558,15568,85.9,110,48,43.6
11,All Students,2021-22,17803,3329,14474,81.3,118,61,51.7
11,All Students,2022-23,17182,547,16635,96.8,111,10,9.0
12,All Students,2018-19,13896,2280,11616,83.6,88,54,61.4
12,All Students,2019-20,11166,1991,9175,82.2,107,64,59.8
12,All Students,2020-21,17164,1974,15190,88.5,111,45,40.5
12,All Students,2021-22,14345,s,s,s,s,s,s
12,All Students,2022-23,17149,800,16349,95.3,111,17,15.3
All Grades,All Students,2018-19,50333,8183,42150,83.7,337,139,41.2
All Grades,All Students,2019-20,32288,4872,27416,84.9,317,109,34.4
All Grades,All Students,2020-21,44466,8277,36189,81.4,285,151,53.0
All Grades,All Students,2021-22,38987,7180,31807,81.6,269,157,58.4
All Grades,All Students,2022-23,37026,5233,31793,85.9,261,124,47.5
9,All Students,2018-19,10815,1141,9674,89.4,85,33,38.8
9,All Students,2019-20,7874,896,6978,88.6,79,25,31.6
9,All Students,2020-21,9334,1153,8181,87.6,58,21,36.2
9,All Students,2021-22,8408,1202,7206,85.7,68,34,50.0
9,All Students,2022-23,8035,1163,6872,85.5,65,32,49.2
10,All Students,2018-19,14528,2449,12079,83.1,97,41,42.3
10,All Students,2019-20,8744,1235,7509,85.9,90,31,34.4
10,All Students,2020-21,12345,2322,10023,81.2,84,48,57.1
10,All Students,2021-22,10561,1980,8581,81.3,76,39,51.3
10,All Students,2022-23,9718,1372,8346,85.9,69,30,43.5
11,All Students,2018-19,12691,2307,10384,81.8,81,33,40.7
11,All Students,2019-20,9308,1641,7667,82.4,88,37,42.0
11,All Students,2020-21,12129,2293,9836,81.1,78,37,47.4
11,All Students,2021-22,11679,2589,9090,77.8,75,51,68.0
11,All Students,2022-23,10361,1079,9282,89.6,70,25,35.7
12,All Students,2018-19,12299,2286,10013,81.4,74,32,43.2
12,All Students,2019-20,6362,1100,5262,82.7,61,17,27.9
12,All Students,2020-21,10658,2509,8149,76.5,65,45,69.2
12,All Students,2021-22,8339,1409,6930,83.1,50,33,66.0
12,All Students,2022-23,8912,1619,7293,81.8,57,37,64.9
All Grades,All Students,2018-19,98299,3380,94919,96.6,586,48,8.2
All Grades,All Students,2019-20,69592,2445,67147,96.5,631,57,9.0
All Grades,All Students,2020-21,113084,8880,104204,92.1,651,159,24.4
All Grades,All Students,2021-22,107545,9053,98492,91.6,634,163,25.7
All Grades,All Students,2022-23,102240,4013,98227,96.1,615,71,11.5
6,All Students,2018-19,15715,537,15178,96.6,92,5,5.4
6,All Students,2019-20,9585,378,9207,96.1,85,10,11.8
6,All Students,2020-21,15304,857,14447,94.4,88,10,11.4
6,All Students,2021-22,3710,191,3519,94.9,22,5,22.7
6,All Students,2022-23,9060,442,8618,95.1,52,6,11.5
7,All Students,2018-19,11986,456,11530,96.2,69,9,13.0
7,All Students,2019-20,10341,302,10039,97.1,93,3,3.2
7,All Students,2020-21,13463,872,12591,93.5,78,14,17.9
7,All Students,2021-22,14184,1092,13092,92.3,81,22,27.2
7,All Students,2022-23,4056,245,3811,94.0,24,5,20.8
8,All Students,2018-19,11203,336,10867,97.0,64,3,4.7
8,All Students,2019-20,8195,255,7940,96.9,73,4,5.5
8,All Students,2020-21,15854,1311,14543,91.7,92,26,28.3
8,All Students,2021-22,13422,943,12479,93.0,77,16,20.8
8,All Students,2022-23,12962,191,12771,98.5,77,4,5.2
9,All Students,2018-19,13951,383,13568,97.3,86,5,5.8
9,All Students,2019-20,11946,283,11663,97.6,109,7,6.4
9,All Students,2020-21,19873,2062,17811,89.6,114,42,36.8
9,All Students,2021-22,26218,1756,24462,93.3,157,30,19.1
9,All Students,2022-23,19001,832,18169,95.6,117,15,12.8
10,All Students,2018-19,15040,416,14624,97.2,92,4,4.3
10,All Students,2019-20,9734,346,9388,96.4,91,9,9.9
10,All Students,2020-21,18104,1749,16355,90.3,104,29,27.9
10,All Students,2021-22,18062,1431,16631,92.1,108,26,24.1
10,All Students,2022-23,24193,408,23785,98.3,147,4,2.7
11,All Students,2018-19,15357,514,14843,96.7,92,8,8.7
11,All Students,2019-20,9671,389,9282,96.0,88,8,9.1
11,All Students,2020-21,15472,1102,14370,92.9,89,24,27.0
11,All Students,2021-22,17063,1861,15202,89.1,101,39,38.6
11,All Students,2022-23,16349,849,15500,94.8,98,13,13.3
12,All Students,2018-19,15047,738,14309,95.1,91,14,15.4
12,All Students,2019-20,10120,492,9628,95.1,92,16,17.4
12,All Students,2020-21,15014,927,14087,93.8,86,14,16.3
12,All Students,2021-22,14886,1779,13107,88.0,88,25,28.4
12,All Students,2022-23,16619,1046,15573,93.7,100,24,24.0
All Grades,All Students,2018-19,76974,5814,71160,92.4,469,97,20.7
All Grades,All Students,2019-20,52370,3660,48710,93.0,492,115,23.4
All Grades,All Students,2020-21,90038,15460,74578,82.8,518,236,45.6
All Grades,All Students,2021-22,83298,12577,70721,84.9,523,274,52.4
All Grades,All Students,2022-23,72495,9560,62935,86.8,459,195,42.5
8,All Students,2021-22,5,s,s,s,s,s,s
9,All Students,2018-19,22970,1348,21622,94.1,141,26,18.4
9,All Students,2019-20,13611,937,12674,93.1,130,32,24.6
9,All Students,2020-21,26086,3666,22420,85.9,151,61,40.4
9,All Students,2021-22,18101,s,s,s,s,s,s
9,All Students,2022-23,15119,1877,13242,87.6,95,29,30.5
10,All Students,2018-19,18431,1346,17085,92.7,113,17,15.0
10,All Students,2019-20,14988,961,14027,93.6,144,38,26.4
10,All Students,2020-21,20982,4067,16915,80.6,120,57,47.5
10,All Students,2021-22,23011,3442,19569,85.0,144,71,49.3
10,All Students,2022-23,16904,2180,14724,87.1,109,42,38.5
11,All Students,2018-19,18014,1396,16618,92.3,110,21,19.1
11,All Students,2019-20,12035,676,11359,94.4,110,16,14.5
11,All Students,2020-21,24250,4685,19565,80.7,139,68,48.9
11,All Students,2021-22,21100,2990,18110,85.8,128,62,48.4
11,All Students,2022-23,21687,3012,18675,86.1,141,69,48.9
12,All Students,2018-19,17559,1724,15835,90.2,105,33,31.4
12,All Students,2019-20,11736,1086,10650,90.7,108,29,26.9
12,All Students,2020-21,18720,3042,15678,83.8,108,50,46.3
12,All Students,2021-22,21081,3699,17382,82.5,127,85,66.9
12,All Students,2022-23,18785,2491,16294,86.7,114,55,48.2
All Grades,All Students,2018-19,62332,5942,56390,90.5,394,98,24.9
All Grades,All Students,2019-20,37457,3457,34000,90.8,356,92,25.8
All Grades,All Students,2020-21,55779,7631,48148,86.3,337,120,35.6
All Grades,All Students,2021-22,52853,5699,47154,89.2,335,119,35.5
All Grades,All Students,2022-23,42669,5392,37277,87.4,289,130,45.0
9,All Students,2018-19,12191,1063,11128,91.3,84,17,20.2
9,All Students,2019-20,10324,636,9688,93.8,97,18,18.6
9,All Students,2020-21,11243,892,10351,92.1,73,22,30.1
9,All Students,2021-22,15616,1174,14442,92.5,101,31,30.7
9,All Students,2022-23,8011,1015,6996,87.3,58,25,43.1
10,All Students,2018-19,16294,1611,14683,90.1,103,26,25.2
10,All Students,2019-20,8426,934,7492,88.9,83,22,26.5
10,All Students,2020-21,15915,2217,13698,86.1,95,38,40.0
10,All Students,2021-22,10546,988,9558,90.6,69,19,27.5
10,All Students,2022-23,11993,1419,10574,88.2,79,37,46.8
11,All Students,2018-19,14000,1251,12749,91.1,87,26,29.9
11,All Students,2019-20,9789,1052,8737,89.3,95,28,29.5
11,All Students,2020-21,13227,2017,11210,84.8,77,23,29.9
11,All Students,2021-22,13785,1535,12250,88.9,86,33,38.4
11,All Students,2022-23,9522,1346,8176,85.9,65,32,49.2
12,All Students,2018-19,19847,2017,17830,89.8,120,29,24.2
12,All Students,2019-20,8918,835,8083,90.6,83,26,31.3
12,All Students,2020-21,15394,2505,12889,83.7,92,37,40.2
12,All Students,2021-22,12906,2002,10904,84.5,79,36,45.6
12,All Students,2022-23,13143,1612,11531,87.7,87,36,41.4
All Grades,All Students,2018-19,48658,7887,40771,83.8,309,137,44.3
All Grades,All Students,2019-20,30497,4691,25806,84.6,289,121,41.9
All Grades,All Students,2020-21,49824,10548,39276,78.8,294,163,55.4
All Grades,All Students,2021-22,41066,7756,33310,81.1,276,172,62.3
All Grades,All Students,2022-23,33135,4907,28228,85.2,228,99,43.4
8,All Students,2019-20,6,s,s,s,s,s,s
9,All Students,2018-19,16796,2571,14225,84.7,107,42,39.3
9,All Students,2019-20,7427,850,6577,88.6,71,23,32.4
9,All Students,2020-21,10982,1901,9081,82.7,68,35,51.5
9,All Students,2021-22,10530,1899,8631,82.0,67,36,53.7
9,All Students,2022-23,9117,897,8220,90.2,61,22,36.1
10,All Students,2018-19,12799,2055,10744,83.9,82,32,39.0
10,All Students,2019-20,9503,1274,8229,86.6,91,37,40.7
10,All Students,2020-21,11782,2766,9016,76.5,69,39,56.5
10,All Students,2021-22,9442,1654,7788,82.5,64,35,54.7
10,All Students,2022-23,9654,1410,8244,85.4,66,28,42.4
11,All Students,2018-19,9538,1720,7818,82.0,60,26,43.3
11,All Students,2019-20,7922,1229,6693,84.5,76,33,43.4
11,All Students,2020-21,15029,2616,12413,82.6,86,42,48.8
11,All Students,2021-22,10153,1930,8223,81.0,67,43,64.2
11,All Students,2022-23,7517,963,6554,87.2,46,19,41.3
12,All Students,2018-19,9525,1541,7984,83.8,60,37,61.7
12,All Students,2019-20,5639,s,s,s,s,s,s
12,All Students,2020-21,12031,3265,8766,72.9,71,47,66.2
12,All Students,2021-22,10941,2273,8668,79.2,78,58,74.4
12,All Students,2022-23,6847,1637,5210,76.1,55,30,54.5
All Grades,All Students,2018-19,223866,11157,212709,95.0,1347,206,15.3
All Grades,All Students,2019-20,156182,10404,145778,93.3,1431,321,22.4
All Grades,All Students,2020-21,260104,18108,241996,93.0,1496,283,18.9
All Grades,All Students,2021-22,244460,6420,238040,97.4,1458,85,5.8
All Grades,All Students,2022-23,223525,10728,212797,95.2,1365,180,13.2
6,All Students,2018-19,31186,508,30678,98.4,180,1,0.6
6,All Students,2019-20,22935,642,22293,97.2,205,10,4.9
6,All Students,2020-21,36505,847,35658,97.7,211,7,3.3
6,All Students,2021-22,30529,675,29854,97.8,185,9,4.9
6,All Students,2022-23,25189,1014,24175,96.0,149,11,7.4
7,All Students,2018-19,25588,436,25152,98.3,145,3,2.1
7,All Students,2019-20,19470,642,18828,96.7,177,6,3.4
7,All Students,2020-21,33649,1422,32227,95.8,194,24,12.4
7,All Students,2021-22,33278,523,32755,98.4,195,4,2.1
7,All Students,2022-23,26420,1247,25173,95.3,153,15,9.8
8,All Students,2018-19,19361,567,18794,97.1,112,7,6.3
8,All Students,2019-20,15909,670,15239,95.8,141,17,12.1
8,All Students,2020-21,29173,1026,28147,96.5,167,9,5.4
8,All Students,2021-22,29693,433,29260,98.5,176,4,2.3
8,All Students,2022-23,29048,1330,27718,95.4,173,16,9.2
9,All Students,2018-19,39002,1031,37971,97.4,239,14,5.9
9,All Students,2019-20,24830,1276,23554,94.9,231,39,16.9
9,All Students,2020-21,41410,1908,39502,95.4,240,26,10.8
9,All Students,2021-22,39010,747,38263,98.1,238,8,3.4
9,All Students,2022-23,40166,1528,38638,96.2,253,26,10.3
10,All Students,2018-19,41355,1493,39862,96.4,256,23,9.0
10,All Students,2019-20,25268,1887,23381,92.5,235,64,27.2
10,All Students,2020-21,38574,2984,35590,92.3,222,42,18.9
10,All Students,2021-22,39810,789,39021,98.0,240,10,4.2
10,All Students,2022-23,35775,2032,33743,94.3,225,34,15.1
11,All Students,2018-19,34589,2272,32317,93.4,215,45,20.9
11,All Students,2019-20,26127,1957,24170,92.5,240,64,26.7
11,All Students,2020-21,39681,4494,35187,88.7,227,72,31.7
11,All Students,2021-22,35833,1012,34821,97.2,213,11,5.2
11,All Students,2022-23,34675,1760,32915,94.9,216,36,16.7
12,All Students,2018-19,32785,4850,27935,85.2,200,113,56.5
12,All Students,2019-20,21643,3330,18313,84.6,202,121,59.9
12,All Students,2020-21,41112,5427,35685,86.8,235,103,43.8
12,All Students,2021-22,36307,2241,34066,93.8,211,39,18.5
12,All Students,2022-23,32252,1817,30435,94.4,196,42,21.4
All Grades,All Students,2018-19,196694,25135,171559,87.2,1231,455,37.0
All Grades,All Students,2019-20,136397,17730,118667,87.0,1271,501,39.4
All Grades,All Students,2020-21,217220,46185,171035,78.7,1320,742,56.2
All Grades,All Students,2021-22,220684,43178,177506,80.4,1396,844,60.5
All Grades,All Students,2022-23,187959,16716,171243,91.1,1249,337,27.0
9,All Students,2018-19,62121,9157,52964,85.3,403,154,38.2
9,All Students,2019-20,44244,6610,37634,85.1,418,171,40.9
9,All Students,2020-21,72953,20805,52148,71.5,445,304,68.3
9,All Students,2021-22,73913,16523,57390,77.6,477,285,59.7
9,All Students,2022-23,56596,7040,49556,87.6,391,134,34.3
10,All Students,2018-19,52666,7099,45567,86.5,328,125,38.1
10,All Students,2019-20,38343,4661,33682,87.8,358,132,36.9
10,All Students,2020-21,56625,10394,46231,81.6,342,170,49.7
10,All Students,2021-22,52756,9743,43013,81.5,344,212,61.6
10,All Students,2022-23,50844,3401,47443,93.3,346,74,21.4
11,All Students,2018-19,40730,3588,37142,91.2,248,64,25.8
11,All Students,2019-20,24870,2238,22632,91.0,231,68,29.4
11,All Students,2020-21,44129,6565,37564,85.1,266,125,47.0
11,All Students,2021-22,45302,7096,38206,84.3,282,153,54.3
11,All Students,2022-23,39072,2172,36900,94.4,250,45,18.0
12,All Students,2018-19,41177,5291,35886,87.2,252,112,44.4
12,All Students,2019-20,28940,4221,24719,85.4,264,130,49.2
12,All Students,2020-21,43513,8421,35092,80.6,267,143,53.6
12,All Students,2021-22,48713,9816,38897,79.8,293,194,66.2
12,All Students,2022-23,41447,4103,37344,90.1,262,84,32.1
All Grades,All Students,2018-19,64900,4299,60601,93.4,382,87,22.8
All Grades,All Students,2019-20,36908,2449,34459,93.4,337,64,19.0
All Grades,All Students,2020-21,53036,4067,48969,92.3,318,77,24.2
All Grades,All Students,2021-22,52710,3796,48914,92.8,318,75,23.6
All Grades,All Students,2022-23,50480,4947,45533,90.2,298,117,39.3
PK in K-12 Schools,All Students,2018-19,6350,464,5886,92.7,38,9,23.7
PK in K-12 Schools,All Students,2019-20,4112,336,3776,91.8,36,12,33.3
PK in K-12 Schools,All Students,2020-21,5527,524,5003,90.5,35,11,31.4
PK in K-12 Schools,All Students,2021-22,8741,555,8186,93.7,51,11,21.6
PK in K-12 Schools,All Students,2022-23,8914,946,7968,89.4,52,19,36.5
0K,All Students,2018-19,9242,545,8697,94.1,53,9,17.0
0K,All Students,2019-20,5491,461,5030,91.6,52,14,26.9
0K,All Students,2020-21,7473,716,6757,90.4,45,14,31.1
0K,All Students,2021-22,7676,580,7096,92.4,48,13,27.1
0K,All Students,2022-23,7646,598,7048,92.2,44,11,25.0
1,All Students,2018-19,11684,815,10869,93.0,70,14,20.0
1,All Students,2019-20,5033,310,4723,93.8,46,6,13.0
1,All Students,2020-21,7666,643,7023,91.6,46,12,26.1
1,All Students,2021-22,7980,610,7370,92.4,47,15,31.9
1,All Students,2022-23,7978,983,6995,87.7,48,27,56.3
2,All Students,2018-19,10995,635,10360,94.2,64,13,20.3
2,All Students,2019-20,6049,385,5664,93.6,57,10,17.5
2,All Students,2020-21,6770,434,6336,93.6,40,8,20.0
2,All Students,2021-22,6113,382,5731,93.8,37,6,16.2
2,All Students,2022-23,6196,610,5586,90.2,37,15,40.5
3,All Students,2018-19,9916,589,9327,94.1,59,10,16.9
3,All Students,2019-20,5659,348,5311,93.9,52,9,17.3
3,All Students,2020-21,8992,745,8247,91.7,53,14,26.4
3,All Students,2021-22,6548,386,6162,94.1,40,6,15.0
3,All Students,2022-23,5806,476,5330,91.8,34,9,26.5
4,All Students,2018-19,7649,520,7129,93.2,46,12,26.1
4,All Students,2019-20,5751,313,5438,94.6,51,7,13.7
4,All Students,2020-21,8278,544,7734,93.4,49,10,20.4
4,All Students,2021-22,7031,590,6441,91.6,44,11,25.0
4,All Students,2022-23,6277,557,5720,91.1,37,14,37.8
5,All Students,2018-19,9064,731,8333,91.9,52,20,38.5
5,All Students,2019-20,4813,296,4517,93.8,43,6,14.0
5,All Students,2020-21,8330,461,7869,94.5,50,8,16.0
5,All Students,2021-22,8621,693,7928,92.0,51,13,25.5
5,All Students,2022-23,7663,777,6886,89.9,46,22,47.8
All Grades,All Students,2018-19,46854,3092,43762,93.4,280,60,21.4
All Grades,All Students,2019-20,28630,1740,26890,93.9,263,51,19.4
All Grades,All Students,2020-21,41461,2241,39220,94.6,248,45,18.1
All Grades,All Students,2021-22,37247,2987,34260,92.0,226,67,29.6
All Grades,All Students,2022-23,43434,4041,39393,90.7,270,87,32.2
5,All Students,2020-21,7,s,s,s,s,s,s
6,All Students,2018-19,16425,1261,15164,92.3,96,21,21.9
6,All Students,2019-20,6198,367,5831,94.1,58,8,13.8
6,All Students,2020-21,15306,903,14403,94.1,92,17,18.5
6,All Students,2021-22,11202,907,10295,91.9,69,23,33.3
6,All Students,2022-23,14857,1197,13660,91.9,93,26,28.0
7,All Students,2018-19,17254,930,16324,94.6,105,24,22.9
7,All Students,2019-20,11202,726,10476,93.5,104,24,23.1
7,All Students,2020-21,9783,s,s,s,s,s,s
7,All Students,2021-22,15673,1276,14397,91.9,95,28,29.5
7,All Students,2022-23,12754,1284,11470,89.9,79,27,34.2
8,All Students,2018-19,13175,901,12274,93.2,79,15,19.0
8,All Students,2019-20,11230,647,10583,94.2,101,19,18.8
8,All Students,2020-21,16365,833,15532,94.9,97,15,15.5
8,All Students,2021-22,10372,804,9568,92.2,62,16,25.8
8,All Students,2022-23,15823,1560,14263,90.1,98,34,34.7
All Grades,All Students,2018-19,69527,6063,63464,91.3,431,109,25.3
All Grades,All Students,2019-20,50371,4697,45674,90.7,463,124,26.8
All Grades,All Students,2020-21,89737,10735,79002,88.0,519,143,27.6
All Grades,All Students,2021-22,89514,12200,77314,86.4,538,242,45.0
All Grades,All Students,2022-23,78089,9402,68687,88.0,484,196,40.5
9,All Students,2018-19,21704,1887,19817,91.3,137,34,24.8
9,All Students,2019-20,16301,1737,14564,89.3,153,45,29.4
9,All Students,2020-21,32477,4207,28270,87.0,188,58,30.9
9,All Students,2021-22,27325,4325,23000,84.2,166,81,48.8
9,All Students,2022-23,16302,2804,13498,82.8,104,49,47.1
10,All Students,2018-19,16562,1288,15274,92.2,108,30,27.8
10,All Students,2019-20,13155,1013,12142,92.3,120,26,21.7
10,All Students,2020-21,23206,3194,20012,86.2,136,39,28.7
10,All Students,2021-22,25680,2996,22684,88.3,155,57,36.8
10,All Students,2022-23,21477,2595,18882,87.9,135,63,46.7
11,All Students,2018-19,16956,1514,15442,91.1,101,21,20.8
11,All Students,2019-20,10132,1143,8989,88.7,93,33,35.5
11,All Students,2020-21,18744,1528,17216,91.8,107,19,17.8
11,All Students,2021-22,18684,2218,16466,88.1,113,45,39.8
11,All Students,2022-23,22507,2076,20431,90.8,138,42,30.4
12,All Students,2018-19,14305,1374,12931,90.4,85,24,28.2
12,All Students,2019-20,10783,804,9979,92.5,97,20,20.6
12,All Students,2020-21,15310,1806,13504,88.2,88,27,30.7
12,All Students,2021-22,17825,2661,15164,85.1,104,59,56.7
12,All Students,2022-23,17803,1927,15876,89.2,107,42,39.3
All Grades,All Students,2018-19,49588,6694,42894,86.5,321,148,46.1
All Grades,All Students,2019-20,29943,4159,25784,86.1,287,126,43.9
All Grades,All Students,2020-21,48431,9686,38745,80.0,279,133,47.7
All Grades,All Students,2021-22,41484,8717,32767,79.0,275,195,70.9
All Grades,All Students,2022-23,36732,6950,29782,81.1,249,172,69.1
9,All Students,2018-19,11438,1478,9960,87.1,81,34,42.0
9,All Students,2019-20,7784,1002,6782,87.1,74,32,43.2
9,All Students,2020-21,14410,2220,12190,84.6,83,30,36.1
9,All Students,2021-22,9894,1558,8336,84.3,70,42,60.0
9,All Students,2022-23,9827,1831,7996,81.4,69,42,60.9
10,All Students,2018-19,12259,1804,10455,85.3,80,33,41.3
10,All Students,2019-20,7294,1121,6173,84.6,73,32,43.8
10,All Students,2020-21,12969,3347,9622,74.2,75,42,56.0
10,All Students,2021-22,11103,2071,9032,81.3,76,51,67.1
10,All Students,2022-23,8876,1672,7204,81.2,63,38,60.3
11,All Students,2018-19,14299,1696,12603,88.1,88,40,45.5
11,All Students,2019-20,6340,919,5421,85.5,60,26,43.3
11,All Students,2020-21,10854,1959,8895,82.0,62,26,41.9
11,All Students,2021-22,11657,2732,8925,76.6,72,55,76.4
11,All Students,2022-23,8795,1430,7365,83.7,56,37,66.1
12,All Students,2018-19,11592,1716,9876,85.2,72,41,56.9
12,All Students,2019-20,8525,1117,7408,86.9,80,36,45.0
12,All Students,2020-21,10198,2160,8038,78.8,59,35,59.3
12,All Students,2021-22,8830,2356,6474,73.3,57,47,82.5
12,All Students,2022-23,9234,2017,7217,78.2,61,55,90.2
All Grades,All Students,2018-19,56584,3898,52686,93.1,342,85,24.9
All Grades,All Students,2019-20,33438,2233,31205,93.3,310,74,23.9
All Grades,All Students,2020-21,49413,2422,46991,95.1,295,48,16.3
All Grades,All Students,2021-22,51204,5150,46054,89.9,311,117,37.6
All Grades,All Students,2022-23,51567,4754,46813,90.8,316,115,36.4
PK in K-12 Schools,All Students,2018-19,7892,675,7217,91.4,48,17,35.4
PK in K-12 Schools,All Students,2019-20,5266,493,4773,90.6,52,20,38.5
PK in K-12 Schools,All Students,2020-21,5848,427,5421,92.7,37,12,32.4
PK in K-12 Schools,All Students,2021-22,5046,580,4466,88.5,33,15,45.5
PK in K-12 Schools,All Students,2022-23,8548,984,7564,88.5,51,24,47.1
0K,All Students,2018-19,10225,714,9511,93.0,61,13,21.3
0K,All Students,2019-20,5688,468,5220,91.8,58,15,25.9
0K,All Students,2020-21,10153,693,9460,93.2,61,15,24.6
0K,All Students,2021-22,9417,1122,8295,88.1,58,27,46.6
0K,All Students,2022-23,7329,673,6656,90.8,44,17,38.6
1,All Students,2018-19,9242,695,8547,92.5,58,14,24.1
1,All Students,2019-20,5064,296,4768,94.2,44,7,15.9
1,All Students,2020-21,7807,505,7302,93.5,46,11,23.9
1,All Students,2021-22,10450,1120,9330,89.3,65,24,36.9
1,All Students,2022-23,8346,842,7504,89.9,54,21,38.9
2,All Students,2018-19,7953,575,7378,92.8,49,15,30.6
2,All Students,2019-20,4767,346,4421,92.7,45,15,33.3
2,All Students,2020-21,7077,164,6913,97.7,42,1,2.4
2,All Students,2021-22,6381,475,5906,92.6,39,9,23.1
2,All Students,2022-23,9845,843,9002,91.4,59,19,32.2
3,All Students,2018-19,7505,437,7068,94.2,44,9,20.5
3,All Students,2019-20,3860,214,3646,94.5,35,7,20.0
3,All Students,2020-21,7187,292,6895,95.9,43,5,11.6
3,All Students,2021-22,7490,591,6899,92.1,44,15,34.1
3,All Students,2022-23,5337,422,4915,92.1,33,10,30.3
4,All Students,2018-19,7521,426,7095,94.3,46,8,17.4
4,All Students,2019-20,4313,219,4094,94.9,38,6,15.8
4,All Students,2020-21,5131,118,5013,97.7,30,1,3.3
4,All Students,2021-22,6582,673,5909,89.8,39,14,35.9
4,All Students,2022-23,6157,484,5673,92.1,39,11,28.2
5,All Students,2018-19,6246,376,5870,94.0,36,9,25.0
5,All Students,2019-20,4480,197,4283,95.6,39,5,12.8
5,All Students,2020-21,6210,223,5987,96.4,36,3,8.3
5,All Students,2021-22,5838,589,5249,89.9,33,13,39.4
5,All Students,2022-23,6005,506,5499,91.6,36,13,36.1
All Grades,All Students,2018-19,141268,8882,132386,93.7,820,143,17.4
All Grades,All Students,2019-20,87705,5465,82240,93.8,787,151,19.2
All Grades,All Students,2020-21,116926,17369,99557,85.1,693,350,50.5
All Grades,All Students,2021-22,107256,12878,94378,88.0,650,272,41.8
All Grades,All Students,2022-23,101793,10691,91102,89.5,615,251,40.8
PK in K-12 Schools,All Students,2018-19,5569,475,5094,91.5,35,10,28.6
PK in K-12 Schools,All Students,2019-20,3918,327,3591,91.7,37,10,27.0
PK in K-12 Schools,All Students,2020-21,4746,770,3976,83.8,30,18,60.0
PK in K-12 Schools,All Students,2021-22,7678,927,6751,87.9,46,20,43.5
PK in K-12 Schools,All Students,2022-23,7439,983,6456,86.8,47,26,55.3
0K,All Students,2018-19,10166,825,9341,91.9,59,12,20.3
0K,All Students,2019-20,5670,419,5251,92.6,53,17,32.1
0K,All Students,2020-21,8492,1682,6810,80.2,53,28,52.8
0K,All Students,2021-22,8895,1297,7598,85.4,53,25,47.2
0K,All Students,2022-23,7311,s,s,s,s,s,s
1,All Students,2018-19,12585,879,11706,93.0,73,17,23.3
1,All Students,2019-20,7221,424,6797,94.1,65,11,16.9
1,All Students,2020-21,8135,1155,6980,85.8,50,20,40.0
1,All Students,2021-22,6971,840,6131,88.0,44,17,38.6
1,All Students,2022-23,9294,939,8355,89.9,57,23,40.4
2,All Students,2018-19,11620,813,10807,93.0,69,13,18.8
2,All Students,2019-20,8038,514,7524,93.6,73,16,21.9
2,All Students,2020-21,9995,905,9090,90.9,60,14,23.3
2,All Students,2021-22,7247,785,6462,89.2,48,19,39.6
2,All Students,2022-23,7594,566,7028,92.5,45,9,20.0
3,All Students,2018-19,11838,743,11095,93.7,68,10,14.7
3,All Students,2019-20,6538,479,6059,92.7,60,18,30.0
3,All Students,2020-21,12037,1475,10562,87.7,70,27,38.6
3,All Students,2021-22,9070,1048,8022,88.4,54,21,38.9
3,All Students,2022-23,7407,682,6725,90.8,43,14,32.6
4,All Students,2018-19,13877,693,13184,95.0,79,11,13.9
4,All Students,2019-20,8238,514,7724,93.8,72,12,16.7
4,All Students,2020-21,8427,1039,7388,87.7,49,24,49.0
4,All Students,2021-22,10929,1299,9630,88.1,68,30,44.1
4,All Students,2022-23,7607,642,6965,91.6,45,11,24.4
5,All Students,2018-19,14853,831,14022,94.4,86,10,11.6
5,All Students,2019-20,8714,391,8323,95.5,77,6,7.8
5,All Students,2020-21,12085,1187,10898,90.2,72,22,30.6
5,All Students,2021-22,8115,980,7135,87.9,47,21,44.7
5,All Students,2022-23,11652,1037,10615,91.1,69,25,36.2
6,All Students,2018-19,21027,1078,19949,94.9,123,13,10.6
6,All Students,2019-20,11930,684,11246,94.3,107,19,17.8
6,All Students,2020-21,15511,2011,13500,87.0,90,49,54.4
6,All Students,2021-22,15424,2100,13324,86.4,95,48,50.5
6,All Students,2022-23,12289,1393,10896,88.7,76,34,44.7
7,All Students,2018-19,22175,1477,20698,93.3,127,28,22.0
7,All Students,2019-20,13861,722,13139,94.8,123,16,13.0
7,All Students,2020-21,17297,3050,14247,82.4,102,64,62.7
7,All Students,2021-22,16217,1729,14488,89.3,96,33,34.4
7,All Students,2022-23,14952,1672,13280,88.8,92,44,47.8
8,All Students,2018-19,17558,1068,16490,93.9,101,19,18.8
8,All Students,2019-20,13577,991,12586,92.7,121,26,21.5
8,All Students,2020-21,20201,4095,16106,79.7,117,84,71.8
8,All Students,2021-22,16710,1873,14837,88.8,99,38,38.4
8,All Students,2022-23,16233,1855,14378,88.6,97,41,42.3
9,All Students,2022-23,15,s,s,s,s,s,s
All Grades,All Students,2018-19,51264,4392,46872,91.4,302,83,27.5
All Grades,All Students,2019-20,28035,2153,25882,92.3,266,69,25.9
All Grades,All Students,2020-21,40642,6204,34438,84.7,245,123,50.2
All Grades,All Students,2021-22,40340,4547,35793,88.7,257,107,41.6
All Grades,All Students,2022-23,39634,4377,35257,89.0,258,118,45.7
6,All Students,2018-19,13879,1342,12537,90.3,84,24,28.6
6,All Students,2019-20,8622,671,7951,92.2,83,21,25.3
6,All Students,2020-21,13175,2486,10689,81.1,79,55,69.6
6,All Students,2021-22,12400,1540,10860,87.6,81,35,43.2
6,All Students,2022-23,12968,1672,11296,87.1,83,44,53.0
7,All Students,2018-19,15037,1185,13852,92.1,90,26,28.9
7,All Students,2019-20,8491,s,s,s,s,s,s
7,All Students,2020-21,13863,1986,11877,85.7,83,37,44.6
7,All Students,2021-22,12287,1317,10970,89.3,79,31,39.2
7,All Students,2022-23,12993,1414,11579,89.1,90,39,43.3
8,All Students,2018-19,22348,1865,20483,91.7,128,33,25.8
8,All Students,2019-20,10816,750,10066,93.1,104,24,23.1
8,All Students,2020-21,13604,1732,11872,87.3,83,31,37.3
8,All Students,2021-22,15653,1690,13963,89.2,97,41,42.3
8,All Students,2022-23,13673,1291,12382,90.6,85,35,41.2
9,All Students,2019-20,106,s,s,s,s,s,s
All Grades,All Students,2018-19,91939,8941,82998,90.3,572,232,40.6
All Grades,All Students,2019-20,56361,5325,51036,90.6,533,179,33.6
All Grades,All Students,2020-21,73535,10786,62749,85.3,452,216,47.8
All Grades,All Students,2021-22,66658,9680,56978,85.5,407,218,53.6
All Grades,All Students,2022-23,66002,8026,57976,87.8,410,211,51.5
PK in K-12 Schools,All Students,2018-19,9495,1009,8486,89.4,60,25,41.7
PK in K-12 Schools,All Students,2019-20,6027,657,5370,89.1,55,21,38.2
PK in K-12 Schools,All Students,2020-21,5893,1026,4867,82.6,37,23,62.2
PK in K-12 Schools,All Students,2021-22,6780,952,5828,86.0,42,26,61.9
PK in K-12 Schools,All Students,2022-23,8730,1135,7595,87.0,53,27,50.9
0K,All Students,2018-19,14628,1835,12793,87.5,97,51,52.6
0K,All Students,2019-20,8253,949,7304,88.5,83,37,44.6
0K,All Students,2020-21,10718,2170,8548,79.8,71,41,57.7
0K,All Students,2021-22,10876,1970,8906,81.9,71,45,63.4
0K,All Students,2022-23,8863,1275,7588,85.6,60,38,63.3
1,All Students,2018-19,13155,1295,11860,90.2,81,31,38.3
1,All Students,2019-20,8545,1062,7483,87.6,81,33,40.7
1,All Students,2020-21,10622,1524,9098,85.7,66,37,56.1
1,All Students,2021-22,10790,1508,9282,86.0,66,35,53.0
1,All Students,2022-23,9467,1249,8218,86.8,60,36,60.0
2,All Students,2018-19,12625,1364,11261,89.2,77,33,42.9
2,All Students,2019-20,7748,670,7078,91.4,72,20,27.8
2,All Students,2020-21,12483,1626,10857,87.0,75,35,46.7
2,All Students,2021-22,8884,1333,7551,85.0,52,27,51.9
2,All Students,2022-23,10574,1384,9190,86.9,64,36,56.3
3,All Students,2018-19,13326,1066,12260,92.0,80,26,32.5
3,All Students,2019-20,7849,809,7040,89.7,76,27,35.5
3,All Students,2020-21,11188,1402,9786,87.5,67,23,34.3
3,All Students,2021-22,10720,1425,9295,86.7,65,33,50.8
3,All Students,2022-23,9056,1036,8020,88.6,55,27,49.1
4,All Students,2018-19,14556,1201,13355,91.7,92,36,39.1
4,All Students,2019-20,8919,614,8305,93.1,82,21,25.6
4,All Students,2020-21,10610,1343,9267,87.3,65,25,38.5
4,All Students,2021-22,8776,1102,7674,87.4,52,21,40.4
4,All Students,2022-23,10879,1148,9731,89.4,66,29,43.9
5,All Students,2018-19,14154,1171,12983,91.7,85,30,35.3
5,All Students,2019-20,9020,564,8456,93.7,84,20,23.8
5,All Students,2020-21,12021,1695,10326,85.9,71,32,45.1
5,All Students,2021-22,9832,1390,8442,85.9,59,31,52.5
5,All Students,2022-23,8433,799,7634,90.5,52,18,34.6
All Grades,All Students,2018-19,160529,10484,150045,93.5,961,212,22.1
All Grades,All Students,2019-20,99235,6416,92819,93.5,910,204,22.4
All Grades,All Students,2020-21,145518,13715,131803,90.6,870,286,32.9
All Grades,All Students,2021-22,136258,13330,122928,90.2,830,320,38.6
All Grades,All Students,2022-23,131490,13169,118321,90.0,807,331,41.0
PK in K-12 Schools,All Students,2018-19,15469,1376,14093,91.1,99,33,33.3
PK in K-12 Schools,All Students,2019-20,11086,s,s,s,s,s,s
PK in K-12 Schools,All Students,2020-21,14844,s,s,s,s,s,s
PK in K-12 Schools,All Students,2021-22,18109,2382,15727,86.8,114,64,56.1
PK in K-12 Schools,All Students,2022-23,20260,3117,17143,84.6,128,89,69.5
0K,All Students,2018-19,19288,1342,17946,93.0,117,28,23.9
0K,All Students,2019-20,12614,1004,11610,92.0,121,36,29.8
0K,All Students,2020-21,22283,2213,20070,90.1,138,45,32.6
0K,All Students,2021-22,19403,2000,17403,89.7,118,50,42.4
0K,All Students,2022-23,17579,1941,15638,89.0,110,55,50.0
1,All Students,2018-19,22852,1693,21159,92.6,136,36,26.5
1,All Students,2019-20,11885,774,11111,93.5,106,22,20.8
1,All Students,2020-21,19414,1607,17807,91.7,116,36,31.0
1,All Students,2021-22,20422,2051,18371,90.0,121,45,37.2
1,All Students,2022-23,19295,1807,17488,90.6,119,41,34.5
2,All Students,2018-19,22944,1201,21743,94.8,137,25,18.2
2,All Students,2019-20,15020,1052,13968,93.0,136,34,25.0
2,All Students,2020-21,18616,1301,17315,93.0,115,32,27.8
2,All Students,2021-22,19042,1658,17384,91.3,120,44,36.7
2,All Students,2022-23,18357,1665,16692,90.9,113,38,33.6
3,All Students,2018-19,26456,1588,24868,94.0,159,35,22.0
3,All Students,2019-20,14882,783,14099,94.7,138,23,16.7
3,All Students,2020-21,22209,2382,19827,89.3,128,49,38.3
3,All Students,2021-22,17361,1557,15804,91.0,108,38,35.2
3,All Students,2022-23,18735,1628,17107,91.3,115,34,29.6
4,All Students,2018-19,26557,1407,25150,94.7,154,23,14.9
4,All Students,2019-20,17151,962,16189,94.4,155,26,16.8
4,All Students,2020-21,22744,1761,20983,92.3,133,32,24.1
4,All Students,2021-22,20514,1627,18887,92.1,122,33,27.0
4,All Students,2022-23,16926,1355,15571,92.0,103,35,34.0
5,All Students,2018-19,26963,1877,25086,93.0,159,32,20.1
5,All Students,2019-20,16595,886,15709,94.7,148,23,15.5
5,All Students,2020-21,25241,2777,22464,89.0,148,60,40.5
5,All Students,2021-22,21407,2055,19352,90.4,127,46,36.2
5,All Students,2022-23,20338,1656,18682,91.9,119,39,32.8
6,All Students,2019-20,2,s,s,s,s,s,s
6,All Students,2020-21,167,s,s,s,s,s,s
All Grades,All Students,2018-19,91452,6494,84958,92.9,543,135,24.9
All Grades,All Students,2019-20,53158,3775,49383,92.9,479,122,25.5
All Grades,All Students,2020-21,71426,10789,60637,84.9,424,221,52.1
All Grades,All Students,2021-22,64339,8003,56336,87.6,395,174,44.1
All Grades,All Students,2022-23,55996,5207,50789,90.7,341,118,34.6
PK in K-12 Schools,All Students,2018-19,6292,709,5583,88.7,36,17,47.2
PK in K-12 Schools,All Students,2019-20,4035,391,3644,90.3,37,15,40.5
PK in K-12 Schools,All Students,2020-21,3153,580,2573,81.6,19,11,57.9
PK in K-12 Schools,All Students,2021-22,10774,1885,8889,82.5,70,44,62.9
PK in K-12 Schools,All Students,2022-23,8605,938,7667,89.1,53,21,39.6
0K,All Students,2018-19,10791,1108,9683,89.7,68,27,39.7
0K,All Students,2019-20,6866,838,6028,87.8,61,31,50.8
0K,All Students,2020-21,9454,2325,7129,75.4,58,46,79.3
0K,All Students,2021-22,5527,967,4560,82.5,35,24,68.6
0K,All Students,2022-23,7554,889,6665,88.2,48,26,54.2
1,All Students,2018-19,12638,1103,11535,91.3,76,28,36.8
1,All Students,2019-20,6601,390,6211,94.1,62,12,19.4
1,All Students,2020-21,11170,2347,8823,79.0,65,50,76.9
1,All Students,2021-22,9591,1558,8033,83.8,59,38,64.4
1,All Students,2022-23,4469,478,3991,89.3,27,12,44.4
2,All Students,2018-19,14103,894,13209,93.7,85,19,22.4
2,All Students,2019-20,7936,561,7375,92.9,71,18,25.4
2,All Students,2020-21,9401,1215,8186,87.1,57,24,42.1
2,All Students,2021-22,8572,979,7593,88.6,54,16,29.6
2,All Students,2022-23,8545,913,7632,89.3,50,21,42.0
3,All Students,2018-19,16193,1176,15017,92.7,95,23,24.2
3,All Students,2019-20,7901,535,7366,93.2,72,18,25.0
3,All Students,2020-21,11656,1370,10286,88.2,69,30,43.5
3,All Students,2021-22,8245,691,7554,91.6,50,12,24.0
3,All Students,2022-23,8401,753,7648,91.0,53,16,30.2
4,All Students,2018-19,16971,790,16181,95.3,98,13,13.3
4,All Students,2019-20,9962,539,9423,94.6,89,15,16.9
4,All Students,2020-21,11994,1477,10517,87.7,71,34,47.9
4,All Students,2021-22,10861,1015,9846,90.7,63,20,31.7
4,All Students,2022-23,8404,622,7782,92.6,51,12,23.5
5,All Students,2018-19,14464,714,13750,95.1,85,8,9.4
5,All Students,2019-20,9857,521,9336,94.7,87,13,14.9
5,All Students,2020-21,14568,1469,13099,89.9,84,25,29.8
5,All Students,2021-22,10769,908,9861,91.6,64,20,31.3
5,All Students,2022-23,10018,614,9404,93.9,59,10,16.9
All Grades,All Students,2018-19,64898,5383,59515,91.7,390,118,30.3
All Grades,All Students,2019-20,38920,2839,36081,92.7,363,95,26.2
All Grades,All Students,2020-21,52887,5541,47346,89.5,313,113,36.1
All Grades,All Students,2021-22,48131,4777,43354,90.1,311,120,38.6
All Grades,All Students,2022-23,46308,4503,41805,90.3,304,131,43.1
PK in K-12 Schools,All Students,2018-19,5684,525,5159,90.8,35,15,42.9
PK in K-12 Schools,All Students,2019-20,3122,254,2868,91.9,31,11,35.5
PK in K-12 Schools,All Students,2020-21,3958,320,3638,91.9,24,5,20.8
PK in K-12 Schools,All Students,2021-22,6442,926,5516,85.6,48,27,56.3
PK in K-12 Schools,All Students,2022-23,6566,820,5746,87.5,43,23,53.5
0K,All Students,2018-19,7519,577,6942,92.3,46,14,30.4
0K,All Students,2019-20,5452,374,5078,93.1,50,13,26.0
0K,All Students,2020-21,5680,495,5185,91.3,34,10,29.4
0K,All Students,2021-22,6041,651,5390,89.2,38,17,44.7
0K,All Students,2022-23,7141,902,6239,87.4,51,29,56.9
1,All Students,2018-19,8506,799,7707,90.6,53,14,26.4
1,All Students,2019-20,3987,246,3741,93.8,38,7,18.4
1,All Students,2020-21,7904,1041,6863,86.8,46,22,47.8
1,All Students,2021-22,5866,597,5269,89.8,38,14,36.8
1,All Students,2022-23,6424,587,5837,90.9,42,18,42.9
2,All Students,2018-19,12463,895,11568,92.8,73,20,27.4
2,All Students,2019-20,5738,387,5351,93.3,53,13,24.5
2,All Students,2020-21,6312,915,5397,85.5,37,18,48.6
2,All Students,2021-22,6013,504,5509,91.6,40,15,37.5
2,All Students,2022-23,6426,465,5961,92.8,41,14,34.1
3,All Students,2018-19,8532,757,7775,91.1,51,12,23.5
3,All Students,2019-20,8243,604,7639,92.7,77,19,24.7
3,All Students,2020-21,8769,904,7865,89.7,53,18,34.0
3,All Students,2021-22,5840,504,5336,91.4,38,12,31.6
3,All Students,2022-23,6356,530,5826,91.7,44,17,38.6
4,All Students,2018-19,11551,1075,10476,90.7,70,29,41.4
4,All Students,2019-20,5619,395,5224,93.0,51,12,23.5
4,All Students,2020-21,12091,1166,10925,90.4,72,26,36.1
4,All Students,2021-22,7428,614,6814,91.7,45,13,28.9
4,All Students,2022-23,5542,481,5061,91.3,33,14,42.4
5,All Students,2018-19,10643,755,9888,92.9,62,14,22.6
5,All Students,2019-20,6759,579,6180,91.4,64,20,31.3
5,All Students,2020-21,8173,700,7473,91.4,47,14,29.8
5,All Students,2021-22,10501,981,9520,90.7,64,22,34.4
5,All Students,2022-23,7853,718,7135,90.9,50,16,32.0
All Grades,All Students,2018-19,77079,6906,70173,91.0,466,143,30.7
All Grades,All Students,2019-20,39067,3200,35867,91.8,352,86,24.4
All Grades,All Students,2020-21,44183,1054,43129,97.6,261,5,1.9
All Grades,All Students,2021-22,37815,4905,32910,87.0,223,99,44.4
All Grades,All Students,2022-23,34256,3802,30454,88.9,213,78,36.6
6,All Students,2018-19,20394,s,s,s,s,s,s
6,All Students,2019-20,10775,798,9977,92.6,97,18,18.6
6,All Students,2020-21,9998,222,9776,97.8,59,2,3.4
6,All Students,2021-22,12681,1765,10916,86.1,77,35,45.5
6,All Students,2022-23,10554,1034,9520,90.2,67,21,31.3
7,All Students,2018-19,23627,1964,21663,91.7,144,41,28.5
7,All Students,2019-20,13165,1211,11954,90.8,120,39,32.5
7,All Students,2020-21,15824,242,15582,98.5,96,1,1.0
7,All Students,2021-22,10253,s,s,s,s,s,s
7,All Students,2022-23,13899,1734,12165,87.5,86,34,39.5
8,All Students,2018-19,33027,3092,29935,90.6,203,61,30.0
8,All Students,2019-20,15127,1191,13936,92.1,135,29,21.5
8,All Students,2020-21,18361,590,17771,96.8,106,2,1.9
8,All Students,2021-22,14772,1894,12878,87.2,86,37,43.0
8,All Students,2022-23,9803,1034,8769,89.5,60,23,38.3
9,All Students,2021-22,109,s,s,s,s,s,s
10,All Students,2018-19,31,s,s,s,s,s,s
All Grades,All Students,2018-19,76306,6847,69459,91.0,471,167,35.5
All Grades,All Students,2019-20,41914,4156,37758,90.1,394,147,37.3
All Grades,All Students,2020-21,52907,7568,45339,85.7,318,132,41.5
All Grades,All Students,2021-22,54304,7665,46639,85.9,336,180,53.6
All Grades,All Students,2022-23,55052,7233,47819,86.9,350,182,52.0
PK in K-12 Schools,All Students,2018-19,6963,831,6132,88.1,46,23,50.0
PK in K-12 Schools,All Students,2019-20,3624,412,3212,88.6,36,16,44.4
PK in K-12 Schools,All Students,2020-21,3958,410,3548,89.6,23,9,39.1
PK in K-12 Schools,All Students,2021-22,7381,1157,6224,84.3,50,31,62.0
PK in K-12 Schools,All Students,2022-23,8128,1464,6664,82.0,55,40,72.7
0K,All Students,2018-19,9178,1110,8068,87.9,60,34,56.7
0K,All Students,2019-20,5418,633,4785,88.3,53,26,49.1
0K,All Students,2020-21,5892,762,5130,87.1,37,14,37.8
0K,All Students,2021-22,5681,1075,4606,81.1,36,25,69.4
0K,All Students,2022-23,7008,810,6198,88.4,45,24,53.3
1,All Students,2018-19,12314,1109,11205,91.0,77,30,39.0
1,All Students,2019-20,4942,508,4434,89.7,47,19,40.4
1,All Students,2020-21,7787,1101,6686,85.9,47,20,42.6
1,All Students,2021-22,6721,946,5775,85.9,43,24,55.8
1,All Students,2022-23,6515,1067,5448,83.6,42,27,64.3
2,All Students,2018-19,12548,1079,11469,91.4,74,21,28.4
2,All Students,2019-20,6820,684,6136,90.0,64,25,39.1
2,All Students,2020-21,7020,1322,5698,81.2,43,23,53.5
2,All Students,2021-22,8103,1130,6973,86.1,50,23,46.0
2,All Students,2022-23,7003,819,6184,88.3,45,20,44.4
3,All Students,2018-19,11256,877,10379,92.2,68,18,26.5
3,All Students,2019-20,7182,637,6545,91.1,65,16,24.6
3,All Students,2020-21,8474,1433,7041,83.1,51,19,37.3
3,All Students,2021-22,7305,946,6359,87.0,43,25,58.1
3,All Students,2022-23,8604,1149,7455,86.6,52,23,44.2
4,All Students,2018-19,13471,1105,12366,91.8,81,25,30.9
4,All Students,2019-20,7424,669,6755,91.0,69,23,33.3
4,All Students,2020-21,9675,1611,8064,83.3,59,29,49.2
4,All Students,2021-22,9221,1121,8100,87.8,54,24,44.4
4,All Students,2022-23,7573,840,6733,88.9,45,19,42.2
5,All Students,2018-19,10576,736,9840,93.0,65,16,24.6
5,All Students,2019-20,6504,613,5891,90.6,60,22,36.7
5,All Students,2020-21,10101,929,9172,90.8,58,18,31.0
5,All Students,2021-22,9892,1290,8602,87.0,60,28,46.7
5,All Students,2022-23,10221,1084,9137,89.4,66,29,43.9
All Grades,All Students,2018-19,74152,7052,67100,90.5,444,162,36.5
All Grades,All Students,2019-20,38460,3192,35268,91.7,354,107,30.2
All Grades,All Students,2020-21,53206,7425,45781,86.0,318,144,45.3
All Grades,All Students,2021-22,50301,6179,44122,87.7,312,163,52.2
All Grades,All Students,2022-23,54418,5893,48525,89.2,339,134,39.5
PK in K-12 Schools,All Students,2018-19,9017,977,8040,89.2,54,23,42.6
PK in K-12 Schools,All Students,2019-20,5427,496,4931,90.9,50,15,30.0
PK in K-12 Schools,All Students,2020-21,5533,774,4759,86.0,33,18,54.5
PK in K-12 Schools,All Students,2021-22,8512,1526,6986,82.1,56,43,76.8
PK in K-12 Schools,All Students,2022-23,10618,1473,9145,86.1,67,35,52.2
0K,All Students,2018-19,8668,1053,7615,87.9,52,27,51.9
0K,All Students,2019-20,3607,282,3325,92.2,34,9,26.5
0K,All Students,2020-21,8063,1503,6560,81.4,52,31,59.6
0K,All Students,2021-22,6554,723,5831,89.0,41,16,39.0
0K,All Students,2022-23,8543,1210,7333,85.8,58,31,53.4
1,All Students,2018-19,9729,1026,8703,89.5,62,22,35.5
1,All Students,2019-20,4895,419,4476,91.4,46,15,32.6
1,All Students,2020-21,4711,723,3988,84.7,28,14,50.0
1,All Students,2021-22,7061,928,6133,86.9,42,21,50.0
1,All Students,2022-23,7822,715,7107,90.9,48,15,31.3
2,All Students,2018-19,11928,1058,10870,91.1,71,28,39.4
2,All Students,2019-20,5517,553,4964,90.0,51,20,39.2
2,All Students,2020-21,8621,882,7739,89.8,51,19,37.3
2,All Students,2021-22,4999,439,4560,91.2,33,16,48.5
2,All Students,2022-23,6896,624,6272,91.0,44,14,31.8
3,All Students,2018-19,12564,1094,11470,91.3,74,22,29.7
3,All Students,2019-20,5785,485,5300,91.6,53,17,32.1
3,All Students,2020-21,7273,592,6681,91.9,42,13,31.0
3,All Students,2021-22,7551,673,6878,91.1,45,17,37.8
3,All Students,2022-23,5447,416,5031,92.4,32,9,28.1
4,All Students,2018-19,9165,790,8375,91.4,56,16,28.6
4,All Students,2019-20,7615,481,7134,93.7,69,16,23.2
4,All Students,2020-21,8225,1161,7064,85.9,50,21,42.0
4,All Students,2021-22,7103,702,6401,90.1,43,19,44.2
4,All Students,2022-23,7319,578,6741,92.1,44,13,29.5
5,All Students,2018-19,13081,1054,12027,91.9,75,24,32.0
5,All Students,2019-20,5614,476,5138,91.5,51,15,29.4
5,All Students,2020-21,10780,1790,8990,83.4,62,28,45.2
5,All Students,2021-22,8521,1188,7333,86.1,52,31,59.6
5,All Students,2022-23,7773,877,6896,88.7,46,17,37.0
All Grades,All Students,2018-19,215540,10394,205146,95.2,1238,150,12.1
All Grades,All Students,2019-20,134340,5852,128488,95.6,1192,127,10.7
All Grades,All Students,2020-21,193376,8835,184541,95.4,1122,152,13.5
All Grades,All Students,2021-22,177762,17114,160648,90.4,1038,365,35.2
All Grades,All Students,2022-23,167081,14120,152961,91.5,975,296,30.4
PK in K-12 Schools,All Students,2018-19,5257,423,4834,92.0,30,7,23.3
PK in K-12 Schools,All Students,2019-20,3899,272,3627,93.0,37,7,18.9
PK in K-12 Schools,All Students,2020-21,6159,441,5718,92.8,36,8,22.2
PK in K-12 Schools,All Students,2021-22,8773,1115,7658,87.3,54,27,50.0
PK in K-12 Schools,All Students,2022-23,8964,1307,7657,85.4,53,27,50.9
0K,All Students,2018-19,18635,1094,17541,94.1,109,16,14.7
0K,All Students,2019-20,11773,678,11095,94.2,107,16,15.0
0K,All Students,2020-21,20527,1224,19303,94.0,122,20,16.4
0K,All Students,2021-22,14737,1798,12939,87.8,87,39,44.8
0K,All Students,2022-23,14218,1604,12614,88.7,85,42,49.4
1,All Students,2018-19,25211,1472,23739,94.2,147,24,16.3
1,All Students,2019-20,12497,573,11924,95.4,113,9,8.0
1,All Students,2020-21,19988,785,19203,96.1,117,17,14.5
1,All Students,2021-22,21517,2388,19129,88.9,127,55,43.3
1,All Students,2022-23,15215,1266,13949,91.7,88,25,28.4
2,All Students,2018-19,28472,1333,27139,95.3,164,22,13.4
2,All Students,2019-20,16362,820,15542,95.0,147,19,12.9
2,All Students,2020-21,17634,671,16963,96.2,104,13,12.5
2,All Students,2021-22,18917,1699,17218,91.0,110,42,38.2
2,All Students,2022-23,21237,2126,19111,90.0,125,49,39.2
3,All Students,2018-19,27165,1472,25693,94.6,156,27,17.3
3,All Students,2019-20,17954,718,17236,96.0,157,16,10.2
3,All Students,2020-21,23916,790,23126,96.7,137,9,6.6
3,All Students,2021-22,16576,1338,15238,91.9,99,28,28.3
3,All Students,2022-23,21521,1651,19870,92.3,126,38,30.2
4,All Students,2018-19,31884,1609,30275,95.0,185,22,11.9
4,All Students,2019-20,16878,718,16160,95.7,151,15,9.9
4,All Students,2020-21,26007,1345,24662,94.8,151,24,15.9
4,All Students,2021-22,21673,1945,19728,91.0,127,47,37.0
4,All Students,2022-23,16872,1170,15702,93.1,100,23,23.0
5,All Students,2018-19,24272,1116,23156,95.4,138,16,11.6
5,All Students,2019-20,19795,823,18972,95.8,173,16,9.2
5,All Students,2020-21,24156,835,23321,96.5,139,13,9.4
5,All Students,2021-22,24757,1972,22785,92.0,141,38,27.0
5,All Students,2022-23,20993,1554,19439,92.6,121,30,24.8
6,All Students,2018-19,17144,582,16562,96.6,97,6,6.2
6,All Students,2019-20,11087,374,10713,96.6,97,8,8.2
6,All Students,2020-21,22772,1042,21730,95.4,131,18,13.7
6,All Students,2021-22,14612,1733,12879,88.1,85,25,29.4
6,All Students,2022-23,15008,1098,13910,92.7,88,29,33.0
7,All Students,2018-19,21242,699,20543,96.7,120,6,5.0
7,All Students,2019-20,10764,359,10405,96.7,94,9,9.6
7,All Students,2020-21,16117,660,15457,95.9,93,9,9.7
7,All Students,2021-22,20801,1922,18879,90.8,121,37,30.6
7,All Students,2022-23,13717,1223,12494,91.1,79,12,15.2
8,All Students,2018-19,16258,594,15664,96.3,92,4,4.3
8,All Students,2019-20,13331,517,12814,96.1,116,12,10.3
8,All Students,2020-21,16100,1042,15058,93.5,92,21,22.8
8,All Students,2021-22,15399,1204,14195,92.2,87,27,31.0
8,All Students,2022-23,19336,1121,18215,94.2,110,21,19.1
All Grades,All Students,2018-19,85391,8684,76707,89.8,503,149,29.6
All Grades,All Students,2019-20,48909,3335,45574,93.2,439,108,24.6
All Grades,All Students,2020-21,66684,5640,61044,91.5,390,93,23.8
All Grades,All Students,2021-22,66117,6337,59780,90.4,395,151,38.2
All Grades,All Students,2022-23,62448,6440,56008,89.7,382,159,41.6
PK in K-12 Schools,All Students,2018-19,5228,937,4291,82.1,31,16,51.6
PK in K-12 Schools,All Students,2019-20,4252,455,3797,89.3,37,16,43.2
PK in K-12 Schools,All Students,2020-21,4708,s,s,s,s,s,s
PK in K-12 Schools,All Students,2021-22,4846,416,4430,91.4,31,11,35.5
PK in K-12 Schools,All Students,2022-23,5956,788,5168,86.8,37,23,62.2
0K,All Students,2018-19,12254,1403,10851,88.6,71,26,36.6
0K,All Students,2019-20,5254,471,4783,91.0,46,18,39.1
0K,All Students,2020-21,7932,1218,6714,84.6,48,21,43.8
0K,All Students,2021-22,8923,1020,7903,88.6,54,29,53.7
0K,All Students,2022-23,8115,898,7217,88.9,53,22,41.5
1,All Students,2018-19,10629,1185,9444,88.9,66,30,45.5
1,All Students,2019-20,7521,520,7001,93.1,68,17,25.0
1,All Students,2020-21,7647,631,7016,91.7,45,12,26.7
1,All Students,2021-22,8351,974,7377,88.3,48,21,43.8
1,All Students,2022-23,9738,1054,8684,89.2,60,26,43.3
2,All Students,2018-19,14449,1146,13303,92.1,87,19,21.8
2,All Students,2019-20,7205,525,6680,92.7,66,17,25.8
2,All Students,2020-21,11494,1140,10354,90.1,67,19,28.4
2,All Students,2021-22,7036,675,6361,90.4,43,15,34.9
2,All Students,2022-23,8476,999,7477,88.2,53,28,52.8
3,All Students,2018-19,10941,1252,9689,88.6,60,10,16.7
3,All Students,2019-20,8762,508,8254,94.2,78,14,17.9
3,All Students,2020-21,10310,778,9532,92.5,60,13,21.7
3,All Students,2021-22,12033,973,11060,91.9,71,23,32.4
3,All Students,2022-23,7238,613,6625,91.5,46,14,30.4
4,All Students,2018-19,15523,1069,14454,93.1,94,22,23.4
4,All Students,2019-20,7128,333,6795,95.3,65,11,16.9
4,All Students,2020-21,13480,966,12514,92.8,78,14,17.9
4,All Students,2021-22,10897,1000,9897,90.8,66,24,36.4
4,All Students,2022-23,12214,1063,11151,91.3,71,25,35.2
5,All Students,2018-19,16367,1692,14675,89.7,94,26,27.7
5,All Students,2019-20,8787,523,8264,94.0,79,15,19.0
5,All Students,2020-21,11107,418,10689,96.2,65,4,6.2
5,All Students,2021-22,14031,1279,12752,90.9,82,28,34.1
5,All Students,2022-23,10711,1025,9686,90.4,62,21,33.9
6,All Students,2020-21,6,s,s,s,s,s,s
All Grades,All Students,2018-19,60675,5136,55539,91.5,375,120,32.0
All Grades,All Students,2019-20,37540,3262,34278,91.3,349,108,30.9
All Grades,All Students,2020-21,50149,7885,42264,84.3,303,156,51.5
All Grades,All Students,2021-22,44208,5556,38652,87.4,280,140,50.0
All Grades,All Students,2022-23,49578,6806,42772,86.3,336,183,54.5
PK in K-12 Schools,All Students,2018-19,6159,535,5624,91.3,39,13,33.3
PK in K-12 Schools,All Students,2019-20,4058,480,3578,88.2,37,14,37.8
PK in K-12 Schools,All Students,2020-21,2985,541,2444,81.9,20,13,65.0
PK in K-12 Schools,All Students,2021-22,5822,969,4853,83.4,41,29,70.7
PK in K-12 Schools,All Students,2022-23,7446,1485,5961,80.1,58,41,70.7
0K,All Students,2018-19,8169,817,7352,90.0,49,18,36.7
0K,All Students,2019-20,4594,456,4138,90.1,42,17,40.5
0K,All Students,2020-21,6965,1439,5526,79.3,44,31,70.5
0K,All Students,2021-22,6212,737,5475,88.1,41,19,46.3
0K,All Students,2022-23,7449,1107,6342,85.1,49,34,69.4
1,All Students,2018-19,7869,820,7049,89.6,50,22,44.0
1,All Students,2019-20,4697,422,4275,91.0,43,14,32.6
1,All Students,2020-21,6580,1192,5388,81.9,40,25,62.5
1,All Students,2021-22,6915,1022,5893,85.2,41,26,63.4
1,All Students,2022-23,8299,1123,7176,86.5,57,26,45.6
2,All Students,2018-19,9657,788,8869,91.8,60,12,20.0
2,All Students,2019-20,5444,588,4856,89.2,51,21,41.2
2,All Students,2020-21,6774,874,5900,87.1,39,19,48.7
2,All Students,2021-22,5627,772,4855,86.3,35,17,48.6
2,All Students,2022-23,7333,823,6510,88.8,48,22,45.8
3,All Students,2018-19,10945,1038,9907,90.5,69,29,42.0
3,All Students,2019-20,6672,506,6166,92.4,61,17,27.9
3,All Students,2020-21,7719,1276,6443,83.5,46,24,52.2
3,All Students,2021-22,5228,560,4668,89.3,33,14,42.4
3,All Students,2022-23,5330,737,4593,86.2,37,19,51.4
4,All Students,2018-19,9344,675,8669,92.8,57,14,24.6
4,All Students,2019-20,6602,409,6193,93.8,62,13,21.0
4,All Students,2020-21,9281,1291,7990,86.1,56,19,33.9
4,All Students,2021-22,7150,760,6390,89.4,45,18,40.0
4,All Students,2022-23,5979,731,5248,87.8,37,19,51.4
5,All Students,2018-19,8532,463,8069,94.6,51,12,23.5
5,All Students,2019-20,5473,401,5072,92.7,53,12,22.6
5,All Students,2020-21,9781,1260,8521,87.1,57,24,42.1
5,All Students,2021-22,7254,736,6518,89.9,44,17,38.6
5,All Students,2022-23,7742,800,6942,89.7,50,22,44.0
All Grades,All Students,2018-19,81486,9028,72458,88.9,499,229,45.9
All Grades,All Students,2019-20,50338,5660,44678,88.8,475,227,47.8
All Grades,All Students,2020-21,68436,15971,52465,76.7,409,261,63.8
All Grades,All Students,2021-22,62627,10713,51914,82.9,399,272,68.2
All Grades,All Students,2022-23,63061,9495,53566,84.9,398,235,59.0
PK in K-12 Schools,All Students,2018-19,8968,1443,7525,83.9,58,34,58.6
PK in K-12 Schools,All Students,2019-20,5315,s,s,s,s,s,s
PK in K-12 Schools,All Students,2020-21,6215,s,s,s,s,s,s
PK in K-12 Schools,All Students,2021-22,11762,2306,9456,80.4,83,65,78.3
PK in K-12 Schools,All Students,2022-23,13086,2486,10600,81.0,84,61,72.6
0K,All Students,2018-19,11134,1621,9513,85.4,69,43,62.3
0K,All Students,2019-20,7630,1091,6539,85.7,75,41,54.7
0K,All Students,2020-21,10572,2938,7634,72.2,63,40,63.5
0K,All Students,2021-22,7799,1527,6272,80.4,51,37,72.5
0K,All Students,2022-23,9400,1572,7828,83.3,62,43,69.4
1,All Students,2018-19,9058,1281,7777,85.9,57,36,63.2
1,All Students,2019-20,6861,902,5959,86.9,66,41,62.1
1,All Students,2020-21,10175,3379,6796,66.8,61,42,68.9
1,All Students,2021-22,9436,1533,7903,83.8,59,42,71.2
1,All Students,2022-23,10157,1579,8578,84.5,63,37,58.7
2,All Students,2018-19,12845,1234,11611,90.4,78,29,37.2
2,All Students,2019-20,5435,686,4749,87.4,53,28,52.8
2,All Students,2020-21,9981,2722,7259,72.7,60,46,76.7
2,All Students,2021-22,8218,1336,6882,83.7,51,37,72.5
2,All Students,2022-23,8288,909,7379,89.0,54,25,46.3
3,All Students,2018-19,14008,1408,12600,89.9,86,42,48.8
3,All Students,2019-20,7522,620,6902,91.8,70,24,34.3
3,All Students,2020-21,7555,1648,5907,78.2,45,24,53.3
3,All Students,2021-22,10066,1960,8106,80.5,62,39,62.9
3,All Students,2022-23,8275,1013,7262,87.8,50,22,44.0
4,All Students,2018-19,13438,1183,12255,91.2,79,28,35.4
4,All Students,2019-20,9105,835,8270,90.8,83,27,32.5
4,All Students,2020-21,11087,1455,9632,86.9,66,34,51.5
4,All Students,2021-22,6022,1037,4985,82.8,36,28,77.8
4,All Students,2022-23,7577,1029,6548,86.4,48,23,47.9
5,All Students,2018-19,12035,858,11177,92.9,72,17,23.6
5,All Students,2019-20,8469,832,7637,90.2,77,35,45.5
5,All Students,2020-21,12678,2386,10292,81.2,74,47,63.5
5,All Students,2021-22,9324,1014,8310,89.1,57,24,42.1
5,All Students,2022-23,6278,907,5371,85.6,37,24,64.9
6,All Students,2019-20,1,s,s,s,s,s,s
6,All Students,2020-21,167,s,s,s,s,s,s
All Grades,All Students,2018-19,107404,7905,99499,92.6,642,178,27.7
All Grades,All Students,2019-20,62899,4481,58418,92.9,579,150,25.9
All Grades,All Students,2020-21,86089,10175,75914,88.2,519,216,41.6
All Grades,All Students,2021-22,88016,10372,77644,88.2,547,248,45.3
All Grades,All Students,2022-23,93732,11009,82723,88.3,583,246,42.2
PK in K-12 Schools,All Students,2018-19,11485,1083,10402,90.6,71,29,40.8
PK in K-12 Schools,All Students,2019-20,5740,586,5154,89.8,55,22,40.0
PK in K-12 Schools,All Students,2020-21,6011,s,s,s,s,s,s
PK in K-12 Schools,All Students,2021-22,14515,2671,11844,81.6,95,67,70.5
PK in K-12 Schools,All Students,2022-23,20502,3284,17218,84.0,126,80,63.5
0K,All Students,2018-19,13858,1359,12499,90.2,83,35,42.2
0K,All Students,2019-20,8687,869,7818,90.0,78,28,35.9
0K,All Students,2020-21,11748,2152,9596,81.7,74,43,58.1
0K,All Students,2021-22,10471,1362,9109,87.0,64,32,50.0
0K,All Students,2022-23,12623,1802,10821,85.7,77,41,53.2
1,All Students,2018-19,15437,1003,14434,93.5,95,24,25.3
1,All Students,2019-20,9020,690,8330,92.4,84,21,25.0
1,All Students,2020-21,11518,1518,10000,86.8,70,36,51.4
1,All Students,2021-22,11054,1252,9802,88.7,71,28,39.4
1,All Students,2022-23,11701,1401,10300,88.0,72,26,36.1
2,All Students,2018-19,14645,951,13694,93.5,89,20,22.5
2,All Students,2019-20,8722,571,8151,93.5,80,18,22.5
2,All Students,2020-21,13028,1476,11552,88.7,78,31,39.7
2,All Students,2021-22,11399,1018,10381,91.1,72,26,36.1
2,All Students,2022-23,10755,1076,9679,90.0,67,26,38.8
3,All Students,2018-19,17736,1220,16516,93.1,106,24,22.6
3,All Students,2019-20,10001,590,9411,94.1,93,21,22.6
3,All Students,2020-21,14047,1454,12593,89.6,85,28,32.9
3,All Students,2021-22,11978,1295,10683,89.2,72,33,45.8
3,All Students,2022-23,11702,1129,10573,90.4,76,25,32.9
4,All Students,2018-19,16415,887,15528,94.6,94,16,17.0
4,All Students,2019-20,10325,661,9664,93.6,95,24,25.3
4,All Students,2020-21,13895,1499,12396,89.2,83,31,37.3
4,All Students,2021-22,14076,1384,12692,90.2,86,29,33.7
4,All Students,2022-23,12114,964,11150,92.0,76,18,23.7
5,All Students,2018-19,17828,1402,16426,92.1,104,30,28.8
5,All Students,2019-20,10404,514,9890,95.1,94,16,17.0
5,All Students,2020-21,15671,1496,14175,90.5,92,33,35.9
5,All Students,2021-22,14523,1390,13133,90.4,87,33,37.9
5,All Students,2022-23,14335,1353,12982,90.6,89,30,33.7
6,All Students,2020-21,167,s,s,s,s,s,s
All Grades,All Students,2018-19,70744,5546,65198,92.2,428,138,32.2
All Grades,All Students,2019-20,40007,2649,37358,93.4,362,75,20.7
All Grades,All Students,2020-21,49981,8565,41416,82.9,297,158,53.2
All Grades,All Students,2021-22,49274,5977,43297,87.9,295,139,47.1
All Grades,All Students,2022-23,49580,5020,44560,89.9,298,123,41.3
PK in K-12 Schools,All Students,2018-19,6833,s,s,s,s,s,s
PK in K-12 Schools,All Students,2019-20,5547,561,4986,89.9,49,18,36.7
PK in K-12 Schools,All Students,2020-21,4885,s,s,s,s,s,s
PK in K-12 Schools,All Students,2021-22,8499,1274,7225,85.0,50,29,58.0
PK in K-12 Schools,All Students,2022-23,8853,1168,7685,86.8,51,30,58.8
0K,All Students,2018-19,12028,962,11066,92.0,75,24,32.0
0K,All Students,2019-20,4347,301,4046,93.1,40,9,22.5
0K,All Students,2020-21,7095,1344,5751,81.1,42,19,45.2
0K,All Students,2021-22,7035,1288,5747,81.7,43,29,67.4
0K,All Students,2022-23,7548,854,6694,88.7,45,21,46.7
1,All Students,2018-19,9739,856,8883,91.2,61,24,39.3
1,All Students,2019-20,5793,335,5458,94.2,53,10,18.9
1,All Students,2020-21,6707,1430,5277,78.7,41,26,63.4
1,All Students,2021-22,5815,s,s,s,s,s,s
1,All Students,2022-23,5841,661,5180,88.7,35,18,51.4
2,All Students,2018-19,8150,638,7512,92.2,50,11,22.0
2,All Students,2019-20,5779,408,5371,92.9,55,13,23.6
2,All Students,2020-21,6606,861,5745,87.0,40,16,40.0
2,All Students,2021-22,7235,754,6481,89.6,43,20,46.5
2,All Students,2022-23,5506,537,4969,90.2,32,13,40.6
3,All Students,2018-19,11512,713,10799,93.8,68,15,22.1
3,All Students,2019-20,4599,264,4335,94.3,41,6,14.6
3,All Students,2020-21,8164,1142,7022,86.0,49,23,46.9
3,All Students,2021-22,6848,559,6289,91.8,41,13,31.7
3,All Students,2022-23,7301,531,6770,92.7,44,13,29.5
4,All Students,2018-19,10826,714,10112,93.4,64,17,26.6
4,All Students,2019-20,6979,406,6573,94.2,63,9,14.3
4,All Students,2020-21,5798,1023,4775,82.4,35,22,62.9
4,All Students,2021-22,7698,738,6960,90.4,47,17,36.2
4,All Students,2022-23,6433,500,5933,92.2,40,12,30.0
5,All Students,2018-19,11645,899,10746,92.3,69,25,36.2
5,All Students,2019-20,6963,374,6589,94.6,61,10,16.4
5,All Students,2020-21,10559,1759,8800,83.3,61,31,50.8
5,All Students,2021-22,6143,632,5511,89.7,35,12,34.3
5,All Students,2022-23,8098,769,7329,90.5,51,16,31.4
6,All Students,2018-19,11,s,s,s,s,s,s
6,All Students,2020-21,167,s,s,s,s,s,s
6,All Students,2021-22,1,s,s,s,s,s,s
All Grades,All Students,2018-19,132406,13727,118679,89.6,771,291,37.7
All Grades,All Students,2019-20,83887,5613,78274,93.3,740,132,17.8
All Grades,All Students,2020-21,132563,16681,115882,87.4,766,329,43.0
All Grades,All Students,2021-22,102922,11489,91433,88.8,606,267,44.1
All Grades,All Students,2022-23,99078,9816,89262,90.1,584,237,40.6
6,All Students,2018-19,52244,3819,48425,92.7,304,77,25.3
6,All Students,2019-20,24632,1441,23191,94.1,219,28,12.8
6,All Students,2020-21,48011,5423,42588,88.7,280,103,36.8
6,All Students,2021-22,27113,2783,24330,89.7,159,62,39.0
6,All Students,2022-23,30611,2813,27798,90.8,180,69,38.3
7,All Students,2018-19,41370,4189,37181,89.9,242,89,36.8
7,All Students,2019-20,33278,1980,31298,94.1,295,48,16.3
7,All Students,2020-21,36987,4484,32503,87.9,212,87,41.0
7,All Students,2021-22,41467,4243,37224,89.8,247,94,38.1
7,All Students,2022-23,26694,2495,24199,90.7,159,61,38.4
8,All Students,2018-19,38792,5719,33073,85.3,225,125,55.6
8,All Students,2019-20,25977,2192,23785,91.6,226,56,24.8
8,All Students,2020-21,47565,6774,40791,85.8,274,139,50.7
8,All Students,2021-22,34342,4463,29879,87.0,200,111,55.5
8,All Students,2022-23,41773,4508,37265,89.2,245,107,43.7
All Grades,All Students,2018-19,71136,5056,66080,92.9,411,99,24.1
All Grades,All Students,2019-20,46741,3082,43659,93.4,417,95,22.8
All Grades,All Students,2020-21,67792,2381,65411,96.5,390,22,5.6
All Grades,All Students,2021-22,62097,6779,55318,89.1,365,146,40.0
All Grades,All Students,2022-23,50017,4484,45533,91.0,292,93,31.8
6,All Students,2018-19,23756,1517,22239,93.6,138,30,21.7
6,All Students,2019-20,16113,1186,14927,92.6,143,38,26.6
6,All Students,2020-21,21577,553,21024,97.4,125,3,2.4
6,All Students,2021-22,19341,s,s,s,s,s,s
6,All Students,2022-23,12855,1220,11635,90.5,75,27,36.0
7,All Students,2018-19,25094,1914,23180,92.4,146,38,26.0
7,All Students,2019-20,14871,s,s,s,s,s,s
7,All Students,2020-21,23816,890,22926,96.3,137,10,7.3
7,All Students,2021-22,20380,1725,18655,91.5,121,36,29.8
7,All Students,2022-23,18188,1676,16512,90.8,108,39,36.1
8,All Students,2018-19,22286,1625,20661,92.7,127,31,24.4
8,All Students,2019-20,15681,1068,14613,93.2,139,37,26.6
8,All Students,2020-21,22399,938,21461,95.8,128,9,7.0
8,All Students,2021-22,22351,2960,19391,86.8,128,62,48.4
8,All Students,2022-23,18974,1588,17386,91.6,109,27,24.8
9,All Students,2019-20,76,s,s,s,s,s,s
9,All Students,2021-22,25,s,s,s,s,s,s
All Grades,All Students,2018-19,110321,10857,99464,90.2,718,226,31.5
All Grades,All Students,2019-20,68359,8353,60006,87.8,647,226,34.9
All Grades,All Students,2020-21,85501,18147,67354,78.8,502,240,47.8
All Grades,All Students,2021-22,61918,11238,50680,81.9,394,199,50.5
All Grades,All Students,2022-23,49230,6759,42471,86.3,346,145,41.9
9,All Students,2018-19,23522,2257,21265,90.4,171,47,27.5
9,All Students,2019-20,14243,1563,12680,89.0,140,41,29.3
9,All Students,2020-21,14542,2833,11709,80.5,89,50,56.2
9,All Students,2021-22,11902,2376,9526,80.0,82,47,57.3
9,All Students,2022-23,8608,1030,7578,88.0,67,25,37.3
10,All Students,2018-19,28671,2065,26606,92.8,190,43,22.6
10,All Students,2019-20,13773,1250,12523,90.9,132,39,29.5
10,All Students,2020-21,21557,5041,16516,76.6,126,64,50.8
10,All Students,2021-22,11784,1377,10407,88.3,81,36,44.4
10,All Students,2022-23,11251,1883,9368,83.3,85,43,50.6
11,All Students,2018-19,32378,2896,29482,91.1,199,56,28.1
11,All Students,2019-20,18457,2009,16448,89.1,175,58,33.1
11,All Students,2020-21,20832,4598,16234,77.9,122,60,49.2
11,All Students,2021-22,18874,2463,16411,87.0,120,47,39.2
11,All Students,2022-23,12719,1615,11104,87.3,86,38,44.2
12,All Students,2018-19,25750,3639,22111,85.9,158,80,50.6
12,All Students,2019-20,21886,3531,18355,83.9,200,88,44.0
12,All Students,2020-21,28570,5675,22895,80.1,165,66,40.0
12,All Students,2021-22,19358,5022,14336,74.1,111,69,62.2
12,All Students,2022-23,16652,2231,14421,86.6,108,39,36.1
All Grades,All Students,2018-19,31803,3111,28692,90.2,215,50,23.3
All Grades,All Students,2019-20,22129,2431,19698,89.0,209,61,29.2
All Grades,All Students,2020-21,34753,8198,26555,76.4,215,157,73.0
All Grades,All Students,2021-22,35839,6350,29489,82.3,240,125,52.1
All Grades,All Students,2022-23,29892,5488,24404,81.6,219,116,53.0
8,All Students,2022-23,1,s,s,s,s,s,s
9,All Students,2018-19,9097,1386,7711,84.8,66,20,30.3
9,All Students,2019-20,6075,903,5172,85.1,56,18,32.1
9,All Students,2020-21,12184,3494,8690,71.3,74,59,79.7
9,All Students,2021-22,11808,2157,9651,81.7,81,41,50.6
9,All Students,2022-23,5795,s,s,s,s,s,s
10,All Students,2018-19,8918,936,7982,89.5,63,16,25.4
10,All Students,2019-20,6010,931,5079,84.5,57,22,38.6
10,All Students,2020-21,8773,2261,6512,74.2,60,44,73.3
10,All Students,2021-22,10964,1944,9020,82.3,73,38,52.1
10,All Students,2022-23,8912,1866,7046,79.1,68,33,48.5
11,All Students,2018-19,7085,372,6713,94.7,45,9,20.0
11,All Students,2019-20,5061,316,4745,93.8,51,12,23.5
11,All Students,2020-21,6180,1167,5013,81.1,37,24,64.9
11,All Students,2021-22,7010,1318,5692,81.2,46,25,54.3
11,All Students,2022-23,8220,1166,7054,85.8,60,25,41.7
12,All Students,2018-19,6703,417,6286,93.8,41,5,12.2
12,All Students,2019-20,4983,281,4702,94.4,47,10,21.3
12,All Students,2020-21,7616,1276,6340,83.2,44,30,68.2
12,All Students,2021-22,6057,931,5126,84.6,40,21,52.5
12,All Students,2022-23,6964,1349,5615,80.6,47,34,72.3
All Grades,All Students,2018-19,57276,10800,46476,81.1,382,220,57.6
All Grades,All Students,2019-20,36175,6535,29640,81.9,351,195,55.6
All Grades,All Students,2020-21,41758,11148,30610,73.3,295,210,71.2
All Grades,All Students,2021-22,34771,4247,30524,87.8,250,121,48.4
All Grades,All Students,2022-23,33295,6322,26973,81.0,236,156,66.1
9,All Students,2018-19,13198,2583,10615,80.4,95,51,53.7
9,All Students,2019-20,8988,1433,7555,84.1,89,44,49.4
9,All Students,2020-21,9287,1912,7375,79.4,67,45,67.2
9,All Students,2021-22,10663,1111,9552,89.6,79,30,38.0
9,All Students,2022-23,9821,1609,8212,83.6,70,39,55.7
10,All Students,2018-19,18349,3503,14846,80.9,119,64,53.8
10,All Students,2019-20,8527,1814,6713,78.7,83,48,57.8
10,All Students,2020-21,11189,3303,7886,70.5,75,54,72.0
10,All Students,2021-22,8980,1120,7860,87.5,67,36,53.7
10,All Students,2022-23,8567,1647,6920,80.8,65,39,60.0
11,All Students,2018-19,14390,2691,11699,81.3,90,49,54.4
11,All Students,2019-20,9643,1524,8119,84.2,91,49,53.8
11,All Students,2020-21,9949,2410,7539,75.8,64,46,71.9
11,All Students,2021-22,7682,1016,6666,86.8,52,25,48.1
11,All Students,2022-23,7852,1708,6144,78.2,55,46,83.6
12,All Students,2018-19,11339,2023,9316,82.2,78,56,71.8
12,All Students,2019-20,9017,1764,7253,80.4,89,55,61.8
12,All Students,2020-21,11333,3523,7810,68.9,89,65,73.0
12,All Students,2021-22,7446,1000,6446,86.6,52,30,57.7
12,All Students,2022-23,7055,1358,5697,80.8,46,32,69.6
All Grades,All Students,2018-19,49285,6418,42867,87.0,317,138,43.5
All Grades,All Students,2019-20,28727,4320,24407,85.0,273,121,44.3
All Grades,All Students,2020-21,37093,14086,23007,62.0,217,198,91.2
All Grades,All Students,2021-22,27315,9091,18224,66.7,173,134,77.5
All Grades,All Students,2022-23,24426,5573,18853,77.2,161,95,59.0
9,All Students,2018-19,10466,2145,8321,79.5,68,35,51.5
9,All Students,2019-20,6024,1077,4947,82.1,56,23,41.1
9,All Students,2020-21,7633,2982,4651,60.9,45,44,97.8
9,All Students,2021-22,7246,1800,5446,75.2,48,36,75.0
9,All Students,2022-23,4910,1056,3854,78.5,36,20,55.6
10,All Students,2018-19,11445,1204,10241,89.5,79,32,40.5
10,All Students,2019-20,6021,1023,4998,83.0,61,35,57.4
10,All Students,2020-21,11237,4971,6266,55.8,67,61,91.0
10,All Students,2021-22,7900,2733,5167,65.4,51,42,82.4
10,All Students,2022-23,5640,1062,4578,81.2,37,19,51.4
11,All Students,2018-19,13425,1409,12016,89.5,85,31,36.5
11,All Students,2019-20,6350,683,5667,89.2,59,23,39.0
11,All Students,2020-21,6405,2172,4233,66.1,37,32,86.5
11,All Students,2021-22,4856,1518,3338,68.7,33,21,63.6
11,All Students,2022-23,6176,1313,4863,78.7,40,26,65.0
12,All Students,2018-19,13949,1660,12289,88.1,85,40,47.1
12,All Students,2019-20,10332,1537,8795,85.1,97,40,41.2
12,All Students,2020-21,11818,3961,7857,66.5,68,61,89.7
12,All Students,2021-22,7313,3040,4273,58.4,41,35,85.4
12,All Students,2022-23,7700,2142,5558,72.2,48,30,62.5
All Grades,All Students,2018-19,55842,7861,47981,85.9,362,185,51.1
All Grades,All Students,2019-20,33679,4993,28686,85.2,335,167,49.9
All Grades,All Students,2020-21,47928,13090,34838,72.7,294,202,68.7
All Grades,All Students,2021-22,39951,6073,33878,84.8,250,132,52.8
All Grades,All Students,2022-23,42839,7115,35724,83.4,283,156,55.1
8,All Students,2018-19,24,s,s,s,s,s,s
8,All Students,2020-21,8,s,s,s,s,s,s
9,All Students,2018-19,13688,1786,11902,87.0,84,32,38.1
9,All Students,2019-20,8040,1522,6518,81.1,82,45,54.9
9,All Students,2020-21,10068,s,s,s,s,s,s
9,All Students,2021-22,10033,1341,8692,86.6,66,28,42.4
9,All Students,2022-23,13161,1942,11219,85.2,90,50,55.6
10,All Students,2018-19,13747,1881,11866,86.3,91,43,47.3
10,All Students,2019-20,8925,1234,7691,86.2,91,45,49.5
10,All Students,2020-21,12308,3641,8667,70.4,75,51,68.0
10,All Students,2021-22,8049,1213,6836,84.9,50,25,50.0
10,All Students,2022-23,12237,1986,10251,83.8,78,38,48.7
11,All Students,2018-19,15403,2349,13054,84.7,100,61,61.0
11,All Students,2019-20,8430,1022,7408,87.9,85,32,37.6
11,All Students,2020-21,13628,4566,9062,66.5,83,61,73.5
11,All Students,2021-22,10524,1469,9055,86.0,65,36,55.4
11,All Students,2022-23,8425,1059,7366,87.4,55,25,45.5
12,All Students,2018-19,12980,s,s,s,s,s,s
12,All Students,2019-20,8284,1215,7069,85.3,77,45,58.4
12,All Students,2020-21,11916,2505,9411,79.0,72,44,61.1
12,All Students,2021-22,11345,2050,9295,81.9,69,43,62.3
12,All Students,2022-23,9016,2128,6888,76.4,60,43,71.7
All Grades,All Students,2018-19,48790,3779,45011,92.3,298,81,27.2
All Grades,All Students,2019-20,27056,2285,24771,91.6,255,78,30.6
All Grades,All Students,2020-21,35456,5092,30364,85.6,215,100,46.5
All Grades,All Students,2021-22,29135,4039,25096,86.1,179,82,45.8
All Grades,All Students,2022-23,34480,4353,30127,87.4,231,103,44.6
6,All Students,2018-19,16227,1213,15014,92.5,104,29,27.9
6,All Students,2019-20,7398,739,6659,90.0,69,29,42.0
6,All Students,2020-21,8704,s,s,s,s,s,s
6,All Students,2021-22,9517,s,s,s,s,s,s
6,All Students,2022-23,11759,1582,10177,86.5,81,37,45.7
7,All Students,2018-19,13939,1258,12681,91.0,83,25,30.1
7,All Students,2019-20,11237,853,10384,92.4,107,26,24.3
7,All Students,2020-21,10422,1792,8630,82.8,63,35,55.6
7,All Students,2021-22,10056,1138,8918,88.7,62,24,38.7
7,All Students,2022-23,11348,1391,9957,87.7,76,30,39.5
8,All Students,2018-19,18624,1308,17316,93.0,111,27,24.3
8,All Students,2019-20,8421,693,7728,91.8,79,23,29.1
8,All Students,2020-21,16269,2063,14206,87.3,95,39,41.1
8,All Students,2021-22,9560,1344,8216,85.9,59,33,55.9
8,All Students,2022-23,11373,1380,9993,87.9,74,36,48.6
9,All Students,2020-21,35,s,s,s,s,s,s
9,All Students,2021-22,2,s,s,s,s,s,s
All Grades,All Students,2018-19,31095,2348,28747,92.4,183,51,27.9
All Grades,All Students,2019-20,18790,1238,17552,93.4,175,44,25.1
All Grades,All Students,2020-21,23635,1730,21905,92.7,141,42,29.8
All Grades,All Students,2021-22,27936,4077,23859,85.4,167,81,48.5
All Grades,All Students,2022-23,26752,3168,23584,88.2,163,68,41.7
5,All Students,2018-19,50,s,s,s,s,s,s
6,All Students,2018-19,8150,s,s,s,s,s,s
6,All Students,2019-20,5566,332,5234,94.0,52,9,17.3
6,All Students,2020-21,4897,s,s,s,s,s,s
6,All Students,2021-22,12960,1894,11066,85.4,75,35,46.7
6,All Students,2022-23,8127,1146,6981,85.9,51,26,51.0
7,All Students,2018-19,10213,868,9345,91.5,60,20,33.3
7,All Students,2019-20,6572,415,6157,93.7,60,16,26.7
7,All Students,2020-21,9310,880,8430,90.5,57,24,42.1
7,All Students,2021-22,6038,s,s,s,s,s,s
7,All Students,2022-23,11849,1019,10830,91.4,71,27,38.0
8,All Students,2018-19,12682,952,11730,92.5,73,21,28.8
8,All Students,2019-20,6652,491,6161,92.6,63,19,30.2
8,All Students,2020-21,9421,626,8795,93.4,54,14,25.9
8,All Students,2021-22,8929,1332,7597,85.1,55,26,47.3
8,All Students,2022-23,6776,1003,5773,85.2,41,15,36.6
9,All Students,2020-21,4,s,s,s,s,s,s
9,All Students,2021-22,9,s,s,s,s,s,s
All Grades,All Students,2018-19,38772,6596,32176,83.0,260,141,54.2
All Grades,All Students,2019-20,22979,3987,18992,82.6,234,131,56.0
All Grades,All Students,2020-21,35303,6888,28415,80.5,212,109,51.4
All Grades,All Students,2021-22,42881,6192,36689,85.6,289,136,47.1
All Grades,All Students,2022-23,47515,7668,39847,83.9,312,157,50.3
9,All Students,2018-19,11514,2476,9038,78.5,73,40,54.8
9,All Students,2019-20,6284,1422,4862,77.4,67,36,53.7
9,All Students,2020-21,12279,3083,9196,74.9,75,40,53.3
9,All Students,2021-22,15248,1505,13743,90.1,99,32,32.3
9,All Students,2022-23,13243,2177,11066,83.6,89,45,50.6
10,All Students,2018-19,10890,1974,8916,81.9,83,46,55.4
10,All Students,2019-20,5864,895,4969,84.7,64,39,60.9
10,All Students,2020-21,9120,1707,7413,81.3,54,26,48.1
10,All Students,2021-22,11596,2003,9593,82.7,80,44,55.0
10,All Students,2022-23,15856,2352,13504,85.2,102,45,44.1
11,All Students,2018-19,8607,1004,7603,88.3,56,27,48.2
11,All Students,2019-20,5153,722,4431,86.0,51,24,47.1
11,All Students,2020-21,7278,1057,6221,85.5,44,21,47.7
11,All Students,2021-22,9286,1486,7800,84.0,65,31,47.7
11,All Students,2022-23,10692,1824,8868,82.9,69,39,56.5
12,All Students,2018-19,7761,1142,6619,85.3,48,28,58.3
12,All Students,2019-20,5678,948,4730,83.3,52,32,61.5
12,All Students,2020-21,6626,1041,5585,84.3,39,22,56.4
12,All Students,2021-22,6751,1198,5553,82.3,45,29,64.4
12,All Students,2022-23,7724,1315,6409,83.0,52,28,53.8
All Grades,All Students,2018-19,47369,6853,40516,85.5,334,138,41.3
All Grades,All Students,2019-20,27450,3964,23486,85.6,268,111,41.4
All Grades,All Students,2020-21,35242,8071,27171,77.1,214,102,47.7
All Grades,All Students,2021-22,34408,6105,28303,82.3,232,128,55.2
All Grades,All Students,2022-23,38712,5233,33479,86.5,260,120,46.2
9,All Students,2018-19,18465,3608,14857,80.5,138,69,50.0
9,All Students,2019-20,12436,2132,10304,82.9,124,59,47.6
9,All Students,2020-21,10735,3324,7411,69.0,66,39,59.1
9,All Students,2021-22,15104,2519,12585,83.3,105,47,44.8
9,All Students,2022-23,13091,1867,11224,85.7,94,44,46.8
10,All Students,2018-19,6729,839,5890,87.5,51,19,37.3
10,All Students,2019-20,4371,515,3856,88.2,46,17,37.0
10,All Students,2020-21,10289,3024,7265,70.6,63,35,55.6
10,All Students,2021-22,6694,1430,5264,78.6,47,39,83.0
10,All Students,2022-23,13360,1534,11826,88.5,86,37,43.0
11,All Students,2018-19,4758,652,4106,86.3,35,18,51.4
11,All Students,2019-20,2470,320,2150,87.0,24,10,41.7
11,All Students,2020-21,4850,590,4260,87.8,29,11,37.9
11,All Students,2021-22,5180,1003,4177,80.6,33,18,54.5
11,All Students,2022-23,5918,869,5049,85.3,38,17,44.7
12,All Students,2018-19,17417,1754,15663,89.9,110,32,29.1
12,All Students,2019-20,8173,997,7176,87.8,75,26,34.7
12,All Students,2020-21,9368,1133,8235,87.9,56,17,30.4
12,All Students,2021-22,7430,1153,6277,84.5,47,24,51.1
12,All Students,2022-23,6343,963,5380,84.8,42,22,52.4
All Grades,All Students,2018-19,76312,7878,68434,89.7,477,167,35.0
All Grades,All Students,2019-20,49549,5274,44275,89.4,475,166,34.9
All Grades,All Students,2020-21,79774,10790,68984,86.5,489,174,35.6
All Grades,All Students,2021-22,74942,13026,61916,82.6,483,271,56.1
All Grades,All Students,2022-23,61858,8970,52888,85.5,420,204,48.6
9,All Students,2018-19,24212,2240,21972,90.7,151,42,27.8
9,All Students,2019-20,12442,1170,11272,90.6,122,36,29.5
9,All Students,2020-21,24194,3706,20488,84.7,142,61,43.0
9,All Students,2021-22,19694,3865,15829,80.4,130,70,53.8
9,All Students,2022-23,15728,2518,13210,84.0,111,55,49.5
10,All Students,2018-19,17700,1446,16254,91.8,112,32,28.6
10,All Students,2019-20,14453,1455,12998,89.9,142,47,33.1
10,All Students,2020-21,19027,2814,16213,85.2,114,42,36.8
10,All Students,2021-22,19739,3173,16566,83.9,128,72,56.3
10,All Students,2022-23,16860,2443,14417,85.5,111,50,45.0
11,All Students,2018-19,15807,1737,14070,89.0,100,40,40.0
11,All Students,2019-20,12410,1060,11350,91.5,116,38,32.8
11,All Students,2020-21,21747,2311,19436,89.4,127,41,32.3
11,All Students,2021-22,18012,3132,14880,82.6,108,56,51.9
11,All Students,2022-23,15703,1952,13751,87.6,101,44,43.6
12,All Students,2018-19,18593,2455,16138,86.8,114,53,46.5
12,All Students,2019-20,10244,1589,8655,84.5,95,45,47.4
12,All Students,2020-21,14806,1959,12847,86.8,106,30,28.3
12,All Students,2021-22,17497,2856,14641,83.7,117,73,62.4
12,All Students,2022-23,13567,2057,11510,84.8,97,55,56.7
All Grades,All Students,2018-19,50010,7010,43000,86.0,332,141,42.5
All Grades,All Students,2019-20,33021,5095,27926,84.6,325,142,43.7
All Grades,All Students,2020-21,59080,1941,57139,96.7,348,10,2.9
All Grades,All Students,2021-22,58182,10194,47988,82.5,388,190,49.0
All Grades,All Students,2022-23,61279,4357,56922,92.9,423,93,22.0
8,All Students,2021-22,92,s,s,s,s,s,s
9,All Students,2018-19,14092,1976,12116,86.0,95,30,31.6
9,All Students,2019-20,11464,2067,9397,82.0,114,49,43.0
9,All Students,2020-21,24936,974,23962,96.1,146,6,4.1
9,All Students,2021-22,19512,3141,16371,83.9,136,61,44.9
9,All Students,2022-23,19321,1355,17966,93.0,142,34,23.9
10,All Students,2018-19,11941,1498,10443,87.5,81,31,38.3
10,All Students,2019-20,7738,745,6993,90.4,79,24,30.4
10,All Students,2020-21,13832,393,13439,97.2,81,2,2.5
10,All Students,2021-22,17128,2725,14403,84.1,109,39,35.8
10,All Students,2022-23,16065,907,15158,94.4,112,21,18.8
11,All Students,2018-19,10948,1674,9274,84.7,74,38,51.4
11,All Students,2019-20,6761,986,5775,85.4,64,30,46.9
11,All Students,2020-21,9328,262,9066,97.2,56,1,1.8
11,All Students,2021-22,11479,1826,9653,84.1,73,33,45.2
11,All Students,2022-23,15637,1152,14485,92.6,99,15,15.2
12,All Students,2018-19,13029,1862,11167,85.7,82,42,51.2
12,All Students,2019-20,7058,1297,5761,81.6,68,39,57.4
12,All Students,2020-21,10984,312,10672,97.2,65,1,1.5
12,All Students,2021-22,9971,s,s,s,s,s,s
12,All Students,2022-23,10256,943,9313,90.8,70,23,32.9
All Grades,All Students,2018-19,41049,8758,32291,78.7,283,173,61.1
All Grades,All Students,2019-20,22683,4095,18588,81.9,234,128,54.7
All Grades,All Students,2020-21,28535,7004,21531,75.5,182,97,53.3
All Grades,All Students,2021-22,23696,5622,18074,76.3,149,77,51.7
All Grades,All Students,2022-23,21577,3073,18504,85.8,150,67,44.7
8,All Students,2022-23,12,s,s,s,s,s,s
9,All Students,2018-19,11818,2364,9454,80.0,79,43,54.4
9,All Students,2019-20,6707,1412,5295,78.9,73,40,54.8
9,All Students,2020-21,5260,1937,3323,63.2,35,23,65.7
9,All Students,2021-22,5953,1674,4279,71.9,38,20,52.6
9,All Students,2022-23,5560,1017,4543,81.7,40,21,52.5
10,All Students,2018-19,9618,2083,7535,78.3,65,38,58.5
10,All Students,2019-20,6286,1223,5063,80.5,65,32,49.2
10,All Students,2020-21,8622,1871,6751,78.3,51,26,51.0
10,All Students,2021-22,4275,1500,2775,64.9,26,18,69.2
10,All Students,2022-23,3487,s,s,s,s,s,s
11,All Students,2018-19,9234,1903,7331,79.4,63,39,61.9
11,All Students,2019-20,4228,585,3643,86.2,40,23,57.5
11,All Students,2020-21,5043,1298,3745,74.3,31,19,61.3
11,All Students,2021-22,7024,1075,5949,84.7,43,16,37.2
11,All Students,2022-23,3833,477,3356,87.6,27,13,48.1
12,All Students,2018-19,10379,2408,7971,76.8,76,53,69.7
12,All Students,2019-20,5462,875,4587,84.0,56,33,58.9
12,All Students,2020-21,9610,1898,7712,80.2,65,29,44.6
12,All Students,2021-22,6444,1373,5071,78.7,42,23,54.8
12,All Students,2022-23,8685,883,7802,89.8,56,17,30.4
All Grades,All Students,2018-19,56675,2808,53867,95.0,326,41,12.6
All Grades,All Students,2019-20,40449,1930,38519,95.2,358,43,12.0
All Grades,All Students,2020-21,62634,4041,58593,93.5,362,74,20.4
All Grades,All Students,2021-22,60593,4276,56317,92.9,353,80,22.7
All Grades,All Students,2022-23,62384,3870,58514,93.8,363,70,19.3
6,All Students,2018-19,22028,1048,20980,95.2,128,17,13.3
6,All Students,2019-20,13767,672,13095,95.1,122,13,10.7
6,All Students,2020-21,20582,s,s,s,s,s,s
6,All Students,2021-22,21550,1428,20122,93.4,126,26,20.6
6,All Students,2022-23,23472,1393,22079,94.1,136,23,16.9
7,All Students,2018-19,20023,913,19110,95.4,115,13,11.3
7,All Students,2019-20,13568,639,12929,95.3,121,13,10.7
7,All Students,2020-21,21208,1283,19925,94.0,122,23,18.9
7,All Students,2021-22,18561,1408,17153,92.4,110,29,26.4
7,All Students,2022-23,20970,1156,19814,94.5,122,19,15.6
8,All Students,2018-19,14624,847,13777,94.2,83,11,13.3
8,All Students,2019-20,13114,619,12495,95.3,115,17,14.8
8,All Students,2020-21,20837,1611,19226,92.3,120,29,24.2
8,All Students,2021-22,20482,1440,19042,93.0,117,25,21.4
8,All Students,2022-23,17942,1321,16621,92.6,105,28,26.7
9,All Students,2020-21,7,s,s,s,s,s,s
All Grades,All Students,2018-19,149392,11284,138108,92.4,899,258,28.7
All Grades,All Students,2019-20,90279,6878,83401,92.4,823,251,30.5
All Grades,All Students,2020-21,125008,10477,114531,91.6,739,231,31.3
All Grades,All Students,2021-22,117418,9994,107424,91.5,703,227,32.3
All Grades,All Students,2022-23,113956,9654,104302,91.5,696,243,34.9
PK in K-12 Schools,All Students,2018-19,6260,592,5668,90.5,41,17,41.5
PK in K-12 Schools,All Students,2019-20,5798,638,5160,89.0,51,29,56.9
PK in K-12 Schools,All Students,2020-21,7399,721,6678,90.3,49,19,38.8
PK in K-12 Schools,All Students,2021-22,8845,914,7931,89.7,53,25,47.2
PK in K-12 Schools,All Students,2022-23,8987,879,8108,90.2,53,19,35.8
0K,All Students,2018-19,19709,1795,17914,90.9,119,49,41.2
0K,All Students,2019-20,11031,1013,10018,90.8,101,41,40.6
0K,All Students,2020-21,15931,1519,14412,90.5,95,35,36.8
0K,All Students,2021-22,13099,1467,11632,88.8,82,40,48.8
0K,All Students,2022-23,15275,1550,13725,89.9,93,46,49.5
1,All Students,2018-19,25068,1813,23255,92.8,148,39,26.4
1,All Students,2019-20,12439,1026,11413,91.8,116,42,36.2
1,All Students,2020-21,17511,1832,15679,89.5,105,41,39.0
1,All Students,2021-22,16796,1448,15348,91.4,103,35,34.0
1,All Students,2022-23,15019,1447,13572,90.4,95,42,44.2
2,All Students,2018-19,21827,1563,20264,92.8,132,36,27.3
2,All Students,2019-20,15748,1139,14609,92.8,143,38,26.6
2,All Students,2020-21,17619,1239,16380,93.0,105,32,30.5
2,All Students,2021-22,16692,1372,15320,91.8,98,33,33.7
2,All Students,2022-23,16265,1342,14923,91.7,102,31,30.4
3,All Students,2018-19,25912,2151,23761,91.7,159,54,34.0
3,All Students,2019-20,13251,842,12409,93.6,119,28,23.5
3,All Students,2020-21,23603,2223,21380,90.6,137,48,35.0
3,All Students,2021-22,18716,1491,17225,92.0,111,30,27.0
3,All Students,2022-23,17423,1297,16126,92.6,105,33,31.4
4,All Students,2018-19,24235,1768,22467,92.7,144,33,22.9
4,All Students,2019-20,16103,1161,14942,92.8,146,38,26.0
4,All Students,2020-21,19898,1191,18707,94.0,115,21,18.3
4,All Students,2021-22,23181,1838,21343,92.1,137,34,24.8
4,All Students,2022-23,18904,1493,17411,92.1,116,34,29.3
5,All Students,2018-19,26381,1602,24779,93.9,156,30,19.2
5,All Students,2019-20,15909,1059,14850,93.3,147,35,23.8
5,All Students,2020-21,23047,1752,21295,92.4,133,35,26.3
5,All Students,2021-22,20089,1464,18625,92.7,119,30,25.2
5,All Students,2022-23,22083,1646,20437,92.5,132,38,28.8
All Grades,All Students,2018-19,78348,8899,69449,88.6,506,248,49.0
All Grades,All Students,2019-20,48425,5210,43215,89.2,457,204,44.6
All Grades,All Students,2020-21,69557,9693,59864,86.1,423,206,48.7
All Grades,All Students,2021-22,67524,7355,60169,89.1,430,171,39.8
All Grades,All Students,2022-23,61034,6129,54905,90.0,414,116,28.0
PK in K-12 Schools,All Students,2018-19,6348,775,5573,87.8,40,21,52.5
PK in K-12 Schools,All Students,2019-20,7215,1139,6076,84.2,72,54,75.0
PK in K-12 Schools,All Students,2020-21,9867,1304,8563,86.8,64,31,48.4
PK in K-12 Schools,All Students,2021-22,9892,1365,8527,86.2,73,43,58.9
PK in K-12 Schools,All Students,2022-23,10258,1234,9024,88.0,74,26,35.1
0K,All Students,2018-19,10143,1482,8661,85.4,67,46,68.7
0K,All Students,2019-20,6257,682,5575,89.1,58,24,41.4
0K,All Students,2020-21,8762,1758,7004,79.9,55,36,65.5
0K,All Students,2021-22,9988,908,9080,90.9,62,20,32.3
0K,All Students,2022-23,6523,782,5741,88.0,49,18,36.7
1,All Students,2018-19,12194,1510,10684,87.6,83,46,55.4
1,All Students,2019-20,6307,663,5644,89.5,60,25,41.7
1,All Students,2020-21,9444,1416,8028,85.0,55,25,45.5
1,All Students,2021-22,8812,832,7980,90.6,57,20,35.1
1,All Students,2022-23,9585,942,8643,90.2,64,16,25.0
2,All Students,2018-19,13552,1430,12122,89.4,91,43,47.3
2,All Students,2019-20,6320,738,5582,88.3,57,26,45.6
2,All Students,2020-21,9400,2134,7266,77.3,57,40,70.2
2,All Students,2021-22,9416,1214,8202,87.1,59,26,44.1
2,All Students,2022-23,7245,738,6507,89.8,50,18,36.0
3,All Students,2018-19,11497,1204,10293,89.5,72,31,43.1
3,All Students,2019-20,8250,796,7454,90.4,78,30,38.5
3,All Students,2020-21,8882,1091,7791,87.7,54,27,50.0
3,All Students,2021-22,9387,861,8526,90.8,57,19,33.3
3,All Students,2022-23,9201,1052,8149,88.6,62,22,35.5
4,All Students,2018-19,13068,1489,11579,88.6,81,37,45.7
4,All Students,2019-20,7247,608,6639,91.6,70,22,31.4
4,All Students,2020-21,12272,1210,11062,90.1,73,31,42.5
4,All Students,2021-22,8012,952,7060,88.1,49,21,42.9
4,All Students,2022-23,9465,606,8859,93.6,58,5,8.6
5,All Students,2018-19,11546,1009,10537,91.3,72,24,33.3
5,All Students,2019-20,6829,584,6245,91.4,62,23,37.1
5,All Students,2020-21,10930,780,10150,92.9,65,16,24.6
5,All Students,2021-22,12017,1223,10794,89.8,73,22,30.1
5,All Students,2022-23,8757,775,7982,91.1,57,11,19.3
All Grades,All Students,2018-19,103999,8042,95957,92.3,616,164,26.6
All Grades,All Students,2019-20,63863,5042,58821,92.1,571,160,28.0
All Grades,All Students,2020-21,89636,8951,80685,90.0,531,178,33.5
All Grades,All Students,2021-22,86088,7162,78926,91.7,521,153,29.4
All Grades,All Students,2022-23,86998,7896,79102,90.9,526,193,36.7
PK in K-12 Schools,All Students,2019-20,1695,170,1525,90.0,15,6,40.0
PK in K-12 Schools,All Students,2020-21,3784,633,3151,83.3,26,17,65.4
PK in K-12 Schools,All Students,2021-22,6998,658,6340,90.6,42,15,35.7
PK in K-12 Schools,All Students,2022-23,7076,886,6190,87.5,44,28,63.6
0K,All Students,2018-19,16341,1399,14942,91.4,98,23,23.5
0K,All Students,2019-20,9457,887,8570,90.6,87,32,36.8
0K,All Students,2020-21,9810,1152,8658,88.3,59,22,37.3
0K,All Students,2021-22,11989,1003,10986,91.6,74,23,31.1
0K,All Students,2022-23,8982,1075,7907,88.0,57,30,52.6
1,All Students,2018-19,14796,s,s,s,s,s,s
1,All Students,2019-20,10892,878,10014,91.9,97,27,27.8
1,All Students,2020-21,13556,1331,12225,90.2,80,28,35.0
1,All Students,2021-22,10166,690,9476,93.2,62,12,19.4
1,All Students,2022-23,12351,1037,11314,91.6,74,24,32.4
2,All Students,2018-19,16636,1276,15360,92.3,97,27,27.8
2,All Students,2019-20,8917,715,8202,92.0,80,22,27.5
2,All Students,2020-21,16191,1312,14879,91.9,97,25,25.8
2,All Students,2021-22,14215,1025,13190,92.8,86,23,26.7
2,All Students,2022-23,10934,801,10133,92.7,68,17,25.0
3,All Students,2018-19,18800,1287,17513,93.2,110,25,22.7
3,All Students,2019-20,10017,822,9195,91.8,89,27,30.3
3,All Students,2020-21,13743,1381,12362,90.0,80,25,31.3
3,All Students,2021-22,15315,1373,13942,91.0,94,29,30.9
3,All Students,2022-23,16093,1296,14797,91.9,98,29,29.6
4,All Students,2018-19,17019,1081,15938,93.6,103,23,22.3
4,All Students,2019-20,12193,818,11375,93.3,108,24,22.2
4,All Students,2020-21,14119,1121,12998,92.1,82,22,26.8
4,All Students,2021-22,13974,1070,12904,92.3,83,20,24.1
4,All Students,2022-23,16972,1449,15523,91.5,99,33,33.3
5,All Students,2018-19,20237,1648,18589,91.9,119,32,26.9
5,All Students,2019-20,10692,752,9940,93.0,95,22,23.2
5,All Students,2020-21,18433,2021,16412,89.0,107,39,36.4
5,All Students,2021-22,13431,1343,12088,90.0,80,31,38.8
5,All Students,2022-23,14590,1352,13238,90.7,86,32,37.2
6,All Students,2018-19,170,s,s,s,s,s,s
All Grades,All Students,2018-19,83092,4362,78730,94.8,484,68,14.0
All Grades,All Students,2019-20,56092,2915,53177,94.8,505,62,12.3
All Grades,All Students,2020-21,82175,4410,77765,94.6,493,85,17.2
All Grades,All Students,2021-22,80644,6332,74312,92.1,477,129,27.0
All Grades,All Students,2022-23,85196,6790,78406,92.0,518,152,29.3
PK in K-12 Schools,All Students,2018-19,3171,336,2835,89.4,19,7,36.8
PK in K-12 Schools,All Students,2019-20,3795,302,3493,92.0,33,9,27.3
PK in K-12 Schools,All Students,2020-21,5749,411,5338,92.9,34,10,29.4
PK in K-12 Schools,All Students,2021-22,5762,786,4976,86.4,35,18,51.4
PK in K-12 Schools,All Students,2022-23,5764,595,5169,89.7,35,16,45.7
0K,All Students,2018-19,7429,455,6974,93.9,44,6,13.6
0K,All Students,2019-20,4570,338,4232,92.6,43,12,27.9
0K,All Students,2020-21,7565,507,7058,93.3,48,10,20.8
0K,All Students,2021-22,7417,870,6547,88.3,46,24,52.2
0K,All Students,2022-23,7732,871,6861,88.7,51,24,47.1
1,All Students,2018-19,7756,396,7360,94.9,45,6,13.3
1,All Students,2019-20,5342,314,5028,94.1,48,7,14.6
1,All Students,2020-21,6413,334,6079,94.8,39,9,23.1
1,All Students,2021-22,7847,624,7223,92.0,47,11,23.4
1,All Students,2022-23,7424,789,6635,89.4,42,19,45.2
2,All Students,2018-19,8092,413,7679,94.9,48,7,14.6
2,All Students,2019-20,4981,262,4719,94.7,45,5,11.1
2,All Students,2020-21,7969,458,7511,94.3,49,9,18.4
2,All Students,2021-22,6790,547,6243,91.9,40,13,32.5
2,All Students,2022-23,8692,677,8015,92.2,51,12,23.5
3,All Students,2018-19,8830,503,8327,94.3,51,11,21.6
3,All Students,2019-20,5288,275,5013,94.8,48,2,4.2
3,All Students,2020-21,7618,410,7208,94.6,46,6,13.0
3,All Students,2021-22,8440,546,7894,93.5,49,9,18.4
3,All Students,2022-23,7653,577,7076,92.5,46,12,26.1
4,All Students,2018-19,7665,407,7258,94.7,46,9,19.6
4,All Students,2019-20,5531,243,5288,95.6,50,7,14.0
4,All Students,2020-21,8169,343,7826,95.8,49,4,8.2
4,All Students,2021-22,7767,445,7322,94.3,44,4,9.1
4,All Students,2022-23,7787,503,7284,93.5,52,12,23.1
5,All Students,2018-19,9190,365,8825,96.0,54,3,5.6
5,All Students,2019-20,4952,249,4703,95.0,47,3,6.4
5,All Students,2020-21,8661,313,8348,96.4,53,7,13.2
5,All Students,2021-22,8029,499,7530,93.8,47,11,23.4
5,All Students,2022-23,8990,567,8423,93.7,53,9,17.0
6,All Students,2018-19,11356,506,10850,95.5,64,7,10.9
6,All Students,2019-20,7342,315,7027,95.7,64,7,10.9
6,All Students,2020-21,8804,285,8519,96.8,52,4,7.7
6,All Students,2021-22,9464,678,8786,92.8,58,15,25.9
6,All Students,2022-23,10896,820,10076,92.5,65,19,29.2
7,All Students,2018-19,10702,513,10189,95.2,62,8,12.9
7,All Students,2019-20,6980,296,6684,95.8,63,4,6.3
7,All Students,2020-21,10801,552,10249,94.9,62,9,14.5
7,All Students,2021-22,8605,701,7904,91.9,50,13,26.0
7,All Students,2022-23,10333,734,9599,92.9,64,19,29.7
8,All Students,2018-19,8901,468,8433,94.7,51,4,7.8
8,All Students,2019-20,7311,321,6990,95.6,64,6,9.4
8,All Students,2020-21,10426,797,9629,92.4,61,17,27.9
8,All Students,2021-22,10523,636,9887,94.0,61,11,18.0
8,All Students,2022-23,9925,657,9268,93.4,59,10,16.9
All Grades,All Students,2018-19,164844,11891,152953,92.8,996,273,27.4
All Grades,All Students,2019-20,103887,7031,96856,93.2,955,210,22.0
All Grades,All Students,2020-21,147565,11078,136487,92.5,894,245,27.4
All Grades,All Students,2021-22,135188,11299,123889,91.6,836,265,31.7
All Grades,All Students,2022-23,129081,11036,118045,91.5,791,268,33.9
PK in K-12 Schools,All Students,2018-19,18577,1726,16851,90.7,113,49,43.4
PK in K-12 Schools,All Students,2019-20,11661,1080,10581,90.7,110,42,38.2
PK in K-12 Schools,All Students,2020-21,12545,1208,11337,90.4,85,33,38.8
PK in K-12 Schools,All Students,2021-22,15203,1441,13762,90.5,96,42,43.8
PK in K-12 Schools,All Students,2022-23,16844,1746,15098,89.6,106,46,43.4
0K,All Students,2018-19,22716,1779,20937,92.2,144,46,31.9
0K,All Students,2019-20,16033,1252,14781,92.2,148,42,28.4
0K,All Students,2020-21,22577,2629,19948,88.4,136,64,47.1
0K,All Students,2021-22,18652,1816,16836,90.3,116,42,36.2
0K,All Students,2022-23,16094,1467,14627,90.9,102,39,38.2
1,All Students,2018-19,25496,1974,23522,92.3,155,51,32.9
1,All Students,2019-20,14469,1056,13413,92.7,131,33,25.2
1,All Students,2020-21,24785,2040,22745,91.8,149,47,31.5
1,All Students,2021-22,19450,1912,17538,90.2,120,45,37.5
1,All Students,2022-23,17688,1723,15965,90.3,115,48,41.7
2,All Students,2018-19,24567,1852,22715,92.5,149,41,27.5
2,All Students,2019-20,15890,1015,14875,93.6,146,30,20.5
2,All Students,2020-21,20150,1660,18490,91.8,120,29,24.2
2,All Students,2021-22,20917,1495,19422,92.9,131,30,22.9
2,All Students,2022-23,18695,1574,17121,91.6,110,38,34.5
3,All Students,2018-19,25042,1604,23438,93.6,147,31,21.1
3,All Students,2019-20,15201,922,14279,93.9,142,27,19.0
3,All Students,2020-21,23091,1319,21772,94.3,139,30,21.6
3,All Students,2021-22,17789,1465,16324,91.8,108,37,34.3
3,All Students,2022-23,20656,1535,19121,92.6,123,29,23.6
4,All Students,2018-19,26054,1766,24288,93.2,155,36,23.2
4,All Students,2019-20,15094,894,14200,94.1,137,19,13.9
4,All Students,2020-21,22945,1192,21753,94.8,135,22,16.3
4,All Students,2021-22,21487,1665,19822,92.3,133,42,31.6
4,All Students,2022-23,16848,1300,15548,92.3,101,28,27.7
5,All Students,2018-19,22392,1190,21202,94.7,133,19,14.3
5,All Students,2019-20,15539,812,14727,94.8,141,17,12.1
5,All Students,2020-21,21472,1030,20442,95.2,130,20,15.4
5,All Students,2021-22,21690,1505,20185,93.1,132,27,20.5
5,All Students,2022-23,22256,1691,20565,92.4,134,40,29.9
All Grades,All Students,2018-19,112659,11430,101229,89.9,700,295,42.1
All Grades,All Students,2019-20,69267,6681,62586,90.4,650,260,40.0
All Grades,All Students,2020-21,86210,5299,80911,93.9,512,111,21.7
All Grades,All Students,2021-22,84142,8122,76020,90.3,519,199,38.3
All Grades,All Students,2022-23,86096,7293,78803,91.5,534,179,33.5
PK in K-12 Schools,All Students,2018-19,9927,1389,8538,86.0,60,35,58.3
PK in K-12 Schools,All Students,2019-20,8647,860,7787,90.1,83,34,41.0
PK in K-12 Schools,All Students,2020-21,7046,60,6986,99.1,42,0,0.0
PK in K-12 Schools,All Students,2021-22,10058,340,9718,96.6,61,3,4.9
PK in K-12 Schools,All Students,2022-23,10721,232,10489,97.8,66,3,4.5
0K,All Students,2018-19,14573,1934,12639,86.7,95,54,56.8
0K,All Students,2019-20,8597,962,7635,88.8,84,39,46.4
0K,All Students,2020-21,12396,1083,11313,91.3,76,25,32.9
0K,All Students,2021-22,13115,1615,11500,87.7,86,49,57.0
0K,All Students,2022-23,13850,1305,12545,90.6,86,30,34.9
1,All Students,2018-19,14639,1620,13019,88.9,94,47,50.0
1,All Students,2019-20,8194,844,7350,89.7,78,39,50.0
1,All Students,2020-21,11268,806,10462,92.8,68,19,27.9
1,All Students,2021-22,12772,1356,11416,89.4,78,29,37.2
1,All Students,2022-23,12597,1240,11357,90.2,80,38,47.5
2,All Students,2018-19,15991,1442,14549,91.0,100,36,36.0
2,All Students,2019-20,9913,963,8950,90.3,94,39,41.5
2,All Students,2020-21,12823,721,12102,94.4,75,13,17.3
2,All Students,2021-22,10437,1161,9276,88.9,60,27,45.0
2,All Students,2022-23,13518,1406,12112,89.6,87,36,41.4
3,All Students,2018-19,17856,1748,16108,90.2,109,44,40.4
3,All Students,2019-20,10265,1031,9234,90.0,96,42,43.8
3,All Students,2020-21,14450,843,13607,94.2,85,16,18.8
3,All Students,2021-22,12555,1122,11433,91.1,81,29,35.8
3,All Students,2022-23,11025,1090,9935,90.1,67,30,44.8
4,All Students,2018-19,20434,1596,18838,92.2,124,37,29.8
4,All Students,2019-20,10637,907,9730,91.5,95,29,30.5
4,All Students,2020-21,13584,966,12618,92.9,81,22,27.2
4,All Students,2021-22,12322,1166,11156,90.5,77,33,42.9
4,All Students,2022-23,12699,921,11778,92.7,77,18,23.4
5,All Students,2018-19,19239,1701,17538,91.2,118,42,35.6
5,All Students,2019-20,13014,1114,11900,91.4,120,38,31.7
5,All Students,2020-21,14643,820,13823,94.4,85,16,18.8
5,All Students,2021-22,12883,1362,11521,89.4,76,29,38.2
5,All Students,2022-23,11686,1099,10587,90.6,71,24,33.8
All Grades,All Students,2018-19,91739,9141,82598,90.0,559,249,44.5
All Grades,All Students,2019-20,58335,5304,53031,90.9,544,185,34.0
All Grades,All Students,2020-21,85192,11071,74121,87.0,507,224,44.2
All Grades,All Students,2021-22,75745,10338,65407,86.4,463,262,56.6
All Grades,All Students,2022-23,71081,7292,63789,89.7,440,178,40.5
PK in K-12 Schools,All Students,2018-19,7329,s,s,s,s,s,s
PK in K-12 Schools,All Students,2019-20,10283,1112,9171,89.2,96,45,46.9
PK in K-12 Schools,All Students,2020-21,13888,1683,12205,87.9,84,35,41.7
PK in K-12 Schools,All Students,2021-22,12646,2060,10586,83.7,83,61,73.5
PK in K-12 Schools,All Students,2022-23,13959,1750,12209,87.5,88,46,52.3
0K,All Students,2018-19,12468,1267,11201,89.8,79,36,45.6
0K,All Students,2019-20,5912,700,5212,88.2,62,29,46.8
0K,All Students,2020-21,10871,1196,9675,89.0,67,30,44.8
0K,All Students,2021-22,8997,1488,7509,83.5,58,41,70.7
0K,All Students,2022-23,9185,1050,8135,88.6,56,29,51.8
1,All Students,2018-19,14003,1465,12538,89.5,88,44,50.0
1,All Students,2019-20,7736,669,7067,91.4,71,22,31.0
1,All Students,2020-21,9344,1457,7887,84.4,57,28,49.1
1,All Students,2021-22,9932,1223,8709,87.7,58,29,50.0
1,All Students,2022-23,10400,1070,9330,89.7,65,25,38.5
2,All Students,2018-19,15444,1694,13750,89.0,93,46,49.5
2,All Students,2019-20,8152,682,7470,91.6,77,19,24.7
2,All Students,2020-21,10817,1264,9553,88.3,63,26,41.3
2,All Students,2021-22,8896,936,7960,89.5,55,25,45.5
2,All Students,2022-23,8479,796,7683,90.6,53,18,34.0
3,All Students,2018-19,14561,1346,13215,90.8,89,30,33.7
3,All Students,2019-20,9695,910,8785,90.6,87,31,35.6
3,All Students,2020-21,11840,1600,10240,86.5,70,32,45.7
3,All Students,2021-22,10628,1295,9333,87.8,64,28,43.8
3,All Students,2022-23,8572,740,7832,91.4,51,17,33.3
4,All Students,2018-19,13218,1182,12036,91.1,78,33,42.3
4,All Students,2019-20,8775,693,8082,92.1,79,22,27.8
4,All Students,2020-21,14924,2043,12881,86.3,87,39,44.8
4,All Students,2021-22,11737,1529,10208,87.0,68,36,52.9
4,All Students,2022-23,10026,775,9251,92.3,63,13,20.6
5,All Students,2018-19,14546,1325,13221,90.9,87,37,42.5
5,All Students,2019-20,7782,538,7244,93.1,72,17,23.6
5,All Students,2020-21,13508,1828,11680,86.5,79,34,43.0
5,All Students,2021-22,12909,1807,11102,86.0,77,42,54.5
5,All Students,2022-23,10460,1111,9349,89.4,64,30,46.9
6,All Students,2018-19,170,s,s,s,s,s,s
All Grades,All Students,2018-19,134386,12132,122254,91.0,823,301,36.6
All Grades,All Students,2019-20,86158,7913,78245,90.8,779,268,34.4
All Grades,All Students,2020-21,120057,9292,110765,92.3,721,211,29.3
All Grades,All Students,2021-22,111384,13502,97882,87.9,710,360,50.7
All Grades,All Students,2022-23,108374,10714,97660,90.1,675,263,39.0
PK in K-12 Schools,All Students,2019-20,2049,378,1671,81.6,18,13,72.2
PK in K-12 Schools,All Students,2020-21,6192,s,s,s,s,s,s
PK in K-12 Schools,All Students,2021-22,5712,868,4844,84.8,42,26,61.9
PK in K-12 Schools,All Students,2022-23,6309,665,5644,89.5,37,17,45.9
0K,All Students,2018-19,21542,2652,18890,87.7,136,72,52.9
0K,All Students,2019-20,14191,1831,12360,87.1,128,62,48.4
0K,All Students,2020-21,14263,1208,13055,91.5,94,33,35.1
0K,All Students,2021-22,19671,2781,16890,85.9,122,79,64.8
0K,All Students,2022-23,19926,2265,17661,88.6,126,61,48.4
1,All Students,2018-19,21098,1947,19151,90.8,130,48,36.9
1,All Students,2019-20,13785,1434,12351,89.6,126,57,45.2
1,All Students,2020-21,20034,1528,18506,92.4,120,33,27.5
1,All Students,2021-22,15099,1956,13143,87.0,98,49,50.0
1,All Students,2022-23,18568,1853,16715,90.0,114,43,37.7
2,All Students,2018-19,23682,2100,21582,91.1,143,49,34.3
2,All Students,2019-20,13562,1072,12490,92.1,124,37,29.8
2,All Students,2020-21,19261,1494,17767,92.2,113,33,29.2
2,All Students,2021-22,19472,2433,17039,87.5,119,62,52.1
2,All Students,2022-23,13535,1536,11999,88.7,84,37,44.0
3,All Students,2018-19,23183,1948,21235,91.6,140,50,35.7
3,All Students,2019-20,14882,1251,13631,91.6,133,41,30.8
3,All Students,2020-21,19696,1452,18244,92.6,117,32,27.4
3,All Students,2021-22,15741,2054,13687,87.0,104,53,51.0
3,All Students,2022-23,18462,1810,16652,90.2,115,41,35.7
4,All Students,2018-19,21054,1529,19525,92.7,128,30,23.4
4,All Students,2019-20,14245,965,13280,93.2,129,26,20.2
4,All Students,2020-21,20824,1469,19355,92.9,123,31,25.2
4,All Students,2021-22,17000,1632,15368,90.4,111,44,39.6
4,All Students,2022-23,14026,1082,12944,92.3,92,31,33.7
5,All Students,2018-19,23827,1956,21871,91.8,146,52,35.6
5,All Students,2019-20,13444,982,12462,92.7,121,32,26.4
5,All Students,2020-21,19785,1561,18224,92.1,117,35,29.9
5,All Students,2021-22,18689,1778,16911,90.5,114,47,41.2
5,All Students,2022-23,17548,1503,16045,91.4,107,33,30.8
6,All Students,2020-21,2,s,s,s,s,s,s
All Grades,All Students,2018-19,73433,5132,68301,93.0,447,97,21.7
All Grades,All Students,2019-20,43686,2847,40839,93.5,406,84,20.7
All Grades,All Students,2020-21,59448,2952,56496,95.0,347,42,12.1
All Grades,All Students,2021-22,54019,5288,48731,90.2,323,122,37.8
All Grades,All Students,2022-23,48008,4267,43741,91.1,296,105,35.5
6,All Students,2018-19,20130,1499,18631,92.6,126,30,23.8
6,All Students,2019-20,14413,982,13431,93.2,133,27,20.3
6,All Students,2020-21,16140,510,15630,96.8,96,5,5.2
6,All Students,2021-22,15207,1531,13676,89.9,97,38,39.2
6,All Students,2022-23,14657,1307,13350,91.1,91,34,37.4
7,All Students,2018-19,26588,2011,24577,92.4,159,35,22.0
7,All Students,2019-20,12887,807,12080,93.7,122,31,25.4
7,All Students,2020-21,23371,1309,22062,94.4,135,16,11.9
7,All Students,2021-22,16926,1328,15598,92.2,100,31,31.0
7,All Students,2022-23,15025,1346,13679,91.0,91,30,33.0
8,All Students,2018-19,26715,1622,25093,93.9,162,32,19.8
8,All Students,2019-20,16386,1058,15328,93.5,151,26,17.2
8,All Students,2020-21,19937,1133,18804,94.3,116,21,18.1
8,All Students,2021-22,21886,2429,19457,88.9,126,53,42.1
8,All Students,2022-23,18326,1614,16712,91.2,114,41,36.0
All Grades,All Students,2018-19,33323,4390,28933,86.8,215,114,53.0
All Grades,All Students,2019-20,21360,2826,18534,86.8,200,104,52.0
All Grades,All Students,2020-21,28067,4493,23574,84.0,166,75,45.2
All Grades,All Students,2021-22,23624,3730,19894,84.2,148,90,60.8
All Grades,All Students,2022-23,23212,3834,19378,83.5,141,79,56.0
PK in K-12 Schools,All Students,2018-19,2941,476,2465,83.8,19,11,57.9
PK in K-12 Schools,All Students,2019-20,2594,484,2110,81.3,26,18,69.2
PK in K-12 Schools,All Students,2020-21,3345,1009,2336,69.8,20,14,70.0
PK in K-12 Schools,All Students,2021-22,2544,532,2012,79.1,17,13,76.5
PK in K-12 Schools,All Students,2022-23,4212,1113,3099,73.6,26,23,88.5
0K,All Students,2018-19,5157,815,4342,84.2,33,22,66.7
0K,All Students,2019-20,1921,291,1630,84.9,19,13,68.4
0K,All Students,2020-21,2208,399,1809,81.9,14,7,50.0
0K,All Students,2021-22,3508,472,3036,86.5,21,11,52.4
0K,All Students,2022-23,1907,325,1582,83.0,12,8,66.7
1,All Students,2018-19,4481,557,3924,87.6,29,16,55.2
1,All Students,2019-20,2699,375,2324,86.1,25,13,52.0
1,All Students,2020-21,2795,477,2318,82.9,17,9,52.9
1,All Students,2021-22,1921,262,1659,86.4,13,8,61.5
1,All Students,2022-23,3596,418,3178,88.4,21,5,23.8
2,All Students,2018-19,4543,626,3917,86.2,29,13,44.8
2,All Students,2019-20,2876,343,2533,88.1,27,15,55.6
2,All Students,2020-21,4330,675,3655,84.4,25,12,48.0
2,All Students,2021-22,3166,552,2614,82.6,20,12,60.0
2,All Students,2022-23,2202,272,1930,87.6,14,6,42.9
3,All Students,2018-19,6545,694,5851,89.4,41,14,34.1
3,All Students,2019-20,3689,478,3211,87.0,33,14,42.4
3,All Students,2020-21,4508,644,3864,85.7,26,10,38.5
3,All Students,2021-22,3510,570,2940,83.8,22,14,63.6
3,All Students,2022-23,2646,536,2110,79.7,15,10,66.7
4,All Students,2018-19,4769,812,3957,83.0,35,28,80.0
4,All Students,2019-20,3937,401,3536,89.8,36,13,36.1
4,All Students,2020-21,5327,741,4586,86.1,31,12,38.7
4,All Students,2021-22,4033,650,3383,83.9,26,17,65.4
4,All Students,2022-23,3988,563,3425,85.9,25,13,52.0
5,All Students,2018-19,4887,410,4477,91.6,29,10,34.5
5,All Students,2019-20,3644,454,3190,87.5,34,18,52.9
5,All Students,2020-21,5554,548,5006,90.1,33,11,33.3
5,All Students,2021-22,4942,692,4250,86.0,29,15,51.7
5,All Students,2022-23,4661,607,4054,87.0,28,14,50.0
All Grades,All Students,2018-19,63287,8070,55217,87.2,396,215,54.3
All Grades,All Students,2019-20,40713,6265,34448,84.6,390,219,56.2
All Grades,All Students,2020-21,48587,6728,41859,86.2,311,156,50.2
All Grades,All Students,2021-22,45153,6320,38833,86.0,282,163,57.8
All Grades,All Students,2022-23,42195,6583,35612,84.4,263,165,62.7
PK in K-12 Schools,All Students,2018-19,5835,1142,4693,80.4,36,27,75.0
PK in K-12 Schools,All Students,2019-20,4877,1350,3527,72.3,52,41,78.8
PK in K-12 Schools,All Students,2020-21,6330,1187,5143,81.2,48,30,62.5
PK in K-12 Schools,All Students,2021-22,7571,1249,6322,83.5,46,31,67.4
PK in K-12 Schools,All Students,2022-23,7466,1335,6131,82.1,47,36,76.6
0K,All Students,2018-19,8347,1408,6939,83.1,56,39,69.6
0K,All Students,2019-20,5417,832,4585,84.6,56,33,58.9
0K,All Students,2020-21,3514,438,3076,87.5,23,10,43.5
0K,All Students,2021-22,6626,911,5715,86.3,43,28,65.1
0K,All Students,2022-23,6430,1290,5140,79.9,42,26,61.9
1,All Students,2018-19,6709,951,5758,85.8,44,27,61.4
1,All Students,2019-20,5664,1076,4588,81.0,53,36,67.9
1,All Students,2020-21,7524,1349,6175,82.1,47,32,68.1
1,All Students,2021-22,4751,s,s,s,s,s,s
1,All Students,2022-23,5476,807,4669,85.3,34,24,70.6
2,All Students,2018-19,9025,1068,7957,88.2,55,26,47.3
2,All Students,2019-20,4524,s,s,s,s,s,s
2,All Students,2020-21,7200,1010,6190,86.0,48,26,54.2
2,All Students,2021-22,6552,1100,5452,83.2,41,27,65.9
2,All Students,2022-23,5298,754,4544,85.8,33,18,54.5
3,All Students,2018-19,11847,1516,10331,87.2,74,42,56.8
3,All Students,2019-20,6355,910,5445,85.7,60,33,55.0
3,All Students,2020-21,5784,454,5330,92.2,33,11,33.3
3,All Students,2021-22,5390,758,4632,85.9,32,21,65.6
3,All Students,2022-23,6433,944,5489,85.3,39,26,66.7
4,All Students,2018-19,11858,1027,10831,91.3,73,26,35.6
4,All Students,2019-20,6270,766,5504,87.8,56,27,48.2
4,All Students,2020-21,9058,1353,7705,85.1,57,29,50.9
4,All Students,2021-22,5547,687,4860,87.6,35,14,40.0
4,All Students,2022-23,5076,760,4316,85.0,32,18,56.3
5,All Students,2018-19,9666,958,8708,90.1,58,28,48.3
5,All Students,2019-20,7604,792,6812,89.6,71,29,40.8
5,All Students,2020-21,9177,937,8240,89.8,55,18,32.7
5,All Students,2021-22,8705,1018,7687,88.3,54,26,48.1
5,All Students,2022-23,6016,693,5323,88.5,36,17,47.2
6,All Students,2019-20,2,s,s,s,s,s,s
7,All Students,2021-22,11,s,s,s,s,s,s
All Grades,All Students,2018-19,48183,6319,41864,86.9,316,169,53.5
All Grades,All Students,2019-20,29945,3504,26441,88.3,293,139,47.4
All Grades,All Students,2020-21,40648,2811,37837,93.1,255,72,28.2
All Grades,All Students,2021-22,40201,5792,34409,85.6,263,142,54.0
All Grades,All Students,2022-23,39707,5617,34090,85.9,250,137,54.8
PK in K-12 Schools,All Students,2018-19,6262,1029,5233,83.6,39,27,69.2
PK in K-12 Schools,All Students,2019-20,6616,877,5739,86.7,62,37,59.7
PK in K-12 Schools,All Students,2020-21,7809,794,7015,89.8,50,22,44.0
PK in K-12 Schools,All Students,2021-22,6584,987,5597,85.0,43,22,51.2
PK in K-12 Schools,All Students,2022-23,8107,1368,6739,83.1,55,37,67.3
0K,All Students,2018-19,7217,996,6221,86.2,49,31,63.3
0K,All Students,2019-20,3690,473,3217,87.2,35,17,48.6
0K,All Students,2020-21,5658,637,5021,88.7,38,18,47.4
0K,All Students,2021-22,7314,1139,6175,84.4,49,34,69.4
0K,All Students,2022-23,4789,573,4216,88.0,32,13,40.6
1,All Students,2018-19,7499,1114,6385,85.1,49,29,59.2
1,All Students,2019-20,3801,465,3336,87.8,38,16,42.1
1,All Students,2020-21,5133,234,4899,95.4,32,4,12.5
1,All Students,2021-22,4984,651,4333,86.9,32,15,46.9
1,All Students,2022-23,7140,975,6165,86.3,43,25,58.1
2,All Students,2018-19,6901,1022,5879,85.2,48,27,56.3
2,All Students,2019-20,5173,582,4591,88.7,48,27,56.3
2,All Students,2020-21,6053,415,5638,93.1,37,13,35.1
2,All Students,2021-22,5006,819,4187,83.6,31,19,61.3
2,All Students,2022-23,5133,519,4614,89.9,31,13,41.9
3,All Students,2018-19,5159,621,4538,88.0,34,15,44.1
3,All Students,2019-20,3683,475,3208,87.1,37,18,48.6
3,All Students,2020-21,6703,313,6390,95.3,40,7,17.5
3,All Students,2021-22,5385,756,4629,86.0,36,17,47.2
3,All Students,2022-23,4624,769,3855,83.4,28,17,60.7
4,All Students,2018-19,7278,721,6557,90.1,47,23,48.9
4,All Students,2019-20,2688,249,2439,90.7,31,9,29.0
4,All Students,2020-21,5012,183,4829,96.3,32,4,12.5
4,All Students,2021-22,5988,796,5192,86.7,40,21,52.5
4,All Students,2022-23,4599,684,3915,85.1,28,16,57.1
5,All Students,2018-19,7867,816,7051,89.6,50,17,34.0
5,All Students,2019-20,4294,383,3911,91.1,42,15,35.7
5,All Students,2020-21,4280,235,4045,94.5,26,4,15.4
5,All Students,2021-22,4940,644,4296,87.0,32,14,43.8
5,All Students,2022-23,5315,729,4586,86.3,33,16,48.5
All Grades,All Students,2018-19,155921,15313,140608,90.2,932,371,39.8
All Grades,All Students,2019-20,99923,9610,90313,90.4,924,350,37.9
All Grades,All Students,2020-21,143450,16323,127127,88.6,852,293,34.4
All Grades,All Students,2021-22,135856,17485,118371,87.1,818,440,53.8
All Grades,All Students,2022-23,130661,14208,116453,89.1,813,382,47.0
PK in K-12 Schools,All Students,2018-19,17696,2609,15087,85.3,108,69,63.9
PK in K-12 Schools,All Students,2019-20,11211,1577,9634,85.9,107,66,61.7
PK in K-12 Schools,All Students,2020-21,16950,2708,14242,84.0,101,54,53.5
PK in K-12 Schools,All Students,2021-22,16212,2808,13404,82.7,103,77,74.8
PK in K-12 Schools,All Students,2022-23,17268,2907,14361,83.2,112,83,74.1
0K,All Students,2018-19,23007,2490,20517,89.2,141,62,44.0
0K,All Students,2019-20,14609,1662,12947,88.6,135,62,45.9
0K,All Students,2020-21,21104,3184,17920,84.9,133,61,45.9
0K,All Students,2021-22,20808,3306,17502,84.1,125,82,65.6
0K,All Students,2022-23,17594,2241,15353,87.3,112,67,59.8
1,All Students,2018-19,25253,2307,22946,90.9,150,51,34.0
1,All Students,2019-20,15002,1332,13670,91.1,141,46,32.6
1,All Students,2020-21,21850,2666,19184,87.8,128,39,30.5
1,All Students,2021-22,20657,2620,18037,87.3,123,69,56.1
1,All Students,2022-23,20236,2310,17926,88.6,125,63,50.4
2,All Students,2018-19,23251,2116,21135,90.9,138,51,37.0
2,All Students,2019-20,15283,1324,13959,91.3,136,43,31.6
2,All Students,2020-21,20720,1958,18762,90.6,122,31,25.4
2,All Students,2021-22,19646,2564,17082,86.9,116,59,50.9
2,All Students,2022-23,18256,1861,16395,89.8,111,44,39.6
3,All Students,2018-19,22435,2029,20406,91.0,133,46,34.6
3,All Students,2019-20,14860,1224,13636,91.8,138,43,31.2
3,All Students,2020-21,21485,2144,19341,90.0,127,40,31.5
3,All Students,2021-22,19632,2026,17606,89.7,117,46,39.3
3,All Students,2022-23,18174,1728,16446,90.5,115,48,41.7
4,All Students,2018-19,21062,2217,18845,89.5,124,55,44.4
4,All Students,2019-20,14867,1315,13552,91.2,133,46,34.6
4,All Students,2020-21,20170,2129,18041,89.4,117,43,36.8
4,All Students,2021-22,20345,2236,18109,89.0,124,59,47.6
4,All Students,2022-23,19408,1562,17846,92.0,117,39,33.3
5,All Students,2018-19,23217,1545,21672,93.3,138,37,26.8
5,All Students,2019-20,14091,1176,12915,91.7,134,44,32.8
5,All Students,2020-21,21171,1534,19637,92.8,124,25,20.2
5,All Students,2021-22,18556,1925,16631,89.6,110,48,43.6
5,All Students,2022-23,19725,1599,18126,91.9,121,38,31.4
All Grades,All Students,2018-19,77258,8744,68514,88.7,485,208,42.9
All Grades,All Students,2019-20,44067,4160,39907,90.6,415,142,34.2
All Grades,All Students,2020-21,58546,7368,51178,87.4,348,151,43.4
All Grades,All Students,2021-22,55321,8588,46733,84.5,349,196,56.2
All Grades,All Students,2022-23,55916,7678,48238,86.3,355,183,51.5
6,All Students,2018-19,22575,s,s,s,s,s,s
6,All Students,2019-20,11278,1010,10268,91.0,107,35,32.7
6,All Students,2020-21,17251,2106,15145,87.8,102,42,41.2
6,All Students,2021-22,17951,2496,15455,86.1,116,65,56.0
6,All Students,2022-23,15302,s,s,s,s,s,s
7,All Students,2018-19,25148,2895,22253,88.5,158,77,48.7
7,All Students,2019-20,16646,1477,15169,91.1,154,48,31.2
7,All Students,2020-21,16876,s,s,s,s,s,s
7,All Students,2021-22,18464,2798,15666,84.8,112,61,54.5
7,All Students,2022-23,19650,2767,16883,85.9,125,67,53.6
8,All Students,2018-19,29452,3637,25815,87.7,185,84,45.4
8,All Students,2019-20,16143,1673,14470,89.6,154,59,38.3
8,All Students,2020-21,24216,3219,20997,86.7,143,69,48.3
8,All Students,2021-22,18906,3294,15612,82.6,121,70,57.9
8,All Students,2022-23,20793,3238,17555,84.4,130,74,56.9
9,All Students,2018-19,83,s,s,s,s,s,s
9,All Students,2020-21,203,s,s,s,s,s,s
9,All Students,2022-23,171,s,s,s,s,s,s
All Grades,All Students,2018-19,70892,9492,61400,86.6,447,259,57.9
All Grades,All Students,2019-20,38541,4065,34476,89.5,366,149,40.7
All Grades,All Students,2020-21,49579,4879,44700,90.2,301,91,30.2
All Grades,All Students,2021-22,48961,8148,40813,83.4,312,190,60.9
All Grades,All Students,2022-23,49309,6817,42492,86.2,319,187,58.6
PK in K-12 Schools,All Students,2018-19,8752,1550,7202,82.3,58,40,69.0
PK in K-12 Schools,All Students,2019-20,3685,575,3110,84.4,35,22,62.9
PK in K-12 Schools,All Students,2020-21,4861,844,4017,82.6,31,12,38.7
PK in K-12 Schools,All Students,2021-22,6424,1116,5308,82.6,43,25,58.1
PK in K-12 Schools,All Students,2022-23,6940,1180,5760,83.0,46,33,71.7
0K,All Students,2018-19,9343,1454,7889,84.4,64,41,64.1
0K,All Students,2019-20,5351,734,4617,86.3,55,28,50.9
0K,All Students,2020-21,5916,896,5020,84.9,37,19,51.4
0K,All Students,2021-22,6660,1153,5507,82.7,41,29,70.7
0K,All Students,2022-23,6024,901,5123,85.0,41,28,68.3
1,All Students,2018-19,8690,1171,7519,86.5,54,31,57.4
1,All Students,2019-20,5102,570,4532,88.8,48,22,45.8
1,All Students,2020-21,7315,770,6545,89.5,46,16,34.8
1,All Students,2021-22,6730,1361,5369,79.8,44,32,72.7
1,All Students,2022-23,7049,990,6059,86.0,45,26,57.8
2,All Students,2018-19,8302,1060,7242,87.2,55,36,65.5
2,All Students,2019-20,5767,630,5137,89.1,52,17,32.7
2,All Students,2020-21,7544,519,7025,93.1,45,13,28.9
2,All Students,2021-22,6934,1111,5823,84.0,45,28,62.2
2,All Students,2022-23,6447,891,5556,86.2,42,24,57.1
3,All Students,2018-19,11367,1361,10006,88.0,68,34,50.0
3,All Students,2019-20,4774,428,4346,91.0,46,19,41.3
3,All Students,2020-21,8155,861,7294,89.4,48,13,27.1
3,All Students,2021-22,7487,1268,6219,83.1,47,28,59.6
3,All Students,2022-23,6855,818,6037,88.1,44,23,52.3
4,All Students,2018-19,12413,1658,10755,86.6,76,42,55.3
4,All Students,2019-20,6486,511,5975,92.1,60,16,26.7
4,All Students,2020-21,6601,503,6098,92.4,41,12,29.3
4,All Students,2021-22,8110,1338,6772,83.5,50,31,62.0
4,All Students,2022-23,7969,890,7079,88.8,50,24,48.0
5,All Students,2018-19,12025,1238,10787,89.7,72,35,48.6
5,All Students,2019-20,7376,617,6759,91.6,70,25,35.7
5,All Students,2020-21,9187,486,8701,94.7,53,6,11.3
5,All Students,2021-22,6616,801,5815,87.9,42,17,40.5
5,All Students,2022-23,8025,1147,6878,85.7,51,29,56.9
All Grades,All Students,2018-19,61177,7163,54014,88.3,380,188,49.5
All Grades,All Students,2019-20,38516,3856,34660,90.0,368,148,40.2
All Grades,All Students,2020-21,53339,7430,45909,86.1,321,170,53.0
All Grades,All Students,2021-22,54195,7528,46667,86.1,331,190,57.4
All Grades,All Students,2022-23,55267,7766,47501,85.9,333,191,57.4
PK in K-12 Schools,All Students,2018-19,5557,1153,4404,79.3,39,31,79.5
PK in K-12 Schools,All Students,2019-20,6351,773,5578,87.8,63,27,42.9
PK in K-12 Schools,All Students,2020-21,6964,744,6220,89.3,45,18,40.0
PK in K-12 Schools,All Students,2021-22,8292,959,7333,88.4,51,24,47.1
PK in K-12 Schools,All Students,2022-23,8817,1647,7170,81.3,56,43,76.8
0K,All Students,2018-19,9961,1227,8734,87.7,61,33,54.1
0K,All Students,2019-20,4082,452,3630,88.9,39,17,43.6
0K,All Students,2020-21,7125,1158,5967,83.7,42,26,61.9
0K,All Students,2021-22,8066,1036,7030,87.2,51,29,56.9
0K,All Students,2022-23,8889,1270,7619,85.7,51,31,60.8
1,All Students,2018-19,10020,1135,8885,88.7,62,29,46.8
1,All Students,2019-20,6021,607,5414,89.9,55,24,43.6
1,All Students,2020-21,5244,756,4488,85.6,33,20,60.6
1,All Students,2021-22,7946,1181,6765,85.1,49,30,61.2
1,All Students,2022-23,8348,1083,7265,87.0,52,27,51.9
2,All Students,2018-19,8531,1032,7499,87.9,55,32,58.2
2,All Students,2019-20,6037,584,5453,90.3,56,23,41.1
2,All Students,2020-21,8816,1419,7397,83.9,52,35,67.3
2,All Students,2021-22,5031,679,4352,86.5,29,16,55.2
2,All Students,2022-23,7360,864,6496,88.3,44,21,47.7
3,All Students,2018-19,9336,940,8396,89.9,55,25,45.5
3,All Students,2019-20,4878,502,4376,89.7,48,20,41.7
3,All Students,2020-21,9332,1487,7845,84.1,55,30,54.5
3,All Students,2021-22,7866,1157,6709,85.3,49,33,67.3
3,All Students,2022-23,4743,566,4177,88.1,28,14,50.0
4,All Students,2018-19,8827,793,8034,91.0,55,18,32.7
4,All Students,2019-20,5555,466,5089,91.6,56,21,37.5
4,All Students,2020-21,7776,871,6905,88.8,47,18,38.3
4,All Students,2021-22,9716,1433,8283,85.3,60,34,56.7
4,All Students,2022-23,7979,1148,6831,85.6,47,29,61.7
5,All Students,2018-19,8945,883,8062,90.1,53,20,37.7
5,All Students,2019-20,5592,472,5120,91.6,51,16,31.4
5,All Students,2020-21,8082,995,7087,87.7,47,23,48.9
5,All Students,2021-22,7278,1083,6195,85.1,42,24,57.1
5,All Students,2022-23,9131,1188,7943,87.0,55,26,47.3
All Grades,All Students,2018-19,83209,6776,76433,91.9,534,174,32.6
All Grades,All Students,2019-20,50476,4038,46438,92.0,486,146,30.0
All Grades,All Students,2020-21,67340,6750,60590,90.0,403,131,32.5
All Grades,All Students,2021-22,65104,7037,58067,89.2,411,187,45.5
All Grades,All Students,2022-23,64383,6414,57969,90.0,409,150,36.7
PK in K-12 Schools,All Students,2018-19,5495,555,4940,89.9,41,18,43.9
PK in K-12 Schools,All Students,2019-20,3612,263,3349,92.7,40,15,37.5
PK in K-12 Schools,All Students,2020-21,3064,398,2666,87.0,19,8,42.1
PK in K-12 Schools,All Students,2021-22,5005,s,s,s,s,s,s
PK in K-12 Schools,All Students,2022-23,5265,660,4605,87.5,39,17,43.6
0K,All Students,2018-19,9519,1099,8420,88.5,67,37,55.2
0K,All Students,2019-20,9134,863,8271,90.6,92,39,42.4
0K,All Students,2020-21,9967,1237,8730,87.6,63,23,36.5
0K,All Students,2021-22,9822,1326,8496,86.5,65,38,58.5
0K,All Students,2022-23,10457,1369,9088,86.9,67,32,47.8
1,All Students,2018-19,16112,1440,14672,91.1,100,39,39.0
1,All Students,2019-20,6404,639,5765,90.0,62,23,37.1
1,All Students,2020-21,14000,1558,12442,88.9,84,31,36.9
1,All Students,2021-22,10873,1147,9726,89.5,68,26,38.2
1,All Students,2022-23,8739,795,7944,90.9,56,20,35.7
2,All Students,2018-19,11584,922,10662,92.0,78,22,28.2
2,All Students,2019-20,8670,669,8001,92.3,81,20,24.7
2,All Students,2020-21,9551,1118,8433,88.3,57,19,33.3
2,All Students,2021-22,10273,1095,9178,89.3,64,33,51.6
2,All Students,2022-23,11138,1093,10045,90.2,76,29,38.2
3,All Students,2018-19,12151,830,11321,93.2,76,15,19.7
3,All Students,2019-20,6599,461,6138,93.0,63,15,23.8
3,All Students,2020-21,10244,686,9558,93.3,60,17,28.3
3,All Students,2021-22,9023,1026,7997,88.6,58,26,44.8
3,All Students,2022-23,9344,741,8603,92.1,56,18,32.1
4,All Students,2018-19,13392,975,12417,92.7,81,22,27.2
4,All Students,2019-20,7456,464,6992,93.8,70,12,17.1
4,All Students,2020-21,10020,667,9353,93.3,59,15,25.4
4,All Students,2021-22,10572,981,9591,90.7,67,26,38.8
4,All Students,2022-23,8383,800,7583,90.5,51,18,35.3
5,All Students,2018-19,14956,955,14001,93.6,91,21,23.1
5,All Students,2019-20,8601,679,7922,92.1,78,22,28.2
5,All Students,2020-21,10494,1086,9408,89.7,61,18,29.5
5,All Students,2021-22,9533,847,8686,91.1,58,23,39.7
5,All Students,2022-23,11057,956,10101,91.4,64,16,25.0
6,All Students,2021-22,3,s,s,s,s,s,s
All Grades,All Students,2018-19,98601,10569,88032,89.3,620,243,39.2
All Grades,All Students,2019-20,60528,6137,54391,89.9,559,184,32.9
All Grades,All Students,2020-21,83762,10198,73564,87.8,521,208,39.9
All Grades,All Students,2021-22,71880,8248,63632,88.5,451,146,32.4
All Grades,All Students,2022-23,61321,7721,53600,87.4,397,192,48.4
6,All Students,2018-19,30633,s,s,s,s,s,s
6,All Students,2019-20,19061,s,s,s,s,s,s
6,All Students,2020-21,25157,s,s,s,s,s,s
6,All Students,2021-22,20933,s,s,s,s,s,s
6,All Students,2022-23,17941,s,s,s,s,s,s
7,All Students,2018-19,32785,3443,29342,89.5,212,86,40.6
7,All Students,2019-20,20438,2183,18255,89.3,191,65,34.0
7,All Students,2020-21,29432,3448,25984,88.3,176,64,36.4
7,All Students,2021-22,23233,3031,20202,87.0,146,45,30.8
7,All Students,2022-23,19765,2733,17032,86.2,130,66,50.8
8,All Students,2018-19,35168,3864,31304,89.0,215,82,38.1
8,All Students,2019-20,21014,2322,18692,89.0,193,65,33.7
8,All Students,2020-21,29143,3648,25495,87.5,180,70,38.9
8,All Students,2021-22,27650,3014,24636,89.1,170,53,31.2
8,All Students,2022-23,23606,2897,20709,87.7,147,72,49.0
9,All Students,2018-19,15,s,s,s,s,s,s
9,All Students,2019-20,15,s,s,s,s,s,s
9,All Students,2020-21,30,s,s,s,s,s,s
9,All Students,2021-22,64,s,s,s,s,s,s
9,All Students,2022-23,9,s,s,s,s,s,s
All Grades,All Students,2018-19,53093,6224,46869,88.3,330,171,51.8
All Grades,All Students,2019-20,35825,3668,32157,89.8,344,151,43.9
All Grades,All Students,2020-21,48825,6988,41837,85.7,295,154,52.2
All Grades,All Students,2021-22,46489,6457,40032,86.1,276,169,61.2
All Grades,All Students,2022-23,42193,5537,36656,86.9,275,148,53.8
PK in K-12 Schools,All Students,2018-19,6064,1115,4949,81.6,36,31,86.1
PK in K-12 Schools,All Students,2019-20,7129,854,6275,88.0,73,40,54.8
PK in K-12 Schools,All Students,2020-21,7282,795,6487,89.1,49,20,40.8
PK in K-12 Schools,All Students,2021-22,7281,1046,6235,85.6,47,30,63.8
PK in K-12 Schools,All Students,2022-23,5742,919,4823,84.0,45,27,60.0
0K,All Students,2018-19,7158,861,6297,88.0,44,22,50.0
0K,All Students,2019-20,5565,818,4747,85.3,51,29,56.9
0K,All Students,2020-21,6971,1293,5678,81.5,43,26,60.5
0K,All Students,2021-22,7512,996,6516,86.7,45,27,60.0
0K,All Students,2022-23,5454,775,4679,85.8,36,20,55.6
1,All Students,2018-19,8150,883,7267,89.2,51,27,52.9
1,All Students,2019-20,4183,313,3870,92.5,38,8,21.1
1,All Students,2020-21,7837,1266,6571,83.8,47,24,51.1
1,All Students,2021-22,6733,980,5753,85.4,40,22,55.0
1,All Students,2022-23,5927,677,5250,88.6,38,18,47.4
2,All Students,2018-19,7509,872,6637,88.4,52,26,50.0
2,All Students,2019-20,4659,465,4194,90.0,45,23,51.1
2,All Students,2020-21,6145,894,5251,85.5,36,20,55.6
2,All Students,2021-22,6168,1059,5109,82.8,35,27,77.1
2,All Students,2022-23,6492,803,5689,87.6,40,22,55.0
3,All Students,2018-19,6622,721,5901,89.1,42,20,47.6
3,All Students,2019-20,4468,408,4060,90.9,43,16,37.2
3,All Students,2020-21,7183,1297,5886,81.9,42,34,81.0
3,All Students,2021-22,6080,724,5356,88.1,35,17,48.6
3,All Students,2022-23,5855,951,4904,83.8,36,22,61.1
4,All Students,2018-19,8628,904,7724,89.5,51,24,47.1
4,All Students,2019-20,4691,437,4254,90.7,44,17,38.6
4,All Students,2020-21,6667,849,5818,87.3,39,18,46.2
4,All Students,2021-22,6795,990,5805,85.4,40,27,67.5
4,All Students,2022-23,5766,648,5118,88.8,38,18,47.4
5,All Students,2018-19,8962,868,8094,90.3,54,21,38.9
5,All Students,2019-20,5130,373,4757,92.7,50,18,36.0
5,All Students,2020-21,6740,594,6146,91.2,39,12,30.8
5,All Students,2021-22,5920,662,5258,88.8,34,19,55.9
5,All Students,2022-23,6957,764,6193,89.0,42,21,50.0
All Grades,All Students,2018-19,34194,4181,30013,87.8,212,110,51.9
All Grades,All Students,2019-20,21616,2505,19111,88.4,203,96,47.3
All Grades,All Students,2020-21,24844,3058,21786,87.7,150,67,44.7
All Grades,All Students,2021-22,27753,2100,25653,92.4,175,58,33.1
All Grades,All Students,2022-23,27733,2889,24844,89.6,181,80,44.2
PK in K-12 Schools,All Students,2018-19,2503,367,2136,85.3,16,9,56.3
PK in K-12 Schools,All Students,2019-20,3375,454,2921,86.5,30,18,60.0
PK in K-12 Schools,All Students,2020-21,3209,593,2616,81.5,19,11,57.9
PK in K-12 Schools,All Students,2021-22,5288,398,4890,92.5,35,12,34.3
PK in K-12 Schools,All Students,2022-23,4674,627,4047,86.6,33,21,63.6
0K,All Students,2018-19,4406,711,3695,83.9,29,18,62.1
0K,All Students,2019-20,2297,359,1938,84.4,24,14,58.3
0K,All Students,2020-21,3021,405,2616,86.6,20,9,45.0
0K,All Students,2021-22,4009,346,3663,91.4,26,13,50.0
0K,All Students,2022-23,3908,313,3595,92.0,24,6,25.0
1,All Students,2018-19,5461,861,4600,84.2,34,21,61.8
1,All Students,2019-20,2470,324,2146,86.9,23,12,52.2
1,All Students,2020-21,2766,225,2541,91.9,17,6,35.3
1,All Students,2021-22,4388,345,4043,92.1,27,7,25.9
1,All Students,2022-23,4355,585,3770,86.6,28,15,53.6
2,All Students,2018-19,5302,672,4630,87.3,35,24,68.6
2,All Students,2019-20,3113,368,2745,88.2,29,16,55.2
2,All Students,2020-21,3065,283,2782,90.8,18,7,38.9
2,All Students,2021-22,2723,210,2513,92.3,18,7,38.9
2,All Students,2022-23,4811,516,4295,89.3,31,14,45.2
3,All Students,2018-19,6753,650,6103,90.4,40,18,45.0
3,All Students,2019-20,3366,337,3029,90.0,33,15,45.5
3,All Students,2020-21,3624,620,3004,82.9,22,15,68.2
3,All Students,2021-22,2846,196,2650,93.1,18,5,27.8
3,All Students,2022-23,2602,169,2433,93.5,18,4,22.2
4,All Students,2018-19,5706,608,5098,89.3,35,14,40.0
4,All Students,2019-20,3654,341,3313,90.7,34,14,41.2
4,All Students,2020-21,4013,295,3718,92.6,23,4,17.4
4,All Students,2021-22,3950,236,3714,94.0,24,5,20.8
4,All Students,2022-23,3644,313,3331,91.4,22,8,36.4
5,All Students,2018-19,4063,312,3751,92.3,23,6,26.1
5,All Students,2019-20,3341,322,3019,90.4,30,7,23.3
5,All Students,2020-21,5146,637,4509,87.6,31,15,48.4
5,All Students,2021-22,4549,369,4180,91.9,27,9,33.3
5,All Students,2022-23,3739,366,3373,90.2,25,12,48.0
All Grades,All Students,2018-19,52577,5373,47204,89.8,346,148,42.8
All Grades,All Students,2019-20,35711,4748,30963,86.7,352,194,55.1
All Grades,All Students,2020-21,50631,2922,47709,94.2,323,46,14.2
All Grades,All Students,2021-22,47379,6806,40573,85.6,308,175,56.8
All Grades,All Students,2022-23,43664,4579,39085,89.5,299,127,42.5
PK in K-12 Schools,All Students,2018-19,5940,785,5155,86.8,40,20,50.0
PK in K-12 Schools,All Students,2019-20,6991,1048,5943,85.0,68,38,55.9
PK in K-12 Schools,All Students,2020-21,8262,443,7819,94.6,56,4,7.1
PK in K-12 Schools,All Students,2021-22,9356,1397,7959,85.1,64,41,64.1
PK in K-12 Schools,All Students,2022-23,10122,983,9139,90.3,72,27,37.5
0K,All Students,2018-19,7248,802,6446,88.9,52,24,46.2
0K,All Students,2019-20,5083,908,4175,82.1,52,35,67.3
0K,All Students,2020-21,5388,276,5112,94.9,34,4,11.8
0K,All Students,2021-22,6488,1052,5436,83.8,43,32,74.4
0K,All Students,2022-23,5536,625,4911,88.7,36,15,41.7
1,All Students,2018-19,9397,1008,8389,89.3,66,28,42.4
1,All Students,2019-20,5375,718,4657,86.6,54,28,51.9
1,All Students,2020-21,7685,371,7314,95.2,50,4,8.0
1,All Students,2021-22,4134,s,s,s,s,s,s
1,All Students,2022-23,6187,679,5508,89.0,44,19,43.2
2,All Students,2018-19,9237,955,8282,89.7,58,26,44.8
2,All Students,2019-20,5321,748,4573,85.9,53,35,66.0
2,All Students,2020-21,7250,472,6778,93.5,47,8,17.0
2,All Students,2021-22,6552,952,5600,85.5,41,22,53.7
2,All Students,2022-23,3959,501,3458,87.3,25,12,48.0
3,All Students,2018-19,5746,433,5313,92.5,38,12,31.6
3,All Students,2019-20,5226,591,4635,88.7,53,28,52.8
3,All Students,2020-21,7825,633,7192,91.9,48,13,27.1
3,All Students,2021-22,5873,891,4982,84.8,38,19,50.0
3,All Students,2022-23,5306,510,4796,90.4,39,16,41.0
4,All Students,2018-19,6351,704,5647,88.9,40,22,55.0
4,All Students,2019-20,3773,277,3496,92.7,37,13,35.1
4,All Students,2020-21,8264,454,7810,94.5,51,8,15.7
4,All Students,2021-22,7367,810,6557,89.0,46,20,43.5
4,All Students,2022-23,6619,766,5853,88.4,44,23,52.3
5,All Students,2018-19,8658,686,7972,92.1,52,16,30.8
5,All Students,2019-20,3942,458,3484,88.4,35,17,48.6
5,All Students,2020-21,5957,273,5684,95.4,37,5,13.5
5,All Students,2021-22,7605,882,6723,88.4,49,23,46.9
5,All Students,2022-23,5935,515,5420,91.3,39,15,38.5
6,All Students,2021-22,4,s,s,s,s,s,s
All Grades,All Students,2018-19,96781,9233,87548,90.5,583,225,38.6
All Grades,All Students,2019-20,65785,6237,59548,90.5,601,229,38.1
All Grades,All Students,2020-21,86046,9650,76396,88.8,524,207,39.5
All Grades,All Students,2021-22,92001,10716,81285,88.4,576,283,49.1
All Grades,All Students,2022-23,92143,10303,81840,88.8,571,272,47.6
PK in K-12 Schools,All Students,2018-19,4520,584,3936,87.1,27,15,55.6
PK in K-12 Schools,All Students,2019-20,7278,878,6400,87.9,67,35,52.2
PK in K-12 Schools,All Students,2020-21,6802,s,s,s,s,s,s
PK in K-12 Schools,All Students,2021-22,10332,s,s,s,s,s,s
PK in K-12 Schools,All Students,2022-23,10704,1605,9099,85.0,67,45,67.2
0K,All Students,2018-19,16395,2084,14311,87.3,103,54,52.4
0K,All Students,2019-20,10666,1216,9450,88.6,97,45,46.4
0K,All Students,2020-21,10079,1481,8598,85.3,69,37,53.6
0K,All Students,2021-22,13735,1516,12219,89.0,82,41,50.0
0K,All Students,2022-23,13162,1859,11303,85.9,81,47,58.0
1,All Students,2018-19,12853,1255,11598,90.2,77,31,40.3
1,All Students,2019-20,9970,1049,8921,89.5,92,38,41.3
1,All Students,2020-21,15472,2370,13102,84.7,91,45,49.5
1,All Students,2021-22,11961,1488,10473,87.6,75,41,54.7
1,All Students,2022-23,14107,1594,12513,88.7,88,43,48.9
2,All Students,2018-19,13703,1265,12438,90.8,85,33,38.8
2,All Students,2019-20,8039,722,7317,91.0,75,31,41.3
2,All Students,2020-21,14141,1803,12338,87.2,87,39,44.8
2,All Students,2021-22,15893,1911,13982,88.0,99,49,49.5
2,All Students,2022-23,11786,1328,10458,88.7,75,37,49.3
3,All Students,2018-19,16837,1384,15453,91.8,100,27,27.0
3,All Students,2019-20,9633,745,8888,92.3,88,28,31.8
3,All Students,2020-21,10788,832,9956,92.3,63,18,28.6
3,All Students,2021-22,13928,1670,12258,88.0,91,40,44.0
3,All Students,2022-23,16553,1619,14934,90.2,102,42,41.2
4,All Students,2018-19,15108,1338,13770,91.1,90,34,37.8
4,All Students,2019-20,10545,871,9674,91.7,97,28,28.9
4,All Students,2020-21,14436,953,13483,93.4,86,18,20.9
4,All Students,2021-22,11217,1098,10119,90.2,71,30,42.3
4,All Students,2022-23,13877,1256,12621,90.9,86,35,40.7
5,All Students,2018-19,17365,1323,16042,92.4,101,31,30.7
5,All Students,2019-20,9654,756,8898,92.2,85,24,28.2
5,All Students,2020-21,14162,1065,13097,92.5,84,25,29.8
5,All Students,2021-22,14790,1367,13423,90.8,93,40,43.0
5,All Students,2022-23,11954,1042,10912,91.3,72,23,31.9
6,All Students,2020-21,166,s,s,s,s,s,s
6,All Students,2021-22,145,s,s,s,s,s,s
All Grades,All Students,2018-19,102175,8261,93914,91.9,599,177,29.5
All Grades,All Students,2019-20,63793,4909,58884,92.3,579,170,29.4
All Grades,All Students,2020-21,85121,9335,75786,89.0,510,193,37.8
All Grades,All Students,2021-22,77639,11148,66491,85.6,469,283,60.3
All Grades,All Students,2022-23,73899,7450,66449,89.9,448,184,41.1
PK in K-12 Schools,All Students,2018-19,5393,663,4730,87.7,33,15,45.5
PK in K-12 Schools,All Students,2019-20,5756,663,5093,88.5,54,29,53.7
PK in K-12 Schools,All Students,2020-21,6512,s,s,s,s,s,s
PK in K-12 Schools,All Students,2021-22,6959,1453,5506,79.1,44,38,86.4
PK in K-12 Schools,All Students,2022-23,6303,842,5461,86.6,39,27,69.2
0K,All Students,2018-19,13226,1379,11847,89.6,81,33,40.7
0K,All Students,2019-20,7458,754,6704,89.9,68,29,42.6
0K,All Students,2020-21,11448,1401,10047,87.8,70,32,45.7
0K,All Students,2021-22,9699,1654,8045,82.9,60,44,73.3
0K,All Students,2022-23,11458,1178,10280,89.7,74,30,40.5
1,All Students,2018-19,14970,1253,13717,91.6,88,28,31.8
1,All Students,2019-20,8211,655,7556,92.0,75,24,32.0
1,All Students,2020-21,10270,957,9313,90.7,61,19,31.1
1,All Students,2021-22,11584,1515,10069,86.9,74,42,56.8
1,All Students,2022-23,7425,733,6692,90.1,49,19,38.8
2,All Students,2018-19,16760,1221,15539,92.7,96,24,25.0
2,All Students,2019-20,9928,751,9177,92.4,89,28,31.5
2,All Students,2020-21,11644,1058,10586,90.9,71,23,32.4
2,All Students,2021-22,10166,1420,8746,86.0,61,36,59.0
2,All Students,2022-23,12214,1214,11000,90.1,73,28,38.4
3,All Students,2018-19,16587,1090,15497,93.4,97,28,28.9
3,All Students,2019-20,10312,738,9574,92.8,94,20,21.3
3,All Students,2020-21,14011,1368,12643,90.2,81,28,34.6
3,All Students,2021-22,11833,1626,10207,86.3,69,38,55.1
3,All Students,2022-23,10520,1075,9445,89.8,62,25,40.3
4,All Students,2018-19,16306,1220,15086,92.5,96,23,24.0
4,All Students,2019-20,11742,721,11021,93.9,106,24,22.6
4,All Students,2020-21,14512,1558,12954,89.3,86,33,38.4
4,All Students,2021-22,13083,1648,11435,87.4,79,44,55.7
4,All Students,2022-23,12545,1185,11360,90.6,75,26,34.7
5,All Students,2018-19,18933,1435,17498,92.4,108,26,24.1
5,All Students,2019-20,10386,627,9759,94.0,93,16,17.2
5,All Students,2020-21,16642,1726,14916,89.6,97,33,34.0
5,All Students,2021-22,14315,1832,12483,87.2,82,41,50.0
5,All Students,2022-23,13434,1223,12211,90.9,76,29,38.2
6,All Students,2020-21,46,s,s,s,s,s,s
All Grades,All Students,2018-19,58665,5383,53282,90.8,339,121,35.7
All Grades,All Students,2019-20,30781,2419,28362,92.1,278,81,29.1
All Grades,All Students,2020-21,36594,2454,34140,93.3,212,45,21.2
All Grades,All Students,2021-22,32377,3194,29183,90.1,199,66,33.2
All Grades,All Students,2022-23,28792,3319,25473,88.5,170,75,44.1
5,All Students,2019-20,9,s,s,s,s,s,s
6,All Students,2018-19,15411,1511,13900,90.2,90,35,38.9
6,All Students,2019-20,8013,s,s,s,s,s,s
6,All Students,2020-21,10365,730,9635,93.0,61,10,16.4
6,All Students,2021-22,10975,979,9996,91.1,67,20,29.9
6,All Students,2022-23,7255,804,6451,88.9,42,17,40.5
7,All Students,2018-19,21500,1826,19674,91.5,123,41,33.3
7,All Students,2019-20,9233,811,8422,91.2,82,28,34.1
7,All Students,2020-21,12688,911,11777,92.8,73,17,23.3
7,All Students,2021-22,10210,1180,9030,88.4,66,23,34.8
7,All Students,2022-23,10831,1213,9618,88.8,65,29,44.6
8,All Students,2018-19,21754,2046,19708,90.6,126,45,35.7
8,All Students,2019-20,13526,951,12575,93.0,122,30,24.6
8,All Students,2020-21,13541,813,12728,94.0,78,18,23.1
8,All Students,2021-22,11192,1035,10157,90.8,66,23,34.8
8,All Students,2022-23,10706,1302,9404,87.8,63,29,46.0
All Grades,All Students,2018-19,92121,10219,81902,88.9,552,217,39.3
All Grades,All Students,2019-20,60462,6567,53895,89.1,553,214,38.7
All Grades,All Students,2020-21,93815,17285,76530,81.6,546,277,50.7
All Grades,All Students,2021-22,88788,17300,71488,80.5,554,342,61.7
All Grades,All Students,2022-23,79916,14635,65281,81.7,510,308,60.4
5,All Students,2018-19,1,s,s,s,s,s,s
6,All Students,2018-19,13236,1122,12114,91.5,77,21,27.3
6,All Students,2019-20,7976,666,7310,91.6,71,21,29.6
6,All Students,2020-21,7200,968,6232,86.6,42,16,38.1
6,All Students,2021-22,8329,837,7492,90.0,52,21,40.4
6,All Students,2022-23,7921,802,7119,89.9,48,18,37.5
7,All Students,2018-19,10735,s,s,s,s,s,s
7,All Students,2019-20,8135,782,7353,90.4,73,27,37.0
7,All Students,2020-21,11917,1906,10011,84.0,69,29,42.0
7,All Students,2021-22,7142,925,6217,87.0,47,23,48.9
7,All Students,2022-23,7777,748,7029,90.4,47,19,40.4
8,All Students,2018-19,13474,1417,12057,89.5,77,26,33.8
8,All Students,2019-20,7025,502,6523,92.9,62,13,21.0
8,All Students,2020-21,12162,1194,10968,90.2,71,22,31.0
8,All Students,2021-22,11101,1007,10094,90.9,65,17,26.2
8,All Students,2022-23,6020,928,5092,84.6,39,24,61.5
9,All Students,2018-19,16734,1756,14978,89.5,102,35,34.3
9,All Students,2019-20,10902,1387,9515,87.3,102,39,38.2
9,All Students,2020-21,17268,3416,13852,80.2,101,57,56.4
9,All Students,2021-22,18295,3861,14434,78.9,116,82,70.7
9,All Students,2022-23,16194,2490,13704,84.6,104,56,53.8
10,All Students,2018-19,15303,2206,13097,85.6,97,53,54.6
10,All Students,2019-20,10410,1273,9137,87.8,98,46,46.9
10,All Students,2020-21,16177,3990,12187,75.3,94,54,57.4
10,All Students,2021-22,14654,3479,11175,76.3,93,69,74.2
10,All Students,2022-23,15768,3597,12171,77.2,106,77,72.6
11,All Students,2018-19,11423,1423,10000,87.5,69,32,46.4
11,All Students,2019-20,8318,1036,7282,87.5,77,37,48.1
11,All Students,2020-21,15761,3781,11980,76.0,92,57,62.0
11,All Students,2021-22,14613,3477,11136,76.2,92,60,65.2
11,All Students,2022-23,13571,2998,10573,77.9,84,56,66.7
12,All Students,2018-19,11215,1439,9776,87.2,68,30,44.1
12,All Students,2019-20,7696,921,6775,88.0,70,31,44.3
12,All Students,2020-21,13330,2030,11300,84.8,77,42,54.5
12,All Students,2021-22,14654,3714,10940,74.7,89,70,78.7
12,All Students,2022-23,12665,3072,9593,75.7,82,58,70.7
All Grades,All Students,2018-19,84742,8762,75980,89.7,514,195,37.9
All Grades,All Students,2019-20,56438,5562,50876,90.1,523,203,38.8
All Grades,All Students,2020-21,97264,8730,88534,91.0,564,163,28.9
All Grades,All Students,2021-22,104572,14933,89639,85.7,630,334,53.0
All Grades,All Students,2022-23,109269,13930,95339,87.3,670,295,44.0
6,All Students,2018-19,12738,1275,11463,90.0,75,29,38.7
6,All Students,2019-20,8026,759,7267,90.5,71,25,35.2
6,All Students,2020-21,14163,946,13217,93.3,84,15,17.9
6,All Students,2021-22,14398,1833,12565,87.3,87,47,54.0
6,All Students,2022-23,16398,2222,14176,86.4,95,45,47.4
7,All Students,2018-19,11628,975,10653,91.6,70,24,34.3
7,All Students,2019-20,8044,709,7335,91.2,74,28,37.8
7,All Students,2020-21,11900,651,11249,94.5,68,7,10.3
7,All Students,2021-22,14330,2166,12164,84.9,85,38,44.7
7,All Students,2022-23,14256,1646,12610,88.5,85,29,34.1
8,All Students,2018-19,12892,1011,11881,92.2,73,18,24.7
8,All Students,2019-20,7144,475,6669,93.4,64,15,23.4
8,All Students,2020-21,12146,1053,11093,91.3,70,18,25.7
8,All Students,2021-22,12874,1561,11313,87.9,73,31,42.5
8,All Students,2022-23,13859,1406,12453,89.9,82,27,32.9
9,All Students,2018-19,20485,2435,18050,88.1,129,52,40.3
9,All Students,2019-20,10653,1073,9580,89.9,100,40,40.0
9,All Students,2020-21,19934,2324,17610,88.3,116,43,37.1
9,All Students,2021-22,19231,2571,16660,86.6,119,60,50.4
9,All Students,2022-23,19712,2425,17287,87.7,121,44,36.4
10,All Students,2018-19,11290,1210,10080,89.3,69,26,37.7
10,All Students,2019-20,11063,1333,9730,88.0,106,48,45.3
10,All Students,2020-21,14816,1427,13389,90.4,86,32,37.2
10,All Students,2021-22,17872,2237,15635,87.5,108,57,52.8
10,All Students,2022-23,17088,1918,15170,88.8,110,49,44.5
11,All Students,2018-19,9828,1055,8773,89.3,62,27,43.5
11,All Students,2019-20,5927,592,5335,90.0,57,21,36.8
11,All Students,2020-21,12743,909,11834,92.9,73,17,23.3
11,All Students,2021-22,14192,2302,11890,83.8,86,49,57.0
11,All Students,2022-23,14789,1935,12854,86.9,93,43,46.2
12,All Students,2018-19,5881,801,5080,86.4,36,19,52.8
12,All Students,2019-20,5581,621,4960,88.9,51,26,51.0
12,All Students,2020-21,11562,1420,10142,87.7,67,31,46.3
12,All Students,2021-22,11675,2263,9412,80.6,72,52,72.2
12,All Students,2022-23,13167,2378,10789,81.9,84,58,69.0
All Grades,All Students,2018-19,90414,9088,81326,89.9,550,177,32.2
All Grades,All Students,2019-20,59022,6566,52456,88.9,542,193,35.6
All Grades,All Students,2020-21,91787,9184,82603,90.0,535,153,28.6
All Grades,All Students,2021-22,83534,14801,68733,82.3,532,333,62.6
All Grades,All Students,2022-23,76247,11019,65228,85.5,476,245,51.5
6,All Students,2018-19,12910,1268,11642,90.2,74,29,39.2
6,All Students,2019-20,8561,587,7974,93.1,81,17,21.0
6,All Students,2020-21,13198,1218,11980,90.8,77,25,32.5
6,All Students,2021-22,8137,1118,7019,86.3,53,28,52.8
6,All Students,2022-23,7963,951,7012,88.1,48,18,37.5
7,All Students,2018-19,12664,981,11683,92.3,74,19,25.7
7,All Students,2019-20,7496,683,6813,90.9,67,20,29.9
7,All Students,2020-21,12975,1053,11922,91.9,75,15,20.0
7,All Students,2021-22,13015,1841,11174,85.9,77,42,54.5
7,All Students,2022-23,8260,975,7285,88.2,50,23,46.0
8,All Students,2018-19,14655,786,13869,94.6,85,9,10.6
8,All Students,2019-20,8080,590,7490,92.7,71,15,21.1
8,All Students,2020-21,11389,970,10419,91.5,66,18,27.3
8,All Students,2021-22,11936,1743,10193,85.4,70,43,61.4
8,All Students,2022-23,12549,1537,11012,87.8,76,40,52.6
9,All Students,2018-19,15920,2752,13168,82.7,101,53,52.5
9,All Students,2019-20,10890,1006,9884,90.8,101,34,33.7
9,All Students,2020-21,14082,1458,12624,89.6,84,22,26.2
9,All Students,2021-22,13484,2263,11221,83.2,94,55,58.5
9,All Students,2022-23,13811,1560,12251,88.7,91,39,42.9
10,All Students,2018-19,12844,1497,11347,88.3,82,26,31.7
10,All Students,2019-20,9012,1755,7257,80.5,84,43,51.2
10,All Students,2020-21,16828,1964,14864,88.3,97,30,30.9
10,All Students,2021-22,12861,2881,9980,77.6,85,58,68.2
10,All Students,2022-23,11738,2109,9629,82.0,73,35,47.9
11,All Students,2018-19,10986,830,10156,92.4,71,15,21.1
11,All Students,2019-20,7397,856,6541,88.4,68,27,39.7
11,All Students,2020-21,13149,1633,11516,87.6,77,28,36.4
11,All Students,2021-22,13452,2418,11034,82.0,86,51,59.3
11,All Students,2022-23,10823,1945,8878,82.0,70,46,65.7
12,All Students,2018-19,10435,974,9461,90.7,63,26,41.3
12,All Students,2019-20,7586,1089,6497,85.6,71,38,53.5
12,All Students,2020-21,10166,888,9278,91.3,59,15,25.4
12,All Students,2021-22,10649,2537,8112,76.2,67,56,83.6
12,All Students,2022-23,11103,1942,9161,82.5,68,44,64.7
All Grades,All Students,2018-19,59560,4290,55270,92.8,340,74,21.8
All Grades,All Students,2019-20,35373,2254,33119,93.6,310,61,19.7
All Grades,All Students,2020-21,47875,4051,43824,91.5,279,75,26.9
All Grades,All Students,2021-22,38524,3718,34806,90.3,227,79,34.8
All Grades,All Students,2022-23,33696,2921,30775,91.3,198,67,33.8
6,All Students,2018-19,19603,1406,18197,92.8,111,27,24.3
6,All Students,2019-20,11939,719,11220,94.0,105,22,21.0
6,All Students,2020-21,12539,1008,11531,92.0,75,19,25.3
6,All Students,2021-22,11820,1270,10550,89.3,70,24,34.3
6,All Students,2022-23,10496,892,9604,91.5,63,23,36.5
7,All Students,2018-19,19684,1261,18423,93.6,114,22,19.3
7,All Students,2019-20,11976,839,11137,93.0,105,22,21.0
7,All Students,2020-21,16959,1262,15697,92.6,99,29,29.3
7,All Students,2021-22,11831,1131,10700,90.4,70,20,28.6
7,All Students,2022-23,11519,1003,10516,91.3,68,23,33.8
8,All Students,2018-19,20273,1623,18650,92.0,115,25,21.7
8,All Students,2019-20,11458,696,10762,93.9,100,17,17.0
8,All Students,2020-21,18377,1781,16596,90.3,105,27,25.7
8,All Students,2021-22,14873,1317,13556,91.1,87,35,40.2
8,All Students,2022-23,11681,1026,10655,91.2,67,21,31.3
All Grades,All Students,2018-19,45638,11619,34019,74.5,295,170,57.6
All Grades,All Students,2019-20,29717,6164,23553,79.3,276,129,46.7
All Grades,All Students,2020-21,45239,10003,35236,77.9,275,140,50.9
All Grades,All Students,2021-22,39169,7326,31843,81.3,258,150,58.1
All Grades,All Students,2022-23,35573,4346,31227,87.8,230,88,38.3
9,All Students,2018-19,15574,4956,10618,68.2,99,59,59.6
9,All Students,2019-20,12707,3180,9527,75.0,113,54,47.8
9,All Students,2020-21,17775,5639,12136,68.3,108,67,62.0
9,All Students,2021-22,9584,1841,7743,80.8,66,36,54.5
9,All Students,2022-23,9959,1269,8690,87.3,67,35,52.2
10,All Students,2018-19,12679,3315,9364,73.9,86,53,61.6
10,All Students,2019-20,6465,1583,4882,75.5,60,34,56.7
10,All Students,2020-21,14708,2766,11942,81.2,92,40,43.5
10,All Students,2021-22,10678,2037,8641,80.9,70,44,62.9
10,All Students,2022-23,8460,969,7491,88.5,56,19,33.9
11,All Students,2018-19,8737,1459,7278,83.3,56,29,51.8
11,All Students,2019-20,5407,741,4666,86.3,53,25,47.2
11,All Students,2020-21,7995,1059,6936,86.8,47,24,51.1
11,All Students,2021-22,11505,2020,9485,82.4,76,47,61.8
11,All Students,2022-23,8402,1036,7366,87.7,53,19,35.8
12,All Students,2018-19,8648,1889,6759,78.2,54,29,53.7
12,All Students,2019-20,5138,660,4478,87.2,50,16,32.0
12,All Students,2020-21,4761,539,4222,88.7,28,9,32.1
12,All Students,2021-22,7402,1428,5974,80.7,46,23,50.0
12,All Students,2022-23,8752,1072,7680,87.8,54,15,27.8
All Grades,All Students,2018-19,36347,7830,28517,78.5,261,160,61.3
All Grades,All Students,2019-20,25246,6274,18972,75.1,242,137,56.6
All Grades,All Students,2020-21,30600,8270,22330,73.0,204,137,67.2
All Grades,All Students,2021-22,27257,6456,20801,76.3,210,144,68.6
All Grades,All Students,2022-23,24063,5128,18935,78.7,182,111,61.0
8,All Students,2020-21,24,s,s,s,s,s,s
9,All Students,2018-19,10514,2460,8054,76.6,83,57,68.7
9,All Students,2019-20,6465,1640,4825,74.6,66,38,57.6
9,All Students,2020-21,5281,s,s,s,s,s,s
9,All Students,2021-22,8282,1753,6529,78.8,62,39,62.9
9,All Students,2022-23,6523,1475,5048,77.4,58,43,74.1
10,All Students,2018-19,14866,3295,11571,77.8,102,60,58.8
10,All Students,2019-20,7785,2195,5590,71.8,72,40,55.6
10,All Students,2020-21,8156,2186,5970,73.2,54,37,68.5
10,All Students,2021-22,6260,1958,4302,68.7,48,41,85.4
10,All Students,2022-23,8893,1715,7178,80.7,63,32,50.8
11,All Students,2018-19,4638,881,3757,81.0,33,18,54.5
11,All Students,2019-20,6557,1203,5354,81.7,63,35,55.6
11,All Students,2020-21,8807,2106,6701,76.1,58,36,62.1
11,All Students,2021-22,6189,1334,4855,78.4,47,28,59.6
11,All Students,2022-23,5133,1145,3988,77.7,35,21,60.0
12,All Students,2018-19,6329,1194,5135,81.1,43,25,58.1
12,All Students,2019-20,4439,1236,3203,72.2,41,24,58.5
12,All Students,2020-21,8332,2729,5603,67.2,54,39,72.2
12,All Students,2021-22,6526,1411,5115,78.4,53,36,67.9
12,All Students,2022-23,3514,793,2721,77.4,26,15,57.7
All Grades,All Students,2018-19,65330,8251,57079,87.4,414,120,29.0
All Grades,All Students,2019-20,41223,6904,34319,83.3,400,183,45.8
All Grades,All Students,2020-21,58554,5146,53408,91.2,353,100,28.3
All Grades,All Students,2021-22,53926,5211,48715,90.3,358,121,33.8
All Grades,All Students,2022-23,53081,4883,48198,90.8,352,93,26.4
8,All Students,2021-22,64,s,s,s,s,s,s
9,All Students,2018-19,18636,1766,16870,90.5,122,25,20.5
9,All Students,2019-20,11405,893,10512,92.2,115,35,30.4
9,All Students,2020-21,17092,1411,15681,91.7,103,30,29.1
9,All Students,2021-22,19619,1252,18367,93.6,128,28,21.9
9,All Students,2022-23,16873,1635,15238,90.3,117,35,29.9
10,All Students,2018-19,18431,2567,15864,86.1,115,31,27.0
10,All Students,2019-20,11697,2061,9636,82.4,113,53,46.9
10,All Students,2020-21,16129,1498,14631,90.7,97,30,30.9
10,All Students,2021-22,9691,s,s,s,s,s,s
10,All Students,2022-23,16554,1650,14904,90.0,111,28,25.2
11,All Students,2018-19,14185,2200,11985,84.5,88,30,34.1
11,All Students,2019-20,8562,1591,6971,81.4,83,44,53.0
11,All Students,2020-21,14992,1429,13563,90.5,87,22,25.3
11,All Students,2021-22,14779,1287,13492,91.3,93,32,34.4
11,All Students,2022-23,11701,882,10819,92.5,73,12,16.4
12,All Students,2018-19,14078,1718,12360,87.8,89,34,38.2
12,All Students,2019-20,9559,2359,7200,75.3,89,51,57.3
12,All Students,2020-21,10341,808,9533,92.2,66,18,27.3
12,All Students,2021-22,9773,1346,8427,86.2,64,30,46.9
12,All Students,2022-23,7953,716,7237,91.0,51,18,35.3
All Grades,All Students,2018-19,41462,9703,31759,76.6,287,179,62.4
All Grades,All Students,2019-20,21554,4271,17283,80.2,216,107,49.5
All Grades,All Students,2020-21,29058,5632,23426,80.6,174,88,50.6
All Grades,All Students,2021-22,24354,5095,19259,79.1,165,106,64.2
All Grades,All Students,2022-23,23779,4768,19011,79.9,174,108,62.1
9,All Students,2018-19,8695,1233,7462,85.8,66,34,51.5
9,All Students,2019-20,4725,867,3858,81.7,53,29,54.7
9,All Students,2020-21,5133,716,4417,86.1,31,11,35.5
9,All Students,2021-22,4418,827,3591,81.3,32,19,59.4
9,All Students,2022-23,5607,1037,4570,81.5,45,28,62.2
10,All Students,2018-19,9873,2430,7443,75.4,75,47,62.7
10,All Students,2019-20,5684,738,4946,87.0,57,20,35.1
10,All Students,2020-21,8046,2037,6009,74.7,47,28,59.6
10,All Students,2021-22,5286,1272,4014,75.9,34,22,64.7
10,All Students,2022-23,6629,1249,5380,81.2,50,28,56.0
11,All Students,2018-19,11007,3186,7821,71.1,72,47,65.3
11,All Students,2019-20,6002,1563,4439,74.0,57,32,56.1
11,All Students,2020-21,8493,1381,7112,83.7,49,25,51.0
11,All Students,2021-22,7527,1846,5681,75.5,51,37,72.5
11,All Students,2022-23,4546,894,3652,80.3,32,19,59.4
12,All Students,2018-19,11887,2854,9033,76.0,74,51,68.9
12,All Students,2019-20,5143,1103,4040,78.6,48,25,52.1
12,All Students,2020-21,7386,1498,5888,79.7,47,24,51.1
12,All Students,2021-22,7123,1150,5973,83.9,48,28,58.3
12,All Students,2022-23,6997,1588,5409,77.3,47,33,70.2
All Grades,All Students,2018-19,53024,5081,47943,90.4,334,128,38.3
All Grades,All Students,2019-20,34987,3370,31617,90.4,338,124,36.7
All Grades,All Students,2020-21,49647,4785,44862,90.4,303,88,29.0
All Grades,All Students,2021-22,49479,7850,41629,84.1,323,205,63.5
All Grades,All Students,2022-23,51262,7346,43916,85.7,327,182,55.7
PK in K-12 Schools,All Students,2018-19,4994,733,4261,85.3,37,25,67.6
PK in K-12 Schools,All Students,2019-20,5131,651,4480,87.3,51,27,52.9
PK in K-12 Schools,All Students,2020-21,7416,308,7108,95.8,48,8,16.7
PK in K-12 Schools,All Students,2021-22,8279,1504,6775,81.8,53,40,75.5
PK in K-12 Schools,All Students,2022-23,8605,1284,7321,85.1,54,28,51.9
0K,All Students,2018-19,5083,629,4454,87.6,32,17,53.1
0K,All Students,2019-20,4638,532,4106,88.5,46,20,43.5
0K,All Students,2020-21,6111,1004,5107,83.6,37,16,43.2
0K,All Students,2021-22,8669,1405,7264,83.8,60,36,60.0
0K,All Students,2022-23,9796,1539,8257,84.3,62,39,62.9
1,All Students,2018-19,8722,887,7835,89.8,55,20,36.4
1,All Students,2019-20,3678,354,3324,90.4,37,16,43.2
1,All Students,2020-21,7055,601,6454,91.5,42,13,31.0
1,All Students,2021-22,6279,1161,5118,81.5,43,30,69.8
1,All Students,2022-23,8010,1158,6852,85.5,49,27,55.1
2,All Students,2018-19,9304,989,8315,89.4,59,25,42.4
2,All Students,2019-20,4938,423,4515,91.4,50,15,30.0
2,All Students,2020-21,5247,s,s,s,s,s,s
2,All Students,2021-22,6564,901,5663,86.3,44,27,61.4
2,All Students,2022-23,6040,779,5261,87.1,40,19,47.5
3,All Students,2018-19,8504,658,7846,92.3,49,14,28.6
3,All Students,2019-20,5574,520,5054,90.7,51,17,33.3
3,All Students,2020-21,6924,897,6027,87.0,44,14,31.8
3,All Students,2021-22,5049,911,4138,82.0,32,25,78.1
3,All Students,2022-23,6273,856,5417,86.4,40,25,62.5
4,All Students,2018-19,8585,668,7917,92.2,54,15,27.8
4,All Students,2019-20,5725,471,5254,91.8,53,15,28.3
4,All Students,2020-21,7936,441,7495,94.4,47,7,14.9
4,All Students,2021-22,6902,890,6012,87.1,43,23,53.5
4,All Students,2022-23,5177,818,4359,84.2,35,21,60.0
5,All Students,2018-19,7832,517,7315,93.4,48,12,25.0
5,All Students,2019-20,5303,419,4884,92.1,50,14,28.0
5,All Students,2020-21,8624,729,7895,91.5,51,13,25.5
5,All Students,2021-22,7737,1078,6659,86.1,48,24,50.0
5,All Students,2022-23,7361,912,6449,87.6,47,23,48.9
6,All Students,2020-21,334,s,s,s,s,s,s
All Grades,All Students,2018-19,42661,4528,38133,89.4,281,91,32.4
All Grades,All Students,2019-20,33024,3351,29673,89.9,327,99,30.3
All Grades,All Students,2020-21,48437,7322,41115,84.9,292,129,44.2
All Grades,All Students,2021-22,57488,5877,51611,89.8,366,139,38.0
All Grades,All Students,2022-23,57674,5702,51972,90.1,391,136,34.8
9,All Students,2018-19,12803,1315,11488,89.7,87,30,34.5
9,All Students,2019-20,10732,764,9968,92.9,112,32,28.6
9,All Students,2020-21,8591,1562,7029,81.8,54,22,40.7
9,All Students,2021-22,17470,1435,16035,91.8,108,32,29.6
9,All Students,2022-23,15457,1504,13953,90.3,115,42,36.5
10,All Students,2018-19,11556,1192,10364,89.7,74,17,23.0
10,All Students,2019-20,10072,1247,8825,87.6,99,30,30.3
10,All Students,2020-21,15408,1954,13454,87.3,94,42,44.7
10,All Students,2021-22,13831,1267,12564,90.8,94,34,36.2
10,All Students,2022-23,16532,1544,14988,90.7,107,29,27.1
11,All Students,2018-19,10701,1096,9605,89.8,70,27,38.6
11,All Students,2019-20,7323,768,6555,89.5,70,23,32.9
11,All Students,2020-21,14644,2216,12428,84.9,87,36,41.4
11,All Students,2021-22,16406,1731,14675,89.4,103,42,40.8
11,All Students,2022-23,13704,1342,12362,90.2,94,32,34.0
12,All Students,2018-19,7601,925,6676,87.8,50,17,34.0
12,All Students,2019-20,4897,572,4325,88.3,47,15,31.9
12,All Students,2020-21,9794,1590,8204,83.8,57,29,50.9
12,All Students,2021-22,9781,1444,8337,85.2,61,31,50.8
12,All Students,2022-23,11981,1312,10669,89.0,75,33,44.0
All Grades,All Students,2018-19,108375,20795,87580,80.8,686,314,45.8
All Grades,All Students,2019-20,77755,15461,62294,80.1,718,316,44.0
All Grades,All Students,2020-21,145825,28506,117319,80.5,859,439,51.1
All Grades,All Students,2021-22,133101,26120,106981,80.4,846,479,56.6
All Grades,All Students,2022-23,131722,17534,114188,86.7,853,309,36.2
8,All Students,2021-22,76,s,s,s,s,s,s
9,All Students,2018-19,35605,7463,28142,79.0,237,110,46.4
9,All Students,2019-20,30717,5687,25030,81.5,290,115,39.7
9,All Students,2020-21,66458,15281,51177,77.0,388,243,62.6
9,All Students,2021-22,38402,7362,31040,80.8,254,132,52.0
9,All Students,2022-23,37535,5567,31968,85.2,251,86,34.3
10,All Students,2018-19,25920,4817,21103,81.4,167,78,46.7
10,All Students,2019-20,19402,4089,15313,78.9,182,91,50.0
10,All Students,2020-21,34794,6129,28665,82.4,206,107,51.9
10,All Students,2021-22,47111,10357,36754,78.0,301,193,64.1
10,All Students,2022-23,37923,5969,31954,84.3,250,107,42.8
11,All Students,2018-19,20593,2690,17903,86.9,127,46,36.2
11,All Students,2019-20,11961,1473,10488,87.7,113,38,33.6
11,All Students,2020-21,20754,1809,18945,91.3,123,26,21.1
11,All Students,2021-22,26226,3967,22259,84.9,164,82,50.0
11,All Students,2022-23,27379,2681,24698,90.2,173,47,27.2
12,All Students,2018-19,26257,5825,20432,77.8,155,80,51.6
12,All Students,2019-20,15675,4212,11463,73.1,133,72,54.1
12,All Students,2020-21,23819,5287,18532,77.8,142,63,44.4
12,All Students,2021-22,21286,s,s,s,s,s,s
12,All Students,2022-23,28885,3317,25568,88.5,179,69,38.5
All Grades,All Students,2018-19,69663,7820,61843,88.8,435,161,37.0
All Grades,All Students,2019-20,48995,5631,43364,88.5,456,161,35.3
All Grades,All Students,2020-21,78738,15410,63328,80.4,458,239,52.2
All Grades,All Students,2021-22,69336,10956,58380,84.2,440,212,48.2
All Grades,All Students,2022-23,66147,10312,55835,84.4,429,222,51.7
9,All Students,2018-19,19993,2067,17926,89.7,129,40,31.0
9,All Students,2019-20,14130,1605,12525,88.6,134,41,30.6
9,All Students,2020-21,22071,4816,17255,78.2,128,71,55.5
9,All Students,2021-22,19591,3018,16573,84.6,126,60,47.6
9,All Students,2022-23,19384,2543,16841,86.9,125,46,36.8
10,All Students,2018-19,19719,2451,17268,87.6,123,50,40.7
10,All Students,2019-20,13595,1526,12069,88.8,128,44,34.4
10,All Students,2020-21,20339,3114,17225,84.7,120,54,45.0
10,All Students,2021-22,18492,3733,14759,79.8,116,62,53.4
10,All Students,2022-23,17270,3339,13931,80.7,116,66,56.9
11,All Students,2018-19,15971,1704,14267,89.3,99,37,37.4
11,All Students,2019-20,11729,1373,10356,88.3,107,41,38.3
11,All Students,2020-21,19384,4080,15304,79.0,112,55,49.1
11,All Students,2021-22,17387,1932,15455,88.9,110,43,39.1
11,All Students,2022-23,14610,2077,12533,85.8,95,56,58.9
12,All Students,2018-19,13980,1598,12382,88.6,84,34,40.5
12,All Students,2019-20,9541,1127,8414,88.2,87,35,40.2
12,All Students,2020-21,16944,3400,13544,79.9,98,59,60.2
12,All Students,2021-22,13866,2273,11593,83.6,88,47,53.4
12,All Students,2022-23,14883,2353,12530,84.2,93,54,58.1
All Grades,All Students,2018-19,68513,11610,56903,83.1,470,233,49.6
All Grades,All Students,2019-20,47362,7426,39936,84.3,455,196,43.1
All Grades,All Students,2020-21,63273,10162,53111,83.9,407,159,39.1
All Grades,All Students,2021-22,57873,8720,49153,84.9,369,200,54.2
All Grades,All Students,2022-23,61867,7960,53907,87.1,407,182,44.7
9,All Students,2018-19,22533,2956,19577,86.9,151,60,39.7
9,All Students,2019-20,14932,1927,13005,87.1,149,56,37.6
9,All Students,2020-21,16358,2916,13442,82.2,96,44,45.8
9,All Students,2021-22,16019,1936,14083,87.9,99,45,45.5
9,All Students,2022-23,20297,2242,18055,89.0,132,50,37.9
10,All Students,2018-19,20086,3845,16241,80.9,138,75,54.3
10,All Students,2019-20,12853,1627,11226,87.3,123,49,39.8
10,All Students,2020-21,22040,4051,17989,81.6,129,59,45.7
10,All Students,2021-22,13226,2482,10744,81.2,86,48,55.8
10,All Students,2022-23,17808,2229,15579,87.5,116,53,45.7
11,All Students,2018-19,17023,3195,13828,81.2,117,63,53.8
11,All Students,2019-20,10666,2007,8659,81.2,98,47,48.0
11,All Students,2020-21,17644,2108,15536,88.1,108,33,30.6
11,All Students,2021-22,16486,2747,13739,83.3,103,63,61.2
11,All Students,2022-23,11265,1681,9584,85.1,73,27,37.0
12,All Students,2018-19,8871,1614,7257,81.8,64,35,54.7
12,All Students,2019-20,8911,1865,7046,79.1,85,44,51.8
12,All Students,2020-21,7231,1087,6144,85.0,74,23,31.1
12,All Students,2021-22,12142,1555,10587,87.2,81,44,54.3
12,All Students,2022-23,12497,1808,10689,85.5,86,52,60.5
All Grades,All Students,2018-19,56073,6073,50000,89.2,339,137,40.4
All Grades,All Students,2019-20,33373,3107,30266,90.7,314,117,37.3
All Grades,All Students,2020-21,50418,9803,40615,80.6,296,162,54.7
All Grades,All Students,2021-22,42372,4961,37411,88.3,269,125,46.5
All Grades,All Students,2022-23,40319,5532,34787,86.3,264,139,52.7
6,All Students,2018-19,19324,2154,17170,88.9,116,49,42.2
6,All Students,2019-20,9899,s,s,s,s,s,s
6,All Students,2020-21,16933,3304,13629,80.5,99,55,55.6
6,All Students,2021-22,12972,1437,11535,88.9,82,38,46.3
6,All Students,2022-23,9846,1736,8110,82.4,66,42,63.6
7,All Students,2018-19,19437,2169,17268,88.8,114,48,42.1
7,All Students,2019-20,12471,1116,11355,91.1,115,39,33.9
7,All Students,2020-21,14812,s,s,s,s,s,s
7,All Students,2021-22,14923,1870,13053,87.5,98,53,54.1
7,All Students,2022-23,12854,1613,11241,87.5,85,47,55.3
8,All Students,2018-19,17309,s,s,s,s,s,s
8,All Students,2019-20,10745,997,9748,90.7,102,40,39.2
8,All Students,2020-21,18629,3204,15425,82.8,109,57,52.3
8,All Students,2021-22,14477,1654,12823,88.6,89,34,38.2
8,All Students,2022-23,17619,2183,15436,87.6,113,50,44.2
9,All Students,2018-19,3,s,s,s,s,s,s
9,All Students,2019-20,258,s,s,s,s,s,s
9,All Students,2020-21,44,s,s,s,s,s,s
All Grades,All Students,2018-19,49510,6725,42785,86.4,308,147,47.7
All Grades,All Students,2019-20,38190,4948,33242,87.0,357,158,44.3
All Grades,All Students,2020-21,63955,7072,56883,88.9,379,131,34.6
All Grades,All Students,2021-22,63810,11683,52127,81.7,404,234,57.9
All Grades,All Students,2022-23,66741,9928,56813,85.1,428,208,48.6
9,All Students,2018-19,16447,2081,14366,87.3,102,47,46.1
9,All Students,2019-20,11977,1245,10732,89.6,114,35,30.7
9,All Students,2020-21,17168,2094,15074,87.8,101,36,35.6
9,All Students,2021-22,16894,2193,14701,87.0,108,49,45.4
9,All Students,2022-23,16179,1629,14550,89.9,104,37,35.6
10,All Students,2018-19,15841,1948,13893,87.7,96,40,41.7
10,All Students,2019-20,9661,1411,8250,85.4,91,43,47.3
10,All Students,2020-21,18277,1730,16547,90.5,106,29,27.4
10,All Students,2021-22,17742,3083,14659,82.6,110,63,57.3
10,All Students,2022-23,17434,2215,15219,87.3,118,51,43.2
11,All Students,2018-19,10334,1495,8839,85.5,66,37,56.1
11,All Students,2019-20,9790,1077,8713,89.0,90,40,44.4
11,All Students,2020-21,13959,1911,12048,86.3,83,37,44.6
11,All Students,2021-22,16892,3308,13584,80.4,104,64,61.5
11,All Students,2022-23,17057,2795,14262,83.6,107,57,53.3
12,All Students,2018-19,6888,1201,5687,82.6,44,23,52.3
12,All Students,2019-20,6762,1215,5547,82.0,62,40,64.5
12,All Students,2020-21,14551,1337,13214,90.8,89,29,32.6
12,All Students,2021-22,12282,3099,9183,74.8,82,58,70.7
12,All Students,2022-23,16071,3289,12782,79.5,99,63,63.6
All Grades,All Students,2018-19,59662,13691,45971,77.1,400,241,60.3
All Grades,All Students,2019-20,42647,9597,33050,77.5,412,271,65.8
All Grades,All Students,2020-21,63423,8341,55082,86.8,400,164,41.0
All Grades,All Students,2021-22,65104,16359,48745,74.9,451,308,68.3
All Grades,All Students,2022-23,65492,13669,51823,79.1,460,296,64.3
9,All Students,2018-19,17033,4285,12748,74.8,120,77,64.2
9,All Students,2019-20,12982,2551,10431,80.3,135,89,65.9
9,All Students,2020-21,18264,1733,16531,90.5,111,42,37.8
9,All Students,2021-22,23350,4440,18910,81.0,157,101,64.3
9,All Students,2022-23,20714,3930,16784,81.0,148,94,63.5
10,All Students,2018-19,15867,4373,11494,72.4,105,68,64.8
10,All Students,2019-20,10252,2803,7449,72.7,101,69,68.3
10,All Students,2020-21,19328,2303,17025,88.1,113,44,38.9
10,All Students,2021-22,15170,3364,11806,77.8,107,67,62.6
10,All Students,2022-23,21264,3926,17338,81.5,148,88,59.5
11,All Students,2018-19,15146,2647,12499,82.5,94,47,50.0
11,All Students,2019-20,10240,2463,7777,75.9,91,66,72.5
11,All Students,2020-21,15413,1983,13430,87.1,89,28,31.5
11,All Students,2021-22,17744,5012,12732,71.8,114,80,70.2
11,All Students,2022-23,12636,2845,9791,77.5,89,64,71.9
12,All Students,2018-19,11616,2386,9230,79.5,81,49,60.5
12,All Students,2019-20,9173,1780,7393,80.6,85,47,55.3
12,All Students,2020-21,10418,2322,8096,77.7,87,50,57.5
12,All Students,2021-22,8840,3543,5297,59.9,73,60,82.2
12,All Students,2022-23,10878,2968,7910,72.7,75,50,66.7
All Grades,All Students,2018-19,83741,5317,78424,93.7,491,103,21.0
All Grades,All Students,2019-20,54506,3440,51066,93.7,494,99,20.0
All Grades,All Students,2020-21,83321,5156,78165,93.8,487,78,16.0
All Grades,All Students,2021-22,79984,7213,72771,91.0,481,152,31.6
All Grades,All Students,2022-23,75623,7182,68441,90.5,468,165,35.3
6,All Students,2018-19,27633,1681,25952,93.9,163,35,21.5
6,All Students,2019-20,18539,1103,17436,94.1,167,28,16.8
6,All Students,2020-21,29082,1485,27597,94.9,173,17,9.8
6,All Students,2021-22,25479,s,s,s,s,s,s
6,All Students,2022-23,23172,2181,20991,90.6,141,50,35.5
7,All Students,2018-19,28092,1793,26299,93.6,165,35,21.2
7,All Students,2019-20,18147,1059,17088,94.2,163,26,16.0
7,All Students,2020-21,27137,1673,25464,93.8,156,28,17.9
7,All Students,2021-22,27538,2629,24909,90.5,163,60,36.8
7,All Students,2022-23,25913,2584,23329,90.0,161,61,37.9
8,All Students,2018-19,28016,1843,26173,93.4,163,33,20.2
8,All Students,2019-20,17820,1278,16542,92.8,164,45,27.4
8,All Students,2020-21,27102,1998,25104,92.6,158,33,20.9
8,All Students,2021-22,26950,1914,25036,92.9,163,38,23.3
8,All Students,2022-23,26538,2417,24121,90.9,166,54,32.5
9,All Students,2021-22,17,s,s,s,s,s,s
All Grades,All Students,2018-19,87243,6968,80275,92.0,520,139,26.7
All Grades,All Students,2019-20,59557,3252,56305,94.5,543,77,14.2
All Grades,All Students,2020-21,93265,10068,83197,89.2,556,181,32.6
All Grades,All Students,2021-22,86136,9976,76160,88.4,530,244,46.0
All Grades,All Students,2022-23,79388,7368,72020,90.7,480,161,33.5
6,All Students,2018-19,27086,1702,25384,93.7,161,31,19.3
6,All Students,2019-20,20161,1177,18984,94.2,186,33,17.7
6,All Students,2020-21,31821,2693,29128,91.5,191,44,23.0
6,All Students,2021-22,23498,2386,21112,89.8,147,61,41.5
6,All Students,2022-23,23803,1893,21910,92.0,148,44,29.7
7,All Students,2018-19,29934,2541,27393,91.5,180,52,28.9
7,All Students,2019-20,19064,s,s,s,s,s,s
7,All Students,2020-21,30792,3747,27045,87.8,183,71,38.8
7,All Students,2021-22,31940,3778,28162,88.2,195,91,46.7
7,All Students,2022-23,23565,2129,21436,91.0,143,50,35.0
8,All Students,2018-19,30223,2725,27498,91.0,179,56,31.3
8,All Students,2019-20,20293,1169,19124,94.2,182,26,14.3
8,All Students,2020-21,30652,3628,27024,88.2,182,66,36.3
8,All Students,2021-22,30670,3791,26879,87.6,188,92,48.9
8,All Students,2022-23,32020,3346,28674,89.6,189,67,35.4
9,All Students,2019-20,39,s,s,s,s,s,s
9,All Students,2021-22,21,s,s,s,s,s,s
10,All Students,2021-22,7,s,s,s,s,s,s
All Grades,All Students,2018-19,34159,3988,30171,88.3,211,96,45.5
All Grades,All Students,2019-20,19600,1898,17702,90.3,180,71,39.4
All Grades,All Students,2020-21,19591,3797,15794,80.6,118,63,53.4
All Grades,All Students,2021-22,17338,2610,14728,84.9,114,73,64.0
All Grades,All Students,2022-23,19598,2777,16821,85.8,125,66,52.8
6,All Students,2018-19,11006,1273,9733,88.4,71,37,52.1
6,All Students,2019-20,4218,377,3841,91.1,41,18,43.9
6,All Students,2020-21,4131,1035,3096,74.9,26,16,61.5
6,All Students,2021-22,8371,1310,7061,84.4,53,33,62.3
6,All Students,2022-23,8049,1205,6844,85.0,54,32,59.3
7,All Students,2018-19,12605,1356,11249,89.2,79,27,34.2
7,All Students,2019-20,6507,725,5782,88.9,59,29,49.2
7,All Students,2020-21,6053,1048,5005,82.7,36,20,55.6
7,All Students,2021-22,4446,718,3728,83.9,33,22,66.7
7,All Students,2022-23,7855,1067,6788,86.4,50,22,44.0
8,All Students,2018-19,10548,1359,9189,87.1,61,32,52.5
8,All Students,2019-20,8875,796,8079,91.0,80,24,30.0
8,All Students,2020-21,9407,1714,7693,81.8,56,27,48.2
8,All Students,2021-22,4521,582,3939,87.1,28,18,64.3
8,All Students,2022-23,3694,505,3189,86.3,21,12,57.1
All Grades,All Students,2018-19,91681,10067,81614,89.0,550,265,48.2
All Grades,All Students,2019-20,56825,5758,51067,89.9,529,225,42.5
All Grades,All Students,2020-21,77401,10885,66516,85.9,465,232,49.9
All Grades,All Students,2021-22,74799,9874,64925,86.8,461,264,57.3
All Grades,All Students,2022-23,69341,9180,60161,86.8,431,233,54.1
PK in K-12 Schools,All Students,2018-19,5725,755,4970,86.8,37,22,59.5
PK in K-12 Schools,All Students,2019-20,5558,669,4889,88.0,51,28,54.9
PK in K-12 Schools,All Students,2020-21,6862,1308,5554,80.9,47,28,59.6
PK in K-12 Schools,All Students,2021-22,7886,1307,6579,83.4,47,34,72.3
PK in K-12 Schools,All Students,2022-23,8008,1226,6782,84.7,54,37,68.5
0K,All Students,2018-19,13641,1951,11690,85.7,85,51,60.0
0K,All Students,2019-20,7605,915,6690,88.0,72,34,47.2
0K,All Students,2020-21,10373,1599,8774,84.6,64,38,59.4
0K,All Students,2021-22,10611,1523,9088,85.6,70,45,64.3
0K,All Students,2022-23,8797,1476,7321,83.2,56,36,64.3
1,All Students,2018-19,13447,1536,11911,88.6,79,38,48.1
1,All Students,2019-20,9175,1141,8034,87.6,88,51,58.0
1,All Students,2020-21,9915,1491,8424,85.0,61,33,54.1
1,All Students,2021-22,10391,1455,8936,86.0,63,39,61.9
1,All Students,2022-23,10641,1512,9129,85.8,67,39,58.2
2,All Students,2018-19,12937,1458,11479,88.7,79,40,50.6
2,All Students,2019-20,7793,629,7164,91.9,75,22,29.3
2,All Students,2020-21,13799,2097,11702,84.8,81,45,55.6
2,All Students,2021-22,10704,1487,9217,86.1,67,43,64.2
2,All Students,2022-23,9975,1362,8613,86.3,63,35,55.6
3,All Students,2018-19,15789,1690,14099,89.3,93,45,48.4
3,All Students,2019-20,8755,817,7938,90.7,79,30,38.0
3,All Students,2020-21,10952,1354,9598,87.6,66,25,37.9
3,All Students,2021-22,12825,1561,11264,87.8,78,40,51.3
3,All Students,2022-23,9912,1240,8672,87.5,58,30,51.7
4,All Students,2018-19,13443,1230,12213,90.9,80,33,41.3
4,All Students,2019-20,9752,954,8798,90.2,90,37,41.1
4,All Students,2020-21,12371,1375,10996,88.9,71,28,39.4
4,All Students,2021-22,10910,1217,9693,88.8,67,33,49.3
4,All Students,2022-23,10703,1336,9367,87.5,64,32,50.0
5,All Students,2018-19,16699,1447,15252,91.3,97,36,37.1
5,All Students,2019-20,8187,633,7554,92.3,74,23,31.1
5,All Students,2020-21,13129,1661,11468,87.3,75,35,46.7
5,All Students,2021-22,11472,1324,10148,88.5,69,30,43.5
5,All Students,2022-23,11305,1028,10277,90.9,69,24,34.8
All Grades,All Students,2018-19,46760,3712,43048,92.1,274,82,29.9
All Grades,All Students,2019-20,29766,2071,27695,93.0,264,65,24.6
All Grades,All Students,2020-21,42793,346,42447,99.2,248,5,2.0
All Grades,All Students,2021-22,42940,291,42649,99.3,257,5,1.9
All Grades,All Students,2022-23,42381,3533,38848,91.7,256,76,29.7
6,All Students,2018-19,15422,1126,14296,92.7,92,28,30.4
6,All Students,2019-20,10476,701,9775,93.3,93,21,22.6
6,All Students,2020-21,12699,57,12642,99.6,75,1,1.3
6,All Students,2021-22,14635,42,14593,99.7,89,1,1.1
6,All Students,2022-23,12855,940,11915,92.7,78,15,19.2
7,All Students,2018-19,15963,1253,14710,92.2,94,31,33.0
7,All Students,2019-20,10209,661,9548,93.5,89,19,21.3
7,All Students,2020-21,15401,157,15244,99.0,88,2,2.3
7,All Students,2021-22,14294,229,14065,98.4,85,4,4.7
7,All Students,2022-23,14783,1267,13516,91.4,91,29,31.9
8,All Students,2018-19,15367,s,s,s,s,s,s
8,All Students,2019-20,8988,s,s,s,s,s,s
8,All Students,2020-21,14693,132,14561,99.1,85,2,2.4
8,All Students,2021-22,14011,20,13991,99.9,83,0,0.0
8,All Students,2022-23,14743,1326,13417,91.0,87,32,36.8
9,All Students,2018-19,8,s,s,s,s,s,s
9,All Students,2019-20,93,s,s,s,s,s,s
All Grades,All Students,2018-19,43658,8273,35385,81.1,282,150,53.2
All Grades,All Students,2019-20,28884,4742,24142,83.6,275,132,48.0
All Grades,All Students,2020-21,41138,10398,30740,74.7,242,131,54.1
All Grades,All Students,2021-22,41001,8063,32938,80.3,270,142,52.6
All Grades,All Students,2022-23,45353,7187,38166,84.2,302,132,43.7
8,All Students,2021-22,20,s,s,s,s,s,s
9,All Students,2018-19,10755,1601,9154,85.1,71,32,45.1
9,All Students,2019-20,6504,793,5711,87.8,64,22,34.4
9,All Students,2020-21,10525,2297,8228,78.2,63,32,50.8
9,All Students,2021-22,12148,2166,9982,82.2,86,46,53.5
9,All Students,2022-23,13625,1823,11802,86.6,96,40,41.7
10,All Students,2018-19,9302,2100,7202,77.4,65,40,61.5
10,All Students,2019-20,7963,1111,6852,86.0,77,34,44.2
10,All Students,2020-21,9738,1814,7924,81.4,57,24,42.1
10,All Students,2021-22,10361,2294,8067,77.9,67,35,52.2
10,All Students,2022-23,12436,2139,10297,82.8,82,34,41.5
11,All Students,2018-19,13789,2407,11382,82.5,87,42,48.3
11,All Students,2019-20,5632,1345,4287,76.1,53,33,62.3
11,All Students,2020-21,12173,2798,9375,77.0,70,37,52.9
11,All Students,2021-22,7869,s,s,s,s,s,s
11,All Students,2022-23,10366,1709,8657,83.5,68,30,44.1
12,All Students,2018-19,9812,2165,7647,77.9,59,36,61.0
12,All Students,2019-20,8785,1493,7292,83.0,81,43,53.1
12,All Students,2020-21,8702,3489,5213,59.9,52,38,73.1
12,All Students,2021-22,10603,2253,8350,78.8,66,34,51.5
12,All Students,2022-23,8926,1516,7410,83.0,56,28,50.0
All Grades,All Students,2018-19,60738,4969,55769,91.8,354,99,28.0
All Grades,All Students,2019-20,41428,3088,38340,92.5,371,85,22.9
All Grades,All Students,2020-21,62543,5867,56676,90.6,370,114,30.8
All Grades,All Students,2021-22,51765,5037,46728,90.3,304,96,31.6
All Grades,All Students,2022-23,48374,4260,44114,91.2,282,92,32.6
6,All Students,2018-19,21411,1424,19987,93.3,123,26,21.1
6,All Students,2019-20,14770,1061,13709,92.8,131,20,15.3
6,All Students,2020-21,23865,2747,21118,88.5,141,55,39.0
6,All Students,2021-22,12595,s,s,s,s,s,s
6,All Students,2022-23,14824,1160,13664,92.2,85,29,34.1
7,All Students,2018-19,22581,1792,20789,92.1,130,38,29.2
7,All Students,2019-20,12911,832,12079,93.6,115,26,22.6
7,All Students,2020-21,20461,2078,18383,89.8,121,38,31.4
7,All Students,2021-22,20074,2054,18020,89.8,116,37,31.9
7,All Students,2022-23,14101,1290,12811,90.9,83,26,31.3
8,All Students,2018-19,16746,1753,14993,89.5,101,35,34.7
8,All Students,2019-20,13747,1195,12552,91.3,125,39,31.2
8,All Students,2020-21,18217,1042,17175,94.3,108,21,19.4
8,All Students,2021-22,19005,1765,17240,90.7,112,37,33.0
8,All Students,2022-23,19449,1810,17639,90.7,114,37,32.5
9,All Students,2021-22,91,s,s,s,s,s,s
All Grades,All Students,2018-19,55421,7720,47701,86.1,358,164,45.8
All Grades,All Students,2019-20,37095,4307,32788,88.4,361,150,41.6
All Grades,All Students,2020-21,60432,11372,49060,81.2,356,202,56.7
All Grades,All Students,2021-22,57304,8635,48669,84.9,371,202,54.4
All Grades,All Students,2022-23,54872,7701,47171,86.0,361,180,49.9
8,All Students,2018-19,35,s,s,s,s,s,s
9,All Students,2018-19,16037,2544,13493,84.1,107,52,48.6
9,All Students,2019-20,10649,1354,9295,87.3,108,48,44.4
9,All Students,2020-21,15481,2522,12959,83.7,95,53,55.8
9,All Students,2021-22,17425,2203,15222,87.4,113,52,46.0
9,All Students,2022-23,16104,2023,14081,87.4,107,47,43.9
10,All Students,2018-19,17943,2716,15227,84.9,118,55,46.6
10,All Students,2019-20,10894,1512,9382,86.1,108,53,49.1
10,All Students,2020-21,15563,3285,12278,78.9,91,52,57.1
10,All Students,2021-22,14553,2188,12365,85.0,96,52,54.2
10,All Students,2022-23,16642,2316,14326,86.1,111,57,51.4
11,All Students,2018-19,10764,912,9852,91.5,66,22,33.3
11,All Students,2019-20,8625,756,7869,91.2,82,26,31.7
11,All Students,2020-21,14755,2839,11916,80.8,86,52,60.5
11,All Students,2021-22,13561,2298,11263,83.1,88,53,60.2
11,All Students,2022-23,12684,1939,10745,84.7,80,42,52.5
12,All Students,2018-19,10642,s,s,s,s,s,s
12,All Students,2019-20,6927,685,6242,90.1,63,23,36.5
12,All Students,2020-21,14633,2726,11907,81.4,84,45,53.6
12,All Students,2021-22,11765,1946,9819,83.5,74,45,60.8
12,All Students,2022-23,9442,1423,8019,84.9,63,34,54.0
All Grades,All Students,2018-19,7544,577,6967,92.4,47,15,31.9
All Grades,All Students,2019-20,13955,1464,12491,89.5,132,56,42.4
All Grades,All Students,2020-21,24928,3281,21647,86.8,145,65,44.8
All Grades,All Students,2021-22,27038,3471,23567,87.2,161,77,47.8
All Grades,All Students,2022-23,26530,2560,23970,90.4,161,61,37.9
5,All Students,2021-22,8,s,s,s,s,s,s
6,All Students,2018-19,7544,577,6967,92.4,47,15,31.9
6,All Students,2019-20,8344,917,7427,89.0,78,35,44.9
6,All Students,2020-21,5258,s,s,s,s,s,s
6,All Students,2021-22,10765,1294,9471,88.0,67,34,50.7
6,All Students,2022-23,12216,1340,10876,89.0,71,33,46.5
7,All Students,2019-20,5611,547,5064,90.3,54,21,38.9
7,All Students,2020-21,12301,1781,10520,85.5,71,31,43.7
7,All Students,2021-22,5382,s,s,s,s,s,s
7,All Students,2022-23,9161,738,8423,91.9,60,19,31.7
8,All Students,2020-21,7361,816,6545,88.9,44,20,45.5
8,All Students,2021-22,10883,1352,9531,87.6,62,23,37.1
8,All Students,2022-23,5153,482,4671,90.6,30,9,30.0
9,All Students,2020-21,8,s,s,s,s,s,s
All Grades,All Students,2021-22,16804,1096,15708,93.5,100,20,20.0
All Grades,All Students,2022-23,33129,2130,30999,93.6,195,31,15.9
6,All Students,2021-22,16804,1096,15708,93.5,100,20,20.0
6,All Students,2022-23,16406,1020,15386,93.8,97,14,14.4
7,All Students,2022-23,16723,1110,15613,93.4,98,17,17.3
All Grades,All Students,2020-21,10475,1086,9389,89.6,63,25,39.7
All Grades,All Students,2021-22,17558,1941,15617,88.9,106,56,52.8
All Grades,All Students,2022-23,24954,2654,22300,89.4,150,73,48.7
PK in K-12 Schools,All Students,2020-21,5419,531,4888,90.2,32,12,37.5
PK in K-12 Schools,All Students,2021-22,5744,672,5072,88.3,35,21,60.0
PK in K-12 Schools,All Students,2022-23,5807,640,5167,89.0,33,18,54.5
0K,All Students,2020-21,5056,555,4501,89.0,31,13,41.9
0K,All Students,2021-22,7070,842,6228,88.1,44,25,56.8
0K,All Students,2022-23,7679,885,6794,88.5,48,26,54.2
1,All Students,2021-22,4744,427,4317,91.0,27,10,37.0
1,All Students,2022-23,6716,706,6010,89.5,39,20,51.3
2,All Students,2022-23,4752,423,4329,91.1,30,9,30.0
All Grades,All Students,2020-21,28578,5600,22978,80.4,169,88,52.1
All Grades,All Students,2021-22,23591,4529,19062,80.8,167,109,65.3
All Grades,All Students,2022-23,26559,3907,22652,85.3,187,88,47.1
9,All Students,2020-21,2854,400,2454,86.0,19,8,42.1
9,All Students,2021-22,6254,1230,5024,80.3,49,31,63.3
9,All Students,2022-23,8280,1284,6996,84.5,62,30,48.4
10,All Students,2020-21,7945,1268,6677,84.0,48,23,47.9
10,All Students,2021-22,5509,1007,4502,81.7,38,24,63.2
10,All Students,2022-23,7116,1038,6078,85.4,50,25,50.0
11,All Students,2020-21,5446,1201,4245,77.9,31,22,71.0
11,All Students,2021-22,6145,822,5323,86.6,40,20,50.0
11,All Students,2022-23,6190,660,5530,89.3,42,17,40.5
12,All Students,2020-21,12333,2731,9602,77.9,71,35,49.3
12,All Students,2021-22,5683,1470,4213,74.1,40,34,85.0
12,All Students,2022-23,4973,925,4048,81.4,33,16,48.5
All Grades,All Students,2018-19,176607,7677,168930,95.7,1047,116,11.1
All Grades,All Students,2019-20,112239,5265,106974,95.3,1007,113,11.2
All Grades,All Students,2020-21,168552,13603,154949,91.9,994,266,26.8
All Grades,All Students,2021-22,169954,12539,157415,92.6,1006,264,26.2
All Grades,All Students,2022-23,163906,13660,150246,91.7,968,284,29.3
0K,All Students,2018-19,14288,725,13563,94.9,87,16,18.4
0K,All Students,2019-20,10609,742,9867,93.0,96,19,19.8
0K,All Students,2020-21,15784,1244,14540,92.1,95,25,26.3
0K,All Students,2021-22,16343,1674,14669,89.8,97,39,40.2
0K,All Students,2022-23,13175,1531,11644,88.4,79,34,43.0
1,All Students,2018-19,18219,944,17275,94.8,109,17,15.6
1,All Students,2019-20,8546,443,8103,94.8,79,14,17.7
1,All Students,2020-21,14964,743,14221,95.0,87,13,14.9
1,All Students,2021-22,15958,1521,14437,90.5,95,37,38.9
1,All Students,2022-23,16432,1518,14914,90.8,96,31,32.3
2,All Students,2018-19,18656,832,17824,95.5,113,10,8.8
2,All Students,2019-20,10870,513,10357,95.3,99,10,10.1
2,All Students,2020-21,12416,673,11743,94.6,74,11,14.9
2,All Students,2021-22,15309,1078,14231,93.0,93,21,22.6
2,All Students,2022-23,16404,1686,14718,89.7,101,41,40.6
3,All Students,2018-19,17485,664,16821,96.2,105,9,8.6
3,All Students,2019-20,11709,474,11235,96.0,103,8,7.8
3,All Students,2020-21,16498,1040,15458,93.7,100,16,16.0
3,All Students,2021-22,13472,806,12666,94.0,79,15,19.0
3,All Students,2022-23,14370,944,13426,93.4,83,18,21.7
4,All Students,2018-19,19633,918,18715,95.3,118,21,17.8
4,All Students,2019-20,11359,469,10890,95.9,102,5,4.9
4,All Students,2020-21,17467,1466,16001,91.6,103,29,28.2
4,All Students,2021-22,16182,952,15230,94.1,96,17,17.7
4,All Students,2022-23,13890,922,12968,93.4,83,17,20.5
5,All Students,2018-19,20602,789,19813,96.2,122,11,9.0
5,All Students,2019-20,12418,493,11925,96.0,111,10,9.0
5,All Students,2020-21,17170,816,16354,95.2,102,13,12.7
5,All Students,2021-22,17246,1016,16230,94.1,104,19,18.3
5,All Students,2022-23,18820,1117,17703,94.1,111,20,18.0
6,All Students,2018-19,21277,924,20353,95.7,126,9,7.1
6,All Students,2019-20,18137,884,17253,95.1,163,22,13.5
6,All Students,2020-21,25627,2768,22859,89.2,148,58,39.2
6,All Students,2021-22,22874,1692,21182,92.6,133,35,26.3
6,All Students,2022-23,22962,1749,21213,92.4,135,38,28.1
7,All Students,2018-19,23477,927,22550,96.1,134,10,7.5
7,All Students,2019-20,13223,636,12587,95.2,120,14,11.7
7,All Students,2020-21,27902,2639,25263,90.5,163,51,31.3
7,All Students,2021-22,25412,1687,23725,93.4,149,31,20.8
7,All Students,2022-23,22004,2015,19989,90.8,127,45,35.4
8,All Students,2018-19,22970,954,22016,95.8,133,13,9.8
8,All Students,2019-20,15368,611,14757,96.0,134,11,8.2
8,All Students,2020-21,20724,2214,18510,89.3,122,50,41.0
8,All Students,2021-22,27158,2113,25045,92.2,160,50,31.3
8,All Students,2022-23,25849,2178,23671,91.6,153,40,26.1
All Grades,All Students,2018-19,100331,5520,94811,94.5,587,116,19.8
All Grades,All Students,2019-20,65205,4079,61126,93.7,586,115,19.6
All Grades,All Students,2020-21,97437,5752,91685,94.1,582,116,19.9
All Grades,All Students,2021-22,90956,7481,83475,91.8,549,165,30.1
All Grades,All Students,2022-23,89496,6801,82695,92.4,548,168,30.7
PK in K-12 Schools,All Students,2018-19,3182,215,2967,93.2,18,3,16.7
PK in K-12 Schools,All Students,2019-20,2046,138,1908,93.3,19,3,15.8
PK in K-12 Schools,All Students,2020-21,3137,169,2968,94.6,18,4,22.2
PK in K-12 Schools,All Students,2021-22,3065,585,2480,80.9,20,15,75.0
PK in K-12 Schools,All Students,2022-23,3194,416,2778,87.0,22,17,77.3
0K,All Students,2018-19,18077,1150,16927,93.6,107,26,24.3
0K,All Students,2019-20,11580,982,10598,91.5,106,32,30.2
0K,All Students,2020-21,14464,1333,13131,90.8,92,34,37.0
0K,All Students,2021-22,13047,1068,11979,91.8,81,23,28.4
0K,All Students,2022-23,14500,1317,13183,90.9,91,33,36.3
1,All Students,2018-19,17249,1035,16214,94.0,101,21,20.8
1,All Students,2019-20,11259,652,10607,94.2,100,15,15.0
1,All Students,2020-21,17282,984,16298,94.3,104,20,19.2
1,All Students,2021-22,14430,1370,13060,90.5,85,31,36.5
1,All Students,2022-23,12687,905,11782,92.9,78,18,23.1
2,All Students,2018-19,16291,753,15538,95.4,95,14,14.7
2,All Students,2019-20,11658,829,10829,92.9,104,27,26.0
2,All Students,2020-21,16857,798,16059,95.3,97,12,12.4
2,All Students,2021-22,16060,1148,14912,92.9,96,27,28.1
2,All Students,2022-23,14304,1151,13153,92.0,88,29,33.0
3,All Students,2018-19,16915,803,16112,95.3,99,16,16.2
3,All Students,2019-20,9053,460,8593,94.9,82,12,14.6
3,All Students,2020-21,16479,817,15662,95.0,98,16,16.3
3,All Students,2021-22,15505,1050,14455,93.2,92,20,21.7
3,All Students,2022-23,15216,1115,14101,92.7,89,27,30.3
4,All Students,2018-19,12681,684,11997,94.6,75,18,24.0
4,All Students,2019-20,11087,525,10562,95.3,99,12,12.1
4,All Students,2020-21,13422,813,12609,93.9,80,14,17.5
4,All Students,2021-22,15447,1298,14149,91.6,91,28,30.8
4,All Students,2022-23,14403,776,13627,94.6,85,19,22.4
5,All Students,2018-19,15936,880,15056,94.5,92,18,19.6
5,All Students,2019-20,8522,493,8029,94.2,76,14,18.4
5,All Students,2020-21,15796,838,14958,94.7,93,16,17.2
5,All Students,2021-22,13402,962,12440,92.8,84,21,25.0
5,All Students,2022-23,15192,1121,14071,92.6,95,25,26.3
All Grades,All Students,2018-19,216920,12112,204808,94.4,1266,184,14.5
All Grades,All Students,2019-20,134774,8198,126576,93.9,1206,215,17.8
All Grades,All Students,2020-21,193795,24327,169468,87.4,1139,540,47.4
All Grades,All Students,2021-22,171069,15930,155139,90.7,1030,355,34.5
All Grades,All Students,2022-23,162843,13586,149257,91.7,994,309,31.1
6,All Students,2018-19,67472,3708,63764,94.5,394,58,14.7
6,All Students,2019-20,43599,2452,41147,94.4,395,68,17.2
6,All Students,2020-21,58670,s,s,s,s,s,s
6,All Students,2021-22,46863,s,s,s,s,s,s
6,All Students,2022-23,53397,3999,49398,92.5,330,87,26.4
7,All Students,2018-19,69187,3876,65311,94.4,408,50,12.3
7,All Students,2019-20,45847,2849,42998,93.8,409,72,17.6
7,All Students,2020-21,66036,7585,58451,88.5,385,160,41.6
7,All Students,2021-22,57699,5113,52586,91.1,349,116,33.2
7,All Students,2022-23,49803,3910,45893,92.1,301,97,32.2
8,All Students,2018-19,80261,4528,75733,94.4,464,76,16.4
8,All Students,2019-20,45328,2897,42431,93.6,402,75,18.7
8,All Students,2020-21,69014,9220,59794,86.6,402,205,51.0
8,All Students,2021-22,66497,7036,59461,89.4,396,158,39.9
8,All Students,2022-23,59643,5677,53966,90.5,363,125,34.4
9,All Students,2020-21,73,s,s,s,s,s,s
9,All Students,2021-22,10,s,s,s,s,s,s
All Grades,All Students,2018-19,137943,2847,135096,97.9,819,34,4.2
All Grades,All Students,2019-20,88763,2939,85824,96.7,790,39,4.9
All Grades,All Students,2020-21,131782,2247,129535,98.3,763,31,4.1
All Grades,All Students,2021-22,114244,5437,108807,95.2,678,70,10.3
All Grades,All Students,2022-23,108666,3380,105286,96.9,645,38,5.9
0K,All Students,2018-19,23405,734,22671,96.9,144,9,6.3
0K,All Students,2019-20,15289,819,14470,94.6,136,16,11.8
0K,All Students,2020-21,19162,443,18719,97.7,112,6,5.4
0K,All Students,2021-22,19280,1275,18005,93.4,118,20,16.9
0K,All Students,2022-23,17103,704,16399,95.9,106,10,9.4
1,All Students,2018-19,25848,661,25187,97.4,154,8,5.2
1,All Students,2019-20,15147,607,14540,96.0,135,8,5.9
1,All Students,2020-21,22700,425,22275,98.1,131,5,3.8
1,All Students,2021-22,14938,1020,13918,93.2,90,16,17.8
1,All Students,2022-23,17847,844,17003,95.3,108,10,9.3
2,All Students,2018-19,21842,413,21429,98.1,129,6,4.7
2,All Students,2019-20,17042,563,16479,96.7,151,5,3.3
2,All Students,2020-21,21018,268,20750,98.7,121,6,5.0
2,All Students,2021-22,18476,887,17589,95.2,107,11,10.3
2,All Students,2022-23,16627,642,15985,96.1,96,5,5.2
3,All Students,2018-19,20444,445,19999,97.8,125,7,5.6
3,All Students,2019-20,13829,395,13434,97.1,124,6,4.8
3,All Students,2020-21,26880,475,26405,98.2,156,5,3.2
3,All Students,2021-22,18920,772,18148,95.9,108,8,7.4
3,All Students,2022-23,17391,507,16884,97.1,104,8,7.7
4,All Students,2018-19,22905,329,22576,98.6,133,3,2.3
4,All Students,2019-20,13503,296,13207,97.8,121,3,2.5
4,All Students,2020-21,20939,362,20577,98.3,121,6,5.0
4,All Students,2021-22,22256,752,21504,96.6,134,6,4.5
4,All Students,2022-23,18288,360,17928,98.0,106,4,3.8
5,All Students,2018-19,23499,265,23234,98.9,134,1,0.7
5,All Students,2019-20,13953,259,13694,98.1,123,1,0.8
5,All Students,2020-21,21036,274,20762,98.7,121,3,2.5
5,All Students,2021-22,20374,731,19643,96.4,121,9,7.4
5,All Students,2022-23,21410,323,21087,98.5,125,1,0.8
All Grades,All Students,2018-19,253467,12150,241317,95.2,1465,157,10.7
All Grades,All Students,2019-20,160978,7777,153201,95.2,1438,165,11.5
All Grades,All Students,2020-21,225559,9923,215636,95.6,1336,182,13.6
All Grades,All Students,2021-22,208574,15515,193059,92.6,1224,291,23.8
All Grades,All Students,2022-23,196686,13894,182792,92.9,1151,265,23.0
0K,All Students,2018-19,43002,2630,40372,93.9,251,41,16.3
0K,All Students,2019-20,27148,1584,25564,94.2,247,37,15.0
0K,All Students,2020-21,34663,1622,33041,95.3,209,30,14.4
0K,All Students,2021-22,30985,3109,27876,90.0,187,67,35.8
0K,All Students,2022-23,31001,2788,28213,91.0,183,60,32.8
1,All Students,2018-19,45234,2333,42901,94.8,259,31,12.0
1,All Students,2019-20,26610,1481,25129,94.4,241,35,14.5
1,All Students,2020-21,38172,1770,36402,95.4,229,35,15.3
1,All Students,2021-22,33788,2615,31173,92.3,201,50,24.9
1,All Students,2022-23,31184,2445,28739,92.2,182,51,28.0
2,All Students,2018-19,41737,1845,39892,95.6,243,25,10.3
2,All Students,2019-20,27737,1338,26399,95.2,246,25,10.2
2,All Students,2020-21,37437,1849,35588,95.1,219,32,14.6
2,All Students,2021-22,34634,2359,32275,93.2,202,39,19.3
2,All Students,2022-23,32179,2195,29984,93.2,189,38,20.1
3,All Students,2018-19,40108,1859,38249,95.4,234,20,8.5
3,All Students,2019-20,26719,1130,25589,95.8,239,25,10.5
3,All Students,2020-21,39524,1781,37743,95.5,237,33,13.9
3,All Students,2021-22,34278,2533,31745,92.6,201,40,19.9
3,All Students,2022-23,34369,1933,32436,94.4,199,29,14.6
4,All Students,2018-19,43351,1819,41532,95.8,252,20,7.9
4,All Students,2019-20,26248,1092,25156,95.8,233,17,7.3
4,All Students,2020-21,38430,1423,37007,96.3,225,27,12.0
4,All Students,2021-22,38110,2457,35653,93.6,221,48,21.7
4,All Students,2022-23,31085,1928,29157,93.8,184,37,20.1
5,All Students,2018-19,40035,1664,38371,95.8,226,20,8.8
5,All Students,2019-20,26516,1152,25364,95.7,232,26,11.2
5,All Students,2020-21,37267,1476,35791,96.0,216,25,11.6
5,All Students,2021-22,36779,2442,34337,93.4,212,47,22.2
5,All Students,2022-23,36868,2605,34263,92.9,214,50,23.4
All Grades,All Students,2018-19,220106,10688,209418,95.1,1305,172,13.2
All Grades,All Students,2019-20,140352,6857,133495,95.1,1268,154,12.1
All Grades,All Students,2020-21,207589,9605,197984,95.4,1235,162,13.1
All Grades,All Students,2021-22,195764,12730,183034,93.5,1165,250,21.5
All Grades,All Students,2022-23,195145,12677,182468,93.5,1174,259,22.1
0K,All Students,2018-19,21668,1219,20449,94.4,132,25,18.9
0K,All Students,2019-20,14482,854,13628,94.1,131,20,15.3
0K,All Students,2020-21,20565,1050,19515,94.9,125,21,16.8
0K,All Students,2021-22,16883,1200,15683,92.9,105,24,22.9
0K,All Students,2022-23,13874,1137,12737,91.8,85,26,30.6
1,All Students,2018-19,23054,1065,21989,95.4,143,13,9.1
1,All Students,2019-20,14000,715,13285,94.9,127,14,11.0
1,All Students,2020-21,21189,776,20413,96.3,128,11,8.6
1,All Students,2021-22,19443,1148,18295,94.1,115,27,23.5
1,All Students,2022-23,17364,1167,16197,93.3,108,30,27.8
2,All Students,2018-19,23571,1014,22557,95.7,139,9,6.5
2,All Students,2019-20,13903,649,13254,95.3,128,10,7.8
2,All Students,2020-21,21401,853,20548,96.0,128,15,11.7
2,All Students,2021-22,19776,1152,18624,94.2,115,25,21.7
2,All Students,2022-23,20647,1230,19417,94.0,125,19,15.2
3,All Students,2018-19,22796,1022,21774,95.5,134,14,10.4
3,All Students,2019-20,14918,602,14316,96.0,135,15,11.1
3,All Students,2020-21,19938,s,s,s,s,s,s
3,All Students,2021-22,20391,1210,19181,94.1,125,24,19.2
3,All Students,2022-23,21057,1054,20003,95.0,123,19,15.4
4,All Students,2018-19,21413,867,20546,96.0,124,13,10.5
4,All Students,2019-20,14496,662,13834,95.4,129,15,11.6
4,All Students,2020-21,21133,1035,20098,95.1,127,14,11.0
4,All Students,2021-22,18113,938,17175,94.8,108,16,14.8
4,All Students,2022-23,20910,1216,19694,94.2,130,23,17.7
5,All Students,2018-19,19687,868,18819,95.6,118,11,9.3
5,All Students,2019-20,13576,s,s,s,s,s,s
5,All Students,2020-21,21685,626,21059,97.1,127,9,7.1
5,All Students,2021-22,20779,1292,19487,93.8,123,25,20.3
5,All Students,2022-23,17536,955,16581,94.6,104,17,16.3
6,All Students,2018-19,31347,1373,29974,95.6,185,20,10.8
6,All Students,2019-20,16466,710,15756,95.7,152,19,12.5
6,All Students,2020-21,29033,1083,27950,96.3,174,17,9.8
6,All Students,2021-22,26776,1998,24778,92.5,160,38,23.8
6,All Students,2022-23,27516,1772,25744,93.6,166,37,22.3
7,All Students,2018-19,29477,1688,27789,94.3,172,35,20.3
7,All Students,2019-20,19654,827,18827,95.8,177,19,10.7
7,All Students,2020-21,25099,1611,23488,93.6,147,30,20.4
7,All Students,2021-22,28458,1902,26556,93.3,168,37,22.0
7,All Students,2022-23,27560,2214,25346,92.0,166,49,29.5
8,All Students,2018-19,27093,1572,25521,94.2,158,32,20.3
8,All Students,2019-20,18856,1302,17554,93.1,167,30,18.0
8,All Students,2020-21,27442,1612,25830,94.1,161,29,18.0
8,All Students,2021-22,25145,1890,23255,92.5,146,34,23.3
8,All Students,2022-23,28681,1932,26749,93.3,167,39,23.4
9,All Students,2019-20,1,s,s,s,s,s,s
9,All Students,2020-21,104,s,s,s,s,s,s
All Grades,All Students,2018-19,252223,4549,247674,98.2,1498,41,2.7
All Grades,All Students,2019-20,158507,4928,153579,96.9,1436,74,5.2
All Grades,All Students,2020-21,237944,3210,234734,98.7,1382,46,3.3
All Grades,All Students,2021-22,225207,8401,216806,96.3,1348,134,9.9
All Grades,All Students,2022-23,213805,5642,208163,97.4,1284,73,5.7
0K,All Students,2018-19,39916,1166,38750,97.1,247,14,5.7
0K,All Students,2019-20,28327,1435,26892,94.9,262,36,13.7
0K,All Students,2020-21,40344,886,39458,97.8,237,15,6.3
0K,All Students,2021-22,36939,1839,35100,95.0,227,37,16.3
0K,All Students,2022-23,32574,1367,31207,95.8,206,23,11.2
1,All Students,2018-19,48796,1080,47716,97.8,294,10,3.4
1,All Students,2019-20,24171,919,23252,96.2,222,11,5.0
1,All Students,2020-21,42894,467,42427,98.9,249,10,4.0
1,All Students,2021-22,36945,1798,35147,95.1,220,31,14.1
1,All Students,2022-23,36739,1263,35476,96.6,221,21,9.5
2,All Students,2018-19,41634,789,40845,98.1,242,7,2.9
2,All Students,2019-20,30263,1050,29213,96.5,270,11,4.1
2,All Students,2020-21,34486,261,34225,99.2,201,3,1.5
2,All Students,2021-22,37436,1325,36111,96.5,222,23,10.4
2,All Students,2022-23,36102,1016,35086,97.2,214,11,5.1
3,All Students,2018-19,40087,581,39506,98.6,240,5,2.1
3,All Students,2019-20,26889,712,26177,97.4,244,11,4.5
3,All Students,2020-21,45417,617,44800,98.6,263,6,2.3
3,All Students,2021-22,33961,925,33036,97.3,203,13,6.4
3,All Students,2022-23,34952,722,34230,97.9,210,8,3.8
4,All Students,2018-19,40244,392,39852,99.0,235,1,0.4
4,All Students,2019-20,23216,360,22856,98.4,209,3,1.4
4,All Students,2020-21,40012,588,39424,98.5,233,9,3.9
4,All Students,2021-22,42936,1240,41696,97.1,258,12,4.7
4,All Students,2022-23,31015,554,30461,98.2,183,6,3.3
5,All Students,2018-19,41546,541,41005,98.7,240,4,1.7
5,All Students,2019-20,25641,452,25189,98.2,229,2,0.9
5,All Students,2020-21,34791,391,34400,98.9,199,3,1.5
5,All Students,2021-22,36990,1274,35716,96.6,218,18,8.3
5,All Students,2022-23,42423,720,41703,98.3,250,4,1.6
All Grades,All Students,2018-19,121483,6404,115079,94.7,710,118,16.6
All Grades,All Students,2019-20,83257,4534,78723,94.6,755,126,16.7
All Grades,All Students,2020-21,125366,6114,119252,95.1,740,110,14.9
All Grades,All Students,2021-22,125839,9165,116674,92.7,739,202,27.3
All Grades,All Students,2022-23,132058,9676,122382,92.7,784,203,25.9
PK in K-12 Schools,All Students,2018-19,3122,268,2854,91.4,19,4,21.1
PK in K-12 Schools,All Students,2019-20,2050,175,1875,91.5,19,6,31.6
PK in K-12 Schools,All Students,2020-21,2975,152,2823,94.9,17,2,11.8
PK in K-12 Schools,All Students,2021-22,3186,388,2798,87.8,18,8,44.4
PK in K-12 Schools,All Students,2022-23,3089,374,2715,87.9,19,10,52.6
0K,All Students,2018-19,21843,1413,20430,93.5,130,28,21.5
0K,All Students,2019-20,14138,1072,13066,92.4,130,32,24.6
0K,All Students,2020-21,21676,1405,20271,93.5,132,26,19.7
0K,All Students,2021-22,22720,1977,20743,91.3,130,43,33.1
0K,All Students,2022-23,21509,2069,19440,90.4,129,50,38.8
1,All Students,2018-19,23148,1211,21937,94.8,137,27,19.7
1,All Students,2019-20,13310,733,12577,94.5,121,16,13.2
1,All Students,2020-21,19867,1442,18425,92.7,117,28,23.9
1,All Students,2021-22,22368,1705,20663,92.4,132,40,30.3
1,All Students,2022-23,24395,1825,22570,92.5,145,38,26.2
2,All Students,2018-19,20197,892,19305,95.6,117,9,7.7
2,All Students,2019-20,14757,801,13956,94.6,131,22,16.8
2,All Students,2020-21,18104,722,17382,96.0,109,12,11.0
2,All Students,2021-22,17519,1457,16062,91.7,107,32,29.9
2,All Students,2022-23,23238,1525,21713,93.4,137,29,21.2
3,All Students,2018-19,21248,985,20263,95.4,122,16,13.1
3,All Students,2019-20,13725,661,13064,95.2,127,16,12.6
3,All Students,2020-21,22973,770,22203,96.6,133,14,10.5
3,All Students,2021-22,18384,1116,17268,93.9,107,19,17.8
3,All Students,2022-23,16380,1340,15040,91.8,98,31,31.6
4,All Students,2018-19,16737,873,15864,94.8,99,20,20.2
4,All Students,2019-20,13769,487,13282,96.5,124,13,10.5
4,All Students,2020-21,18762,828,17934,95.6,112,16,14.3
4,All Students,2021-22,22625,1394,21231,93.8,135,35,25.9
4,All Students,2022-23,19020,979,18041,94.9,114,15,13.2
5,All Students,2018-19,15188,762,14426,95.0,86,14,16.3
5,All Students,2019-20,11508,605,10903,94.7,103,21,20.4
5,All Students,2020-21,21009,795,20214,96.2,120,12,10.0
5,All Students,2021-22,19037,1128,17909,94.1,110,25,22.7
5,All Students,2022-23,24427,1564,22863,93.6,142,30,21.1
All Grades,All Students,2018-19,90067,3924,86143,95.6,547,73,13.3
All Grades,All Students,2019-20,59684,3026,56658,94.9,533,79,14.8
All Grades,All Students,2020-21,90895,4993,85902,94.5,533,69,12.9
All Grades,All Students,2021-22,95499,5347,90152,94.4,554,96,17.3
All Grades,All Students,2022-23,106510,6847,99663,93.6,632,135,21.4
0K,All Students,2018-19,14955,832,14123,94.4,89,16,18.0
0K,All Students,2019-20,10390,796,9594,92.3,93,28,30.1
0K,All Students,2020-21,17212,885,16327,94.9,103,16,15.5
0K,All Students,2021-22,19468,1534,17934,92.1,112,35,31.3
0K,All Students,2022-23,19508,1977,17531,89.9,115,42,36.5
1,All Students,2018-19,17444,840,16604,95.2,115,18,15.7
1,All Students,2019-20,9493,553,8940,94.2,85,14,16.5
1,All Students,2020-21,14453,771,13682,94.7,84,11,13.1
1,All Students,2021-22,15502,870,14632,94.4,91,16,17.6
1,All Students,2022-23,19096,1269,17827,93.4,110,24,21.8
2,All Students,2018-19,16802,694,16108,95.9,100,11,11.0
2,All Students,2019-20,10169,411,9758,96.0,90,10,11.1
2,All Students,2020-21,14659,878,13781,94.0,85,11,12.9
2,All Students,2021-22,15720,758,14962,95.2,89,11,12.4
2,All Students,2022-23,17663,1070,16593,93.9,104,21,20.2
3,All Students,2018-19,13624,424,13200,96.9,82,6,7.3
3,All Students,2019-20,10454,464,9990,95.6,93,6,6.5
3,All Students,2020-21,14524,718,13806,95.1,86,9,10.5
3,All Students,2021-22,12682,643,12039,94.9,76,12,15.8
3,All Students,2022-23,19460,1036,18424,94.7,119,19,16.0
4,All Students,2018-19,15199,614,14585,96.0,91,11,12.1
4,All Students,2019-20,9273,405,8868,95.6,84,10,11.9
4,All Students,2020-21,15871,853,15018,94.6,92,9,9.8
4,All Students,2021-22,15847,748,15099,95.3,93,10,10.8
4,All Students,2022-23,14097,667,13430,95.3,87,15,17.2
5,All Students,2018-19,12043,520,11523,95.7,70,11,15.7
5,All Students,2019-20,9905,397,9508,96.0,88,11,12.5
5,All Students,2020-21,14176,888,13288,93.7,83,13,15.7
5,All Students,2021-22,16280,794,15486,95.1,93,12,12.9
5,All Students,2022-23,16686,828,15858,95.0,97,14,14.4
All Grades,All Students,2018-19,226727,4919,221808,97.8,1340,55,4.1
All Grades,All Students,2019-20,141146,4778,136368,96.6,1257,63,5.0
All Grades,All Students,2020-21,199678,3756,195922,98.1,1162,61,5.2
All Grades,All Students,2021-22,176885,7554,169331,95.7,1065,137,12.9
All Grades,All Students,2022-23,168242,5631,162611,96.7,1014,76,7.5
0K,All Students,2018-19,36079,1151,34928,96.8,211,12,5.7
0K,All Students,2019-20,23129,1068,22061,95.4,208,16,7.7
0K,All Students,2020-21,27772,831,26941,97.0,164,13,7.9
0K,All Students,2021-22,31849,1975,29874,93.8,195,44,22.6
0K,All Students,2022-23,28596,1526,27070,94.7,180,24,13.3
1,All Students,2018-19,40665,1111,39554,97.3,245,16,6.5
1,All Students,2019-20,22236,949,21287,95.7,198,12,6.1
1,All Students,2020-21,34821,490,34331,98.6,201,8,4.0
1,All Students,2021-22,29783,1679,28104,94.4,183,37,20.2
1,All Students,2022-23,32380,1341,31039,95.9,201,18,9.0
2,All Students,2018-19,34437,737,33700,97.9,204,9,4.4
2,All Students,2019-20,25160,986,24174,96.1,224,12,5.4
2,All Students,2020-21,31330,272,31058,99.1,181,2,1.1
2,All Students,2021-22,27673,1059,26614,96.2,167,14,8.4
2,All Students,2022-23,26131,973,25158,96.3,154,13,8.4
3,All Students,2018-19,37094,713,36381,98.1,219,5,2.3
3,All Students,2019-20,21663,631,21032,97.1,193,10,5.2
3,All Students,2020-21,36970,500,36470,98.6,216,5,2.3
3,All Students,2021-22,27379,855,26524,96.9,162,9,5.6
3,All Students,2022-23,26246,648,25598,97.5,156,9,5.8
4,All Students,2018-19,41162,674,40488,98.4,242,8,3.3
4,All Students,2019-20,24307,682,23625,97.2,215,9,4.2
4,All Students,2020-21,32849,514,32335,98.4,192,7,3.6
4,All Students,2021-22,31073,926,30147,97.0,188,16,8.5
4,All Students,2022-23,25530,492,25038,98.1,153,5,3.3
5,All Students,2018-19,37290,533,36757,98.6,219,5,2.3
5,All Students,2019-20,24651,462,24189,98.1,219,4,1.8
5,All Students,2020-21,35936,1149,34787,96.8,208,26,12.5
5,All Students,2021-22,29128,1060,28068,96.4,170,17,10.0
5,All Students,2022-23,29359,651,28708,97.8,170,7,4.1
All Grades,All Students,2018-19,109273,6103,103170,94.4,661,131,19.8
All Grades,All Students,2019-20,72304,4091,68213,94.3,649,113,17.4
All Grades,All Students,2020-21,107321,8702,98619,91.9,630,174,27.6
All Grades,All Students,2021-22,106402,8091,98311,92.4,629,176,28.0
All Grades,All Students,2022-23,111175,8553,102622,92.3,674,196,29.1
0K,All Students,2018-19,12688,828,11860,93.5,79,15,19.0
0K,All Students,2019-20,8660,667,7993,92.3,80,23,28.8
0K,All Students,2020-21,12116,1034,11082,91.5,72,20,27.8
0K,All Students,2021-22,9175,894,8281,90.3,54,21,38.9
0K,All Students,2022-23,9512,870,8642,90.9,61,19,31.1
1,All Students,2018-19,10596,622,9974,94.1,72,17,23.6
1,All Students,2019-20,8449,548,7901,93.5,76,13,17.1
1,All Students,2020-21,12395,766,11629,93.8,72,14,19.4
1,All Students,2021-22,12203,878,11325,92.8,71,18,25.4
1,All Students,2022-23,9962,865,9097,91.3,62,22,35.5
2,All Students,2018-19,9977,524,9453,94.7,63,10,15.9
2,All Students,2019-20,7132,442,6690,93.8,65,10,15.4
2,All Students,2020-21,11546,1017,10529,91.2,67,19,28.4
2,All Students,2021-22,12351,874,11477,92.9,75,18,24.0
2,All Students,2022-23,12034,867,11167,92.8,72,15,20.8
3,All Students,2018-19,10252,465,9787,95.5,61,9,14.8
3,All Students,2019-20,7400,444,6956,94.0,66,11,16.7
3,All Students,2020-21,10610,603,10007,94.3,63,10,15.9
3,All Students,2021-22,10898,810,10088,92.6,66,12,18.2
3,All Students,2022-23,13352,1121,12231,91.6,81,29,35.8
4,All Students,2018-19,11043,605,10438,94.5,68,14,20.6
4,All Students,2019-20,7225,303,6922,95.8,65,8,12.3
4,All Students,2020-21,10378,922,9456,91.1,61,18,29.5
4,All Students,2021-22,10468,728,9740,93.0,62,16,25.8
4,All Students,2022-23,10973,802,10171,92.7,67,18,26.9
5,All Students,2018-19,12259,554,11705,95.5,71,10,14.1
5,All Students,2019-20,7973,421,7552,94.7,71,12,16.9
5,All Students,2020-21,10950,715,10235,93.5,64,15,23.4
5,All Students,2021-22,11012,771,10241,93.0,64,20,31.3
5,All Students,2022-23,12054,781,11273,93.5,74,22,29.7
6,All Students,2018-19,13536,757,12779,94.4,80,21,26.3
6,All Students,2019-20,8075,380,7695,95.3,71,10,14.1
6,All Students,2020-21,14477,954,13523,93.4,87,21,24.1
6,All Students,2021-22,13629,1182,12447,91.3,80,28,35.0
6,All Students,2022-23,13029,853,12176,93.5,77,17,22.1
7,All Students,2018-19,13240,677,12563,94.9,77,15,19.5
7,All Students,2019-20,9378,519,8859,94.5,85,17,20.0
7,All Students,2020-21,12040,1262,10778,89.5,70,25,35.7
7,All Students,2021-22,15310,1103,14207,92.8,92,27,29.3
7,All Students,2022-23,14100,1096,13004,92.2,87,24,27.6
8,All Students,2018-19,15682,1071,14611,93.2,90,20,22.2
8,All Students,2019-20,8012,367,7645,95.4,70,9,12.9
8,All Students,2020-21,12809,1429,11380,88.8,74,32,43.2
8,All Students,2021-22,11356,851,10505,92.5,65,16,24.6
8,All Students,2022-23,16159,1298,14861,92.0,93,30,32.3
All Grades,All Students,2018-19,121080,5302,115778,95.6,714,90,12.6
All Grades,All Students,2019-20,77477,3710,73767,95.2,690,91,13.2
All Grades,All Students,2020-21,109193,4922,104271,95.5,639,77,12.1
All Grades,All Students,2021-22,98073,6308,91765,93.6,591,131,22.2
All Grades,All Students,2022-23,88704,5261,83443,94.1,532,97,18.2
PK in K-12 Schools,All Students,2018-19,6068,459,5609,92.4,37,9,24.3
PK in K-12 Schools,All Students,2019-20,4005,228,3777,94.3,37,6,16.2
PK in K-12 Schools,All Students,2020-21,2202,157,2045,92.9,13,2,15.4
PK in K-12 Schools,All Students,2021-22,2328,244,2084,89.5,17,10,58.8
PK in K-12 Schools,All Students,2022-23,2927,360,2567,87.7,18,9,50.0
0K,All Students,2018-19,15321,902,14419,94.1,92,17,18.5
0K,All Students,2019-20,10787,723,10064,93.3,99,23,23.2
0K,All Students,2020-21,16000,837,15163,94.8,95,15,15.8
0K,All Students,2021-22,14248,1331,12917,90.7,91,34,37.4
0K,All Students,2022-23,11479,892,10587,92.2,71,18,25.4
1,All Students,2018-19,22707,996,21711,95.6,137,20,14.6
1,All Students,2019-20,10583,609,9974,94.2,94,15,16.0
1,All Students,2020-21,16543,704,15839,95.7,98,11,11.2
1,All Students,2021-22,15404,1216,14188,92.1,92,25,27.2
1,All Students,2022-23,13818,966,12852,93.0,85,18,21.2
2,All Students,2018-19,24676,1033,23643,95.8,146,19,13.0
2,All Students,2019-20,14464,751,13713,94.8,130,19,14.6
2,All Students,2020-21,17050,1242,15808,92.7,100,21,21.0
2,All Students,2021-22,15655,804,14851,94.9,90,12,13.3
2,All Students,2022-23,15783,893,14890,94.3,92,14,15.2
3,All Students,2018-19,17878,734,17144,95.9,101,8,7.9
3,All Students,2019-20,14405,588,13817,95.9,127,13,10.2
3,All Students,2020-21,19833,617,19216,96.9,115,9,7.8
3,All Students,2021-22,14622,985,13637,93.3,86,17,19.8
3,All Students,2022-23,15337,643,14694,95.8,94,14,14.9
4,All Students,2018-19,18097,632,17465,96.5,106,8,7.5
4,All Students,2019-20,11220,452,10768,96.0,98,10,10.2
4,All Students,2020-21,21472,867,20605,96.0,124,12,9.7
4,All Students,2021-22,17009,812,16197,95.2,104,17,16.3
4,All Students,2022-23,13236,753,12483,94.3,78,12,15.4
5,All Students,2018-19,16333,546,15787,96.7,95,9,9.5
5,All Students,2019-20,12013,359,11654,97.0,105,5,4.8
5,All Students,2020-21,16053,484,15569,97.0,93,6,6.5
5,All Students,2021-22,18807,916,17891,95.1,111,16,14.4
5,All Students,2022-23,16124,754,15370,95.3,94,12,12.8
All Grades,All Students,2018-19,180093,6227,173866,96.5,1069,100,9.4
All Grades,All Students,2019-20,116233,4907,111326,95.8,1064,107,10.1
All Grades,All Students,2020-21,170773,4998,165775,97.1,1013,91,9.0
All Grades,All Students,2021-22,163245,9940,153305,93.9,976,188,19.3
All Grades,All Students,2022-23,157601,7578,150023,95.2,946,125,13.2
0K,All Students,2018-19,25614,1217,24397,95.2,157,22,14.0
0K,All Students,2019-20,17585,1028,16557,94.2,164,27,16.5
0K,All Students,2020-21,25839,1151,24688,95.5,154,26,16.9
0K,All Students,2021-22,26796,1954,24842,92.7,166,39,23.5
0K,All Students,2022-23,22789,1349,21440,94.1,143,27,18.9
1,All Students,2018-19,36375,1320,35055,96.4,218,20,9.2
1,All Students,2019-20,17091,776,16315,95.5,158,16,10.1
1,All Students,2020-21,27001,656,26345,97.6,162,11,6.8
1,All Students,2021-22,25333,1941,23392,92.3,155,41,26.5
1,All Students,2022-23,27483,1510,25973,94.5,166,22,13.3
2,All Students,2018-19,32009,1093,30916,96.6,190,16,8.4
2,All Students,2019-20,23835,999,22836,95.8,217,20,9.2
2,All Students,2020-21,24843,810,24033,96.7,147,14,9.5
2,All Students,2021-22,25992,1363,24629,94.8,154,23,14.9
2,All Students,2022-23,25544,1310,24234,94.9,151,20,13.2
3,All Students,2018-19,26694,800,25894,97.0,159,12,7.5
3,All Students,2019-20,20368,790,19578,96.1,187,13,7.0
3,All Students,2020-21,34257,811,33446,97.6,203,13,6.4
3,All Students,2021-22,25489,1484,24005,94.2,151,30,19.9
3,All Students,2022-23,26002,1182,24820,95.5,159,20,12.6
4,All Students,2018-19,30625,992,29633,96.8,181,16,8.8
4,All Students,2019-20,17846,607,17239,96.6,162,11,6.8
4,All Students,2020-21,31746,887,30859,97.2,189,13,6.9
4,All Students,2021-22,31962,1567,30395,95.1,186,28,15.1
4,All Students,2022-23,24726,1015,23711,95.9,147,13,8.8
5,All Students,2018-19,28776,805,27971,97.2,164,14,8.5
5,All Students,2019-20,19508,707,18801,96.4,176,20,11.4
5,All Students,2020-21,27087,683,26404,97.5,158,14,8.9
5,All Students,2021-22,27673,1631,26042,94.1,164,27,16.5
5,All Students,2022-23,31057,1212,29845,96.1,180,23,12.8
All Grades,All Students,2018-19,231485,6880,224605,97.0,1355,85,6.3
All Grades,All Students,2019-20,140852,4882,135970,96.5,1259,89,7.1
All Grades,All Students,2020-21,201409,3075,198334,98.5,1180,46,3.9
All Grades,All Students,2021-22,198432,10439,187993,94.7,1186,186,15.7
All Grades,All Students,2022-23,199705,9188,190517,95.4,1183,158,13.4
0K,All Students,2018-19,32156,1440,30716,95.5,190,26,13.7
0K,All Students,2019-20,20150,1000,19150,95.0,183,21,11.5
0K,All Students,2020-21,31898,676,31222,97.9,188,12,6.4
0K,All Students,2021-22,29729,2049,27680,93.1,182,38,20.9
0K,All Students,2022-23,27477,1922,25555,93.0,165,40,24.2
1,All Students,2018-19,36957,1263,35694,96.6,221,21,9.5
1,All Students,2019-20,20984,934,20050,95.5,188,20,10.6
1,All Students,2020-21,30120,387,29733,98.7,177,6,3.4
1,All Students,2021-22,31837,2106,29731,93.4,188,36,19.1
1,All Students,2022-23,33755,1773,31982,94.7,203,36,17.7
2,All Students,2018-19,35528,1123,34405,96.8,208,11,5.3
2,All Students,2019-20,23884,804,23080,96.6,214,14,6.5
2,All Students,2020-21,30438,579,29859,98.1,177,8,4.5
2,All Students,2021-22,32322,1865,30457,94.2,195,37,19.0
2,All Students,2022-23,31965,1492,30473,95.3,194,22,11.3
3,All Students,2018-19,38909,1033,37876,97.3,225,10,4.4
3,All Students,2019-20,23251,823,22428,96.5,206,15,7.3
3,All Students,2020-21,36067,552,35515,98.5,211,7,3.3
3,All Students,2021-22,33294,1455,31839,95.6,202,26,12.9
3,All Students,2022-23,35739,1459,34280,95.9,209,26,12.4
4,All Students,2018-19,40600,935,39665,97.7,237,9,3.8
4,All Students,2019-20,24743,665,24078,97.3,221,9,4.1
4,All Students,2020-21,35113,396,34717,98.9,208,5,2.4
4,All Students,2021-22,35463,1473,33990,95.8,209,23,11.0
4,All Students,2022-23,34798,1200,33598,96.6,203,17,8.4
5,All Students,2018-19,47335,1086,46249,97.7,274,8,2.9
5,All Students,2019-20,27840,656,27184,97.6,247,10,4.0
5,All Students,2020-21,37773,485,37288,98.7,219,8,3.7
5,All Students,2021-22,35787,1491,34296,95.8,210,26,12.4
5,All Students,2022-23,35971,1342,34629,96.3,209,17,8.1
All Grades,All Students,2018-19,146962,9560,137402,93.5,882,200,22.7
All Grades,All Students,2019-20,92302,6554,85748,92.9,831,193,23.2
All Grades,All Students,2020-21,134531,14375,120156,89.3,801,287,35.8
All Grades,All Students,2021-22,126132,13718,112414,89.1,763,323,42.3
All Grades,All Students,2022-23,120220,11431,108789,90.5,728,269,37.0
PK in K-12 Schools,All Students,2018-19,6298,695,5603,89.0,39,16,41.0
PK in K-12 Schools,All Students,2019-20,4079,s,s,s,s,s,s
PK in K-12 Schools,All Students,2020-21,6017,1464,4553,75.7,37,27,73.0
PK in K-12 Schools,All Students,2021-22,6140,924,5216,85.0,39,25,64.1
PK in K-12 Schools,All Students,2022-23,6332,805,5527,87.3,38,20,52.6
0K,All Students,2018-19,20180,1545,18635,92.3,127,40,31.5
0K,All Students,2019-20,14218,1275,12943,91.0,130,42,32.3
0K,All Students,2020-21,23592,3145,20447,86.7,143,62,43.4
0K,All Students,2021-22,18717,2733,15984,85.4,114,66,57.9
0K,All Students,2022-23,17011,2075,14936,87.8,106,50,47.2
1,All Students,2018-19,22903,1663,21240,92.7,139,37,26.6
1,All Students,2019-20,12909,1060,11849,91.8,116,35,30.2
1,All Students,2020-21,21660,2659,19001,87.7,131,53,40.5
1,All Students,2021-22,23398,2640,20758,88.7,137,63,46.0
1,All Students,2022-23,19269,2148,17121,88.9,122,56,45.9
2,All Students,2018-19,26589,1751,24838,93.4,152,36,23.7
2,All Students,2019-20,14143,897,13246,93.7,127,28,22.0
2,All Students,2020-21,17671,1484,16187,91.6,106,32,30.2
2,All Students,2021-22,19769,2159,17610,89.1,124,53,42.7
2,All Students,2022-23,21571,1864,19707,91.4,127,39,30.7
3,All Students,2018-19,22235,1285,20950,94.2,135,22,16.3
3,All Students,2019-20,16671,1223,15448,92.7,149,34,22.8
3,All Students,2020-21,20454,2425,18029,88.1,120,50,41.7
3,All Students,2021-22,16523,1675,14848,89.9,102,36,35.3
3,All Students,2022-23,18954,1681,17273,91.1,116,38,32.8
4,All Students,2018-19,25316,1365,23951,94.6,148,27,18.2
4,All Students,2019-20,13975,898,13077,93.6,126,25,19.8
4,All Students,2020-21,24414,1834,22580,92.5,143,36,25.2
4,All Students,2021-22,19884,1829,18055,90.8,119,47,39.5
4,All Students,2022-23,17339,1413,15926,91.9,103,33,32.0
5,All Students,2018-19,23441,1256,22185,94.6,142,22,15.5
5,All Students,2019-20,16301,895,15406,94.5,146,18,12.3
5,All Students,2020-21,20723,1364,19359,93.4,121,27,22.3
5,All Students,2021-22,21701,1758,19943,91.9,128,33,25.8
5,All Students,2022-23,19744,1445,18299,92.7,116,33,28.4
6,All Students,2019-20,6,s,s,s,s,s,s
All Grades,All Students,2018-19,189109,6354,182755,96.6,1105,101,9.1
All Grades,All Students,2019-20,122651,4510,118141,96.3,1089,100,9.2
All Grades,All Students,2020-21,181694,8482,173212,95.3,1048,140,13.4
All Grades,All Students,2021-22,167937,9306,158631,94.5,983,181,18.4
All Grades,All Students,2022-23,161482,9022,152460,94.4,942,184,19.5
PK in K-12 Schools,All Students,2018-19,2844,171,2673,94.0,17,5,29.4
PK in K-12 Schools,All Students,2019-20,2032,183,1849,91.0,18,7,38.9
PK in K-12 Schools,All Students,2020-21,2247,41,2206,98.2,14,0,0.0
PK in K-12 Schools,All Students,2021-22,2557,236,2321,90.8,15,8,53.3
PK in K-12 Schools,All Students,2022-23,2676,283,2393,89.4,18,7,38.9
0K,All Students,2018-19,14308,948,13360,93.4,88,24,27.3
0K,All Students,2019-20,10067,595,9472,94.1,90,15,16.7
0K,All Students,2020-21,14563,1042,13521,92.8,85,22,25.9
0K,All Students,2021-22,11093,999,10094,91.0,67,24,35.8
0K,All Students,2022-23,11595,1180,10415,89.8,67,32,47.8
1,All Students,2018-19,17065,676,16389,96.0,103,13,12.6
1,All Students,2019-20,9084,447,8637,95.1,81,15,18.5
1,All Students,2020-21,13872,544,13328,96.1,80,9,11.3
1,All Students,2021-22,13560,1168,12392,91.4,80,24,30.0
1,All Students,2022-23,12367,957,11410,92.3,74,22,29.7
2,All Students,2018-19,17862,547,17315,96.9,105,7,6.7
2,All Students,2019-20,9764,435,9329,95.5,90,9,10.0
2,All Students,2020-21,12385,619,11766,95.0,71,10,14.1
2,All Students,2021-22,13885,801,13084,94.2,82,13,15.9
2,All Students,2022-23,12903,938,11965,92.7,77,20,26.0
3,All Students,2018-19,16520,627,15893,96.2,96,8,8.3
3,All Students,2019-20,12117,421,11696,96.5,107,6,5.6
3,All Students,2020-21,14105,706,13399,95.0,81,10,12.3
3,All Students,2021-22,10333,885,9448,91.4,65,20,30.8
3,All Students,2022-23,13519,693,12826,94.9,80,12,15.0
4,All Students,2018-19,19239,706,18533,96.3,111,9,8.1
4,All Students,2019-20,10117,350,9767,96.5,91,5,5.5
4,All Students,2020-21,18459,623,17836,96.6,107,6,5.6
4,All Students,2021-22,13581,772,12809,94.3,79,13,16.5
4,All Students,2022-23,10941,733,10208,93.3,63,16,25.4
5,All Students,2018-19,16266,427,15839,97.4,94,3,3.2
5,All Students,2019-20,12394,525,11869,95.8,110,12,10.9
5,All Students,2020-21,15875,549,15326,96.5,92,9,9.8
5,All Students,2021-22,17699,880,16819,95.0,103,17,16.5
5,All Students,2022-23,13915,699,13216,95.0,83,12,14.5
6,All Students,2018-19,31394,807,30587,97.4,180,12,6.7
6,All Students,2019-20,20470,554,19916,97.3,180,7,3.9
6,All Students,2020-21,30625,1958,28667,93.6,177,33,18.6
6,All Students,2021-22,27530,1255,26275,95.4,163,24,14.7
6,All Students,2022-23,29077,1165,27912,96.0,167,20,12.0
7,All Students,2018-19,26572,664,25908,97.5,154,9,5.8
7,All Students,2019-20,19992,561,19431,97.2,176,16,9.1
7,All Students,2020-21,29927,1412,28515,95.3,171,23,13.5
7,All Students,2021-22,28933,1189,27744,95.9,165,19,11.5
7,All Students,2022-23,26118,1287,24831,95.1,151,27,17.9
8,All Students,2018-19,27039,781,26258,97.1,157,11,7.0
8,All Students,2019-20,16614,439,16175,97.4,146,8,5.5
8,All Students,2020-21,29636,988,28648,96.7,170,18,10.6
8,All Students,2021-22,28766,1121,27645,96.1,164,19,11.6
8,All Students,2022-23,28371,1087,27284,96.2,162,16,9.9
All Grades,All Students,2018-19,111953,5242,106711,95.3,650,63,9.7
All Grades,All Students,2019-20,73966,3849,70117,94.8,663,84,12.7
All Grades,All Students,2020-21,101685,5922,95763,94.2,608,97,16.0
All Grades,All Students,2021-22,98888,7292,91596,92.6,575,148,25.7
All Grades,All Students,2022-23,102728,7866,94862,92.3,603,158,26.2
0K,All Students,2018-19,20247,1325,18922,93.5,117,22,18.8
0K,All Students,2019-20,14051,919,13132,93.5,130,27,20.8
0K,All Students,2020-21,17992,1458,16534,91.9,110,26,23.6
0K,All Students,2021-22,18662,1760,16902,90.6,110,44,40.0
0K,All Students,2022-23,19231,1739,17492,91.0,112,33,29.5
1,All Students,2018-19,20352,956,19396,95.3,118,13,11.0
1,All Students,2019-20,12570,716,11854,94.3,115,17,14.8
1,All Students,2020-21,18113,1165,16948,93.6,108,17,15.7
1,All Students,2021-22,17098,1255,15843,92.7,100,25,25.0
1,All Students,2022-23,18138,1421,16717,92.2,105,31,29.5
2,All Students,2018-19,18506,834,17672,95.5,108,7,6.5
2,All Students,2019-20,12220,614,11606,95.0,109,16,14.7
2,All Students,2020-21,18616,1297,17319,93.0,110,21,19.1
2,All Students,2021-22,15965,1083,14882,93.2,92,18,19.6
2,All Students,2022-23,17115,1375,15740,92.0,102,30,29.4
3,All Students,2018-19,18259,680,17579,96.3,106,5,4.7
3,All Students,2019-20,11243,588,10655,94.8,99,9,9.1
3,All Students,2020-21,15288,715,14573,95.3,93,11,11.8
3,All Students,2021-22,17167,1093,16074,93.6,102,23,22.5
3,All Students,2022-23,15785,1194,14591,92.4,94,21,22.3
4,All Students,2018-19,18753,716,18037,96.2,109,8,7.3
4,All Students,2019-20,11721,490,11231,95.8,103,6,5.8
4,All Students,2020-21,15965,784,15181,95.1,93,13,14.0
4,All Students,2021-22,14901,879,14022,94.1,85,16,18.8
4,All Students,2022-23,17745,1157,16588,93.5,104,24,23.1
5,All Students,2018-19,15836,731,15105,95.4,92,8,8.7
5,All Students,2019-20,12161,522,11639,95.7,107,9,8.4
5,All Students,2020-21,15711,503,15208,96.8,94,9,9.6
5,All Students,2021-22,15095,1222,13873,91.9,86,22,25.6
5,All Students,2022-23,14714,980,13734,93.3,86,19,22.1
All Grades,All Students,2018-19,189626,7928,181698,95.8,1110,118,10.6
All Grades,All Students,2019-20,128344,6522,121822,94.9,1158,170,14.7
All Grades,All Students,2020-21,184395,7651,176744,95.9,1078,139,12.9
All Grades,All Students,2021-22,178934,12401,166533,93.1,1075,260,24.2
All Grades,All Students,2022-23,179632,11740,167892,93.5,1085,230,21.2
0K,All Students,2018-19,31337,1597,29740,94.9,185,28,15.1
0K,All Students,2019-20,20625,1331,19294,93.5,186,38,20.4
0K,All Students,2020-21,29026,1688,27338,94.2,169,33,19.5
0K,All Students,2021-22,27159,2116,25043,92.2,169,46,27.2
0K,All Students,2022-23,27488,2186,25302,92.0,169,49,29.0
1,All Students,2018-19,35516,1553,33963,95.6,209,23,11.0
1,All Students,2019-20,21106,1288,19818,93.9,188,35,18.6
1,All Students,2020-21,29979,1047,28932,96.5,175,20,11.4
1,All Students,2021-22,29211,2334,26877,92.0,176,50,28.4
1,All Students,2022-23,28687,2044,26643,92.9,173,38,22.0
2,All Students,2018-19,32302,1313,30989,95.9,187,14,7.5
2,All Students,2019-20,23721,1212,22509,94.9,216,31,14.4
2,All Students,2020-21,31080,1323,29757,95.7,184,24,13.0
2,All Students,2021-22,29118,2196,26922,92.5,179,50,27.9
2,All Students,2022-23,29780,2093,27687,93.0,183,43,23.5
3,All Students,2018-19,27432,1273,26159,95.4,165,23,13.9
3,All Students,2019-20,21919,1046,20873,95.2,202,27,13.4
3,All Students,2020-21,33460,1147,32313,96.6,194,17,8.8
3,All Students,2021-22,29577,2115,27462,92.8,176,49,27.8
3,All Students,2022-23,30222,1811,28411,94.0,180,37,20.6
4,All Students,2018-19,34881,1250,33631,96.4,201,19,9.5
4,All Students,2019-20,18034,752,17282,95.8,165,22,13.3
4,All Students,2020-21,33766,1355,32411,96.0,199,27,13.6
4,All Students,2021-22,31902,1869,30033,94.1,190,30,15.8
4,All Students,2022-23,30189,1912,28277,93.7,183,35,19.1
5,All Students,2018-19,28158,942,27216,96.7,163,11,6.7
5,All Students,2019-20,22939,893,22046,96.1,201,17,8.5
5,All Students,2020-21,27084,1091,25993,96.0,157,18,11.5
5,All Students,2021-22,31967,1771,30196,94.5,185,35,18.9
5,All Students,2022-23,33266,1694,31572,94.9,197,28,14.2
All Grades,All Students,2018-19,168899,2841,166058,98.3,954,29,3.0
All Grades,All Students,2019-20,112766,2133,110633,98.1,982,28,2.9
All Grades,All Students,2020-21,173040,3213,169827,98.1,990,32,3.2
All Grades,All Students,2021-22,163084,4471,158613,97.3,931,58,6.2
All Grades,All Students,2022-23,164467,4162,160305,97.5,932,40,4.3
6,All Students,2018-19,63899,980,62919,98.5,362,9,2.5
6,All Students,2019-20,35121,583,34538,98.3,306,9,2.9
6,All Students,2020-21,61075,1016,60059,98.3,349,7,2.0
6,All Students,2021-22,53085,1624,51461,96.9,306,22,7.2
6,All Students,2022-23,55419,1255,54164,97.7,315,8,2.5
7,All Students,2018-19,58281,743,57538,98.7,328,7,2.1
7,All Students,2019-20,39940,720,39220,98.2,348,9,2.6
7,All Students,2020-21,51943,836,51107,98.4,298,7,2.3
7,All Students,2021-22,58232,1422,56810,97.6,330,15,4.5
7,All Students,2022-23,51342,1366,49976,97.3,293,18,6.1
8,All Students,2018-19,46719,1118,45601,97.6,264,13,4.9
8,All Students,2019-20,37705,830,36875,97.8,328,10,3.0
8,All Students,2020-21,60022,1361,58661,97.7,343,18,5.2
8,All Students,2021-22,51767,1425,50342,97.2,295,21,7.1
8,All Students,2022-23,57706,1541,56165,97.3,324,14,4.3
All Grades,All Students,2018-19,114680,7211,107469,93.7,664,148,22.3
All Grades,All Students,2019-20,74063,4770,69293,93.6,655,128,19.5
All Grades,All Students,2020-21,111987,9311,102676,91.7,647,168,26.0
All Grades,All Students,2021-22,104376,9776,94600,90.6,619,219,35.4
All Grades,All Students,2022-23,104896,8997,95899,91.4,617,201,32.6
PK in K-12 Schools,All Students,2018-19,6152,647,5505,89.5,36,19,52.8
PK in K-12 Schools,All Students,2019-20,3805,405,3400,89.4,36,17,47.2
PK in K-12 Schools,All Students,2020-21,4761,564,4197,88.2,28,13,46.4
PK in K-12 Schools,All Students,2021-22,5465,893,4572,83.7,35,27,77.1
PK in K-12 Schools,All Students,2022-23,5870,904,4966,84.6,36,25,69.4
0K,All Students,2018-19,12041,1034,11007,91.4,71,27,38.0
0K,All Students,2019-20,8381,791,7590,90.6,76,28,36.8
0K,All Students,2020-21,13126,1647,11479,87.5,77,27,35.1
0K,All Students,2021-22,9776,1080,8696,89.0,59,28,47.5
0K,All Students,2022-23,9380,1065,8315,88.6,56,29,51.8
1,All Students,2018-19,12705,813,11892,93.6,74,15,20.3
1,All Students,2019-20,7597,502,7095,93.4,67,15,22.4
1,All Students,2020-21,11147,775,10372,93.0,64,10,15.6
1,All Students,2021-22,11631,1311,10320,88.7,70,30,42.9
1,All Students,2022-23,9292,994,8298,89.3,56,26,46.4
2,All Students,2018-19,11853,703,11150,94.1,69,13,18.8
2,All Students,2019-20,8305,424,7881,94.9,73,7,9.6
2,All Students,2020-21,11187,484,10703,95.7,64,7,10.9
2,All Students,2021-22,11401,1050,10351,90.8,70,25,35.7
2,All Students,2022-23,11444,973,10471,91.5,69,21,30.4
3,All Students,2018-19,14181,833,13348,94.1,83,16,19.3
3,All Students,2019-20,7119,395,6724,94.5,62,8,12.9
3,All Students,2020-21,11900,814,11086,93.2,69,14,20.3
3,All Students,2021-22,9406,805,8601,91.4,56,19,33.9
3,All Students,2022-23,12428,975,11453,92.2,72,23,31.9
4,All Students,2018-19,15129,724,14405,95.2,87,13,14.9
4,All Students,2019-20,9499,606,8893,93.6,84,15,17.9
4,All Students,2020-21,10540,604,9936,94.3,61,11,18.0
4,All Students,2021-22,11355,968,10387,91.5,65,23,35.4
4,All Students,2022-23,8805,774,8031,91.2,53,17,32.1
5,All Students,2018-19,10105,516,9589,94.9,58,9,15.5
5,All Students,2019-20,9735,550,9185,94.4,85,14,16.5
5,All Students,2020-21,14084,1330,12754,90.6,82,27,32.9
5,All Students,2021-22,10083,742,9341,92.6,61,13,21.3
5,All Students,2022-23,10888,712,10176,93.5,63,14,22.2
6,All Students,2018-19,10822,571,10251,94.7,63,11,17.5
6,All Students,2019-20,5811,296,5515,94.9,51,6,11.8
6,All Students,2020-21,15642,991,14651,93.7,90,15,16.7
6,All Students,2021-22,12448,975,11473,92.2,71,14,19.7
6,All Students,2022-23,11837,856,10981,92.8,68,14,20.6
7,All Students,2018-19,10573,573,10000,94.6,60,9,15.0
7,All Students,2019-20,6994,429,6565,93.9,61,10,16.4
7,All Students,2020-21,9100,724,8376,92.0,52,15,28.8
7,All Students,2021-22,14455,1285,13170,91.1,83,29,34.9
7,All Students,2022-23,11352,723,10629,93.6,66,11,16.7
8,All Students,2018-19,11119,797,10322,92.8,63,16,25.4
8,All Students,2019-20,6817,372,6445,94.5,60,8,13.3
8,All Students,2020-21,10500,1378,9122,86.9,60,29,48.3
8,All Students,2021-22,8356,667,7689,92.0,49,11,22.4
8,All Students,2022-23,13600,1021,12579,92.5,78,21,26.9
All Grades,All Students,2018-19,241547,14530,227017,94.0,1437,257,17.9
All Grades,All Students,2019-20,154997,10188,144809,93.4,1419,302,21.3
All Grades,All Students,2020-21,230918,19722,211196,91.5,1389,422,30.4
All Grades,All Students,2021-22,223241,20836,202405,90.7,1347,463,34.4
All Grades,All Students,2022-23,225149,20453,204696,90.9,1344,492,36.6
PK in K-12 Schools,All Students,2018-19,3529,210,3319,94.0,21,3,14.3
PK in K-12 Schools,All Students,2019-20,2259,250,2009,88.9,22,8,36.4
PK in K-12 Schools,All Students,2020-21,3020,478,2542,84.2,19,16,84.2
PK in K-12 Schools,All Students,2021-22,3172,s,s,s,s,s,s
PK in K-12 Schools,All Students,2022-23,3181,508,2673,84.0,18,13,72.2
0K,All Students,2018-19,41440,3416,38024,91.8,252,72,28.6
0K,All Students,2019-20,24198,2219,21979,90.8,224,72,32.1
0K,All Students,2020-21,34987,4087,30900,88.3,224,99,44.2
0K,All Students,2021-22,37194,4598,32596,87.6,230,108,47.0
0K,All Students,2022-23,36866,4149,32717,88.7,224,109,48.7
1,All Students,2018-19,46522,3073,43449,93.4,275,59,21.5
1,All Students,2019-20,27830,2043,25787,92.7,255,61,23.9
1,All Students,2020-21,39363,3739,35624,90.5,236,81,34.3
1,All Students,2021-22,34416,3684,30732,89.3,211,79,37.4
1,All Students,2022-23,38669,3545,35124,90.8,233,89,38.2
2,All Students,2018-19,41521,2224,39297,94.6,247,35,14.2
2,All Students,2019-20,28586,1766,26820,93.8,259,49,18.9
2,All Students,2020-21,39901,3905,35996,90.2,235,78,33.2
2,All Students,2021-22,37313,3184,34129,91.5,228,77,33.8
2,All Students,2022-23,34871,3197,31674,90.8,209,74,35.4
3,All Students,2018-19,35910,2046,33864,94.3,214,32,15.0
3,All Students,2019-20,25415,1443,23972,94.3,234,44,18.8
3,All Students,2020-21,41026,3187,37839,92.2,246,69,28.0
3,All Students,2021-22,37732,3251,34481,91.4,225,74,32.9
3,All Students,2022-23,36860,3172,33688,91.4,219,77,35.2
4,All Students,2018-19,37252,1748,35504,95.3,221,26,11.8
4,All Students,2019-20,23682,1177,22505,95.0,218,30,13.8
4,All Students,2020-21,37486,2356,35130,93.7,223,45,20.2
4,All Students,2021-22,37558,2665,34893,92.9,221,54,24.4
4,All Students,2022-23,37737,3251,34486,91.4,225,73,32.4
5,All Students,2018-19,35373,1813,33560,94.9,207,30,14.5
5,All Students,2019-20,23027,1290,21737,94.4,207,38,18.4
5,All Students,2020-21,35135,1970,33165,94.4,206,34,16.5
5,All Students,2021-22,35851,3088,32763,91.4,213,62,29.1
5,All Students,2022-23,36965,2631,34334,92.9,216,57,26.4
7,All Students,2021-22,5,s,s,s,s,s,s
All Grades,All Students,2018-19,294791,9017,285774,96.9,1687,128,7.6
All Grades,All Students,2019-20,200387,6281,194106,96.9,1766,133,7.5
All Grades,All Students,2020-21,301134,14537,286597,95.2,1741,235,13.5
All Grades,All Students,2021-22,275913,12432,263481,95.5,1583,198,12.5
All Grades,All Students,2022-23,276488,12558,263930,95.5,1597,230,14.4
6,All Students,2018-19,101245,3067,98178,97.0,578,44,7.6
6,All Students,2019-20,67315,2086,65229,96.9,597,39,6.5
6,All Students,2020-21,99068,5161,93907,94.8,575,81,14.1
6,All Students,2021-22,86282,3934,82348,95.4,496,56,11.3
6,All Students,2022-23,88137,4082,84055,95.4,512,69,13.5
7,All Students,2018-19,100059,2901,97158,97.1,573,41,7.2
7,All Students,2019-20,67048,2102,64946,96.9,590,43,7.3
7,All Students,2020-21,101755,4542,97213,95.5,590,71,12.0
7,All Students,2021-22,92081,4237,87844,95.4,531,73,13.7
7,All Students,2022-23,93593,3902,89691,95.8,538,72,13.4
8,All Students,2018-19,93487,3049,90438,96.7,536,43,8.0
8,All Students,2019-20,66024,2093,63931,96.8,579,51,8.8
8,All Students,2020-21,100311,4834,95477,95.2,576,83,14.4
8,All Students,2021-22,97550,4261,93289,95.6,556,69,12.4
8,All Students,2022-23,94758,4574,90184,95.2,547,89,16.3
All Grades,All Students,2018-19,198952,7005,191947,96.5,1150,96,8.3
All Grades,All Students,2019-20,128294,5380,122914,95.8,1143,115,10.1
All Grades,All Students,2020-21,181227,4669,176558,97.4,1058,69,6.5
All Grades,All Students,2021-22,185449,12217,173232,93.4,1108,236,21.3
All Grades,All Students,2022-23,183381,10898,172483,94.1,1094,208,19.0
PK in K-12 Schools,All Students,2018-19,3182,110,3072,96.5,19,1,5.3
PK in K-12 Schools,All Students,2019-20,2040,71,1969,96.5,18,1,5.6
PK in K-12 Schools,All Students,2020-21,3121,98,3023,96.9,19,1,5.3
PK in K-12 Schools,All Students,2021-22,3084,264,2820,91.4,18,3,16.7
PK in K-12 Schools,All Students,2022-23,3186,278,2908,91.3,18,6,33.3
0K,All Students,2018-19,30598,1591,29007,94.8,177,31,17.5
0K,All Students,2019-20,20060,1286,18774,93.6,183,36,19.7
0K,All Students,2020-21,24840,585,24255,97.6,147,10,6.8
0K,All Students,2021-22,25995,2172,23823,91.6,158,45,28.5
0K,All Students,2022-23,27831,2247,25584,91.9,175,56,32.0
1,All Students,2018-19,32595,1311,31284,96.0,192,18,9.4
1,All Students,2019-20,19837,1005,18832,94.9,177,22,12.4
1,All Students,2020-21,29126,723,28403,97.5,170,12,7.1
1,All Students,2021-22,25710,1897,23813,92.6,159,41,25.8
1,All Students,2022-23,27126,1717,25409,93.7,162,27,16.7
2,All Students,2018-19,32633,1008,31625,96.9,188,9,4.8
2,All Students,2019-20,21164,854,20310,96.0,189,18,9.5
2,All Students,2020-21,29279,835,28444,97.1,171,11,6.4
2,All Students,2021-22,29291,1912,27379,93.5,176,36,20.5
2,All Students,2022-23,27377,1450,25927,94.7,162,22,13.6
3,All Students,2018-19,30466,1089,29377,96.4,177,14,7.9
3,All Students,2019-20,21425,733,20692,96.6,189,10,5.3
3,All Students,2020-21,32108,847,31261,97.4,185,14,7.6
3,All Students,2021-22,31297,2126,29171,93.2,184,46,25.0
3,All Students,2022-23,28551,1507,27044,94.7,174,31,17.8
4,All Students,2018-19,34242,923,33319,97.3,196,13,6.6
4,All Students,2019-20,20223,809,19414,96.0,178,19,10.7
4,All Students,2020-21,31915,716,31199,97.8,188,9,4.8
4,All Students,2021-22,34666,1994,32672,94.2,207,40,19.3
4,All Students,2022-23,33007,2040,30967,93.8,194,36,18.6
5,All Students,2018-19,35236,973,34263,97.2,201,10,5.0
5,All Students,2019-20,23545,622,22923,97.4,209,9,4.3
5,All Students,2020-21,30838,865,29973,97.2,178,12,6.7
5,All Students,2021-22,35406,1852,33554,94.8,206,25,12.1
5,All Students,2022-23,36303,1659,34644,95.4,209,30,14.4
All Grades,All Students,2018-19,231519,9813,221706,95.8,1349,180,13.3
All Grades,All Students,2019-20,149886,8024,141862,94.6,1352,200,14.8
All Grades,All Students,2020-21,215694,7949,207745,96.3,1262,137,10.9
All Grades,All Students,2021-22,207197,14092,193105,93.2,1227,279,22.7
All Grades,All Students,2022-23,205837,13416,192421,93.5,1216,255,21.0
PK in K-12 Schools,All Students,2018-19,10557,789,9768,92.5,66,18,27.3
PK in K-12 Schools,All Students,2019-20,6788,591,6197,91.3,65,19,29.2
PK in K-12 Schools,All Students,2020-21,9387,343,9044,96.3,55,7,12.7
PK in K-12 Schools,All Students,2021-22,9520,1023,8497,89.3,56,25,44.6
PK in K-12 Schools,All Students,2022-23,9557,916,8641,90.4,54,19,35.2
0K,All Students,2018-19,34746,1979,32767,94.3,204,42,20.6
0K,All Students,2019-20,22463,1761,20702,92.2,208,53,25.5
0K,All Students,2020-21,32776,2060,30716,93.7,196,45,23.0
0K,All Students,2021-22,32778,2728,30050,91.7,194,55,28.4
0K,All Students,2022-23,27761,2158,25603,92.2,169,41,24.3
1,All Students,2018-19,39831,1909,37922,95.2,232,38,16.4
1,All Students,2019-20,21990,1161,20829,94.7,197,28,14.2
1,All Students,2020-21,33409,947,32462,97.2,195,14,7.2
1,All Students,2021-22,32921,2492,30429,92.4,199,50,25.1
1,All Students,2022-23,32028,2146,29882,93.3,193,40,20.7
2,All Students,2018-19,33291,1318,31973,96.0,193,19,9.8
2,All Students,2019-20,25424,1469,23955,94.2,230,33,14.3
2,All Students,2020-21,32227,894,31333,97.2,189,12,6.3
2,All Students,2021-22,31897,2230,29667,93.0,190,42,22.1
2,All Students,2022-23,33466,2415,31051,92.8,195,47,24.1
3,All Students,2018-19,37392,1303,36089,96.5,218,22,10.1
3,All Students,2019-20,23247,1000,22247,95.7,206,18,8.7
3,All Students,2020-21,37558,1480,36078,96.1,217,20,9.2
3,All Students,2021-22,30852,1850,29002,94.0,183,35,19.1
3,All Students,2022-23,33685,2170,31515,93.6,197,39,19.8
4,All Students,2018-19,40765,1322,39443,96.8,233,20,8.6
4,All Students,2019-20,24682,932,23750,96.2,223,25,11.2
4,All Students,2020-21,33023,1167,31856,96.5,195,23,11.8
4,All Students,2021-22,37369,2239,35130,94.0,219,43,19.6
4,All Students,2022-23,31541,1617,29924,94.9,187,34,18.2
5,All Students,2018-19,34937,1193,33744,96.6,203,21,10.3
5,All Students,2019-20,25292,1110,24182,95.6,223,24,10.8
5,All Students,2020-21,37314,1058,36256,97.2,215,16,7.4
5,All Students,2021-22,31860,1530,30330,95.2,186,29,15.6
5,All Students,2022-23,37799,1994,35805,94.7,221,35,15.8
All Grades,All Students,2018-19,270890,9807,261083,96.4,1593,154,9.7
All Grades,All Students,2019-20,171869,6762,165107,96.1,1528,156,10.2
All Grades,All Students,2020-21,248723,22545,226178,90.9,1439,424,29.5
All Grades,All Students,2021-22,222358,11081,211277,95.0,1326,197,14.9
All Grades,All Students,2022-23,221025,7873,213152,96.4,1322,127,9.6
5,All Students,2018-19,10,s,s,s,s,s,s
5,All Students,2022-23,10,s,s,s,s,s,s
6,All Students,2018-19,94518,3191,91327,96.6,553,47,8.5
6,All Students,2019-20,52703,1623,51080,96.9,467,33,7.1
6,All Students,2020-21,76724,6006,70718,92.2,445,128,28.8
6,All Students,2021-22,71363,3311,68052,95.4,427,60,14.1
6,All Students,2022-23,70521,s,s,s,s,s,s
7,All Students,2018-19,88661,3508,85153,96.0,521,62,11.9
7,All Students,2019-20,60659,2218,58441,96.3,540,47,8.7
7,All Students,2020-21,79052,6643,72409,91.6,460,128,27.8
7,All Students,2021-22,75372,3002,72370,96.0,453,52,11.5
7,All Students,2022-23,72727,2689,70038,96.3,436,41,9.4
8,All Students,2018-19,87701,s,s,s,s,s,s
8,All Students,2019-20,58507,2921,55586,95.0,521,76,14.6
8,All Students,2020-21,92947,9896,83051,89.4,534,168,31.5
8,All Students,2021-22,75623,4768,70855,93.7,446,85,19.1
8,All Students,2022-23,77767,3028,74739,96.1,464,55,11.9
All Grades,All Students,2018-19,167859,7070,160789,95.8,991,120,12.1
All Grades,All Students,2019-20,103131,4451,98680,95.7,921,101,11.0
All Grades,All Students,2020-21,156010,10801,145209,93.1,911,189,20.7
All Grades,All Students,2021-22,138697,9967,128730,92.8,838,210,25.1
All Grades,All Students,2022-23,127513,8472,119041,93.4,769,180,23.4
5,All Students,2021-22,14,s,s,s,s,s,s
6,All Students,2018-19,54675,1923,52752,96.5,326,31,9.5
6,All Students,2019-20,33065,1486,31579,95.5,298,38,12.8
6,All Students,2020-21,49807,4033,45774,91.9,297,71,23.9
6,All Students,2021-22,40688,s,s,s,s,s,s
6,All Students,2022-23,37236,2427,34809,93.5,229,58,25.3
7,All Students,2018-19,51167,1496,49671,97.1,302,24,7.9
7,All Students,2019-20,35936,1516,34420,95.8,321,35,10.9
7,All Students,2020-21,50622,3551,47071,93.0,294,68,23.1
7,All Students,2021-22,47756,3299,44457,93.1,284,65,22.9
7,All Students,2022-23,40837,2469,38368,94.0,246,46,18.7
8,All Students,2018-19,62017,3651,58366,94.1,363,65,17.9
8,All Students,2019-20,34130,1449,32681,95.8,302,28,9.3
8,All Students,2020-21,55581,3217,52364,94.2,320,50,15.6
8,All Students,2021-22,50239,3882,46357,92.3,297,79,26.6
8,All Students,2022-23,49440,3576,45864,92.8,294,76,25.9
All Grades,All Students,2018-19,288433,11200,277233,96.1,1679,207,12.3
All Grades,All Students,2019-20,188857,8328,180529,95.6,1689,216,12.8
All Grades,All Students,2020-21,268486,21168,247318,92.1,1565,414,26.5
All Grades,All Students,2021-22,266794,21494,245300,91.9,1600,412,25.8
All Grades,All Students,2022-23,247454,16760,230694,93.2,1471,320,21.8
5,All Students,2018-19,1,s,s,s,s,s,s
6,All Students,2018-19,92008,3677,88331,96.0,542,75,13.8
6,All Students,2019-20,59372,2540,56832,95.7,533,60,11.3
6,All Students,2020-21,87079,s,s,s,s,s,s
6,All Students,2021-22,77071,5917,71154,92.3,480,118,24.6
6,All Students,2022-23,76499,4833,71666,93.7,455,94,20.7
7,All Students,2018-19,105768,3635,102133,96.6,610,63,10.3
7,All Students,2019-20,60196,2670,57526,95.6,538,77,14.3
7,All Students,2020-21,90995,8124,82871,91.1,530,169,31.9
7,All Students,2021-22,89036,6623,82413,92.6,522,123,23.6
7,All Students,2022-23,80553,5093,75460,93.7,481,97,20.2
8,All Students,2018-19,90656,s,s,s,s,s,s
8,All Students,2019-20,69289,3118,66171,95.5,618,79,12.8
8,All Students,2020-21,90397,6080,84317,93.3,526,109,20.7
8,All Students,2021-22,100687,8954,91733,91.1,598,171,28.6
8,All Students,2022-23,90402,6834,83568,92.4,535,129,24.1
9,All Students,2020-21,15,s,s,s,s,s,s
All Grades,All Students,2018-19,223887,8220,215667,96.3,1300,115,8.8
All Grades,All Students,2019-20,143894,6817,137077,95.3,1273,149,11.7
All Grades,All Students,2020-21,208260,9962,198298,95.2,1218,185,15.2
All Grades,All Students,2021-22,211130,11038,200092,94.8,1235,198,16.0
All Grades,All Students,2022-23,204151,11529,192622,94.4,1197,214,17.9
PK in K-12 Schools,All Students,2018-19,6264,443,5821,92.9,37,10,27.0
PK in K-12 Schools,All Students,2019-20,4005,306,3699,92.4,36,10,27.8
PK in K-12 Schools,All Students,2020-21,5083,510,4573,90.0,31,9,29.0
PK in K-12 Schools,All Students,2021-22,4665,502,4163,89.2,29,15,51.7
PK in K-12 Schools,All Students,2022-23,5185,563,4622,89.1,31,14,45.2
0K,All Students,2018-19,25189,1653,23536,93.4,146,28,19.2
0K,All Students,2019-20,13766,1125,12641,91.8,123,30,24.4
0K,All Students,2020-21,22559,1417,21142,93.7,139,33,23.7
0K,All Students,2021-22,20172,1428,18744,92.9,116,27,23.3
0K,All Students,2022-23,18187,1406,16781,92.3,106,31,29.2
1,All Students,2018-19,25778,904,24874,96.5,149,12,8.1
1,All Students,2019-20,17593,1080,16513,93.9,156,32,20.5
1,All Students,2020-21,21393,1041,20352,95.1,124,22,17.7
1,All Students,2021-22,21938,1153,20785,94.7,130,19,14.6
1,All Students,2022-23,20599,1299,19300,93.7,121,23,19.0
2,All Students,2018-19,25179,874,24305,96.5,149,9,6.0
2,All Students,2019-20,16599,728,15871,95.6,148,14,9.5
2,All Students,2020-21,25189,1054,24135,95.8,147,15,10.2
2,All Students,2021-22,20650,1347,19303,93.5,121,27,22.3
2,All Students,2022-23,22945,1188,21757,94.8,136,19,14.0
3,All Students,2018-19,23327,707,22620,97.0,136,7,5.1
3,All Students,2019-20,16112,620,15492,96.2,141,9,6.4
3,All Students,2020-21,24935,850,24085,96.6,149,13,8.7
3,All Students,2021-22,25914,1408,24506,94.6,150,27,18.0
3,All Students,2022-23,20500,1095,19405,94.7,121,19,15.7
4,All Students,2018-19,24404,614,23790,97.5,141,7,5.0
4,All Students,2019-20,15066,551,14515,96.3,134,11,8.2
4,All Students,2020-21,23975,864,23111,96.4,138,14,10.1
4,All Students,2021-22,24465,990,23475,96.0,142,14,9.9
4,All Students,2022-23,25865,1333,24532,94.8,149,23,15.4
5,All Students,2018-19,29732,722,29010,97.6,170,7,4.1
5,All Students,2019-20,16412,582,15830,96.5,143,10,7.0
5,All Students,2020-21,22357,669,21688,97.0,129,14,10.9
5,All Students,2021-22,23899,837,23062,96.5,139,11,7.9
5,All Students,2022-23,25139,1064,24075,95.8,146,16,11.0
6,All Students,2018-19,21103,600,20503,97.2,126,9,7.1
6,All Students,2019-20,15806,593,15213,96.2,140,11,7.9
6,All Students,2020-21,18058,1282,16776,92.9,105,25,23.8
6,All Students,2021-22,23953,1292,22661,94.6,138,25,18.1
6,All Students,2022-23,20267,1016,19251,95.0,118,17,14.4
7,All Students,2018-19,22890,774,22116,96.6,132,11,8.3
7,All Students,2019-20,13974,513,13461,96.3,123,10,8.1
7,All Students,2020-21,23544,650,22894,97.2,135,10,7.4
7,All Students,2021-22,22091,1115,20976,95.0,135,23,17.0
7,All Students,2022-23,22580,1064,21516,95.3,133,18,13.5
8,All Students,2018-19,20021,929,19092,95.4,114,15,13.2
8,All Students,2019-20,14561,719,13842,95.1,129,12,9.3
8,All Students,2020-21,21167,1625,19542,92.3,121,30,24.8
8,All Students,2021-22,23383,966,22417,95.9,135,10,7.4
8,All Students,2022-23,22884,1501,21383,93.4,136,34,25.0
All Grades,All Students,2018-19,153712,6381,147331,95.8,894,99,11.1
All Grades,All Students,2019-20,97842,4625,93217,95.3,870,112,12.9
All Grades,All Students,2020-21,138463,4615,133848,96.7,809,64,7.9
All Grades,All Students,2021-22,133068,10386,122682,92.2,784,217,27.7
All Grades,All Students,2022-23,128360,7961,120399,93.8,753,146,19.4
0K,All Students,2018-19,22068,1223,20845,94.5,128,20,15.6
0K,All Students,2019-20,14372,944,13428,93.4,128,28,21.9
0K,All Students,2020-21,21760,1071,20689,95.1,125,14,11.2
0K,All Students,2021-22,21758,2115,19643,90.3,131,51,38.9
0K,All Students,2022-23,21984,1665,20319,92.4,129,32,24.8
1,All Students,2018-19,26486,1288,25198,95.1,155,21,13.5
1,All Students,2019-20,14353,891,13462,93.8,127,27,21.3
1,All Students,2020-21,22339,757,21582,96.6,134,13,9.7
1,All Students,2021-22,24000,2050,21950,91.5,140,43,30.7
1,All Students,2022-23,23828,1811,22017,92.4,142,31,21.8
2,All Students,2018-19,25789,1155,24634,95.5,149,20,13.4
2,All Students,2019-20,17299,847,16452,95.1,156,21,13.5
2,All Students,2020-21,20622,735,19887,96.4,120,10,8.3
2,All Students,2021-22,18917,1496,17421,92.1,113,32,28.3
2,All Students,2022-23,21318,1341,19977,93.7,125,28,22.4
3,All Students,2018-19,26096,876,25220,96.6,154,12,7.8
3,All Students,2019-20,16589,726,15863,95.6,148,16,10.8
3,All Students,2020-21,24805,656,24149,97.4,144,7,4.9
3,All Students,2021-22,20995,1607,19388,92.3,121,31,25.6
3,All Students,2022-23,17593,916,16677,94.8,102,16,15.7
4,All Students,2018-19,28856,907,27949,96.9,165,12,7.3
4,All Students,2019-20,17133,531,16602,96.9,151,7,4.6
4,All Students,2020-21,23778,746,23032,96.9,140,10,7.1
4,All Students,2021-22,23889,1534,22355,93.6,142,33,23.2
4,All Students,2022-23,20368,987,19381,95.2,119,18,15.1
5,All Students,2018-19,24417,932,23485,96.2,143,14,9.8
5,All Students,2019-20,18096,686,17410,96.2,160,13,8.1
5,All Students,2020-21,25159,650,24509,97.4,146,10,6.8
5,All Students,2021-22,23509,1584,21925,93.3,137,27,19.7
5,All Students,2022-23,23269,1241,22028,94.7,136,21,15.4
All Grades,All Students,2018-19,337733,12301,325432,96.4,1942,198,10.2
All Grades,All Students,2019-20,214267,8555,205712,96.0,1892,223,11.8
All Grades,All Students,2020-21,306386,7960,298426,97.4,1778,107,6.0
All Grades,All Students,2021-22,272788,14476,258312,94.7,1566,262,16.7
All Grades,All Students,2022-23,286174,15799,270375,94.5,1664,314,18.9
5,All Students,2020-21,40,s,s,s,s,s,s
6,All Students,2018-19,111589,3853,107736,96.5,647,60,9.3
6,All Students,2019-20,69125,2395,66730,96.5,612,55,9.0
6,All Students,2020-21,96026,2712,93314,97.2,560,35,6.3
6,All Students,2021-22,87553,4077,83476,95.3,508,73,14.4
6,All Students,2022-23,105300,5143,100157,95.1,613,103,16.8
7,All Students,2018-19,113843,4144,109699,96.4,655,78,11.9
7,All Students,2019-20,71974,2761,69213,96.2,636,68,10.7
7,All Students,2020-21,103152,2632,100520,97.4,597,29,4.9
7,All Students,2021-22,86528,s,s,s,s,s,s
7,All Students,2022-23,90914,4658,86256,94.9,526,90,17.1
8,All Students,2018-19,112301,4304,107997,96.2,640,60,9.4
8,All Students,2019-20,73168,3399,69769,95.4,644,100,15.5
8,All Students,2020-21,107165,2576,104589,97.6,621,43,6.9
8,All Students,2021-22,98692,5567,93125,94.4,560,106,18.9
8,All Students,2022-23,89960,5998,83962,93.3,525,121,23.0
9,All Students,2020-21,3,s,s,s,s,s,s
9,All Students,2021-22,15,s,s,s,s,s,s
All Grades,All Students,2018-19,81619,4059,77560,95.0,490,64,13.1
All Grades,All Students,2019-20,52657,2822,49835,94.6,474,71,15.0
All Grades,All Students,2020-21,72218,3482,68736,95.2,440,63,14.3
All Grades,All Students,2021-22,65147,4466,60681,93.1,394,93,23.6
All Grades,All Students,2022-23,69444,5325,64119,92.3,421,116,27.6
0K,All Students,2018-19,13028,807,12221,93.8,80,14,17.5
0K,All Students,2019-20,8896,601,8295,93.2,83,19,22.9
0K,All Students,2020-21,13236,732,12504,94.5,83,15,18.1
0K,All Students,2021-22,12024,995,11029,91.7,74,24,32.4
0K,All Students,2022-23,11797,1083,10714,90.8,71,26,36.6
1,All Students,2018-19,13451,640,12811,95.2,81,13,16.0
1,All Students,2019-20,8571,532,8039,93.8,77,15,19.5
1,All Students,2020-21,12327,789,11538,93.6,74,14,18.9
1,All Students,2021-22,11547,809,10738,93.0,69,15,21.7
1,All Students,2022-23,14255,1062,13193,92.5,89,26,29.2
2,All Students,2018-19,13240,515,12725,96.1,78,4,5.1
2,All Students,2019-20,8970,448,8522,95.0,80,9,11.3
2,All Students,2020-21,11181,596,10585,94.7,69,11,15.9
2,All Students,2021-22,10766,936,9830,91.3,66,20,30.3
2,All Students,2022-23,10811,925,9886,91.4,65,20,30.8
3,All Students,2018-19,12983,764,12219,94.1,80,15,18.8
3,All Students,2019-20,7417,262,7155,96.5,65,3,4.6
3,All Students,2020-21,12250,458,11792,96.3,74,7,9.5
3,All Students,2021-22,10314,698,9616,93.2,61,15,24.6
3,All Students,2022-23,10519,822,9697,92.2,64,18,28.1
4,All Students,2018-19,15547,770,14777,95.0,93,11,11.8
4,All Students,2019-20,8997,458,8539,94.9,83,12,14.5
4,All Students,2020-21,11362,417,10945,96.3,70,10,14.3
4,All Students,2021-22,10506,577,9929,94.5,64,11,17.2
4,All Students,2022-23,10976,776,10200,92.9,67,19,28.4
5,All Students,2018-19,13370,563,12807,95.8,78,7,9.0
5,All Students,2019-20,9806,521,9285,94.7,86,13,15.1
5,All Students,2020-21,11862,490,11372,95.9,70,6,8.6
5,All Students,2021-22,9990,451,9539,95.5,60,8,13.3
5,All Students,2022-23,11086,657,10429,94.1,65,7,10.8
All Grades,All Students,2018-19,72977,1325,71652,98.2,428,12,2.8
All Grades,All Students,2019-20,50062,1824,48238,96.4,445,39,8.8
All Grades,All Students,2020-21,85127,1979,83148,97.7,495,35,7.1
All Grades,All Students,2021-22,84330,3746,80584,95.6,493,55,11.2
All Grades,All Students,2022-23,93194,3471,89723,96.3,560,43,7.7
0K,All Students,2018-19,13486,421,13065,96.9,83,5,6.0
0K,All Students,2019-20,12108,729,11379,94.0,109,20,18.3
0K,All Students,2020-21,18654,496,18158,97.3,111,11,9.9
0K,All Students,2021-22,14097,936,13161,93.4,84,20,23.8
0K,All Students,2022-23,14434,743,13691,94.9,88,10,11.4
1,All Students,2018-19,13731,277,13454,98.0,82,3,3.7
1,All Students,2019-20,8493,322,8171,96.2,74,5,6.8
1,All Students,2020-21,18269,412,17857,97.7,106,5,4.7
1,All Students,2021-22,17479,805,16674,95.4,101,10,9.9
1,All Students,2022-23,16948,738,16210,95.6,103,7,6.8
2,All Students,2018-19,9753,180,9573,98.2,55,2,3.6
2,All Students,2019-20,8918,310,8608,96.5,80,7,8.8
2,All Students,2020-21,13592,198,13394,98.5,78,4,5.1
2,All Students,2021-22,16964,783,16181,95.4,100,13,13.0
2,All Students,2022-23,17674,651,17023,96.3,108,8,7.4
3,All Students,2018-19,11720,177,11543,98.5,69,1,1.4
3,All Students,2019-20,6260,208,6052,96.7,55,3,5.5
3,All Students,2020-21,13346,308,13038,97.7,77,7,9.1
3,All Students,2021-22,12086,396,11690,96.7,70,4,5.7
3,All Students,2022-23,17352,496,16856,97.1,104,5,4.8
4,All Students,2018-19,10858,112,10746,99.0,63,0,0.0
4,All Students,2019-20,7249,149,7100,97.9,64,2,3.1
4,All Students,2020-21,10261,328,9933,96.8,60,4,6.7
4,All Students,2021-22,12955,449,12506,96.5,76,5,6.6
4,All Students,2022-23,13190,393,12797,97.0,79,6,7.6
5,All Students,2018-19,13429,158,13271,98.8,76,1,1.3
5,All Students,2019-20,7034,106,6928,98.5,63,2,3.2
5,All Students,2020-21,11005,237,10768,97.8,63,4,6.3
5,All Students,2021-22,10749,377,10372,96.5,62,3,4.8
5,All Students,2022-23,13596,450,13146,96.7,78,7,9.0
All Grades,All Students,2018-19,560817,68579,492238,87.8,3558,1105,31.1
All Grades,All Students,2019-20,382095,45527,336568,88.1,3602,1092,30.3
All Grades,All Students,2020-21,615427,132638,482789,78.4,3545,1442,40.7
All Grades,All Students,2021-22,545004,88913,456091,83.7,3287,1428,43.4
All Grades,All Students,2022-23,507709,70296,437413,86.2,3242,1182,36.5
9,All Students,2018-19,169032,26082,142950,84.6,1102,377,34.2
9,All Students,2019-20,123038,19017,104021,84.5,1179,412,34.9
9,All Students,2020-21,187497,50798,136699,72.9,1071,491,45.8
9,All Students,2021-22,140846,28280,112566,79.9,838,365,43.6
9,All Students,2022-23,142372,23945,118427,83.2,930,356,38.3
10,All Students,2018-19,145147,17569,127578,87.9,927,281,30.3
10,All Students,2019-20,99003,10985,88018,88.9,936,265,28.3
10,All Students,2020-21,167111,37151,129960,77.8,971,412,42.4
10,All Students,2021-22,155709,26350,129359,83.1,947,431,45.5
10,All Students,2022-23,127534,18041,109493,85.9,818,303,37.0
11,All Students,2018-19,117008,8838,108170,92.4,719,134,18.6
11,All Students,2019-20,75068,5707,69361,92.4,699,147,21.0
11,All Students,2020-21,130234,16308,113926,87.5,756,199,26.3
11,All Students,2021-22,113864,11198,102666,90.2,680,210,30.9
11,All Students,2022-23,115452,11216,104236,90.3,720,198,27.5
12,All Students,2018-19,129630,16090,113540,87.6,810,313,38.6
12,All Students,2019-20,84986,9818,75168,88.4,788,268,34.0
12,All Students,2020-21,130585,28381,102204,78.3,747,340,45.5
12,All Students,2021-22,134585,23085,111500,82.8,822,422,51.3
12,All Students,2022-23,122351,17094,105257,86.0,774,325,42.0
All Grades,All Students,2018-19,204587,11752,192835,94.3,1257,202,16.1
All Grades,All Students,2019-20,134456,7756,126700,94.2,1257,216,17.2
All Grades,All Students,2020-21,217814,28329,189485,87.0,1275,421,33.0
All Grades,All Students,2021-22,215607,19611,195996,90.9,1299,371,28.6
All Grades,All Students,2022-23,210080,12035,198045,94.3,1319,209,15.8
9,All Students,2018-19,53733,2350,51383,95.6,330,28,8.5
9,All Students,2019-20,36903,2162,34741,94.1,349,50,14.3
9,All Students,2020-21,59905,6478,53427,89.2,351,96,27.4
9,All Students,2021-22,60448,4933,55515,91.8,369,99,26.8
9,All Students,2022-23,57707,2997,54710,94.8,368,51,13.9
10,All Students,2018-19,57237,3378,53859,94.1,354,62,17.5
10,All Students,2019-20,34290,1664,32626,95.1,323,43,13.3
10,All Students,2020-21,53178,6233,46945,88.3,312,89,28.5
10,All Students,2021-22,54397,4145,50252,92.4,327,79,24.2
10,All Students,2022-23,51426,2647,48779,94.9,322,44,13.7
11,All Students,2018-19,49552,2479,47073,95.0,303,44,14.5
11,All Students,2019-20,33884,1952,31932,94.2,317,61,19.2
11,All Students,2020-21,55246,6935,48311,87.4,322,100,31.1
11,All Students,2021-22,49671,4488,45183,91.0,299,79,26.4
11,All Students,2022-23,53232,2497,50735,95.3,333,45,13.5
12,All Students,2018-19,44065,3545,40520,92.0,270,68,25.2
12,All Students,2019-20,29379,1978,27401,93.3,268,62,23.1
12,All Students,2020-21,49485,8683,40802,82.5,290,136,46.9
12,All Students,2021-22,51091,6045,45046,88.2,304,114,37.5
12,All Students,2022-23,47715,3894,43821,91.8,296,69,23.3
All Grades,All Students,2018-19,750959,68854,682105,90.8,4727,1209,25.6
All Grades,All Students,2019-20,510277,48034,462243,90.6,4768,1218,25.5
All Grades,All Students,2020-21,804394,81422,722972,89.9,4687,1031,22.0
All Grades,All Students,2021-22,695223,97793,597430,85.9,4166,1735,41.6
All Grades,All Students,2022-23,649123,76684,572439,88.2,4074,1448,35.5
8,All Students,2022-23,18,s,s,s,s,s,s
9,All Students,2018-19,216141,23614,192527,89.1,1379,374,27.1
9,All Students,2019-20,146612,15806,130806,89.2,1385,356,25.7
9,All Students,2020-21,222570,32427,190143,85.4,1302,404,31.0
9,All Students,2021-22,169201,25084,144117,85.2,1012,396,39.1
9,All Students,2022-23,173939,20760,153179,88.1,1097,352,32.1
10,All Students,2018-19,210032,18195,191837,91.3,1335,325,24.3
10,All Students,2019-20,135725,12001,123724,91.2,1280,319,24.9
10,All Students,2020-21,212712,19622,193090,90.8,1234,247,20.0
10,All Students,2021-22,177055,24523,152532,86.1,1075,436,40.6
10,All Students,2022-23,159376,20073,139303,87.4,1013,368,36.3
11,All Students,2018-19,162990,11602,151388,92.9,1011,212,21.0
11,All Students,2019-20,119021,8462,110559,92.9,1102,214,19.4
11,All Students,2020-21,189338,13885,175453,92.7,1106,192,17.4
11,All Students,2021-22,172540,18831,153709,89.1,1031,346,33.6
11,All Students,2022-23,155753,s,s,s,s,s,s
12,All Students,2018-19,161796,15443,146353,90.5,1002,298,29.7
12,All Students,2019-20,108919,11765,97154,89.2,1001,329,32.9
12,All Students,2020-21,179774,15488,164286,91.4,1045,188,18.0
12,All Students,2021-22,176427,29355,147072,83.4,1048,557,53.1
12,All Students,2022-23,160037,19105,140932,88.1,991,397,40.1
All Grades,All Students,2018-19,175669,9316,166353,94.7,1027,154,15.0
All Grades,All Students,2019-20,108093,5710,102383,94.7,959,139,14.5
All Grades,All Students,2020-21,149210,13736,135474,90.8,886,273,30.8
All Grades,All Students,2021-22,130400,12051,118349,90.8,772,271,35.1
All Grades,All Students,2022-23,112273,9169,103104,91.8,672,206,30.7
0K,All Students,2018-19,27467,1886,25581,93.1,164,35,21.3
0K,All Students,2019-20,15911,997,14914,93.7,143,28,19.6
0K,All Students,2020-21,18933,s,s,s,s,s,s
0K,All Students,2021-22,16351,s,s,s,s,s,s
0K,All Students,2022-23,13057,1343,11714,89.7,82,37,45.1
1,All Students,2018-19,29830,1594,28236,94.7,176,29,16.5
1,All Students,2019-20,16795,1047,15748,93.8,149,29,19.5
1,All Students,2020-21,22067,1544,20523,93.0,136,30,22.1
1,All Students,2021-22,18584,1789,16795,90.4,113,42,37.2
1,All Students,2022-23,15791,1374,14417,91.3,97,32,33.0
2,All Students,2018-19,26519,1347,25172,94.9,152,23,15.1
2,All Students,2019-20,17770,862,16908,95.1,157,16,10.2
2,All Students,2020-21,24444,2598,21846,89.4,143,50,35.0
2,All Students,2021-22,20350,2254,18096,88.9,121,50,41.3
2,All Students,2022-23,18078,1404,16674,92.2,111,32,28.8
3,All Students,2018-19,31471,1659,29812,94.7,185,27,14.6
3,All Students,2019-20,18267,823,17444,95.5,161,21,13.0
3,All Students,2020-21,26307,2775,23532,89.5,153,54,35.3
3,All Students,2021-22,22244,1818,20426,91.8,134,45,33.6
3,All Students,2022-23,18742,1657,17085,91.2,111,38,34.2
4,All Students,2018-19,31498,1525,29973,95.2,182,25,13.7
4,All Students,2019-20,20292,1099,19193,94.6,179,27,15.1
4,All Students,2020-21,27580,2108,25472,92.4,163,42,25.8
4,All Students,2021-22,25440,2252,23188,91.1,148,52,35.1
4,All Students,2022-23,22094,1562,20532,92.9,129,33,25.6
5,All Students,2018-19,28884,1305,27579,95.5,168,15,8.9
5,All Students,2019-20,19058,882,18176,95.4,170,18,10.6
5,All Students,2020-21,29878,3013,26865,89.9,176,62,35.2
5,All Students,2021-22,27412,2207,25205,91.9,158,44,27.8
5,All Students,2022-23,24511,1829,22682,92.5,142,34,23.9
6,All Students,2020-21,1,s,s,s,s,s,s
6,All Students,2021-22,19,s,s,s,s,s,s
All Grades,All Students,2018-19,526450,76772,449678,85.4,3315,1180,35.6
All Grades,All Students,2019-20,360433,51029,309404,85.8,3405,1192,35.0
All Grades,All Students,2020-21,568663,116959,451704,79.4,3319,1533,46.2
All Grades,All Students,2021-22,536494,96759,439735,82.0,3362,1679,49.9
All Grades,All Students,2022-23,531899,74182,457717,86.1,3467,1286,37.1
9,All Students,2018-19,159235,24523,134712,84.6,1025,346,33.8
9,All Students,2019-20,105004,16017,88987,84.7,1010,358,35.4
9,All Students,2020-21,157536,31843,125693,79.8,927,391,42.2
9,All Students,2021-22,143735,27151,116584,81.1,911,443,48.6
9,All Students,2022-23,151136,24361,126775,83.9,987,366,37.1
10,All Students,2018-19,143385,23324,120061,83.7,901,335,37.2
10,All Students,2019-20,110678,16366,94312,85.2,1046,385,36.8
10,All Students,2020-21,167775,41296,126479,75.4,973,498,51.2
10,All Students,2021-22,157068,30966,126102,80.3,984,512,52.0
10,All Students,2022-23,144655,20707,123948,85.7,954,357,37.4
11,All Students,2018-19,102693,9743,92950,90.5,633,161,25.4
11,All Students,2019-20,65563,6207,59356,90.5,612,156,25.5
11,All Students,2020-21,124259,18229,106030,85.3,719,274,38.1
11,All Students,2021-22,104838,14178,90660,86.5,652,274,42.0
11,All Students,2022-23,119803,13241,106562,88.9,764,244,31.9
12,All Students,2018-19,121137,19182,101955,84.2,756,338,44.7
12,All Students,2019-20,79188,12439,66749,84.3,737,293,39.8
12,All Students,2020-21,119093,25591,93502,78.5,700,370,52.9
12,All Students,2021-22,130853,24464,106389,81.3,815,450,55.2
12,All Students,2022-23,116305,15873,100432,86.4,762,319,41.9
All Grades,All Students,2018-19,139179,8026,131153,94.2,813,156,19.2
All Grades,All Students,2019-20,84848,4542,80306,94.6,756,137,18.1
All Grades,All Students,2020-21,115403,9168,106235,92.1,680,178,26.2
All Grades,All Students,2021-22,94160,7785,86375,91.7,560,175,31.3
All Grades,All Students,2022-23,80471,5817,74654,92.8,482,127,26.3
0K,All Students,2018-19,21885,1499,20386,93.2,131,33,25.2
0K,All Students,2019-20,11733,827,10906,93.0,106,28,26.4
0K,All Students,2020-21,14225,1223,13002,91.4,87,25,28.7
0K,All Students,2021-22,9673,1115,8558,88.5,61,28,45.9
0K,All Students,2022-23,8674,846,7828,90.2,55,20,36.4
1,All Students,2018-19,25028,1513,23515,94.0,149,34,22.8
1,All Students,2019-20,12608,718,11890,94.3,114,19,16.7
1,All Students,2020-21,16918,1483,15435,91.2,101,31,30.7
1,All Students,2021-22,11941,1051,10890,91.2,72,25,34.7
1,All Students,2022-23,9675,988,8687,89.8,58,25,43.1
2,All Students,2018-19,26108,1548,24560,94.1,151,27,17.9
2,All Students,2019-20,15007,802,14205,94.7,132,25,18.9
2,All Students,2020-21,17586,1047,16539,94.0,102,17,16.7
2,All Students,2021-22,16268,1319,14949,91.9,97,29,29.9
2,All Students,2022-23,12101,831,11270,93.1,73,20,27.4
3,All Students,2018-19,24435,1405,23030,94.3,140,25,17.9
3,All Students,2019-20,15878,809,15069,94.9,141,27,19.1
3,All Students,2020-21,22460,1730,20730,92.3,131,34,26.0
3,All Students,2021-22,15372,1135,14237,92.6,90,28,31.1
3,All Students,2022-23,15162,1001,14161,93.4,90,21,23.3
4,All Students,2018-19,22322,1109,21213,95.0,130,16,12.3
4,All Students,2019-20,15044,695,14349,95.4,134,17,12.7
4,All Students,2020-21,22728,2041,20687,91.0,134,42,31.3
4,All Students,2021-22,20589,1591,18998,92.3,123,32,26.0
4,All Students,2022-23,14205,916,13289,93.6,86,17,19.8
5,All Students,2018-19,19401,952,18449,95.1,112,21,18.8
5,All Students,2019-20,14578,691,13887,95.3,129,21,16.3
5,All Students,2020-21,21486,1644,19842,92.3,125,29,23.2
5,All Students,2021-22,20317,1574,18743,92.3,117,33,28.2
5,All Students,2022-23,20654,1235,19419,94.0,120,24,20.0
All Grades,All Students,2018-19,93385,7429,85956,92.0,577,153,26.5
All Grades,All Students,2019-20,63127,4269,58858,93.2,589,128,21.7
All Grades,All Students,2020-21,100341,6564,93777,93.5,583,118,20.2
All Grades,All Students,2021-22,91305,13800,77505,84.9,557,311,55.8
All Grades,All Students,2022-23,83046,9145,73901,89.0,529,214,40.5
6,All Students,2018-19,12211,647,11564,94.7,78,16,20.5
6,All Students,2019-20,9616,445,9171,95.4,87,12,13.8
6,All Students,2020-21,10971,631,10340,94.2,64,13,20.3
6,All Students,2021-22,9982,1096,8886,89.0,59,30,50.8
6,All Students,2022-23,9753,644,9109,93.4,57,15,26.3
7,All Students,2018-19,12522,699,11823,94.4,74,15,20.3
7,All Students,2019-20,8176,446,7730,94.5,74,10,13.5
7,All Students,2020-21,14398,462,13936,96.8,83,9,10.8
7,All Students,2021-22,9343,1247,8096,86.7,56,26,46.4
7,All Students,2022-23,9541,893,8648,90.6,58,22,37.9
8,All Students,2018-19,14501,828,13673,94.3,83,13,15.7
8,All Students,2019-20,8690,368,8322,95.8,79,6,7.6
8,All Students,2020-21,12408,496,11912,96.0,72,9,12.5
8,All Students,2021-22,12673,1516,11157,88.0,75,38,50.7
8,All Students,2022-23,7558,786,6772,89.6,47,16,34.0
9,All Students,2018-19,16799,1366,15433,91.9,110,27,24.5
9,All Students,2019-20,10349,807,9542,92.2,102,27,26.5
9,All Students,2020-21,17734,1353,16381,92.4,103,22,21.4
9,All Students,2021-22,16951,2253,14698,86.7,110,54,49.1
9,All Students,2022-23,15739,1735,14004,89.0,107,44,41.1
10,All Students,2018-19,15126,1395,13731,90.8,93,33,35.5
10,All Students,2019-20,10316,795,9521,92.3,96,22,22.9
10,All Students,2020-21,15373,1422,13951,90.8,89,25,28.1
10,All Students,2021-22,15749,2634,13115,83.3,96,53,55.2
10,All Students,2022-23,15200,1641,13559,89.2,99,34,34.3
11,All Students,2018-19,11493,1161,10332,89.9,74,23,31.1
11,All Students,2019-20,8661,601,8060,93.1,83,24,28.9
11,All Students,2020-21,14097,1014,13083,92.8,84,20,23.8
11,All Students,2021-22,13986,2374,11612,83.0,84,52,61.9
11,All Students,2022-23,12761,1361,11400,89.3,84,33,39.3
12,All Students,2018-19,10733,1333,9400,87.6,65,26,40.0
12,All Students,2019-20,7319,807,6512,89.0,68,27,39.7
12,All Students,2020-21,15310,1179,14131,92.3,87,19,21.8
12,All Students,2021-22,12621,2680,9941,78.8,77,58,75.3
12,All Students,2022-23,12494,2085,10409,83.3,77,50,64.9
All Grades,All Students,2018-19,69389,3138,66251,95.5,408,47,11.5
All Grades,All Students,2019-20,48169,2363,45806,95.1,427,46,10.8
All Grades,All Students,2020-21,67394,3053,64341,95.5,396,51,12.9
All Grades,All Students,2021-22,60827,3469,57358,94.3,365,60,16.4
All Grades,All Students,2022-23,63649,4031,59618,93.7,381,73,19.2
0K,All Students,2018-19,10749,499,10250,95.4,68,6,8.8
0K,All Students,2019-20,7017,336,6681,95.2,61,8,13.1
0K,All Students,2020-21,8785,441,8344,95.0,54,9,16.7
0K,All Students,2021-22,9370,633,8737,93.2,56,16,28.6
0K,All Students,2022-23,9785,897,8888,90.8,58,19,32.8
1,All Students,2018-19,10861,552,10309,94.9,64,10,15.6
1,All Students,2019-20,8152,437,7715,94.6,73,8,11.0
1,All Students,2020-21,11037,589,10448,94.7,64,12,18.8
1,All Students,2021-22,9137,584,8553,93.6,55,9,16.4
1,All Students,2022-23,9197,592,8605,93.6,55,11,20.0
2,All Students,2018-19,10912,583,10329,94.7,62,11,17.7
2,All Students,2019-20,7770,373,7397,95.2,69,5,7.2
2,All Students,2020-21,12774,571,12203,95.5,73,7,9.6
2,All Students,2021-22,11409,680,10729,94.0,68,13,19.1
2,All Students,2022-23,9757,659,9098,93.2,62,14,22.6
3,All Students,2018-19,12301,525,11776,95.7,73,8,11.0
3,All Students,2019-20,6882,339,6543,95.1,62,6,9.7
3,All Students,2020-21,11041,407,10634,96.3,67,6,9.0
3,All Students,2021-22,11685,634,11051,94.6,71,12,16.9
3,All Students,2022-23,11967,675,11292,94.4,70,12,17.1
4,All Students,2018-19,13641,498,13143,96.3,79,7,8.9
4,All Students,2019-20,9182,396,8786,95.7,81,10,12.3
4,All Students,2020-21,10110,465,9645,95.4,59,6,10.2
4,All Students,2021-22,9631,401,9230,95.8,59,4,6.8
4,All Students,2022-23,12006,558,11448,95.4,72,8,11.1
5,All Students,2018-19,10925,481,10444,95.6,62,5,8.1
5,All Students,2019-20,9166,482,8684,94.7,81,9,11.1
5,All Students,2020-21,13647,580,13067,95.7,79,11,13.9
5,All Students,2021-22,9595,537,9058,94.4,56,6,10.7
5,All Students,2022-23,10937,650,10287,94.1,64,9,14.1
All Grades,All Students,2018-19,94694,4098,90596,95.7,536,52,9.7
All Grades,All Students,2019-20,60933,3122,57811,94.9,534,70,13.1
All Grades,All Students,2020-21,90450,865,89585,99.0,526,7,1.3
All Grades,All Students,2021-22,82652,5240,77412,93.7,473,88,18.6
All Grades,All Students,2022-23,85195,4777,80418,94.4,485,65,13.4
0K,All Students,2018-19,9070,598,8472,93.4,51,10,19.6
0K,All Students,2019-20,5721,476,5245,91.7,49,10,20.4
0K,All Students,2020-21,7968,162,7806,98.0,46,2,4.3
0K,All Students,2021-22,6727,422,6305,93.7,38,6,15.8
0K,All Students,2022-23,8228,551,7677,93.3,47,11,23.4
1,All Students,2018-19,10454,703,9751,93.3,59,14,23.7
1,All Students,2019-20,6660,433,6227,93.5,58,14,24.1
1,All Students,2020-21,10026,84,9942,99.2,58,1,1.7
1,All Students,2021-22,8198,549,7649,93.3,47,12,25.5
1,All Students,2022-23,8812,453,8359,94.9,51,6,11.8
2,All Students,2018-19,10653,520,10133,95.1,61,8,13.1
2,All Students,2019-20,7125,523,6602,92.7,63,18,28.6
2,All Students,2020-21,9852,199,9653,98.0,58,2,3.4
2,All Students,2021-22,9735,527,9208,94.6,55,8,14.5
2,All Students,2022-23,10580,590,9990,94.4,60,9,15.0
3,All Students,2018-19,11392,386,11006,96.6,64,1,1.6
3,All Students,2019-20,7217,331,6886,95.4,64,5,7.8
3,All Students,2020-21,10673,118,10555,98.9,62,0,0.0
3,All Students,2021-22,9363,559,8804,94.0,55,10,18.2
3,All Students,2022-23,10585,530,10055,95.0,60,3,5.0
4,All Students,2018-19,10946,448,10498,95.9,62,5,8.1
4,All Students,2019-20,7272,304,6968,95.8,64,6,9.4
4,All Students,2020-21,10982,73,10909,99.3,64,0,0.0
4,All Students,2021-22,9325,702,8623,92.5,53,11,20.8
4,All Students,2022-23,8823,532,8291,94.0,50,7,14.0
5,All Students,2018-19,11529,525,11004,95.4,65,7,10.8
5,All Students,2019-20,7028,309,6719,95.6,62,7,11.3
5,All Students,2020-21,10906,86,10820,99.2,64,1,1.6
5,All Students,2021-22,10108,548,9560,94.6,57,8,14.0
5,All Students,2022-23,9558,574,8984,94.0,54,8,14.8
6,All Students,2018-19,10535,303,10232,97.1,61,1,1.6
6,All Students,2019-20,7179,313,6866,95.6,63,5,7.9
6,All Students,2020-21,10361,63,10298,99.4,60,1,1.7
6,All Students,2021-22,9369,566,8803,94.0,54,8,14.8
6,All Students,2022-23,10553,523,10030,95.0,61,9,14.8
7,All Students,2018-19,9969,228,9741,97.7,56,2,3.6
7,All Students,2019-20,6291,145,6146,97.7,55,2,3.6
7,All Students,2020-21,10460,40,10420,99.6,61,0,0.0
7,All Students,2021-22,10198,722,9476,92.9,58,10,17.2
7,All Students,2022-23,8496,313,8183,96.3,48,3,6.3
8,All Students,2018-19,10146,387,9759,96.2,57,4,7.0
8,All Students,2019-20,6440,288,6152,95.5,56,3,5.4
8,All Students,2020-21,9222,40,9182,99.6,53,0,0.0
8,All Students,2021-22,9629,645,8984,93.3,56,15,26.8
8,All Students,2022-23,9560,711,8849,92.6,54,9,16.7
All Grades,All Students,2018-19,94099,3949,90150,95.8,542,49,9.0
All Grades,All Students,2019-20,57869,2750,55119,95.2,514,66,12.8
All Grades,All Students,2020-21,85631,2772,82859,96.8,510,45,8.8
All Grades,All Students,2021-22,81250,4130,77120,94.9,479,64,13.4
All Grades,All Students,2022-23,77040,4290,72750,94.4,456,75,16.4
0K,All Students,2018-19,14862,870,13992,94.1,87,18,20.7
0K,All Students,2019-20,8157,597,7560,92.7,73,18,24.7
0K,All Students,2020-21,15475,637,14838,95.9,96,12,12.5
0K,All Students,2021-22,12565,964,11601,92.3,75,20,26.7
0K,All Students,2022-23,11814,909,10905,92.3,73,23,31.5
1,All Students,2018-19,18898,915,17983,95.2,108,10,9.3
1,All Students,2019-20,9945,516,9429,94.8,88,13,14.8
1,All Students,2020-21,12062,458,11604,96.2,71,8,11.3
1,All Students,2021-22,14486,901,13585,93.8,85,15,17.6
1,All Students,2022-23,12789,884,11905,93.1,77,15,19.5
2,All Students,2018-19,15700,615,15085,96.1,91,6,6.6
2,All Students,2019-20,11301,615,10686,94.6,102,16,15.7
2,All Students,2020-21,14171,354,13817,97.5,83,4,4.8
2,All Students,2021-22,11276,513,10763,95.5,66,4,6.1
2,All Students,2022-23,13235,715,12520,94.6,78,14,17.9
3,All Students,2018-19,13222,441,12781,96.7,75,5,6.7
3,All Students,2019-20,10819,361,10458,96.7,95,7,7.4
3,All Students,2020-21,16036,526,15510,96.7,96,10,10.4
3,All Students,2021-22,12993,486,12507,96.3,79,6,7.6
3,All Students,2022-23,11070,571,10499,94.8,65,8,12.3
4,All Students,2018-19,14691,635,14056,95.7,85,6,7.1
4,All Students,2019-20,8141,265,7876,96.7,72,4,5.6
4,All Students,2020-21,16003,432,15571,97.3,94,6,6.4
4,All Students,2021-22,14675,610,14065,95.8,86,8,9.3
4,All Students,2022-23,13192,578,12614,95.6,75,6,8.0
5,All Students,2018-19,16726,473,16253,97.2,96,4,4.2
5,All Students,2019-20,9506,396,9110,95.8,84,8,9.5
5,All Students,2020-21,11884,365,11519,96.9,70,5,7.1
5,All Students,2021-22,15255,656,14599,95.7,88,11,12.5
5,All Students,2022-23,14940,633,14307,95.8,88,9,10.2
All Grades,All Students,2022-23,227219,38405,188814,83.1,1382,926,67.0
PK in K-12 Schools,All Students,2022-23,227171,s,s,s,s,s,s
0K,All Students,2022-23,48,s,s,s,s,s,s
All Grades,All Students,2020-21,25911,952,24959,96.3,151,14,9.3
All Grades,All Students,2021-22,53247,2584,50663,95.1,305,38,12.5
All Grades,All Students,2022-23,78522,4336,74186,94.5,449,73,16.3
6,All Students,2020-21,25911,952,24959,96.3,151,14,9.3
6,All Students,2021-22,27983,1212,26771,95.7,161,16,9.9
6,All Students,2022-23,27814,1186,26628,95.7,161,16,9.9
7,All Students,2021-22,25264,1372,23892,94.6,144,22,15.3
7,All Students,2022-23,26767,1515,25252,94.3,151,24,15.9
8,All Students,2022-23,23941,1635,22306,93.2,137,33,24.1
All Grades,All Students,2020-21,11061,730,10331,93.4,66,17,25.8
All Grades,All Students,2021-22,19811,1563,18248,92.1,123,36,29.3
All Grades,All Students,2022-23,27282,1636,25646,94.0,163,33,20.2
0K,All Students,2020-21,11061,730,10331,93.4,66,17,25.8
0K,All Students,2021-22,9352,659,8693,93.0,60,16,26.7
0K,All Students,2022-23,8834,643,8191,92.7,52,16,30.8
1,All Students,2021-22,10459,904,9555,91.4,63,20,31.7
1,All Students,2022-23,9377,499,8878,94.7,57,9,15.8
2,All Students,2022-23,9071,494,8577,94.6,54,8,14.8
All Grades,All Students,2018-19,60586,2591,57995,95.7,357,40,11.2
All Grades,All Students,2019-20,35153,1659,33494,95.3,318,40,12.6
All Grades,All Students,2020-21,45009,1981,43028,95.6,265,32,12.1
All Grades,All Students,2021-22,40819,3527,37292,91.4,253,86,34.0
All Grades,All Students,2022-23,37436,2872,34564,92.3,226,63,27.9
0K,All Students,2018-19,10960,720,10240,93.4,66,12,18.2
0K,All Students,2019-20,5242,267,4975,94.9,49,4,8.2
0K,All Students,2020-21,5992,606,5386,89.9,36,9,25.0
0K,All Students,2021-22,5249,486,4763,90.7,35,13,37.1
0K,All Students,2022-23,5977,548,5429,90.8,36,13,36.1
1,All Students,2018-19,7887,356,7531,95.5,48,7,14.6
1,All Students,2019-20,6177,379,5798,93.9,56,11,19.6
1,All Students,2020-21,6557,290,6267,95.6,38,4,10.5
1,All Students,2021-22,6227,673,5554,89.2,40,18,45.0
1,All Students,2022-23,5261,430,4831,91.8,32,11,34.4
2,All Students,2018-19,10308,345,9963,96.7,58,4,6.9
2,All Students,2019-20,4794,216,4578,95.5,43,4,9.3
2,All Students,2020-21,9164,400,8764,95.6,54,9,16.7
2,All Students,2021-22,5449,435,5014,92.0,36,10,27.8
2,All Students,2022-23,5842,526,5316,91.0,34,11,32.4
3,All Students,2018-19,9766,509,9257,94.8,57,9,15.8
3,All Students,2019-20,6500,276,6224,95.8,59,7,11.9
3,All Students,2020-21,6502,162,6340,97.5,38,1,2.6
3,All Students,2021-22,8975,851,8124,90.5,54,23,42.6
3,All Students,2022-23,5836,384,5452,93.4,35,8,22.9
4,All Students,2018-19,10740,363,10377,96.6,64,4,6.3
4,All Students,2019-20,5495,239,5256,95.7,50,6,12.0
4,All Students,2020-21,9190,164,9026,98.2,54,1,1.9
4,All Students,2021-22,6546,567,5979,91.3,39,12,30.8
4,All Students,2022-23,7949,500,7449,93.7,49,10,20.4
5,All Students,2018-19,10925,298,10627,97.3,64,4,6.3
5,All Students,2019-20,6945,282,6663,95.9,61,8,13.1
5,All Students,2020-21,7604,359,7245,95.3,45,8,17.8
5,All Students,2021-22,8373,515,7858,93.8,49,10,20.4
5,All Students,2022-23,6571,484,6087,92.6,40,10,25.0
All Grades,All Students,2018-19,112890,10832,102058,90.4,689,258,37.4
All Grades,All Students,2019-20,68147,6799,61348,90.0,626,213,34.0
All Grades,All Students,2020-21,90945,14383,76562,84.2,536,240,44.8
All Grades,All Students,2021-22,88335,13087,75248,85.2,548,319,58.2
All Grades,All Students,2022-23,89721,12487,77234,86.1,558,300,53.8
PK in K-12 Schools,All Students,2018-19,12504,1827,10677,85.4,76,48,63.2
PK in K-12 Schools,All Students,2019-20,7596,1144,6452,84.9,71,37,52.1
PK in K-12 Schools,All Students,2020-21,5932,1366,4566,77.0,42,27,64.3
PK in K-12 Schools,All Students,2021-22,11443,2623,8820,77.1,77,66,85.7
PK in K-12 Schools,All Students,2022-23,12076,2433,9643,79.9,82,64,78.0
0K,All Students,2018-19,12766,1307,11459,89.8,82,28,34.1
0K,All Students,2019-20,10242,1481,8761,85.5,93,45,48.4
0K,All Students,2020-21,12709,2800,9909,78.0,76,38,50.0
0K,All Students,2021-22,11258,2185,9073,80.6,69,51,73.9
0K,All Students,2022-23,14274,2336,11938,83.6,85,53,62.4
1,All Students,2018-19,20752,2231,18521,89.2,129,51,39.5
1,All Students,2019-20,8705,752,7953,91.4,80,21,26.3
1,All Students,2020-21,14520,3140,11380,78.4,84,41,48.8
1,All Students,2021-22,13343,1764,11579,86.8,84,46,54.8
1,All Students,2022-23,13338,1750,11588,86.9,82,48,58.5
2,All Students,2018-19,16916,1576,15340,90.7,102,31,30.4
2,All Students,2019-20,11170,1034,10136,90.7,102,30,29.4
2,All Students,2020-21,12879,1845,11034,85.7,76,37,48.7
2,All Students,2021-22,13446,1942,11504,85.6,82,45,54.9
2,All Students,2022-23,13294,1611,11683,87.9,80,32,40.0
3,All Students,2018-19,16135,1235,14900,92.3,98,32,32.7
3,All Students,2019-20,10568,829,9739,92.2,97,24,24.7
3,All Students,2020-21,14865,1979,12886,86.7,86,34,39.5
3,All Students,2021-22,10621,1270,9351,88.0,65,35,53.8
3,All Students,2022-23,12936,1475,11461,88.6,83,35,42.2
4,All Students,2018-19,15195,1163,14032,92.3,92,26,28.3
4,All Students,2019-20,10451,819,9632,92.2,97,28,28.9
4,All Students,2020-21,15682,1704,13978,89.1,90,32,35.6
4,All Students,2021-22,13743,1561,12182,88.6,84,34,40.5
4,All Students,2022-23,9939,1358,8581,86.3,59,31,52.5
5,All Students,2018-19,18622,1493,17129,92.0,110,42,38.2
5,All Students,2019-20,9415,740,8675,92.1,86,28,32.6
5,All Students,2020-21,14358,1549,12809,89.2,82,31,37.8
5,All Students,2021-22,14481,1742,12739,88.0,87,42,48.3
5,All Students,2022-23,13864,1524,12340,89.0,87,37,42.5
All Grades,All Students,2018-19,174300,8791,165509,95.0,1042,167,16.0
All Grades,All Students,2019-20,113858,5710,108148,95.0,1016,169,16.6
All Grades,All Students,2020-21,173496,13131,160365,92.4,1019,235,23.1
All Grades,All Students,2021-22,167957,12998,154959,92.3,1003,276,27.5
All Grades,All Students,2022-23,166571,11712,154859,93.0,993,249,25.1
PK in K-12 Schools,All Students,2018-19,3198,193,3005,94.0,18,3,16.7
PK in K-12 Schools,All Students,2019-20,1964,147,1817,92.5,19,6,31.6
PK in K-12 Schools,All Students,2020-21,3007,150,2857,95.0,20,4,20.0
PK in K-12 Schools,All Students,2021-22,3148,290,2858,90.8,18,7,38.9
0K,All Students,2018-19,22315,1342,20973,94.0,141,28,19.9
0K,All Students,2019-20,13393,823,12570,93.9,123,30,24.4
0K,All Students,2020-21,21598,1809,19789,91.6,134,34,25.4
0K,All Students,2021-22,20715,2084,18631,89.9,128,52,40.6
0K,All Students,2022-23,18803,1786,17017,90.5,113,42,37.2
1,All Students,2018-19,25516,1313,24203,94.9,155,23,14.8
1,All Students,2019-20,15992,845,15147,94.7,143,25,17.5
1,All Students,2020-21,20885,1580,19305,92.4,123,25,20.3
1,All Students,2021-22,21948,1909,20039,91.3,132,37,28.0
1,All Students,2022-23,21778,1810,19968,91.7,133,41,30.8
2,All Students,2018-19,21804,1252,20552,94.3,130,22,16.9
2,All Students,2019-20,15478,717,14761,95.4,137,19,13.9
2,All Students,2020-21,24355,1390,22965,94.3,143,31,21.7
2,All Students,2021-22,18530,1243,17287,93.3,111,28,25.2
2,All Students,2022-23,22331,1624,20707,92.7,136,36,26.5
3,All Students,2018-19,24716,1187,23529,95.2,146,25,17.1
3,All Students,2019-20,13498,758,12740,94.4,119,26,21.8
3,All Students,2020-21,23781,1399,22382,94.1,137,20,14.6
3,All Students,2021-22,22080,1535,20545,93.0,130,33,25.4
3,All Students,2022-23,20347,1140,19207,94.4,123,24,19.5
4,All Students,2018-19,21308,865,20443,95.9,124,20,16.1
4,All Students,2019-20,15465,751,14714,95.1,137,20,14.6
4,All Students,2020-21,18401,1312,17089,92.9,107,23,21.5
4,All Students,2021-22,23157,1265,21892,94.5,141,17,12.1
4,All Students,2022-23,23312,1479,21833,93.7,137,29,21.2
5,All Students,2018-19,25571,1050,24521,95.9,147,16,10.9
5,All Students,2019-20,13229,523,12706,96.0,120,10,8.3
5,All Students,2020-21,22775,1391,21384,93.9,131,26,19.8
5,All Students,2021-22,18322,1494,16828,91.8,107,30,28.0
5,All Students,2022-23,23397,1216,22181,94.8,136,22,16.2
6,All Students,2018-19,11561,525,11036,95.5,66,7,10.6
6,All Students,2019-20,11071,595,10476,94.6,98,18,18.4
6,All Students,2020-21,11900,1093,10807,90.8,68,20,29.4
6,All Students,2021-22,13778,1158,12620,91.6,83,31,37.3
6,All Students,2022-23,12062,885,11177,92.7,69,18,26.1
7,All Students,2018-19,9593,504,9089,94.7,58,9,15.5
7,All Students,2019-20,7366,279,7087,96.2,64,9,14.1
7,All Students,2020-21,15899,1813,14086,88.6,93,34,36.6
7,All Students,2021-22,11387,809,10578,92.9,65,14,21.5
7,All Students,2022-23,13171,963,12208,92.7,81,22,27.2
8,All Students,2018-19,8718,560,8158,93.6,57,14,24.6
8,All Students,2019-20,6402,272,6130,95.8,56,6,10.7
8,All Students,2020-21,10895,1194,9701,89.0,63,18,28.6
8,All Students,2021-22,14892,1211,13681,91.9,88,27,30.7
8,All Students,2022-23,11363,s,s,s,s,s,s
9,All Students,2022-23,7,s,s,s,s,s,s
All Grades,All Students,2018-19,145516,8596,136920,94.1,864,145,16.8
All Grades,All Students,2019-20,95596,5578,90018,94.2,866,166,19.2
All Grades,All Students,2020-21,142013,11789,130224,91.7,838,213,25.4
All Grades,All Students,2021-22,143953,14650,129303,89.8,881,352,40.0
All Grades,All Students,2022-23,152056,14143,137913,90.7,907,283,31.2
6,All Students,2018-19,45107,2162,42945,95.2,269,39,14.5
6,All Students,2019-20,30984,1669,29315,94.6,288,51,17.7
6,All Students,2020-21,44687,3319,41368,92.6,263,58,22.1
6,All Students,2021-22,43821,4471,39350,89.8,267,101,37.8
6,All Students,2022-23,48207,4040,44167,91.6,287,89,31.0
7,All Students,2018-19,47379,2963,44416,93.7,280,47,16.8
7,All Students,2019-20,32223,1923,30300,94.0,292,48,16.4
7,All Students,2020-21,49432,4458,44974,91.0,292,88,30.1
7,All Students,2021-22,47041,4733,42308,89.9,293,116,39.6
7,All Students,2022-23,48048,4664,43384,90.3,282,92,32.6
8,All Students,2018-19,53030,3471,49559,93.5,315,59,18.7
8,All Students,2019-20,32389,1986,30403,93.9,286,67,23.4
8,All Students,2020-21,47894,4012,43882,91.6,283,67,23.7
8,All Students,2021-22,53091,5446,47645,89.7,321,135,42.1
8,All Students,2022-23,55801,5439,50362,90.3,338,102,30.2
All Grades,All Students,2018-19,137469,6317,131152,95.4,815,115,14.1
All Grades,All Students,2019-20,85192,4315,80877,94.9,766,104,13.6
All Grades,All Students,2020-21,122702,4151,118551,96.6,724,74,10.2
All Grades,All Students,2021-22,134216,9444,124772,93.0,797,196,24.6
All Grades,All Students,2022-23,153969,10516,143453,93.2,930,235,25.3
PK in K-12 Schools,All Students,2021-22,8474,1085,7389,87.2,49,30,61.2
PK in K-12 Schools,All Students,2022-23,17409,1750,15659,89.9,105,42,40.0
0K,All Students,2018-19,19624,1128,18496,94.3,121,28,23.1
0K,All Students,2019-20,13444,1048,12396,92.2,126,30,23.8
0K,All Students,2020-21,21315,835,20480,96.1,125,12,9.6
0K,All Students,2021-22,22106,2183,19923,90.1,136,48,35.3
0K,All Students,2022-23,25340,2282,23058,91.0,160,57,35.6
1,All Students,2018-19,22871,1298,21573,94.3,141,26,18.4
1,All Students,2019-20,13026,687,12339,94.7,118,17,14.4
1,All Students,2020-21,18271,840,17431,95.4,112,18,16.1
1,All Students,2021-22,22499,1403,21096,93.8,133,27,20.3
1,All Students,2022-23,24758,1838,22920,92.6,151,36,23.8
2,All Students,2018-19,23351,965,22386,95.9,136,14,10.3
2,All Students,2019-20,14162,818,13344,94.2,126,17,13.5
2,All Students,2020-21,18890,746,18144,96.1,110,13,11.8
2,All Students,2021-22,18103,1145,16958,93.7,108,21,19.4
2,All Students,2022-23,23270,1439,21831,93.8,141,33,23.4
3,All Students,2018-19,23714,983,22731,95.9,139,16,11.5
3,All Students,2019-20,15529,662,14867,95.7,137,14,10.2
3,All Students,2020-21,19811,764,19047,96.1,119,15,12.6
3,All Students,2021-22,20333,1047,19286,94.9,120,17,14.2
3,All Students,2022-23,18704,942,17762,95.0,110,20,18.2
4,All Students,2018-19,21546,1027,20519,95.2,124,20,16.1
4,All Students,2019-20,14934,545,14389,96.4,132,12,9.1
4,All Students,2020-21,23006,484,22522,97.9,132,5,3.8
4,All Students,2021-22,19321,1346,17975,93.0,115,28,24.3
4,All Students,2022-23,22649,974,21675,95.7,132,15,11.4
5,All Students,2018-19,26363,916,25447,96.5,154,11,7.1
5,All Students,2019-20,14097,555,13542,96.1,127,14,11.0
5,All Students,2020-21,21409,482,20927,97.7,126,11,8.7
5,All Students,2021-22,23380,1235,22145,94.7,136,25,18.4
5,All Students,2022-23,21839,1291,20548,94.1,131,32,24.4
All Grades,All Students,2018-19,275716,11116,264600,96.0,1568,138,8.8
All Grades,All Students,2019-20,183678,6594,177084,96.4,1605,106,6.6
All Grades,All Students,2020-21,290049,6259,283790,97.8,1676,83,5.0
All Grades,All Students,2021-22,271051,18130,252921,93.3,1553,350,22.5
All Grades,All Students,2022-23,262808,18583,244225,92.9,1496,386,25.8
6,All Students,2018-19,97494,3926,93568,96.0,554,43,7.8
6,All Students,2019-20,62469,2194,60275,96.5,548,35,6.4
6,All Students,2020-21,103908,1881,102027,98.2,605,22,3.6
6,All Students,2021-22,87230,5626,81604,93.6,502,110,21.9
6,All Students,2022-23,89168,6280,82888,93.0,511,123,24.1
7,All Students,2018-19,91727,3060,88667,96.7,522,30,5.7
7,All Students,2019-20,62909,1891,61018,97.0,549,23,4.2
7,All Students,2020-21,91713,1799,89914,98.0,529,20,3.8
7,All Students,2021-22,96747,6072,90675,93.7,555,115,20.7
7,All Students,2022-23,81383,5178,76205,93.6,461,99,21.5
8,All Students,2018-19,86495,4130,82365,95.2,492,65,13.2
8,All Students,2019-20,58300,2509,55791,95.7,508,48,9.4
8,All Students,2020-21,94428,2579,91849,97.3,542,41,7.6
8,All Students,2021-22,87074,6432,80642,92.6,496,125,25.2
8,All Students,2022-23,92257,7125,85132,92.3,524,164,31.3
All Grades,All Students,2018-19,154317,13976,140341,90.9,922,299,32.4
All Grades,All Students,2019-20,101857,9319,92538,90.9,912,284,31.1
All Grades,All Students,2020-21,146507,27544,118963,81.2,868,453,52.2
All Grades,All Students,2021-22,142028,16437,125591,88.4,851,361,42.4
All Grades,All Students,2022-23,144735,13949,130786,90.4,865,331,38.3
PK in K-12 Schools,All Students,2018-19,6165,741,5424,88.0,36,18,50.0
PK in K-12 Schools,All Students,2019-20,4053,558,3495,86.2,36,24,66.7
PK in K-12 Schools,All Students,2020-21,4407,770,3637,82.5,28,19,67.9
PK in K-12 Schools,All Students,2021-22,5854,837,5017,85.7,37,22,59.5
PK in K-12 Schools,All Students,2022-23,6110,s,s,s,s,s,s
0K,All Students,2018-19,16129,1808,14321,88.8,105,42,40.0
0K,All Students,2019-20,10608,1196,9412,88.7,96,41,42.7
0K,All Students,2020-21,13965,2605,11360,81.3,86,49,57.0
0K,All Students,2021-22,14982,2202,12780,85.3,93,55,59.1
0K,All Students,2022-23,12196,1275,10921,89.5,77,32,41.6
1,All Students,2018-19,18397,1584,16813,91.4,111,34,30.6
1,All Students,2019-20,10752,1131,9621,89.5,95,39,41.1
1,All Students,2020-21,15178,3025,12153,80.1,92,57,62.0
1,All Students,2021-22,13144,1465,11679,88.9,80,38,47.5
1,All Students,2022-23,15841,1716,14125,89.2,94,41,43.6
2,All Students,2018-19,15937,1182,14755,92.6,95,20,21.1
2,All Students,2019-20,12370,1057,11313,91.5,112,29,25.9
2,All Students,2020-21,16315,2765,13550,83.1,96,44,45.8
2,All Students,2021-22,15516,1589,13927,89.8,92,34,37.0
2,All Students,2022-23,13912,1264,12648,90.9,82,28,34.1
3,All Students,2018-19,17337,1370,15967,92.1,104,32,30.8
3,All Students,2019-20,10790,776,10014,92.8,96,25,26.0
3,All Students,2020-21,17854,2256,15598,87.4,105,38,36.2
3,All Students,2021-22,15174,1562,13612,89.7,93,35,37.6
3,All Students,2022-23,16276,1493,14783,90.8,99,30,30.3
4,All Students,2018-19,20402,1181,19221,94.2,118,21,17.8
4,All Students,2019-20,11212,787,10425,93.0,99,22,22.2
4,All Students,2020-21,15755,1704,14051,89.2,93,35,37.6
4,All Students,2021-22,16543,1581,14962,90.4,98,35,35.7
4,All Students,2022-23,15988,1455,14533,90.9,94,35,37.2
5,All Students,2018-19,16902,1215,15687,92.8,100,26,26.0
5,All Students,2019-20,12858,932,11926,92.8,113,26,23.0
5,All Students,2020-21,16746,2001,14745,88.1,96,33,34.4
5,All Students,2021-22,15761,1255,14506,92.0,92,28,30.4
5,All Students,2022-23,17891,1603,16288,91.0,106,35,33.0
6,All Students,2018-19,15814,2127,13687,86.5,94,45,47.9
6,All Students,2019-20,10404,1396,9008,86.6,92,29,31.5
6,All Students,2020-21,16524,3279,13245,80.2,98,53,54.1
6,All Students,2021-22,14029,1496,12533,89.3,83,25,30.1
6,All Students,2022-23,14038,1223,12815,91.3,83,29,34.9
7,All Students,2018-19,13608,1525,12083,88.8,79,32,40.5
7,All Students,2019-20,9832,845,8987,91.4,91,29,31.9
7,All Students,2020-21,14562,4356,10206,70.1,86,63,73.3
7,All Students,2021-22,16656,2294,14362,86.2,95,41,43.2
7,All Students,2022-23,16008,1477,14531,90.8,97,34,35.1
8,All Students,2018-19,13626,1243,12383,90.9,80,29,36.3
8,All Students,2019-20,8978,641,8337,92.9,82,20,24.4
8,All Students,2020-21,15201,4783,10418,68.5,88,62,70.5
8,All Students,2021-22,14369,2156,12213,85.0,88,48,54.5
8,All Students,2022-23,16429,1480,14949,91.0,97,42,43.3
9,All Students,2022-23,46,s,s,s,s,s,s
All Grades,All Students,2018-19,146006,9011,136995,93.8,855,141,16.5
All Grades,All Students,2019-20,95087,6166,88921,93.5,855,175,20.5
All Grades,All Students,2020-21,119220,7218,112002,93.9,717,121,16.9
All Grades,All Students,2021-22,111380,9589,101791,91.4,683,206,30.2
All Grades,All Students,2022-23,113326,10601,102725,90.6,714,244,34.2
PK in K-12 Schools,All Students,2018-19,7712,641,7071,91.7,48,15,31.3
PK in K-12 Schools,All Students,2019-20,3966,407,3559,89.7,38,16,42.1
PK in K-12 Schools,All Students,2020-21,3832,215,3617,94.4,24,4,16.7
PK in K-12 Schools,All Students,2021-22,2917,361,2556,87.6,20,12,60.0
PK in K-12 Schools,All Students,2022-23,3783,617,3166,83.7,27,15,55.6
0K,All Students,2018-19,24900,1795,23105,92.8,144,31,21.5
0K,All Students,2019-20,16968,1203,15765,92.9,154,36,23.4
0K,All Students,2020-21,14079,997,13082,92.9,90,20,22.2
0K,All Students,2021-22,17168,1813,15355,89.4,105,43,41.0
0K,All Students,2022-23,16158,2064,14094,87.2,115,60,52.2
1,All Students,2018-19,26883,1847,25036,93.1,156,35,22.4
1,All Students,2019-20,15203,1001,14202,93.4,138,31,22.5
1,All Students,2020-21,21969,1264,20705,94.2,133,21,15.8
1,All Students,2021-22,18287,1756,16531,90.4,113,41,36.3
1,All Students,2022-23,20035,2063,17972,89.7,123,51,41.5
2,All Students,2018-19,23380,1313,22067,94.4,137,12,8.8
2,All Students,2019-20,16102,1012,15090,93.7,143,25,17.5
2,All Students,2020-21,19288,1343,17945,93.0,116,20,17.2
2,All Students,2021-22,19812,1567,18245,92.1,120,29,24.2
2,All Students,2022-23,17044,1450,15594,91.5,105,34,32.4
3,All Students,2018-19,20618,1189,19429,94.2,122,18,14.8
3,All Students,2019-20,15638,1044,14594,93.3,138,30,21.7
3,All Students,2020-21,20660,1217,19443,94.1,124,21,16.9
3,All Students,2021-22,16142,1329,14813,91.8,101,31,30.7
3,All Students,2022-23,19953,1603,18350,92.0,123,34,27.6
4,All Students,2018-19,20489,1063,19426,94.8,120,15,12.5
4,All Students,2019-20,12950,733,12217,94.3,116,19,16.4
4,All Students,2020-21,22342,1009,21333,95.5,131,16,12.2
4,All Students,2021-22,17651,1204,16447,93.2,108,19,17.6
4,All Students,2022-23,17528,1317,16211,92.5,106,23,21.7
5,All Students,2018-19,22024,1163,20861,94.7,128,15,11.7
5,All Students,2019-20,14260,766,13494,94.6,128,18,14.1
5,All Students,2020-21,17050,1173,15877,93.1,99,19,19.2
5,All Students,2021-22,19403,1559,17844,92.0,116,31,26.7
5,All Students,2022-23,18825,1487,17338,92.1,115,27,23.5
All Grades,All Students,2018-19,155773,6746,149027,95.7,910,115,12.6
All Grades,All Students,2019-20,106525,4518,102007,95.8,953,111,11.6
All Grades,All Students,2020-21,169344,6675,162669,96.1,997,119,11.9
All Grades,All Students,2021-22,177113,11912,165201,93.3,1053,243,23.1
All Grades,All Students,2022-23,188152,10914,177238,94.2,1108,198,17.9
PK in K-12 Schools,All Students,2020-21,6360,374,5986,94.1,37,9,24.3
PK in K-12 Schools,All Students,2021-22,6331,517,5814,91.8,38,14,36.8
PK in K-12 Schools,All Students,2022-23,6197,668,5529,89.2,38,17,44.7
0K,All Students,2018-19,22329,1271,21058,94.3,131,24,18.3
0K,All Students,2019-20,18465,1060,17405,94.3,163,25,15.3
0K,All Students,2020-21,26140,1198,24942,95.4,161,21,13.0
0K,All Students,2021-22,26770,2447,24323,90.9,159,54,34.0
0K,All Students,2022-23,27342,1832,25510,93.3,156,31,19.9
1,All Students,2018-19,25722,1169,24553,95.5,154,22,14.3
1,All Students,2019-20,17335,906,16429,94.8,155,21,13.5
1,All Students,2020-21,29733,790,28943,97.3,174,15,8.6
1,All Students,2021-22,28532,2138,26394,92.5,170,40,23.5
1,All Students,2022-23,32599,2230,30369,93.2,192,42,21.9
2,All Students,2018-19,25040,1080,23960,95.7,146,18,12.3
2,All Students,2019-20,17781,662,17119,96.3,160,15,9.4
2,All Students,2020-21,25926,1452,24474,94.4,151,29,19.2
2,All Students,2021-22,30842,1800,29042,94.2,182,31,17.0
2,All Students,2022-23,29839,1638,28201,94.5,178,30,16.9
3,All Students,2018-19,25758,1036,24722,96.0,148,15,10.1
3,All Students,2019-20,17424,626,16798,96.4,156,15,9.6
3,All Students,2020-21,27998,1004,26994,96.4,164,14,8.5
3,All Students,2021-22,27395,1702,25693,93.8,164,33,20.1
3,All Students,2022-23,32377,1414,30963,95.6,189,20,10.6
4,All Students,2018-19,27628,1220,26408,95.6,164,21,12.8
4,All Students,2019-20,17448,689,16759,96.1,157,20,12.7
4,All Students,2020-21,26531,1097,25434,95.9,155,22,14.2
4,All Students,2021-22,29485,1886,27599,93.6,176,42,23.9
4,All Students,2022-23,29280,1757,27523,94.0,175,34,19.4
5,All Students,2018-19,29296,970,28326,96.7,167,15,9.0
5,All Students,2019-20,18072,575,17497,96.8,162,15,9.3
5,All Students,2020-21,26656,760,25896,97.1,155,9,5.8
5,All Students,2021-22,27758,1422,26336,94.9,164,29,17.7
5,All Students,2022-23,30518,1375,29143,95.5,180,24,13.3
All Grades,All Students,2018-19,60453,3420,57033,94.3,359,60,16.7
All Grades,All Students,2019-20,38374,2000,36374,94.8,347,55,15.9
All Grades,All Students,2020-21,55759,3529,52230,93.7,327,62,19.0
All Grades,All Students,2021-22,56270,4322,51948,92.3,330,95,28.8
All Grades,All Students,2022-23,58331,4458,53873,92.4,356,100,28.1
0K,All Students,2018-19,6385,359,6026,94.4,41,6,14.6
0K,All Students,2019-20,3937,339,3598,91.4,35,12,34.3
0K,All Students,2020-21,5284,420,4864,92.1,33,8,24.2
0K,All Students,2021-22,5156,s,s,s,s,s,s
0K,All Students,2022-23,3844,457,3387,88.1,23,9,39.1
1,All Students,2018-19,7459,401,7058,94.6,43,7,16.3
1,All Students,2019-20,3907,230,3677,94.1,35,7,20.0
1,All Students,2020-21,6149,512,5637,91.7,36,10,27.8
1,All Students,2021-22,6346,486,5860,92.3,38,11,28.9
1,All Students,2022-23,4945,348,4597,93.0,30,8,26.7
2,All Students,2018-19,6534,469,6065,92.8,39,14,35.9
2,All Students,2019-20,4476,257,4219,94.3,40,8,20.0
2,All Students,2020-21,5883,186,5697,96.8,34,0,0.0
2,All Students,2021-22,5258,379,4879,92.8,30,8,26.7
2,All Students,2022-23,6712,478,6234,92.9,40,8,20.0
3,All Students,2018-19,5530,275,5255,95.0,32,4,12.5
3,All Students,2019-20,4608,214,4394,95.4,41,2,4.9
3,All Students,2020-21,6550,332,6218,94.9,39,7,17.9
3,All Students,2021-22,5865,380,5485,93.5,35,9,25.7
3,All Students,2022-23,5422,418,5004,92.3,32,9,28.1
4,All Students,2018-19,8842,476,8366,94.6,55,10,18.2
4,All Students,2019-20,3595,140,3455,96.1,34,3,8.8
4,All Students,2020-21,6882,261,6621,96.2,40,4,10.0
4,All Students,2021-22,7879,661,7218,91.6,46,17,37.0
4,All Students,2022-23,6428,496,5932,92.3,38,11,28.9
5,All Students,2018-19,7260,383,6877,94.7,42,6,14.3
5,All Students,2019-20,5864,264,5600,95.5,52,6,11.5
5,All Students,2020-21,5720,280,5440,95.1,34,5,14.7
5,All Students,2021-22,6372,396,5976,93.8,37,8,21.6
5,All Students,2022-23,8274,567,7707,93.1,50,15,30.0
6,All Students,2018-19,5160,275,4885,94.7,31,5,16.1
6,All Students,2019-20,4864,270,4594,94.4,44,9,20.5
6,All Students,2020-21,7353,602,6751,91.8,42,9,21.4
6,All Students,2021-22,5290,473,4817,91.1,30,8,26.7
6,All Students,2022-23,6428,467,5961,92.7,39,7,17.9
7,All Students,2018-19,6402,281,6121,95.6,37,2,5.4
7,All Students,2019-20,3000,130,2870,95.7,27,4,14.8
7,All Students,2020-21,7073,602,6471,91.5,41,12,29.3
7,All Students,2021-22,6972,545,6427,92.2,41,10,24.4
7,All Students,2022-23,6520,533,5987,91.8,45,17,37.8
8,All Students,2018-19,6881,501,6380,92.7,39,6,15.4
8,All Students,2019-20,4123,156,3967,96.2,39,4,10.3
8,All Students,2020-21,4865,334,4531,93.1,28,7,25.0
8,All Students,2021-22,7130,650,6480,90.9,41,16,39.0
8,All Students,2022-23,9758,694,9064,92.9,59,16,27.1
9,All Students,2021-22,2,s,s,s,s,s,s
All Grades,All Students,2018-19,83588,4723,78865,94.3,503,92,18.3
All Grades,All Students,2019-20,52707,2616,50091,95.0,480,66,13.8
All Grades,All Students,2020-21,73768,7464,66304,89.9,434,133,30.6
All Grades,All Students,2021-22,76046,7397,68649,90.3,459,175,38.1
All Grades,All Students,2022-23,78763,6776,71987,91.4,492,159,32.3
0K,All Students,2018-19,14147,1166,12981,91.8,86,28,32.6
0K,All Students,2019-20,8310,648,7662,92.2,75,21,28.0
0K,All Students,2020-21,12471,1377,11094,89.0,75,20,26.7
0K,All Students,2021-22,13805,1243,12562,91.0,83,30,36.1
0K,All Students,2022-23,13607,1545,12062,88.6,84,36,42.9
1,All Students,2018-19,12034,732,11302,93.9,74,14,18.9
1,All Students,2019-20,7481,400,7081,94.7,70,12,17.1
1,All Students,2020-21,11084,1087,9997,90.2,66,23,34.8
1,All Students,2021-22,12981,1614,11367,87.6,81,42,51.9
1,All Students,2022-23,16256,1334,14922,91.8,102,30,29.4
2,All Students,2018-19,14049,850,13199,93.9,85,16,18.8
2,All Students,2019-20,7380,327,7053,95.6,66,5,7.6
2,All Students,2020-21,11161,937,10224,91.6,65,17,26.2
2,All Students,2021-22,10852,1021,9831,90.6,66,22,33.3
2,All Students,2022-23,12953,1150,11803,91.1,82,29,35.4
3,All Students,2018-19,17115,892,16223,94.8,106,17,16.0
3,All Students,2019-20,9306,379,8927,95.9,84,5,6.0
3,All Students,2020-21,11583,1058,10525,90.9,67,12,17.9
3,All Students,2021-22,12558,1101,11457,91.2,75,23,30.7
3,All Students,2022-23,11306,831,10475,92.6,73,21,28.8
4,All Students,2018-19,14832,599,14233,96.0,87,8,9.2
4,All Students,2019-20,9906,458,9448,95.4,90,14,15.6
4,All Students,2020-21,12224,1169,11055,90.4,73,26,35.6
4,All Students,2021-22,11735,1278,10457,89.1,70,31,44.3
4,All Students,2022-23,13610,1118,12492,91.8,82,26,31.7
5,All Students,2018-19,11411,484,10927,95.8,65,9,13.8
5,All Students,2019-20,10324,404,9920,96.1,95,9,9.5
5,All Students,2020-21,15245,1836,13409,88.0,88,35,39.8
5,All Students,2021-22,14115,1140,12975,91.9,84,27,32.1
5,All Students,2022-23,11030,s,s,s,s,s,s
6,All Students,2022-23,1,s,s,s,s,s,s
All Grades,All Students,2018-19,98238,6620,91618,93.3,582,145,24.9
All Grades,All Students,2019-20,67252,4830,62422,92.8,617,167,27.1
All Grades,All Students,2020-21,95195,13550,81645,85.8,580,274,47.2
All Grades,All Students,2021-22,94917,10701,84216,88.7,583,279,47.9
All Grades,All Students,2022-23,89674,8625,81049,90.4,554,221,39.9
PK in K-12 Schools,All Students,2018-19,10795,1240,9555,88.5,66,31,47.0
PK in K-12 Schools,All Students,2019-20,7576,840,6736,88.9,73,32,43.8
PK in K-12 Schools,All Students,2020-21,8889,1138,7751,87.2,58,29,50.0
PK in K-12 Schools,All Students,2021-22,10627,1807,8820,83.0,68,56,82.4
PK in K-12 Schools,All Students,2022-23,7455,1005,6450,86.5,50,28,56.0
0K,All Students,2018-19,16066,1343,14723,91.6,98,31,31.6
0K,All Students,2019-20,10152,806,9346,92.1,93,32,34.4
0K,All Students,2020-21,13676,2414,11262,82.3,87,56,64.4
0K,All Students,2021-22,13508,1575,11933,88.3,86,47,54.7
0K,All Students,2022-23,15039,1693,13346,88.7,92,50,54.3
1,All Students,2018-19,15407,1161,14246,92.5,89,28,31.5
1,All Students,2019-20,10752,842,9910,92.2,99,29,29.3
1,All Students,2020-21,13963,2056,11907,85.3,85,40,47.1
1,All Students,2021-22,12709,1390,11319,89.1,78,40,51.3
1,All Students,2022-23,13087,1249,11838,90.5,86,32,37.2
2,All Students,2018-19,16431,1021,15410,93.8,97,20,20.6
2,All Students,2019-20,9332,675,8657,92.8,84,23,27.4
2,All Students,2020-21,15442,2836,12606,81.6,94,53,56.4
2,All Students,2021-22,14042,1742,12300,87.6,86,39,45.3
2,All Students,2022-23,14046,1324,12722,90.6,83,26,31.3
3,All Students,2018-19,12725,564,12161,95.6,75,12,16.0
3,All Students,2019-20,11419,819,10600,92.8,103,29,28.2
3,All Students,2020-21,13257,1672,11585,87.4,79,35,44.3
3,All Students,2021-22,14398,1349,13049,90.6,86,33,38.4
3,All Students,2022-23,12315,1068,11247,91.3,74,25,33.8
4,All Students,2018-19,14050,581,13469,95.9,82,10,12.2
4,All Students,2019-20,8562,382,8180,95.5,79,11,13.9
4,All Students,2020-21,17007,2009,14998,88.2,102,37,36.3
4,All Students,2021-22,12422,1317,11105,89.4,76,28,36.8
4,All Students,2022-23,15640,1254,14386,92.0,96,34,35.4
5,All Students,2018-19,12764,710,12054,94.4,75,13,17.3
5,All Students,2019-20,9459,466,8993,95.1,86,11,12.8
5,All Students,2020-21,12961,1425,11536,89.0,75,24,32.0
5,All Students,2021-22,17211,1521,15690,91.2,103,36,35.0
5,All Students,2022-23,12092,1032,11060,91.5,73,26,35.6
All Grades,All Students,2018-19,175812,11134,164678,93.7,1030,239,23.2
All Grades,All Students,2019-20,113247,7893,105354,93.0,1016,246,24.2
All Grades,All Students,2020-21,161892,11988,149904,92.6,982,256,26.1
All Grades,All Students,2021-22,155104,17964,137140,88.4,954,458,48.0
All Grades,All Students,2022-23,154900,14516,140384,90.6,944,377,39.9
PK in K-12 Schools,All Students,2018-19,12590,s,s,s,s,s,s
PK in K-12 Schools,All Students,2019-20,8236,668,7568,91.9,74,24,32.4
PK in K-12 Schools,All Students,2020-21,12396,1286,11110,89.6,77,29,37.7
PK in K-12 Schools,All Students,2021-22,12561,1866,10695,85.1,81,52,64.2
PK in K-12 Schools,All Students,2022-23,12500,1646,10854,86.8,79,52,65.8
0K,All Students,2018-19,24906,1855,23051,92.6,149,42,28.2
0K,All Students,2019-20,18091,1660,16431,90.8,167,64,38.3
0K,All Students,2020-21,23339,2240,21099,90.4,146,49,33.6
0K,All Students,2021-22,26862,3761,23101,86.0,164,102,62.2
0K,All Students,2022-23,25160,2747,22413,89.1,152,74,48.7
1,All Students,2018-19,28291,1859,26432,93.4,168,42,25.0
1,All Students,2019-20,15658,1323,14335,91.6,141,44,31.2
1,All Students,2020-21,24910,1786,23124,92.8,152,36,23.7
1,All Students,2021-22,23692,3008,20684,87.3,147,78,53.1
1,All Students,2022-23,26359,2813,23546,89.3,166,86,51.8
2,All Students,2018-19,27025,1755,25270,93.5,163,39,23.9
2,All Students,2019-20,17456,1102,16354,93.7,156,28,17.9
2,All Students,2020-21,21920,1660,20260,92.4,131,32,24.4
2,All Students,2021-22,21781,2528,19253,88.4,137,66,48.2
2,All Students,2022-23,22948,2037,20911,91.1,137,45,32.8
3,All Students,2018-19,28470,1514,26956,94.7,165,33,20.0
3,All Students,2019-20,17652,1045,16607,94.1,157,30,19.1
3,All Students,2020-21,24862,1769,23093,92.9,155,41,26.5
3,All Students,2021-22,23033,2688,20345,88.3,140,66,47.1
3,All Students,2022-23,21760,1727,20033,92.1,133,40,30.1
4,All Students,2018-19,25387,1354,24033,94.7,145,29,20.0
4,All Students,2019-20,18777,1074,17703,94.3,167,33,19.8
4,All Students,2020-21,26220,1419,24801,94.6,155,29,18.7
4,All Students,2021-22,21575,1936,19639,91.0,133,44,33.1
4,All Students,2022-23,23128,1749,21379,92.4,139,43,30.9
5,All Students,2018-19,29140,1640,27500,94.4,168,29,17.3
5,All Students,2019-20,17377,1021,16356,94.1,154,23,14.9
5,All Students,2020-21,28245,1828,26417,93.5,166,40,24.1
5,All Students,2021-22,25600,2177,23423,91.5,152,50,32.9
5,All Students,2022-23,23045,1797,21248,92.2,138,37,26.8
7,All Students,2018-19,3,s,s,s,s,s,s
All Grades,All Students,2018-19,68292,9409,58883,86.2,420,237,56.4
All Grades,All Students,2019-20,39807,5119,34688,87.1,379,205,54.1
All Grades,All Students,2020-21,53860,10952,42908,79.7,332,221,66.6
All Grades,All Students,2021-22,46055,7970,38085,82.7,285,219,76.8
All Grades,All Students,2022-23,46026,7434,38592,83.8,300,204,68.0
PK in K-12 Schools,All Students,2018-19,5116,565,4551,89.0,33,16,48.5
PK in K-12 Schools,All Students,2019-20,3327,548,2779,83.5,33,26,78.8
PK in K-12 Schools,All Students,2020-21,2414,591,1823,75.5,15,11,73.3
PK in K-12 Schools,All Students,2021-22,2731,583,2148,78.7,17,16,94.1
PK in K-12 Schools,All Students,2022-23,4851,1006,3845,79.3,35,28,80.0
0K,All Students,2018-19,9330,1531,7799,83.6,58,37,63.8
0K,All Students,2019-20,5428,621,4807,88.6,51,25,49.0
0K,All Students,2020-21,7238,1480,5758,79.6,48,31,64.6
0K,All Students,2021-22,4454,911,3543,79.5,30,25,83.3
0K,All Students,2022-23,7846,1597,6249,79.6,49,38,77.6
1,All Students,2018-19,9486,1549,7937,83.7,60,43,71.7
1,All Students,2019-20,4831,714,4117,85.2,48,28,58.3
1,All Students,2020-21,7653,1515,6138,80.2,46,30,65.2
1,All Students,2021-22,6878,1363,5515,80.2,42,30,71.4
1,All Students,2022-23,4864,681,4183,86.0,31,20,64.5
2,All Students,2018-19,11320,1418,9902,87.5,68,33,48.5
2,All Students,2019-20,5250,680,4570,87.0,50,29,58.0
2,All Students,2020-21,7526,1544,5982,79.5,48,31,64.6
2,All Students,2021-22,7393,1031,6362,86.1,46,32,69.6
2,All Students,2022-23,6958,1240,5718,82.2,46,33,71.7
3,All Students,2018-19,12285,1827,10458,85.1,77,50,64.9
3,All Students,2019-20,7288,765,6523,89.5,70,30,42.9
3,All Students,2020-21,7373,1728,5645,76.6,46,34,73.9
3,All Students,2021-22,6855,1083,5772,84.2,42,31,73.8
3,All Students,2022-23,6849,797,6052,88.4,43,24,55.8
4,All Students,2018-19,11296,1634,9662,85.5,69,37,53.6
4,All Students,2019-20,6768,845,5923,87.5,65,35,53.8
4,All Students,2020-21,11351,1992,9359,82.5,68,42,61.8
4,All Students,2021-22,7652,1377,6275,82.0,48,40,83.3
4,All Students,2022-23,6357,867,5490,86.4,44,26,59.1
5,All Students,2018-19,9459,885,8574,90.6,55,21,38.2
5,All Students,2019-20,6915,946,5969,86.3,62,32,51.6
5,All Students,2020-21,10305,2102,8203,79.6,61,42,68.9
5,All Students,2021-22,10092,1622,8470,83.9,60,45,75.0
5,All Students,2022-23,8301,1246,7055,85.0,52,35,67.3
All Grades,All Students,2018-19,100647,7223,93424,92.8,597,138,23.1
All Grades,All Students,2019-20,65161,4047,61114,93.8,585,116,19.8
All Grades,All Students,2020-21,93382,8202,85180,91.2,560,155,27.7
All Grades,All Students,2021-22,91973,10237,81736,88.9,563,252,44.8
All Grades,All Students,2022-23,94286,9528,84758,89.9,581,224,38.6
PK in K-12 Schools,All Students,2018-19,6254,589,5665,90.6,37,11,29.7
PK in K-12 Schools,All Students,2019-20,4090,401,3689,90.2,37,16,43.2
PK in K-12 Schools,All Students,2020-21,5341,1202,4139,77.5,34,21,61.8
PK in K-12 Schools,All Students,2021-22,5518,944,4574,82.9,38,26,68.4
PK in K-12 Schools,All Students,2022-23,6218,1010,5208,83.8,38,28,73.7
0K,All Students,2018-19,15323,1466,13857,90.4,93,32,34.4
0K,All Students,2019-20,11069,816,10253,92.6,101,26,25.7
0K,All Students,2020-21,14276,1438,12838,89.9,87,31,35.6
0K,All Students,2021-22,14509,2016,12493,86.1,88,48,54.5
0K,All Students,2022-23,13909,1867,12042,86.6,91,46,50.5
1,All Students,2018-19,16078,1335,14743,91.7,95,27,28.4
1,All Students,2019-20,9822,640,9182,93.5,89,20,22.5
1,All Students,2020-21,15454,1705,13749,89.0,93,31,33.3
1,All Students,2021-22,13858,1751,12107,87.4,85,44,51.8
1,All Students,2022-23,15402,1701,13701,89.0,94,43,45.7
2,All Students,2018-19,17793,1257,16536,92.9,106,26,24.5
2,All Students,2019-20,9388,595,8793,93.7,84,18,21.4
2,All Students,2020-21,14571,1253,13318,91.4,86,26,30.2
2,All Students,2021-22,14058,1339,12719,90.5,83,31,37.3
2,All Students,2022-23,14957,1528,13429,89.8,93,38,40.9
3,All Students,2018-19,15188,826,14362,94.6,90,12,13.3
3,All Students,2019-20,10914,694,10220,93.6,97,18,18.6
3,All Students,2020-21,13460,1033,12427,92.3,81,20,24.7
3,All Students,2021-22,14204,1589,12615,88.8,90,39,43.3
3,All Students,2022-23,13372,1042,12330,92.2,81,23,28.4
4,All Students,2018-19,14863,926,13937,93.8,87,17,19.5
4,All Students,2019-20,10242,487,9755,95.2,91,11,12.1
4,All Students,2020-21,15642,852,14790,94.6,91,14,15.4
4,All Students,2021-22,13615,1181,12434,91.3,82,28,34.1
4,All Students,2022-23,14972,1151,13821,92.3,90,21,23.3
5,All Students,2018-19,15148,824,14324,94.6,89,13,14.6
5,All Students,2019-20,9636,414,9222,95.7,86,7,8.1
5,All Students,2020-21,14638,719,13919,95.1,88,12,13.6
5,All Students,2021-22,16211,1417,14794,91.3,97,36,37.1
5,All Students,2022-23,15456,1229,14227,92.0,94,25,26.6
All Grades,All Students,2018-19,126751,7705,119046,93.9,752,141,18.8
All Grades,All Students,2019-20,85537,4853,80684,94.3,786,150,19.1
All Grades,All Students,2020-21,120430,4962,115468,95.9,718,86,12.0
All Grades,All Students,2021-22,118943,8056,110887,93.2,729,175,24.0
All Grades,All Students,2022-23,136082,9746,126336,92.8,823,197,23.9
PK in K-12 Schools,All Students,2018-19,6363,612,5751,90.4,36,16,44.4
PK in K-12 Schools,All Students,2019-20,3432,291,3141,91.5,36,15,41.7
PK in K-12 Schools,All Students,2020-21,5704,360,5344,93.7,38,10,26.3
PK in K-12 Schools,All Students,2021-22,5307,483,4824,90.9,34,13,38.2
PK in K-12 Schools,All Students,2022-23,6068,456,5612,92.5,37,9,24.3
0K,All Students,2018-19,14385,1131,13254,92.1,89,23,25.8
0K,All Students,2019-20,10210,786,9424,92.3,95,27,28.4
0K,All Students,2020-21,11901,552,11349,95.4,78,12,15.4
0K,All Students,2021-22,12188,1011,11177,91.7,80,27,33.8
0K,All Students,2022-23,12444,1208,11236,90.3,76,29,38.2
1,All Students,2018-19,14005,898,13107,93.6,86,21,24.4
1,All Students,2019-20,9901,643,9258,93.5,93,24,25.8
1,All Students,2020-21,13649,680,12969,95.0,81,13,16.0
1,All Students,2021-22,12772,880,11892,93.1,79,19,24.1
1,All Students,2022-23,13092,995,12097,92.4,79,17,21.5
2,All Students,2018-19,13932,811,13121,94.2,83,12,14.5
2,All Students,2019-20,9254,515,8739,94.4,82,11,13.4
2,All Students,2020-21,13885,386,13499,97.2,82,7,8.5
2,All Students,2021-22,13817,879,12938,93.6,85,20,23.5
2,All Students,2022-23,13996,854,13142,93.9,85,15,17.6
3,All Students,2018-19,15597,914,14683,94.1,93,17,18.3
3,All Students,2019-20,8691,385,8306,95.6,79,9,11.4
3,All Students,2020-21,12492,391,12101,96.9,72,4,5.6
3,All Students,2021-22,13531,839,12692,93.8,84,21,25.0
3,All Students,2022-23,16410,959,15451,94.2,104,23,22.1
4,All Students,2018-19,16955,797,16158,95.3,100,13,13.0
4,All Students,2019-20,10051,516,9535,94.9,89,13,14.6
4,All Students,2020-21,12749,390,12359,96.9,74,3,4.1
4,All Students,2021-22,11749,669,11080,94.3,71,16,22.5
4,All Students,2022-23,15030,1003,14027,93.3,88,21,23.9
5,All Students,2018-19,12486,712,11774,94.3,72,13,18.1
5,All Students,2019-20,11151,507,10644,95.5,101,13,12.9
5,All Students,2020-21,14356,585,13771,95.9,83,9,10.8
5,All Students,2021-22,12754,709,12045,94.4,79,8,10.1
5,All Students,2022-23,14446,963,13483,93.3,88,19,21.6
6,All Students,2018-19,10705,647,10058,94.0,64,13,20.3
6,All Students,2019-20,7006,352,6654,95.0,67,13,19.4
6,All Students,2020-21,12924,520,12404,96.0,78,10,12.8
6,All Students,2021-22,11421,866,10555,92.4,67,18,26.9
6,All Students,2022-23,11947,790,11157,93.4,69,12,17.4
7,All Students,2018-19,11303,574,10729,94.9,66,7,10.6
7,All Students,2019-20,7861,463,7398,94.1,71,16,22.5
7,All Students,2020-21,11069,430,10639,96.1,64,6,9.4
7,All Students,2021-22,13524,776,12748,94.3,80,14,17.5
7,All Students,2022-23,16129,1366,14763,91.5,99,29,29.3
8,All Students,2018-19,11020,609,10411,94.5,63,6,9.5
8,All Students,2019-20,7980,395,7585,95.1,73,9,12.3
8,All Students,2020-21,11701,668,11033,94.3,68,12,17.6
8,All Students,2021-22,11880,944,10936,92.1,70,19,27.1
8,All Students,2022-23,16520,1152,15368,93.0,98,23,23.5
All Grades,All Students,2018-19,128234,10425,117809,91.9,780,249,31.9
All Grades,All Students,2019-20,79608,5919,73689,92.6,725,213,29.4
All Grades,All Students,2020-21,106293,7327,98966,93.1,624,133,21.3
All Grades,All Students,2021-22,104669,11093,93576,89.4,642,277,43.1
All Grades,All Students,2022-23,107281,10958,96323,89.8,645,279,43.3
PK in K-12 Schools,All Students,2018-19,9254,989,8265,89.3,57,21,36.8
PK in K-12 Schools,All Students,2019-20,6030,s,s,s,s,s,s
PK in K-12 Schools,All Students,2020-21,8032,797,7235,90.1,47,16,34.0
PK in K-12 Schools,All Students,2021-22,7774,1101,6673,85.8,51,33,64.7
PK in K-12 Schools,All Students,2022-23,8486,1313,7173,84.5,56,39,69.6
0K,All Students,2018-19,21813,2140,19673,90.2,138,64,46.4
0K,All Students,2019-20,12596,1281,11315,89.8,120,52,43.3
0K,All Students,2020-21,13901,1178,12723,91.5,82,19,23.2
0K,All Students,2021-22,14461,1974,12487,86.3,93,54,58.1
0K,All Students,2022-23,14061,1882,12179,86.6,86,51,59.3
1,All Students,2018-19,20630,1858,18772,91.0,125,45,36.0
1,All Students,2019-20,13314,1080,12234,91.9,120,37,30.8
1,All Students,2020-21,18485,1793,16692,90.3,110,32,29.1
1,All Students,2021-22,15637,1615,14022,89.7,95,39,41.1
1,All Students,2022-23,13774,1353,12421,90.2,84,35,41.7
2,All Students,2018-19,16488,1116,15372,93.2,98,24,24.5
2,All Students,2019-20,12888,868,12020,93.3,116,32,27.6
2,All Students,2020-21,17914,1280,16634,92.9,105,24,22.9
2,All Students,2021-22,17568,1993,15575,88.7,107,48,44.9
2,All Students,2022-23,18276,1640,16636,91.0,107,39,36.4
3,All Students,2018-19,16746,985,15761,94.1,100,20,20.0
3,All Students,2019-20,10717,687,10030,93.6,97,24,24.7
3,All Students,2020-21,18061,1013,17048,94.4,106,19,17.9
3,All Students,2021-22,16600,1679,14921,89.9,102,45,44.1
3,All Students,2022-23,17146,1740,15406,89.9,105,44,41.9
4,All Students,2018-19,22116,1678,20438,92.4,135,39,28.9
4,All Students,2019-20,10567,602,9965,94.3,96,18,18.8
4,All Students,2020-21,15008,731,14277,95.1,86,14,16.3
4,All Students,2021-22,18070,1657,16413,90.8,107,36,33.6
4,All Students,2022-23,17082,1578,15504,90.8,100,39,39.0
5,All Students,2018-19,21187,1659,19528,92.2,127,36,28.3
5,All Students,2019-20,13491,829,12662,93.9,118,27,22.9
5,All Students,2020-21,14892,535,14357,96.4,88,9,10.2
5,All Students,2021-22,14559,1074,13485,92.6,87,22,25.3
5,All Students,2022-23,18456,1452,17004,92.1,107,32,29.9
6,All Students,2019-20,5,s,s,s,s,s,s
All Grades,All Students,2018-19,148968,9604,139364,93.6,872,200,22.9
All Grades,All Students,2019-20,94893,6023,88870,93.7,847,187,22.1
All Grades,All Students,2020-21,131141,7751,123390,94.1,776,164,21.1
All Grades,All Students,2021-22,126386,12642,113744,90.0,762,306,40.2
All Grades,All Students,2022-23,126544,12201,114343,90.4,758,285,37.6
PK in K-12 Schools,All Students,2018-19,6387,617,5770,90.3,36,16,44.4
PK in K-12 Schools,All Students,2019-20,4125,345,3780,91.6,37,13,35.1
PK in K-12 Schools,All Students,2020-21,5239,374,4865,92.9,30,9,30.0
PK in K-12 Schools,All Students,2021-22,10319,1814,8505,82.4,70,52,74.3
PK in K-12 Schools,All Students,2022-23,11331,1830,9501,83.8,71,44,62.0
0K,All Students,2018-19,21655,1575,20080,92.7,129,32,24.8
0K,All Students,2019-20,14249,1356,12893,90.5,129,53,41.1
0K,All Students,2020-21,18128,957,17171,94.7,109,20,18.3
0K,All Students,2021-22,17964,2019,15945,88.8,110,46,41.8
0K,All Students,2022-23,12843,1569,11274,87.8,77,35,45.5
1,All Students,2018-19,23466,1770,21696,92.5,139,40,28.8
1,All Students,2019-20,15693,878,14815,94.4,140,24,17.1
1,All Students,2020-21,22162,1541,20621,93.0,131,34,26.0
1,All Students,2021-22,17469,1708,15761,90.2,104,45,43.3
1,All Students,2022-23,19424,2019,17405,89.6,119,47,39.5
2,All Students,2018-19,23034,1370,21664,94.1,134,28,20.9
2,All Students,2019-20,14144,857,13287,93.9,126,23,18.3
2,All Students,2020-21,22853,1459,21394,93.6,137,28,20.4
2,All Students,2021-22,20111,1931,18180,90.4,119,44,37.0
2,All Students,2022-23,18400,1660,16740,91.0,109,40,36.7
3,All Students,2018-19,23334,1486,21848,93.6,136,29,21.3
3,All Students,2019-20,14996,909,14087,93.9,134,28,20.9
3,All Students,2020-21,19140,1023,18117,94.7,114,24,21.1
3,All Students,2021-22,20819,1607,19212,92.3,124,39,31.5
3,All Students,2022-23,21078,1651,19427,92.2,124,38,30.6
4,All Students,2018-19,26194,1572,24622,94.0,154,36,23.4
4,All Students,2019-20,15048,804,14244,94.7,134,24,17.9
4,All Students,2020-21,22308,1195,21113,94.6,130,24,18.5
4,All Students,2021-22,19135,1631,17504,91.5,116,36,31.0
4,All Students,2022-23,22600,1836,20764,91.9,133,40,30.1
5,All Students,2018-19,24898,1214,23684,95.1,144,19,13.2
5,All Students,2019-20,16638,874,15764,94.7,147,22,15.0
5,All Students,2020-21,21311,1202,20109,94.4,125,25,20.0
5,All Students,2021-22,20569,1932,18637,90.6,119,44,37.0
5,All Students,2022-23,20868,1636,19232,92.2,125,41,32.8
All Grades,All Students,2018-19,132149,9452,122697,92.8,796,206,25.9
All Grades,All Students,2019-20,87400,6157,81243,93.0,787,188,23.9
All Grades,All Students,2020-21,121821,10409,111412,91.5,734,229,31.2
All Grades,All Students,2021-22,119101,12640,106461,89.4,739,320,43.3
All Grades,All Students,2022-23,124103,12199,111904,90.2,783,313,40.0
PK in K-12 Schools,All Students,2018-19,13453,1724,11729,87.2,84,42,50.0
PK in K-12 Schools,All Students,2019-20,9089,979,8110,89.2,83,32,38.6
PK in K-12 Schools,All Students,2020-21,12756,1347,11409,89.4,80,30,37.5
PK in K-12 Schools,All Students,2021-22,12145,1928,10217,84.1,82,57,69.5
PK in K-12 Schools,All Students,2022-23,9643,1546,8097,84.0,65,35,53.8
0K,All Students,2018-19,21024,1826,19198,91.3,131,40,30.5
0K,All Students,2019-20,14654,1144,13510,92.2,130,36,27.7
0K,All Students,2020-21,16819,2003,14816,88.1,103,49,47.6
0K,All Students,2021-22,20142,2263,17879,88.8,122,59,48.4
0K,All Students,2022-23,20078,2620,17458,87.0,128,72,56.3
1,All Students,2018-19,19936,1383,18553,93.1,119,29,24.4
1,All Students,2019-20,13209,1037,12172,92.1,122,41,33.6
1,All Students,2020-21,20491,1800,18691,91.2,124,37,29.8
1,All Students,2021-22,16928,1844,15084,89.1,103,47,45.6
1,All Students,2022-23,20723,1753,18970,91.5,128,46,35.9
2,All Students,2018-19,19190,1167,18023,93.9,114,25,21.9
2,All Students,2019-20,12432,733,11699,94.1,111,17,15.3
2,All Students,2020-21,18896,2016,16880,89.3,115,42,36.5
2,All Students,2021-22,19187,1891,17296,90.1,117,43,36.8
2,All Students,2022-23,16866,1581,15285,90.6,110,51,46.4
3,All Students,2018-19,19808,1198,18610,94.0,119,28,23.5
3,All Students,2019-20,12957,855,12102,93.4,115,24,20.9
3,All Students,2020-21,16781,1154,15627,93.1,99,26,26.3
3,All Students,2021-22,17887,1621,16266,90.9,112,39,34.8
3,All Students,2022-23,20618,1772,18846,91.4,128,41,32.0
4,All Students,2018-19,20140,1120,19020,94.4,122,24,19.7
4,All Students,2019-20,12796,655,12141,94.9,117,19,16.2
4,All Students,2020-21,18093,1129,16964,93.8,107,25,23.4
4,All Students,2021-22,16511,1469,15042,91.1,103,37,35.9
4,All Students,2022-23,17935,1387,16548,92.3,111,35,31.5
5,All Students,2018-19,18598,1034,17564,94.4,107,18,16.8
5,All Students,2019-20,12263,754,11509,93.9,109,19,17.4
5,All Students,2020-21,17985,960,17025,94.7,106,20,18.9
5,All Students,2021-22,16301,1624,14677,90.0,100,38,38.0
5,All Students,2022-23,18240,1540,16700,91.6,113,33,29.2
All Grades,All Students,2018-19,177527,14415,163112,91.9,1077,337,31.3
All Grades,All Students,2019-20,115637,9432,106205,91.8,1063,310,29.2
All Grades,All Students,2020-21,166680,28359,138321,83.0,1006,522,51.9
All Grades,All Students,2021-22,158886,19942,138944,87.4,1017,513,50.4
All Grades,All Students,2022-23,174935,20497,154438,88.3,1075,510,47.4
PK in K-12 Schools,All Students,2018-19,8347,970,7377,88.4,52,25,48.1
PK in K-12 Schools,All Students,2019-20,5105,632,4473,87.6,50,25,50.0
PK in K-12 Schools,All Students,2020-21,5563,899,4664,83.8,35,16,45.7
PK in K-12 Schools,All Students,2021-22,5171,690,4481,86.7,37,19,51.4
PK in K-12 Schools,All Students,2022-23,3129,579,2550,81.5,18,14,77.8
0K,All Students,2018-19,17468,1727,15741,90.1,113,45,39.8
0K,All Students,2019-20,10741,1240,9501,88.5,103,43,41.7
0K,All Students,2020-21,14519,2004,12515,86.2,93,44,47.3
0K,All Students,2021-22,13927,2133,11794,84.7,92,62,67.4
0K,All Students,2022-23,13733,1903,11830,86.1,89,55,61.8
1,All Students,2018-19,15640,1173,14467,92.5,99,29,29.3
1,All Students,2019-20,11655,905,10750,92.2,106,32,30.2
1,All Students,2020-21,17080,2676,14404,84.3,104,52,50.0
1,All Students,2021-22,15260,1593,13667,89.6,97,39,40.2
1,All Students,2022-23,16134,2042,14092,87.3,99,50,50.5
2,All Students,2018-19,15481,1226,14255,92.1,96,30,31.3
2,All Students,2019-20,9341,684,8657,92.7,84,22,26.2
2,All Students,2020-21,17055,1523,15532,91.1,101,29,28.7
2,All Students,2021-22,17208,2170,15038,87.4,112,61,54.5
2,All Students,2022-23,17264,1893,15371,89.0,107,44,41.1
3,All Students,2018-19,17230,1374,15856,92.0,105,36,34.3
3,All Students,2019-20,9418,672,8746,92.9,86,21,24.4
3,All Students,2020-21,13925,1435,12490,89.7,81,26,32.1
3,All Students,2021-22,15737,1737,14000,89.0,102,53,52.0
3,All Students,2022-23,19450,2313,17137,88.1,123,62,50.4
4,All Students,2018-19,16977,1206,15771,92.9,99,25,25.3
4,All Students,2019-20,11878,876,11002,92.6,106,26,24.5
4,All Students,2020-21,15413,1986,13427,87.1,93,42,45.2
4,All Students,2021-22,12263,1158,11105,90.6,78,30,38.5
4,All Students,2022-23,16936,1675,15261,90.1,104,41,39.4
5,All Students,2018-19,19336,1403,17933,92.7,117,32,27.4
5,All Students,2019-20,11479,611,10868,94.7,105,14,13.3
5,All Students,2020-21,17187,2082,15105,87.9,100,45,45.0
5,All Students,2021-22,15402,1585,13817,89.7,96,40,41.7
5,All Students,2022-23,14224,1295,12929,90.9,90,37,41.1
6,All Students,2018-19,22204,1818,20386,91.8,134,46,34.3
6,All Students,2019-20,16090,1268,14822,92.1,149,47,31.5
6,All Students,2020-21,18695,4499,14196,75.9,117,82,70.1
6,All Students,2021-22,20170,2599,17571,87.1,125,59,47.2
6,All Students,2022-23,23065,2600,20465,88.7,140,67,47.9
7,All Students,2018-19,23043,1789,21254,92.2,135,33,24.4
7,All Students,2019-20,14932,1177,13755,92.1,137,41,29.9
7,All Students,2020-21,24263,6231,18032,74.3,147,106,72.1
7,All Students,2021-22,20642,2549,18093,87.7,136,65,47.8
7,All Students,2022-23,23229,2536,20693,89.1,135,51,37.8
8,All Students,2018-19,21801,1729,20072,92.1,127,36,28.3
8,All Students,2019-20,14998,1367,13631,90.9,137,39,28.5
8,All Students,2020-21,22980,5024,17956,78.1,135,80,59.3
8,All Students,2021-22,23106,3728,19378,83.9,142,85,59.9
8,All Students,2022-23,27771,3661,24110,86.8,170,89,52.4
All Grades,All Students,2018-19,181840,10259,171581,94.4,1053,196,18.6
All Grades,All Students,2019-20,117862,6884,110978,94.2,1051,201,19.1
All Grades,All Students,2020-21,163874,15745,148129,90.4,963,319,33.1
All Grades,All Students,2021-22,159486,16288,143198,89.8,949,356,37.5
All Grades,All Students,2022-23,163639,14346,149293,91.2,976,326,33.4
PK in K-12 Schools,All Students,2018-19,9529,1052,8477,89.0,54,20,37.0
PK in K-12 Schools,All Students,2019-20,5877,597,5280,89.8,58,25,43.1
PK in K-12 Schools,All Students,2020-21,8545,s,s,s,s,s,s
PK in K-12 Schools,All Students,2021-22,8842,1659,7183,81.2,53,39,73.6
PK in K-12 Schools,All Students,2022-23,8438,1400,7038,83.4,56,40,71.4
0K,All Students,2018-19,17521,1301,16220,92.6,104,31,29.8
0K,All Students,2019-20,11592,958,10634,91.7,103,35,34.0
0K,All Students,2020-21,14958,1749,13209,88.3,91,40,44.0
0K,All Students,2021-22,15646,1916,13730,87.8,100,51,51.0
0K,All Students,2022-23,17832,2133,15699,88.0,108,56,51.9
1,All Students,2018-19,19462,1222,18240,93.7,115,22,19.1
1,All Students,2019-20,11246,717,10529,93.6,101,20,19.8
1,All Students,2020-21,16931,1454,15477,91.4,101,30,29.7
1,All Students,2021-22,14764,1628,13136,89.0,87,38,43.7
1,All Students,2022-23,15627,1510,14117,90.3,95,36,37.9
2,All Students,2018-19,18444,1061,17383,94.2,106,21,19.8
2,All Students,2019-20,12208,741,11467,93.9,108,18,16.7
2,All Students,2020-21,16024,1583,14441,90.1,96,29,30.2
2,All Students,2021-22,16289,1655,14634,89.8,100,37,37.0
2,All Students,2022-23,17440,1531,15909,91.2,102,36,35.3
3,All Students,2018-19,17700,810,16890,95.4,104,14,13.5
3,All Students,2019-20,12594,679,11915,94.6,111,21,18.9
3,All Students,2020-21,17786,1465,16321,91.8,103,33,32.0
3,All Students,2021-22,15981,1419,14562,91.1,94,31,33.0
3,All Students,2022-23,15548,1022,14526,93.4,92,24,26.1
4,All Students,2018-19,21277,1008,20269,95.3,124,18,14.5
4,All Students,2019-20,11892,524,11368,95.6,106,13,12.3
4,All Students,2020-21,18127,1363,16764,92.5,106,32,30.2
4,All Students,2021-22,17175,1633,15542,90.5,100,33,33.0
4,All Students,2022-23,16998,1283,15715,92.5,100,21,21.0
5,All Students,2018-19,18951,963,17988,94.9,111,20,18.0
5,All Students,2019-20,13971,751,13220,94.6,124,19,15.3
5,All Students,2020-21,18041,1437,16604,92.0,104,28,26.9
5,All Students,2021-22,17767,1455,16312,91.8,103,29,28.2
5,All Students,2022-23,18817,1391,17426,92.6,111,27,24.3
6,All Students,2018-19,18196,860,17336,95.3,103,12,11.7
6,All Students,2019-20,11650,609,11041,94.8,104,16,15.4
6,All Students,2020-21,17671,2609,15062,85.2,102,47,46.1
6,All Students,2021-22,16959,1343,15616,92.1,100,25,25.0
6,All Students,2022-23,17855,1243,16612,93.0,104,24,23.1
7,All Students,2018-19,22446,890,21556,96.0,129,16,12.4
7,All Students,2019-20,11543,465,11078,96.0,102,11,10.8
7,All Students,2020-21,18094,2083,16011,88.5,107,45,42.1
7,All Students,2021-22,17759,1652,16107,90.7,106,39,36.8
7,All Students,2022-23,17204,1142,16062,93.4,104,21,20.2
8,All Students,2018-19,18314,1092,17222,94.0,103,22,21.4
8,All Students,2019-20,15289,843,14446,94.5,134,23,17.2
8,All Students,2020-21,17689,1175,16514,93.4,102,20,19.6
8,All Students,2021-22,18304,1928,16376,89.5,106,34,32.1
8,All Students,2022-23,17880,1691,16189,90.5,104,41,39.4
9,All Students,2020-21,8,s,s,s,s,s,s
All Grades,All Students,2018-19,251618,13480,238138,94.6,1447,231,16.0
All Grades,All Students,2019-20,172294,8979,163315,94.8,1525,235,15.4
All Grades,All Students,2020-21,277970,26481,251489,90.5,1610,455,28.3
All Grades,All Students,2021-22,272877,22937,249940,91.6,1570,461,29.4
All Grades,All Students,2022-23,273136,20567,252569,92.5,1577,441,28.0
6,All Students,2018-19,90513,4696,85817,94.8,526,83,15.8
6,All Students,2019-20,57627,2952,54675,94.9,508,74,14.6
6,All Students,2020-21,104693,8993,95700,91.4,607,154,25.4
6,All Students,2021-22,98746,7741,91005,92.2,570,156,27.4
6,All Students,2022-23,84985,6672,78313,92.1,492,155,31.5
7,All Students,2018-19,85701,4439,81262,94.8,490,68,13.9
7,All Students,2019-20,59248,3058,56190,94.8,525,79,15.0
7,All Students,2020-21,84495,7332,77163,91.3,489,131,26.8
7,All Students,2021-22,95282,8122,87160,91.5,550,162,29.5
7,All Students,2022-23,96313,6721,89592,93.0,555,143,25.8
8,All Students,2018-19,75404,4345,71059,94.2,431,80,18.6
8,All Students,2019-20,55419,2969,52450,94.6,492,82,16.7
8,All Students,2020-21,88782,10156,78626,88.6,514,170,33.1
8,All Students,2021-22,78849,7074,71775,91.0,450,143,31.8
8,All Students,2022-23,91838,7174,84664,92.2,530,143,27.0
All Grades,All Students,2018-19,109278,8498,100780,92.2,642,180,28.0
All Grades,All Students,2019-20,70363,4833,65530,93.1,644,158,24.5
All Grades,All Students,2020-21,106083,8432,97651,92.1,631,174,27.6
All Grades,All Students,2021-22,102160,10882,91278,89.3,612,265,43.3
All Grades,All Students,2022-23,107628,11392,96236,89.4,662,268,40.5
PK in K-12 Schools,All Students,2018-19,12927,1763,11164,86.4,79,42,53.2
PK in K-12 Schools,All Students,2019-20,7412,731,6681,90.1,72,32,44.4
PK in K-12 Schools,All Students,2020-21,9574,916,8658,90.4,60,22,36.7
PK in K-12 Schools,All Students,2021-22,8722,1076,7646,87.7,54,30,55.6
PK in K-12 Schools,All Students,2022-23,8296,1261,7035,84.8,56,36,64.3
0K,All Students,2018-19,9880,977,8903,90.1,62,20,32.3
0K,All Students,2019-20,8383,776,7607,90.7,78,29,37.2
0K,All Students,2020-21,12538,1053,11485,91.6,75,20,26.7
0K,All Students,2021-22,12200,1408,10792,88.5,74,36,48.6
0K,All Students,2022-23,11590,1339,10251,88.4,72,34,47.2
1,All Students,2018-19,13489,923,12566,93.2,78,21,26.9
1,All Students,2019-20,6456,460,5996,92.9,61,16,26.2
1,All Students,2020-21,11758,981,10777,91.7,70,24,34.3
1,All Students,2021-22,11798,1227,10571,89.6,71,33,46.5
1,All Students,2022-23,13004,1237,11767,90.5,78,28,35.9
2,All Students,2018-19,9742,511,9231,94.8,60,10,16.7
2,All Students,2019-20,8719,530,8189,93.9,77,12,15.6
2,All Students,2020-21,9086,653,8433,92.8,55,16,29.1
2,All Students,2021-22,11249,1139,10110,89.9,65,30,46.2
2,All Students,2022-23,12039,1184,10855,90.2,73,26,35.6
3,All Students,2018-19,12746,790,11956,93.8,73,16,21.9
3,All Students,2019-20,6372,316,6056,95.0,57,9,15.8
3,All Students,2020-21,13004,1209,11795,90.7,76,22,28.9
3,All Students,2021-22,9631,923,8708,90.4,58,20,34.5
3,All Students,2022-23,10570,1043,9527,90.1,67,33,49.3
4,All Students,2018-19,8488,s,s,s,s,s,s
4,All Students,2019-20,7972,490,7482,93.9,72,17,23.6
4,All Students,2020-21,9483,327,9156,96.6,56,7,12.5
4,All Students,2021-22,11367,939,10428,91.7,71,25,35.2
4,All Students,2022-23,9742,752,8990,92.3,59,17,28.8
5,All Students,2018-19,9998,540,9458,94.6,58,7,12.1
5,All Students,2019-20,5801,322,5479,94.4,53,6,11.3
5,All Students,2020-21,11564,875,10689,92.4,67,12,17.9
5,All Students,2021-22,8689,704,7985,91.9,50,17,34.0
5,All Students,2022-23,12166,1103,11063,90.9,73,26,35.6
6,All Students,2018-19,11244,858,10386,92.4,66,21,31.8
6,All Students,2019-20,5961,284,5677,95.2,53,7,13.2
6,All Students,2020-21,8880,742,8138,91.6,53,16,30.2
6,All Students,2021-22,9063,1049,8014,88.4,53,22,41.5
6,All Students,2022-23,9259,810,8449,91.3,57,19,33.3
7,All Students,2018-19,10070,636,9434,93.7,58,14,24.1
7,All Students,2019-20,7005,458,6547,93.5,63,15,23.8
7,All Students,2020-21,8686,387,8299,95.5,52,6,11.5
7,All Students,2021-22,10346,1548,8798,85.0,64,33,51.6
7,All Students,2022-23,9451,960,8491,89.8,59,21,35.6
8,All Students,2018-19,10662,797,9865,92.5,60,15,25.0
8,All Students,2019-20,6282,466,5816,92.6,58,15,25.9
8,All Students,2020-21,11510,1289,10221,88.8,67,29,43.3
8,All Students,2021-22,9095,869,8226,90.4,52,19,36.5
8,All Students,2022-23,11511,1703,9808,85.2,68,28,41.2
9,All Students,2018-19,32,s,s,s,s,s,s
All Grades,All Students,2018-19,236793,9102,227691,96.2,1341,105,7.8
All Grades,All Students,2019-20,154671,5740,148931,96.3,1351,106,7.8
All Grades,All Students,2020-21,230763,9320,221443,96.0,1337,134,10.0
All Grades,All Students,2021-22,218720,12108,206612,94.5,1253,187,14.9
All Grades,All Students,2022-23,211705,13400,198305,93.7,1206,236,19.6
6,All Students,2018-19,84835,3076,81759,96.4,483,35,7.2
6,All Students,2019-20,53913,1934,51979,96.4,471,31,6.6
6,All Students,2020-21,79480,2680,76800,96.6,460,38,8.3
6,All Students,2021-22,71712,4341,67371,93.9,413,75,18.2
6,All Students,2022-23,74989,4613,70376,93.8,430,78,18.1
7,All Students,2018-19,78135,2213,75922,97.2,441,20,4.5
7,All Students,2019-20,51869,1590,50279,96.9,453,25,5.5
7,All Students,2020-21,75997,2608,73389,96.6,440,32,7.3
7,All Students,2021-22,72548,3207,69341,95.6,417,39,9.4
7,All Students,2022-23,67349,4015,63334,94.0,383,68,17.8
8,All Students,2018-19,73823,3813,70010,94.8,417,50,12.0
8,All Students,2019-20,48889,2216,46673,95.5,427,50,11.7
8,All Students,2020-21,75286,4032,71254,94.6,437,64,14.6
8,All Students,2021-22,74460,4560,69900,93.9,423,73,17.3
8,All Students,2022-23,69367,4772,64595,93.1,393,90,22.9
All Grades,All Students,2018-19,168235,10004,158231,94.1,991,178,18.0
All Grades,All Students,2019-20,108250,5592,102658,94.8,975,132,13.5
All Grades,All Students,2020-21,150314,14058,136256,90.6,897,301,33.6
All Grades,All Students,2021-22,146787,14020,132767,90.4,888,329,37.0
All Grades,All Students,2022-23,159578,13786,145792,91.4,969,325,33.5
PK in K-12 Schools,All Students,2018-19,6230,681,5549,89.1,40,13,32.5
PK in K-12 Schools,All Students,2019-20,4081,438,3643,89.3,36,16,44.4
0K,All Students,2018-19,27423,1889,25534,93.1,166,33,19.9
0K,All Students,2019-20,17671,1340,16331,92.4,160,37,23.1
0K,All Students,2020-21,24027,3225,20802,86.6,147,69,46.9
0K,All Students,2021-22,25342,2727,22615,89.2,160,72,45.0
0K,All Students,2022-23,27853,2880,24973,89.7,167,68,40.7
1,All Students,2018-19,27664,1553,26111,94.4,164,27,16.5
1,All Students,2019-20,17402,833,16569,95.2,161,16,9.9
1,All Students,2020-21,25947,2669,23278,89.7,157,59,37.6
1,All Students,2021-22,24819,2691,22128,89.2,146,57,39.0
1,All Students,2022-23,29302,2610,26692,91.1,180,69,38.3
2,All Students,2018-19,28050,1500,26550,94.7,165,27,16.4
2,All Students,2019-20,17907,830,17077,95.4,160,20,12.5
2,All Students,2020-21,25092,2524,22568,89.9,149,55,36.9
2,All Students,2021-22,23368,2382,20986,89.8,143,56,39.2
2,All Students,2022-23,26545,2483,24062,90.6,164,59,36.0
3,All Students,2018-19,24515,1459,23056,94.0,145,27,18.6
3,All Students,2019-20,16715,650,16065,96.1,150,11,7.3
3,All Students,2020-21,26827,2009,24818,92.5,159,43,27.0
3,All Students,2021-22,23431,2107,21324,91.0,141,49,34.8
3,All Students,2022-23,24435,1854,22581,92.4,150,40,26.7
4,All Students,2018-19,28479,1548,26931,94.6,163,29,17.8
4,All Students,2019-20,15834,725,15109,95.4,144,18,12.5
4,All Students,2020-21,24409,1776,22633,92.7,144,32,22.2
4,All Students,2021-22,25542,1991,23551,92.2,157,44,28.0
4,All Students,2022-23,23683,s,s,s,s,s,s
5,All Students,2018-19,25874,1374,24500,94.7,148,22,14.9
5,All Students,2019-20,18640,776,17864,95.8,164,14,8.5
5,All Students,2020-21,24012,1855,22157,92.3,141,43,30.5
5,All Students,2021-22,24285,2122,22163,91.3,141,51,36.2
5,All Students,2022-23,27730,2176,25554,92.2,164,51,31.1
6,All Students,2022-23,30,s,s,s,s,s,s
All Grades,All Students,2018-19,241085,14182,226903,94.1,1413,258,18.3
All Grades,All Students,2019-20,145078,7379,137699,94.9,1295,186,14.4
All Grades,All Students,2020-21,208206,23782,184424,88.6,1217,413,33.9
All Grades,All Students,2021-22,207409,15066,192343,92.7,1245,314,25.2
All Grades,All Students,2022-23,214314,15014,199300,93.0,1299,294,22.6
6,All Students,2018-19,73547,3816,69731,94.8,436,70,16.1
6,All Students,2019-20,46859,2541,44318,94.6,417,63,15.1
6,All Students,2020-21,65993,7027,58966,89.4,384,130,33.9
6,All Students,2021-22,70075,4861,65214,93.1,426,108,25.4
6,All Students,2022-23,67017,4168,62849,93.8,414,88,21.3
7,All Students,2018-19,78869,4289,74580,94.6,461,75,16.3
7,All Students,2019-20,47691,2081,45610,95.6,431,59,13.7
7,All Students,2020-21,70779,8014,62765,88.7,418,142,34.0
7,All Students,2021-22,65717,4590,61127,93.0,394,99,25.1
7,All Students,2022-23,74310,5637,68673,92.4,455,104,22.9
8,All Students,2018-19,88669,6077,82592,93.1,516,113,21.9
8,All Students,2019-20,50528,2757,47771,94.5,447,64,14.3
8,All Students,2020-21,71434,8741,62693,87.8,415,141,34.0
8,All Students,2021-22,71617,5615,66002,92.2,425,107,25.2
8,All Students,2022-23,72987,5209,67778,92.9,430,102,23.7
All Grades,All Students,2018-19,109650,13333,96317,87.8,661,329,49.8
All Grades,All Students,2019-20,66597,7284,59313,89.1,625,271,43.4
All Grades,All Students,2020-21,95616,13870,81746,85.5,567,282,49.7
All Grades,All Students,2021-22,96024,19085,76939,80.1,596,398,66.8
All Grades,All Students,2022-23,91047,13068,77979,85.6,558,309,55.4
PK in K-12 Schools,All Students,2018-19,5481,868,4613,84.2,36,25,69.4
PK in K-12 Schools,All Students,2019-20,3268,455,2813,86.1,33,19,57.6
PK in K-12 Schools,All Students,2020-21,3232,s,s,s,s,s,s
PK in K-12 Schools,All Students,2021-22,4052,1044,3008,74.2,28,19,67.9
PK in K-12 Schools,All Students,2022-23,2683,647,2036,75.9,20,17,85.0
0K,All Students,2018-19,11994,1849,10145,84.6,73,45,61.6
0K,All Students,2019-20,7321,890,6431,87.8,69,34,49.3
0K,All Students,2020-21,9505,1749,7756,81.6,60,41,68.3
0K,All Students,2021-22,8282,1760,6522,78.7,51,41,80.4
0K,All Students,2022-23,8431,1622,6809,80.8,54,42,77.8
1,All Students,2018-19,11650,1347,10303,88.4,68,34,50.0
1,All Students,2019-20,7166,795,6371,88.9,65,26,40.0
1,All Students,2020-21,9957,1386,8571,86.1,58,26,44.8
1,All Students,2021-22,10658,2316,8342,78.3,70,52,74.3
1,All Students,2022-23,8497,1223,7274,85.6,55,36,65.5
2,All Students,2018-19,10728,1395,9333,87.0,70,36,51.4
2,All Students,2019-20,7440,799,6641,89.3,69,33,47.8
2,All Students,2020-21,10191,1182,9009,88.4,64,27,42.2
2,All Students,2021-22,10714,1736,8978,83.8,66,42,63.6
2,All Students,2022-23,10921,1750,9171,84.0,64,36,56.3
3,All Students,2018-19,13219,1499,11720,88.7,81,38,46.9
3,All Students,2019-20,6428,824,5604,87.2,61,27,44.3
3,All Students,2020-21,10489,1141,9348,89.1,62,24,38.7
3,All Students,2021-22,11440,2263,9177,80.2,72,52,72.2
3,All Students,2022-23,10197,1399,8798,86.3,64,34,53.1
4,All Students,2018-19,14536,1899,12637,86.9,87,52,59.8
4,All Students,2019-20,8086,801,7285,90.1,73,33,45.2
4,All Students,2020-21,10349,1782,8567,82.8,60,32,53.3
4,All Students,2021-22,10015,1793,8222,82.1,63,40,63.5
4,All Students,2022-23,10507,1583,8924,84.9,64,37,57.8
5,All Students,2018-19,11960,1151,10809,90.4,72,25,34.7
5,All Students,2019-20,7881,784,7097,90.1,75,28,37.3
5,All Students,2020-21,11285,1533,9752,86.4,66,30,45.5
5,All Students,2021-22,10168,1934,8234,81.0,63,37,58.7
5,All Students,2022-23,8552,1028,7524,88.0,53,28,52.8
6,All Students,2018-19,10854,1228,9626,88.7,61,24,39.3
6,All Students,2019-20,6904,797,6107,88.5,65,30,46.2
6,All Students,2020-21,11443,1863,9580,83.7,67,39,58.2
6,All Students,2021-22,10115,1582,8533,84.4,59,36,61.0
6,All Students,2022-23,10543,1220,9323,88.4,61,25,41.0
7,All Students,2018-19,8639,984,7655,88.6,51,23,45.1
7,All Students,2019-20,6770,672,6098,90.1,64,23,35.9
7,All Students,2020-21,9902,1699,8203,82.8,57,35,61.4
7,All Students,2021-22,10773,2429,8344,77.5,64,42,65.6
7,All Students,2022-23,9178,806,8372,91.2,55,19,34.5
8,All Students,2018-19,10589,1113,9476,89.5,62,27,43.5
8,All Students,2019-20,5333,467,4866,91.2,51,18,35.3
8,All Students,2020-21,9222,1327,7895,85.6,53,26,49.1
8,All Students,2021-22,9807,2228,7579,77.3,60,37,61.7
8,All Students,2022-23,11538,1790,9748,84.5,68,35,51.5
9,All Students,2020-21,41,s,s,s,s,s,s
All Grades,All Students,2018-19,101572,7767,93805,92.4,594,159,26.8
All Grades,All Students,2019-20,66193,4851,61342,92.7,604,138,22.8
All Grades,All Students,2020-21,92245,11610,80635,87.4,542,243,44.8
All Grades,All Students,2021-22,75833,8881,66952,88.3,474,189,39.9
All Grades,All Students,2022-23,74917,6615,68302,91.2,466,122,26.2
6,All Students,2018-19,35733,2655,33078,92.6,210,50,23.8
6,All Students,2019-20,21050,1541,19509,92.7,192,45,23.4
6,All Students,2020-21,27329,3710,23619,86.4,162,76,46.9
6,All Students,2021-22,16559,s,s,s,s,s,s
6,All Students,2022-23,20502,1826,18676,91.1,131,36,27.5
7,All Students,2018-19,31492,2210,29282,93.0,187,50,26.7
7,All Students,2019-20,23959,1649,22310,93.1,220,41,18.6
7,All Students,2020-21,30355,3905,26450,87.1,179,89,49.7
7,All Students,2021-22,27980,3135,24845,88.8,174,67,38.5
7,All Students,2022-23,21670,1872,19798,91.4,135,38,28.1
8,All Students,2018-19,34347,2902,31445,91.6,197,59,29.9
8,All Students,2019-20,21184,1661,19523,92.2,192,52,27.1
8,All Students,2020-21,34561,3995,30566,88.4,201,78,38.8
8,All Students,2021-22,31282,3889,27393,87.6,193,87,45.1
8,All Students,2022-23,32745,2917,29828,91.1,200,48,24.0
9,All Students,2021-22,12,s,s,s,s,s,s
All Grades,All Students,2018-19,69575,7732,61843,88.9,427,210,49.2
All Grades,All Students,2019-20,43980,4723,39257,89.3,403,193,47.9
All Grades,All Students,2020-21,62242,10931,51311,82.4,375,199,53.1
All Grades,All Students,2021-22,59154,10514,48640,82.2,372,241,64.8
All Grades,All Students,2022-23,57855,8995,48860,84.5,364,208,57.1
PK in K-12 Schools,All Students,2018-19,4844,682,4162,85.9,33,17,51.5
PK in K-12 Schools,All Students,2019-20,4441,706,3735,84.1,42,31,73.8
PK in K-12 Schools,All Students,2020-21,4720,734,3986,84.4,30,16,53.3
PK in K-12 Schools,All Students,2021-22,6364,1754,4610,72.4,44,36,81.8
PK in K-12 Schools,All Students,2022-23,8444,1858,6586,78.0,57,44,77.2
0K,All Students,2018-19,12408,1644,10764,86.8,79,52,65.8
0K,All Students,2019-20,5933,820,5113,86.2,54,34,63.0
0K,All Students,2020-21,10315,1864,8451,81.9,63,35,55.6
0K,All Students,2021-22,9404,1482,7922,84.2,59,35,59.3
0K,All Students,2022-23,7699,1328,6371,82.8,47,31,66.0
1,All Students,2018-19,10076,1276,8800,87.3,62,31,50.0
1,All Students,2019-20,7585,847,6738,88.8,70,39,55.7
1,All Students,2020-21,9248,2059,7189,77.7,53,35,66.0
1,All Students,2021-22,9700,1849,7851,80.9,61,42,68.9
1,All Students,2022-23,9497,1381,8116,85.5,60,28,46.7
2,All Students,2018-19,10009,1037,8972,89.6,60,25,41.7
2,All Students,2019-20,6531,712,5819,89.1,59,28,47.5
2,All Students,2020-21,11438,1813,9625,84.1,71,36,50.7
2,All Students,2021-22,8189,1583,6606,80.7,50,33,66.0
2,All Students,2022-23,8766,1371,7395,84.4,54,33,61.1
3,All Students,2018-19,8108,644,7464,92.1,49,19,38.8
3,All Students,2019-20,6576,629,5947,90.4,61,22,36.1
3,All Students,2020-21,9739,1381,8358,85.8,58,26,44.8
3,All Students,2021-22,8804,1582,7222,82.0,56,40,71.4
3,All Students,2022-23,6910,1050,5860,84.8,45,25,55.6
4,All Students,2018-19,11991,1148,10843,90.4,73,33,45.2
4,All Students,2019-20,5369,385,4984,92.8,49,16,32.7
4,All Students,2020-21,9748,2152,7596,77.9,58,33,56.9
4,All Students,2021-22,8347,1319,7028,84.2,52,34,65.4
4,All Students,2022-23,9249,1295,7954,86.0,56,30,53.6
5,All Students,2018-19,12139,1301,10838,89.3,71,33,46.5
5,All Students,2019-20,7545,624,6921,91.7,68,23,33.8
5,All Students,2020-21,7034,928,6106,86.8,42,18,42.9
5,All Students,2021-22,8346,945,7401,88.7,50,21,42.0
5,All Students,2022-23,7290,712,6578,90.2,45,17,37.8
All Grades,All Students,2018-19,56727,7087,49640,87.5,361,112,31.0
All Grades,All Students,2019-20,40046,6201,33845,84.5,361,123,34.1
All Grades,All Students,2020-21,53212,10963,42249,79.4,313,144,46.0
All Grades,All Students,2021-22,57822,11037,46785,80.9,332,129,38.9
All Grades,All Students,2022-23,56208,9963,46245,82.3,351,147,41.9
9,All Students,2018-19,17071,1445,15626,91.5,120,29,24.2
9,All Students,2019-20,13415,1583,11832,88.2,124,39,31.5
9,All Students,2020-21,12900,3045,9855,76.4,86,47,54.7
9,All Students,2021-22,18286,2320,15966,87.3,113,33,29.2
9,All Students,2022-23,21120,2747,18373,87.0,137,50,36.5
10,All Students,2018-19,12526,897,11629,92.8,79,12,15.2
10,All Students,2019-20,7660,619,7041,91.9,70,13,18.6
10,All Students,2020-21,10766,2103,8663,80.5,61,30,49.2
10,All Students,2021-22,11438,1972,9466,82.8,69,24,34.8
10,All Students,2022-23,11292,1337,9955,88.2,71,28,39.4
11,All Students,2018-19,13912,1671,12241,88.0,85,33,38.8
11,All Students,2019-20,8674,1152,7522,86.7,77,20,26.0
11,All Students,2020-21,16040,3284,12756,79.5,92,39,42.4
11,All Students,2021-22,13077,3083,9994,76.4,70,34,48.6
11,All Students,2022-23,10792,2184,8608,79.8,65,27,41.5
12,All Students,2018-19,13218,3074,10144,76.7,77,38,49.4
12,All Students,2019-20,10297,2847,7450,72.4,90,51,56.7
12,All Students,2020-21,13506,2531,10975,81.3,74,28,37.8
12,All Students,2021-22,15021,3662,11359,75.6,80,38,47.5
12,All Students,2022-23,13004,3695,9309,71.6,78,42,53.8
All Grades,All Students,2018-19,101102,14137,86965,86.0,648,288,44.4
All Grades,All Students,2019-20,67760,9510,58250,86.0,634,293,46.2
All Grades,All Students,2020-21,100757,13310,87447,86.8,599,203,33.9
All Grades,All Students,2021-22,99833,16363,83470,83.6,620,323,52.1
All Grades,All Students,2022-23,98197,13425,84772,86.3,621,258,41.5
9,All Students,2018-19,29193,4600,24593,84.2,184,75,40.8
9,All Students,2019-20,18309,2193,16116,88.0,170,60,35.3
9,All Students,2020-21,24082,3019,21063,87.5,145,41,28.3
9,All Students,2021-22,25965,2973,22992,88.5,160,64,40.0
9,All Students,2022-23,27012,2701,24311,90.0,178,59,33.1
10,All Students,2018-19,26127,3898,22229,85.1,171,83,48.5
10,All Students,2019-20,18156,2732,15424,85.0,173,88,50.9
10,All Students,2020-21,29151,3870,25281,86.7,172,54,31.4
10,All Students,2021-22,23628,4650,18978,80.3,154,86,55.8
10,All Students,2022-23,24056,3198,20858,86.7,150,55,36.7
11,All Students,2018-19,24070,2492,21578,89.6,155,60,38.7
11,All Students,2019-20,15754,2365,13389,85.0,148,82,55.4
11,All Students,2020-21,25540,3761,21779,85.3,154,55,35.7
11,All Students,2021-22,26767,4405,22362,83.5,161,89,55.3
11,All Students,2022-23,22697,3243,19454,85.7,141,59,41.8
12,All Students,2018-19,21712,3147,18565,85.5,138,70,50.7
12,All Students,2019-20,15541,2220,13321,85.7,143,63,44.1
12,All Students,2020-21,21984,2660,19324,87.9,128,53,41.4
12,All Students,2021-22,23473,4335,19138,81.5,145,84,57.9
12,All Students,2022-23,24432,4283,20149,82.5,152,85,55.9
All Grades,All Students,2018-19,40099,10098,30001,74.8,260,158,60.8
All Grades,All Students,2019-20,29504,6556,22948,77.8,284,160,56.3
All Grades,All Students,2020-21,47182,14464,32718,69.3,286,203,71.0
All Grades,All Students,2021-22,51736,10191,41545,80.3,352,206,58.5
All Grades,All Students,2022-23,55310,10559,44751,80.9,376,184,48.9
8,All Students,2020-21,3,s,s,s,s,s,s
9,All Students,2018-19,7765,1522,6243,80.4,57,29,50.9
9,All Students,2019-20,8084,1147,6937,85.8,81,45,55.6
9,All Students,2020-21,10395,2626,7769,74.7,66,45,68.2
9,All Students,2021-22,20321,3249,17072,84.0,144,74,51.4
9,All Students,2022-23,11912,1631,10281,86.3,90,40,44.4
10,All Students,2018-19,11852,2685,9167,77.3,75,43,57.3
10,All Students,2019-20,5942,1105,4837,81.4,58,30,51.7
10,All Students,2020-21,13977,3694,10283,73.6,85,60,70.6
10,All Students,2021-22,10675,1826,8849,82.9,75,44,58.7
10,All Students,2022-23,20205,4180,16025,79.3,136,60,44.1
11,All Students,2018-19,12109,3233,8876,73.3,75,42,56.0
11,All Students,2019-20,7822,1706,6116,78.2,75,36,48.0
11,All Students,2020-21,8846,s,s,s,s,s,s
11,All Students,2021-22,13786,3547,10239,74.3,87,59,67.8
11,All Students,2022-23,10663,1995,8668,81.3,73,38,52.1
12,All Students,2018-19,8373,2658,5715,68.3,53,44,83.0
12,All Students,2019-20,7656,2598,5058,66.1,70,49,70.0
12,All Students,2020-21,13961,4952,9009,64.5,82,62,75.6
12,All Students,2021-22,6954,1569,5385,77.4,46,29,63.0
12,All Students,2022-23,12530,2753,9777,78.0,77,46,59.7
All Grades,All Students,2018-19,307867,40573,267294,86.8,1961,738,37.6
All Grades,All Students,2019-20,198218,26278,171940,86.7,1888,708,37.5
All Grades,All Students,2020-21,308704,43110,265594,86.0,1852,682,36.8
All Grades,All Students,2021-22,327251,59432,267819,81.8,2093,1134,54.2
All Grades,All Students,2022-23,335373,66520,268853,80.2,2221,1338,60.2
8,All Students,2020-21,7,s,s,s,s,s,s
9,All Students,2018-19,93811,14608,79203,84.4,595,232,39.0
9,All Students,2019-20,64258,8546,55712,86.7,607,209,34.4
9,All Students,2020-21,92326,14602,77724,84.2,547,201,36.7
9,All Students,2021-22,114183,17196,96987,84.9,730,326,44.7
9,All Students,2022-23,104047,18205,85842,82.5,690,353,51.2
10,All Students,2018-19,78610,9992,68618,87.3,509,196,38.5
10,All Students,2019-20,51862,7693,44169,85.2,503,200,39.8
10,All Students,2020-21,94339,13438,80901,85.8,560,228,40.7
10,All Students,2021-22,78735,14385,64350,81.7,508,269,53.0
10,All Students,2022-23,104796,20176,84620,80.7,685,400,58.4
11,All Students,2018-19,71025,9300,61725,86.9,458,183,40.0
11,All Students,2019-20,41836,4616,37220,89.0,396,134,33.8
11,All Students,2020-21,63053,7600,55453,87.9,374,119,31.8
11,All Students,2021-22,73058,14734,58324,79.8,465,282,60.6
11,All Students,2022-23,64702,13049,51653,79.8,432,275,63.7
12,All Students,2018-19,64421,6673,57748,89.6,399,127,31.8
12,All Students,2019-20,40262,5423,34839,86.5,382,165,43.2
12,All Students,2020-21,58979,s,s,s,s,s,s
12,All Students,2021-22,61275,13117,48158,78.6,390,257,65.9
12,All Students,2022-23,61828,15090,46738,75.6,414,310,74.9
All Grades,All Students,2018-19,113921,7906,106015,93.1,674,158,23.4
All Grades,All Students,2019-20,78471,5430,73041,93.1,710,165,23.2
All Grades,All Students,2020-21,131582,11733,119849,91.1,757,222,29.3
All Grades,All Students,2021-22,127201,19377,107824,84.8,756,413,54.6
All Grades,All Students,2022-23,124139,14751,109388,88.1,750,307,40.9
5,All Students,2022-23,10,s,s,s,s,s,s
6,All Students,2018-19,19512,1376,18136,92.9,112,27,24.1
6,All Students,2019-20,12674,818,11856,93.5,113,24,21.2
6,All Students,2020-21,20228,2023,18205,90.0,118,44,37.3
6,All Students,2021-22,18736,2489,16247,86.7,110,57,51.8
6,All Students,2022-23,19562,1753,17809,91.0,115,43,37.4
7,All Students,2018-19,15491,1098,14393,92.9,89,22,24.7
7,All Students,2019-20,11768,870,10898,92.6,106,26,24.5
7,All Students,2020-21,19255,2023,17232,89.5,110,37,33.6
7,All Students,2021-22,18204,2406,15798,86.8,109,54,49.5
7,All Students,2022-23,17099,1767,15332,89.7,102,40,39.2
8,All Students,2018-19,15933,1043,14890,93.5,92,20,21.7
8,All Students,2019-20,9804,540,9264,94.5,86,15,17.4
8,All Students,2020-21,17810,1845,15965,89.6,102,41,40.2
8,All Students,2021-22,18255,2786,15469,84.7,106,58,54.7
8,All Students,2022-23,17452,1832,15620,89.5,102,41,40.2
9,All Students,2018-19,18770,1083,17687,94.2,115,21,18.3
9,All Students,2019-20,12260,811,11449,93.4,112,23,20.5
9,All Students,2020-21,19722,1442,18280,92.7,114,24,21.1
9,All Students,2021-22,18611,2475,16136,86.7,112,55,49.1
9,All Students,2022-23,19375,1976,17399,89.8,120,44,36.7
10,All Students,2018-19,15569,915,14654,94.1,94,17,18.1
10,All Students,2019-20,11947,699,11248,94.1,110,26,23.6
10,All Students,2020-21,18788,1431,17357,92.4,108,21,19.4
10,All Students,2021-22,17229,2431,14798,85.9,104,48,46.2
10,All Students,2022-23,17228,1906,15322,88.9,105,40,38.1
11,All Students,2018-19,14698,700,13998,95.2,88,11,12.5
11,All Students,2019-20,10083,498,9585,95.1,92,15,16.3
11,All Students,2020-21,19501,1507,17994,92.3,112,26,23.2
11,All Students,2021-22,17788,2838,14950,84.0,106,57,53.8
11,All Students,2022-23,16181,s,s,s,s,s,s
12,All Students,2018-19,13948,1691,12257,87.9,84,40,47.6
12,All Students,2019-20,9935,1194,8741,88.0,91,36,39.6
12,All Students,2020-21,16278,1462,14816,91.0,93,29,31.2
12,All Students,2021-22,18378,3952,14426,78.5,109,84,77.1
12,All Students,2022-23,17232,3350,13882,80.6,104,56,53.8
All Grades,All Students,2018-19,602479,51834,550645,91.4,3760,845,22.5
All Grades,All Students,2019-20,390112,28874,361238,92.6,3644,739,20.3
All Grades,All Students,2020-21,638014,88055,549959,86.2,3700,1099,29.7
All Grades,All Students,2021-22,612211,84745,527466,86.2,3762,1493,39.7
All Grades,All Students,2022-23,585436,64880,520556,88.9,3722,1165,31.3
9,All Students,2018-19,178168,18154,160014,89.8,1113,276,24.8
9,All Students,2019-20,112817,10416,102401,90.8,1067,250,23.4
9,All Students,2020-21,193922,31275,162647,83.9,1121,352,31.4
9,All Students,2021-22,179599,27714,151885,84.6,1107,451,40.7
9,All Students,2022-23,167022,22604,144418,86.5,1061,375,35.3
10,All Students,2018-19,162524,14981,147543,90.8,1042,253,24.3
10,All Students,2019-20,109357,8661,100696,92.1,1034,228,22.1
10,All Students,2020-21,181376,28359,153017,84.4,1059,342,32.3
10,All Students,2021-22,175014,25234,149780,85.6,1110,432,38.9
10,All Students,2022-23,156675,19137,137538,87.8,1033,345,33.4
11,All Students,2018-19,128386,6476,121910,95.0,788,103,13.1
11,All Students,2019-20,82579,4150,78429,95.0,766,107,14.0
11,All Students,2020-21,128645,10383,118262,91.9,741,129,17.4
11,All Students,2021-22,129697,13937,115760,89.3,780,237,30.4
11,All Students,2022-23,136529,10659,125870,92.2,853,187,21.9
12,All Students,2018-19,133401,12223,121178,90.8,817,213,26.1
12,All Students,2019-20,85359,5647,79712,93.4,777,154,19.8
12,All Students,2020-21,134071,18038,116033,86.5,779,276,35.4
12,All Students,2021-22,127901,17860,110041,86.0,765,373,48.8
12,All Students,2022-23,125210,12480,112730,90.0,775,258,33.3
All Grades,All Students,2018-19,359134,28679,330455,92.0,2291,448,19.6
All Grades,All Students,2019-20,241637,18851,222786,92.2,2285,459,20.1
All Grades,All Students,2020-21,390910,83054,307856,78.8,2286,1052,46.0
All Grades,All Students,2021-22,365188,47359,317829,87.0,2282,869,38.1
All Grades,All Students,2022-23,354267,38289,315978,89.2,2267,684,30.2
8,All Students,2020-21,4,s,s,s,s,s,s
9,All Students,2018-19,95390,8964,86426,90.6,632,142,22.5
9,All Students,2019-20,65822,5269,60553,92.0,638,138,21.6
9,All Students,2020-21,108960,24161,84799,77.8,626,301,48.1
9,All Students,2021-22,102085,12026,90059,88.2,648,199,30.7
9,All Students,2022-23,101619,12420,89199,87.8,658,206,31.3
10,All Students,2018-19,96529,7959,88570,91.8,626,141,22.5
10,All Students,2019-20,64122,5515,58607,91.4,615,131,21.3
10,All Students,2020-21,103848,25381,78467,75.6,613,302,49.3
10,All Students,2021-22,98480,14681,83799,85.1,620,255,41.1
10,All Students,2022-23,100171,11412,88759,88.6,646,203,31.4
11,All Students,2018-19,85092,5257,79835,93.8,528,83,15.7
11,All Students,2019-20,54630,3307,51323,93.9,509,79,15.5
11,All Students,2020-21,87116,s,s,s,s,s,s
11,All Students,2021-22,81393,9518,71875,88.3,506,183,36.2
11,All Students,2022-23,80080,7234,72846,91.0,506,131,25.9
12,All Students,2018-19,82123,6499,75624,92.1,505,82,16.2
12,All Students,2019-20,57063,4760,52303,91.7,524,112,21.4
12,All Students,2020-21,90982,19885,71097,78.1,540,268,49.6
12,All Students,2021-22,83230,11134,72096,86.6,508,232,45.7
12,All Students,2022-23,72397,7223,65174,90.0,457,144,31.5
All Grades,All Students,2018-19,47084,7441,39643,84.2,314,154,49.0
All Grades,All Students,2019-20,30594,4602,25992,85.0,292,140,47.9
All Grades,All Students,2020-21,44021,7660,36361,82.6,254,117,46.1
All Grades,All Students,2021-22,43760,8535,35225,80.5,293,172,58.7
All Grades,All Students,2022-23,40259,6882,33377,82.9,271,130,48.0
9,All Students,2018-19,12471,2710,9761,78.3,93,48,51.6
9,All Students,2019-20,8344,954,7390,88.6,85,37,43.5
9,All Students,2020-21,7908,1826,6082,76.9,46,28,60.9
9,All Students,2021-22,11777,1542,10235,86.9,84,31,36.9
9,All Students,2022-23,9643,1584,8059,83.6,68,34,50.0
10,All Students,2018-19,13888,1707,12181,87.7,90,37,41.1
10,All Students,2019-20,8243,1830,6413,77.8,78,42,53.8
10,All Students,2020-21,13435,3063,10372,77.2,77,49,63.6
10,All Students,2021-22,9565,1908,7657,80.1,64,37,57.8
10,All Students,2022-23,10529,1900,8629,82.0,74,29,39.2
11,All Students,2018-19,9159,975,8184,89.4,58,21,36.2
11,All Students,2019-20,7170,1052,6118,85.3,67,37,55.2
11,All Students,2020-21,11803,1728,10075,85.4,69,29,42.0
11,All Students,2021-22,12072,2338,9734,80.6,81,53,65.4
11,All Students,2022-23,8777,1381,7396,84.3,58,25,43.1
12,All Students,2018-19,11566,2049,9517,82.3,73,48,65.8
12,All Students,2019-20,6837,766,6071,88.8,62,24,38.7
12,All Students,2020-21,10875,1043,9832,90.4,62,11,17.7
12,All Students,2021-22,10346,2747,7599,73.4,64,51,79.7
12,All Students,2022-23,11310,2017,9293,82.2,71,42,59.2
All Grades,All Students,2018-19,62679,11250,51429,82.1,374,183,48.9
All Grades,All Students,2019-20,42024,6368,35656,84.8,378,156,41.3
All Grades,All Students,2020-21,65277,11585,53692,82.3,394,172,43.7
All Grades,All Students,2021-22,64546,11953,52593,81.5,399,238,59.6
All Grades,All Students,2022-23,62049,8570,53479,86.2,384,170,44.3
9,All Students,2018-19,17855,2556,15299,85.7,111,47,42.3
9,All Students,2019-20,11323,1098,10225,90.3,104,30,28.8
9,All Students,2020-21,18690,2958,15732,84.2,113,45,39.8
9,All Students,2021-22,16434,2421,14013,85.3,112,47,42.0
9,All Students,2022-23,15832,1843,13989,88.4,104,45,43.3
10,All Students,2018-19,15214,2264,12950,85.1,95,41,43.2
10,All Students,2019-20,10467,1451,9016,86.1,96,38,39.6
10,All Students,2020-21,16674,2342,14332,86.0,101,39,38.6
10,All Students,2021-22,17576,3092,14484,82.4,108,72,66.7
10,All Students,2022-23,16633,2323,14310,86.0,102,40,39.2
11,All Students,2018-19,14990,2217,12773,85.2,89,44,49.4
11,All Students,2019-20,9648,1315,8333,86.4,89,35,39.3
11,All Students,2020-21,14671,2727,11944,81.4,89,36,40.4
11,All Students,2021-22,16116,2745,13371,83.0,96,50,52.1
11,All Students,2022-23,14339,1967,12372,86.3,88,41,46.6
12,All Students,2018-19,14620,4213,10407,71.2,79,51,64.6
12,All Students,2019-20,10586,2504,8082,76.3,89,53,59.6
12,All Students,2020-21,15242,3558,11684,76.7,91,52,57.1
12,All Students,2021-22,14420,3695,10725,74.4,83,69,83.1
12,All Students,2022-23,15245,2437,12808,84.0,90,44,48.9
All Grades,All Students,2018-19,67450,11984,55466,82.2,431,221,51.3
All Grades,All Students,2019-20,49551,7059,42492,85.8,470,179,38.1
All Grades,All Students,2020-21,87129,24222,62907,72.2,507,287,56.6
All Grades,All Students,2021-22,97033,20020,77013,79.4,624,394,63.1
All Grades,All Students,2022-23,100063,18046,82017,82.0,667,380,57.0
9,All Students,2018-19,22812,5039,17773,77.9,147,78,53.1
9,All Students,2019-20,20279,3474,16805,82.9,193,78,40.4
9,All Students,2020-21,33628,10813,22815,67.8,196,111,56.6
9,All Students,2021-22,38023,9156,28867,75.9,249,160,64.3
9,All Students,2022-23,32369,6681,25688,79.4,224,135,60.3
10,All Students,2018-19,20575,3777,16798,81.6,129,68,52.7
10,All Students,2019-20,13320,1941,11379,85.4,127,49,38.6
10,All Students,2020-21,27898,8250,19648,70.4,161,94,58.4
10,All Students,2021-22,25022,4521,20501,81.9,163,92,56.4
10,All Students,2022-23,30741,5168,25573,83.2,206,105,51.0
11,All Students,2018-19,11836,1220,10616,89.7,76,28,36.8
11,All Students,2019-20,7572,822,6750,89.1,72,26,36.1
11,All Students,2020-21,11999,2108,9891,82.4,70,34,48.6
11,All Students,2021-22,19588,3516,16072,82.1,126,81,64.3
11,All Students,2022-23,17601,2334,15267,86.7,117,59,50.4
12,All Students,2018-19,12227,1948,10279,84.1,79,47,59.5
12,All Students,2019-20,8380,822,7558,90.2,78,26,33.3
12,All Students,2020-21,13604,3051,10553,77.6,80,48,60.0
12,All Students,2021-22,14400,2827,11573,80.4,86,61,70.9
12,All Students,2022-23,19352,3863,15489,80.0,120,81,67.5
All Grades,All Students,2018-19,158757,16031,142726,89.9,968,340,35.1
All Grades,All Students,2019-20,103236,8776,94460,91.5,952,260,27.3
All Grades,All Students,2020-21,167513,20486,147027,87.8,971,300,30.9
All Grades,All Students,2021-22,157741,14076,143665,91.1,949,283,29.8
All Grades,All Students,2022-23,150904,13758,137146,90.9,946,290,30.7
6,All Students,2018-19,20490,978,19512,95.2,121,18,14.9
6,All Students,2019-20,12435,653,11782,94.7,115,19,16.5
6,All Students,2020-21,23519,1043,22476,95.6,136,16,11.8
6,All Students,2021-22,19264,942,18322,95.1,116,17,14.7
6,All Students,2022-23,20794,1079,19715,94.8,122,21,17.2
7,All Students,2018-19,19024,1286,17738,93.2,110,27,24.5
7,All Students,2019-20,13406,628,12778,95.3,121,18,14.9
7,All Students,2020-21,19004,955,18049,95.0,110,14,12.7
7,All Students,2021-22,22161,1423,20738,93.6,129,29,22.5
7,All Students,2022-23,18794,1247,17547,93.4,109,20,18.3
8,All Students,2018-19,19923,1516,18407,92.4,114,30,26.3
8,All Students,2019-20,12466,961,11505,92.3,114,25,21.9
8,All Students,2020-21,20019,903,19116,95.5,115,12,10.4
8,All Students,2021-22,18436,1427,17009,92.3,109,30,27.5
8,All Students,2022-23,21971,1483,20488,93.3,136,32,23.5
9,All Students,2018-19,28988,3044,25944,89.5,183,54,29.5
9,All Students,2019-20,22209,2315,19894,89.6,207,66,31.9
9,All Students,2020-21,25572,4245,21327,83.4,151,57,37.7
9,All Students,2021-22,30785,3395,27390,89.0,186,59,31.7
9,All Students,2022-23,23938,3217,20721,86.6,163,60,36.8
10,All Students,2018-19,25817,2980,22837,88.5,168,64,38.1
10,All Students,2019-20,15348,1213,14135,92.1,141,38,27.0
10,All Students,2020-21,32630,6261,26369,80.8,188,87,46.3
10,All Students,2021-22,21741,2102,19639,90.3,136,42,30.9
10,All Students,2022-23,23482,2430,21052,89.7,153,49,32.0
11,All Students,2018-19,18734,2467,16267,86.8,115,56,48.7
11,All Students,2019-20,14994,1361,13633,90.9,140,39,27.9
11,All Students,2020-21,23257,3197,20060,86.3,134,51,38.1
11,All Students,2021-22,21893,1691,20202,92.3,132,30,22.7
11,All Students,2022-23,18259,1655,16604,90.9,118,35,29.7
12,All Students,2018-19,25781,3760,22021,85.4,157,91,58.0
12,All Students,2019-20,12378,1645,10733,86.7,114,55,48.2
12,All Students,2020-21,23512,3882,19630,83.5,137,63,46.0
12,All Students,2021-22,23461,3096,20365,86.8,141,76,53.9
12,All Students,2022-23,23666,2647,21019,88.8,145,73,50.3
All Grades,All Students,2022-23,50801,9528,41273,81.2,326,247,75.8
PK in K-12 Schools,All Students,2022-23,50800,s,s,s,s,s,s
0K,All Students,2022-23,1,s,s,s,s,s,s
All Grades,All Students,2018-19,94750,7608,87142,92.0,571,154,27.0
All Grades,All Students,2019-20,61729,4048,57681,93.4,569,118,20.7
All Grades,All Students,2020-21,92515,9112,83403,90.2,551,150,27.2
All Grades,All Students,2021-22,84667,11125,73542,86.9,528,278,52.7
All Grades,All Students,2022-23,85890,10526,75364,87.7,558,285,51.1
6,All Students,2018-19,29388,2128,27260,92.8,179,39,21.8
6,All Students,2019-20,20234,1405,18829,93.1,187,44,23.5
6,All Students,2020-21,29295,3718,25577,87.3,177,62,35.0
6,All Students,2021-22,23364,3057,20307,86.9,147,77,52.4
6,All Students,2022-23,24213,2861,21352,88.2,165,84,50.9
7,All Students,2018-19,30888,2155,28733,93.0,187,45,24.1
7,All Students,2019-20,20136,1166,18970,94.2,189,36,19.0
7,All Students,2020-21,31323,3002,28321,90.4,186,48,25.8
7,All Students,2021-22,29383,3979,25404,86.5,181,95,52.5
7,All Students,2022-23,28354,3106,25248,89.0,188,88,46.8
8,All Students,2018-19,34474,3325,31149,90.4,205,70,34.1
8,All Students,2019-20,21359,1477,19882,93.1,193,38,19.7
8,All Students,2020-21,31897,2392,29505,92.5,188,40,21.3
8,All Students,2021-22,31920,4089,27831,87.2,200,106,53.0
8,All Students,2022-23,33323,4559,28764,86.3,205,113,55.1
All Grades,All Students,2018-19,145032,11023,134009,92.4,875,250,28.6
All Grades,All Students,2019-20,91669,7005,84664,92.4,841,186,22.1
All Grades,All Students,2020-21,130911,12827,118084,90.2,796,275,34.5
All Grades,All Students,2021-22,125859,14191,111668,88.7,798,383,48.0
All Grades,All Students,2022-23,133394,15600,117794,88.3,838,419,50.0
PK in K-12 Schools,All Students,2018-19,12534,1166,11368,90.7,75,29,38.7
PK in K-12 Schools,All Students,2019-20,8176,1049,7127,87.2,76,34,44.7
PK in K-12 Schools,All Students,2020-21,11551,1317,10234,88.6,69,29,42.0
PK in K-12 Schools,All Students,2021-22,11643,1737,9906,85.1,77,49,63.6
PK in K-12 Schools,All Students,2022-23,10760,1659,9101,84.6,70,45,64.3
0K,All Students,2018-19,21687,2070,19617,90.5,137,55,40.1
0K,All Students,2019-20,15034,1203,13831,92.0,139,39,28.1
0K,All Students,2020-21,18344,2365,15979,87.1,117,51,43.6
0K,All Students,2021-22,19248,2534,16714,86.8,127,70,55.1
0K,All Students,2022-23,19678,2903,16775,85.2,123,83,67.5
1,All Students,2018-19,22301,1808,20493,91.9,139,47,33.8
1,All Students,2019-20,12647,1098,11549,91.3,119,29,24.4
1,All Students,2020-21,20335,1678,18657,91.7,123,34,27.6
1,All Students,2021-22,17150,2250,14900,86.9,112,65,58.0
1,All Students,2022-23,20783,2534,18249,87.8,132,67,50.8
2,All Students,2018-19,18352,1342,17010,92.7,111,34,30.6
2,All Students,2019-20,14653,1138,13515,92.2,133,33,24.8
2,All Students,2020-21,18450,2191,16259,88.1,114,43,37.7
2,All Students,2021-22,20531,1928,18603,90.6,128,56,43.8
2,All Students,2022-23,19494,2509,16985,87.1,128,68,53.1
3,All Students,2018-19,24139,1657,22482,93.1,144,32,22.2
3,All Students,2019-20,11789,701,11088,94.1,111,15,13.5
3,All Students,2020-21,22882,1887,20995,91.8,136,45,33.1
3,All Students,2021-22,17687,1713,15974,90.3,113,42,37.2
3,All Students,2022-23,23581,2237,21344,90.5,147,60,40.8
4,All Students,2018-19,22874,1315,21559,94.3,134,22,16.4
4,All Students,2019-20,14907,982,13925,93.4,136,25,18.4
4,All Students,2020-21,18579,1212,17367,93.5,111,31,27.9
4,All Students,2021-22,21101,2141,18960,89.9,130,57,43.8
4,All Students,2022-23,18805,1901,16904,89.9,114,42,36.8
5,All Students,2018-19,23145,1665,21480,92.8,135,31,23.0
5,All Students,2019-20,14463,834,13629,94.2,127,11,8.7
5,All Students,2020-21,20770,2177,18593,89.5,126,42,33.3
5,All Students,2021-22,18499,1888,16611,89.8,111,44,39.6
5,All Students,2022-23,20293,1857,18436,90.8,124,54,43.5
All Grades,All Students,2018-19,101397,5979,95418,94.1,597,90,15.1
All Grades,All Students,2019-20,63083,3247,59836,94.9,566,81,14.3
All Grades,All Students,2020-21,89731,5609,84122,93.7,529,107,20.2
All Grades,All Students,2021-22,89900,8848,81052,90.2,541,210,38.8
All Grades,All Students,2022-23,96890,8400,88490,91.3,587,189,32.2
6,All Students,2018-19,33859,1872,31987,94.5,202,23,11.4
6,All Students,2019-20,19241,916,18325,95.2,175,24,13.7
6,All Students,2020-21,28060,2015,26045,92.8,166,44,26.5
6,All Students,2021-22,29574,2882,26692,90.3,180,63,35.0
6,All Students,2022-23,36089,2599,33490,92.8,213,62,29.1
7,All Students,2018-19,34498,1895,32603,94.5,201,35,17.4
7,All Students,2019-20,21561,915,20646,95.8,194,19,9.8
7,All Students,2020-21,29864,1921,27943,93.6,175,36,20.6
7,All Students,2021-22,28151,2757,25394,90.2,168,67,39.9
7,All Students,2022-23,30743,2681,28062,91.3,189,58,30.7
8,All Students,2018-19,33040,2212,30828,93.3,194,32,16.5
8,All Students,2019-20,22281,1416,20865,93.6,197,38,19.3
8,All Students,2020-21,31807,1673,30134,94.7,188,27,14.4
8,All Students,2021-22,32175,3209,28966,90.0,193,80,41.5
8,All Students,2022-23,30058,3120,26938,89.6,185,69,37.3
All Grades,All Students,2018-19,105066,8316,96750,92.1,639,187,29.3
All Grades,All Students,2019-20,59416,4887,54529,91.8,564,187,33.2
All Grades,All Students,2020-21,89056,12525,76531,85.9,542,260,48.0
All Grades,All Students,2021-22,86029,11316,74713,86.8,549,279,50.8
All Grades,All Students,2022-23,91339,11655,79684,87.2,603,299,49.6
PK in K-12 Schools,All Students,2018-19,3823,560,3263,85.4,26,18,69.2
PK in K-12 Schools,All Students,2019-20,3141,414,2727,86.8,32,18,56.3
PK in K-12 Schools,All Students,2020-21,3809,499,3310,86.9,28,10,35.7
PK in K-12 Schools,All Students,2021-22,2367,479,1888,79.8,17,11,64.7
PK in K-12 Schools,All Students,2022-23,4911,s,s,s,s,s,s
0K,All Students,2018-19,7796,774,7022,90.1,51,17,33.3
0K,All Students,2019-20,4140,510,3630,87.7,41,22,53.7
0K,All Students,2020-21,10423,1657,8766,84.1,66,37,56.1
0K,All Students,2021-22,8010,1216,6794,84.8,57,35,61.4
0K,All Students,2022-23,6728,1053,5675,84.3,43,26,60.5
1,All Students,2018-19,9480,705,8775,92.6,57,14,24.6
1,All Students,2019-20,5455,554,4901,89.8,54,25,46.3
1,All Students,2020-21,5845,624,5221,89.3,37,16,43.2
1,All Students,2021-22,10130,1731,8399,82.9,66,42,63.6
1,All Students,2022-23,9007,1304,7703,85.5,65,32,49.2
2,All Students,2018-19,10046,837,9209,91.7,64,19,29.7
2,All Students,2019-20,5928,422,5506,92.9,57,16,28.1
2,All Students,2020-21,7770,1208,6562,84.5,49,23,46.9
2,All Students,2021-22,6074,766,5308,87.4,38,19,50.0
2,All Students,2022-23,9882,1367,8515,86.2,65,33,50.8
3,All Students,2018-19,10664,749,9915,93.0,66,16,24.2
3,All Students,2019-20,6189,370,5819,94.0,60,13,21.7
3,All Students,2020-21,9396,1348,8048,85.7,56,26,46.4
3,All Students,2021-22,7008,964,6044,86.2,45,27,60.0
3,All Students,2022-23,6858,734,6124,89.3,45,23,51.1
4,All Students,2018-19,10586,845,9741,92.0,65,21,32.3
4,All Students,2019-20,6313,545,5768,91.4,60,19,31.7
4,All Students,2020-21,8829,572,8257,93.5,54,11,20.4
4,All Students,2021-22,9629,1191,8438,87.6,61,33,54.1
4,All Students,2022-23,8210,1209,7001,85.3,55,29,52.7
5,All Students,2018-19,12017,830,11187,93.1,73,21,28.8
5,All Students,2019-20,6857,482,6375,93.0,64,19,29.7
5,All Students,2020-21,10106,952,9154,90.6,59,20,33.9
5,All Students,2021-22,10247,1137,9110,88.9,65,28,43.1
5,All Students,2022-23,10087,1187,8900,88.2,66,29,43.9
6,All Students,2018-19,12831,857,11974,93.3,75,17,22.7
6,All Students,2019-20,6887,570,6317,91.7,63,19,30.2
6,All Students,2020-21,11786,2539,9247,78.5,69,49,71.0
6,All Students,2021-22,11674,1075,10599,90.8,72,24,33.3
6,All Students,2022-23,12541,1344,11197,89.3,83,35,42.2
7,All Students,2018-19,11267,908,10359,91.9,67,19,28.4
7,All Students,2019-20,7659,515,7144,93.3,69,18,26.1
7,All Students,2020-21,9970,1895,8075,81.0,59,36,61.0
7,All Students,2021-22,11165,1106,10059,90.1,70,26,37.1
7,All Students,2022-23,11792,1023,10769,91.3,74,26,35.1
8,All Students,2018-19,16556,1251,15305,92.4,95,25,26.3
8,All Students,2019-20,6847,505,6342,92.6,64,18,28.1
8,All Students,2020-21,11122,1231,9891,88.9,65,32,49.2
8,All Students,2021-22,9725,1651,8074,83.0,58,34,58.6
8,All Students,2022-23,11292,1184,10108,89.5,67,27,40.3
9,All Students,2022-23,31,s,s,s,s,s,s
All Grades,All Students,2018-19,78196,4267,73929,94.5,466,83,17.8
All Grades,All Students,2019-20,49643,2695,46948,94.6,445,75,16.9
All Grades,All Students,2020-21,72687,5095,67592,93.0,433,112,25.9
All Grades,All Students,2021-22,69913,7254,62659,89.6,415,167,40.2
All Grades,All Students,2022-23,69962,7693,62269,89.0,433,188,43.4
PK in K-12 Schools,All Students,2018-19,5999,615,5384,89.7,36,14,38.9
PK in K-12 Schools,All Students,2019-20,4139,381,3758,90.8,36,15,41.7
PK in K-12 Schools,All Students,2020-21,5218,364,4854,93.0,32,10,31.3
PK in K-12 Schools,All Students,2021-22,6296,1002,5294,84.1,36,26,72.2
PK in K-12 Schools,All Students,2022-23,6205,1211,4994,80.5,38,24,63.2
0K,All Students,2018-19,9873,543,9330,94.5,56,8,14.3
0K,All Students,2019-20,5540,422,5118,92.4,50,9,18.0
0K,All Students,2020-21,8651,681,7970,92.1,52,15,28.8
0K,All Students,2021-22,8475,1217,7258,85.6,53,32,60.4
0K,All Students,2022-23,8656,1272,7384,85.3,57,36,63.2
1,All Students,2018-19,7691,398,7293,94.8,47,7,14.9
1,All Students,2019-20,6774,417,6357,93.8,60,11,18.3
1,All Students,2020-21,9183,784,8399,91.5,56,18,32.1
1,All Students,2021-22,9730,1088,8642,88.8,58,24,41.4
1,All Students,2022-23,8998,1107,7891,87.7,56,33,58.9
2,All Students,2018-19,8496,438,8058,94.8,50,10,20.0
2,All Students,2019-20,5448,226,5222,95.9,49,3,6.1
2,All Students,2020-21,9824,715,9109,92.7,59,15,25.4
2,All Students,2021-22,9612,1014,8598,89.5,56,23,41.1
2,All Students,2022-23,10345,1087,9258,89.5,64,24,37.5
3,All Students,2018-19,16781,755,16026,95.5,102,14,13.7
3,All Students,2019-20,9041,436,8605,95.2,85,16,18.8
3,All Students,2020-21,10992,863,10129,92.1,64,21,32.8
3,All Students,2021-22,12130,998,11132,91.8,72,24,33.3
3,All Students,2022-23,11803,1102,10701,90.7,75,31,41.3
4,All Students,2018-19,14233,673,13560,95.3,83,12,14.5
4,All Students,2019-20,10272,418,9854,95.9,90,10,11.1
4,All Students,2020-21,13615,658,12957,95.2,82,13,15.9
4,All Students,2021-22,11398,998,10400,91.2,68,19,27.9
4,All Students,2022-23,12791,1036,11755,91.9,74,21,28.4
5,All Students,2018-19,15123,845,14278,94.4,92,18,19.6
5,All Students,2019-20,8429,395,8034,95.3,76,12,15.8
5,All Students,2020-21,15138,1024,14114,93.2,87,20,23.0
5,All Students,2021-22,12272,937,11335,92.4,72,19,26.4
5,All Students,2022-23,11164,878,10286,92.1,69,19,27.5
All Grades,All Students,2018-19,106212,5243,100969,95.1,614,76,12.4
All Grades,All Students,2019-20,69784,3606,66178,94.8,627,84,13.4
All Grades,All Students,2020-21,99425,3652,95773,96.3,587,49,8.3
All Grades,All Students,2021-22,90404,6826,83578,92.4,542,145,26.8
All Grades,All Students,2022-23,88622,6026,82596,93.2,531,111,20.9
0K,All Students,2018-19,21157,1426,19731,93.3,123,26,21.1
0K,All Students,2019-20,11552,780,10772,93.2,105,22,21.0
0K,All Students,2020-21,14765,764,14001,94.8,88,12,13.6
0K,All Students,2021-22,14432,1512,12920,89.5,88,34,38.6
0K,All Students,2022-23,17656,1701,15955,90.4,105,41,39.0
1,All Students,2018-19,14778,755,14023,94.9,87,11,12.6
1,All Students,2019-20,13163,811,12352,93.8,117,23,19.7
1,All Students,2020-21,16582,603,15979,96.4,99,11,11.1
1,All Students,2021-22,14213,1258,12955,91.1,85,28,32.9
1,All Students,2022-23,13771,1106,12665,92.0,83,23,27.7
2,All Students,2018-19,17571,794,16777,95.5,101,10,9.9
2,All Students,2019-20,10007,468,9539,95.3,91,12,13.2
2,All Students,2020-21,19084,697,18387,96.3,112,9,8.0
2,All Students,2021-22,15268,1100,14168,92.8,91,22,24.2
2,All Students,2022-23,13973,1003,12970,92.8,83,16,19.3
3,All Students,2018-19,17843,960,16883,94.6,104,15,14.4
3,All Students,2019-20,11673,546,11127,95.3,104,10,9.6
3,All Students,2020-21,15084,372,14712,97.5,88,3,3.4
3,All Students,2021-22,17122,1213,15909,92.9,103,24,23.3
3,All Students,2022-23,13959,758,13201,94.6,84,9,10.7
4,All Students,2018-19,17965,675,17290,96.2,103,8,7.8
4,All Students,2019-20,11565,521,11044,95.5,104,10,9.6
4,All Students,2020-21,16962,542,16420,96.8,99,5,5.1
4,All Students,2021-22,13250,741,12509,94.4,80,16,20.0
4,All Students,2022-23,16833,831,16002,95.1,102,14,13.7
5,All Students,2018-19,16898,633,16265,96.3,96,6,6.3
5,All Students,2019-20,11824,480,11344,95.9,106,7,6.6
5,All Students,2020-21,16948,674,16274,96.0,101,9,8.9
5,All Students,2021-22,16119,1002,15117,93.8,95,21,22.1
5,All Students,2022-23,12430,627,11803,95.0,74,8,10.8
All Grades,All Students,2018-19,169243,11371,157872,93.3,996,217,21.8
All Grades,All Students,2019-20,102756,6678,96078,93.5,925,204,22.1
All Grades,All Students,2020-21,145216,12115,133101,91.7,855,246,28.8
All Grades,All Students,2021-22,136164,14325,121839,89.5,810,333,41.1
All Grades,All Students,2022-23,129423,11403,118020,91.2,758,265,35.0
PK in K-12 Schools,All Students,2018-19,12418,1307,11111,89.5,74,32,43.2
PK in K-12 Schools,All Students,2019-20,7910,665,7245,91.6,74,21,28.4
PK in K-12 Schools,All Students,2020-21,11846,920,10926,92.2,73,20,27.4
PK in K-12 Schools,All Students,2021-22,11424,1544,9880,86.5,69,45,65.2
PK in K-12 Schools,All Students,2022-23,12606,1427,11179,88.7,75,33,44.0
0K,All Students,2018-19,23990,1888,22102,92.1,138,38,27.5
0K,All Students,2019-20,14842,1188,13654,92.0,134,37,27.6
0K,All Students,2020-21,17736,1726,16010,90.3,106,36,34.0
0K,All Students,2021-22,20388,2089,18299,89.8,119,44,37.0
0K,All Students,2022-23,18648,1915,16733,89.7,110,55,50.0
1,All Students,2018-19,28184,1920,26264,93.2,164,37,22.6
1,All Students,2019-20,15123,1076,14047,92.9,137,42,30.7
1,All Students,2020-21,20969,2430,18539,88.4,123,46,37.4
1,All Students,2021-22,17446,2168,15278,87.6,104,56,53.8
1,All Students,2022-23,20581,1596,18985,92.2,119,32,26.9
2,All Students,2018-19,26187,1745,24442,93.3,155,30,19.4
2,All Students,2019-20,17234,1142,16092,93.4,156,39,25.0
2,All Students,2020-21,22478,1673,20805,92.6,131,31,23.7
2,All Students,2021-22,20065,2162,17903,89.2,123,53,43.1
2,All Students,2022-23,16778,1679,15099,90.0,99,39,39.4
3,All Students,2018-19,26281,1504,24777,94.3,156,28,17.9
3,All Students,2019-20,16689,971,15718,94.2,148,22,14.9
3,All Students,2020-21,24845,1848,22997,92.6,144,40,27.8
3,All Students,2021-22,20329,1957,18372,90.4,119,40,33.6
3,All Students,2022-23,18522,1698,16824,90.8,113,45,39.8
4,All Students,2018-19,23427,1302,22125,94.4,138,20,14.5
4,All Students,2019-20,15667,783,14884,95.0,139,21,15.1
4,All Students,2020-21,23439,1599,21840,93.2,139,34,24.5
4,All Students,2021-22,23143,2125,21018,90.8,136,41,30.1
4,All Students,2022-23,20365,1495,18870,92.7,117,29,24.8
5,All Students,2018-19,28756,1705,27051,94.1,171,32,18.7
5,All Students,2019-20,15291,853,14438,94.4,138,23,16.7
5,All Students,2020-21,23850,1917,21933,92.0,138,39,28.3
5,All Students,2021-22,23369,2280,21089,90.2,140,54,38.6
5,All Students,2022-23,21923,1593,20330,92.7,125,32,25.6
All Grades,All Students,2018-19,115980,7501,108479,93.5,689,167,24.2
All Grades,All Students,2019-20,68465,4392,64073,93.6,613,129,21.0
All Grades,All Students,2020-21,97454,10116,87338,89.6,584,198,33.9
All Grades,All Students,2021-22,91493,10682,80811,88.3,549,255,46.4
All Grades,All Students,2022-23,87591,8606,78985,90.2,541,209,38.6
PK in K-12 Schools,All Students,2018-19,6311,s,s,s,s,s,s
PK in K-12 Schools,All Students,2019-20,4040,480,3560,88.1,37,18,48.6
PK in K-12 Schools,All Students,2020-21,6198,795,5403,87.2,39,14,35.9
PK in K-12 Schools,All Students,2021-22,6200,1056,5144,83.0,37,25,67.6
PK in K-12 Schools,All Students,2022-23,6090,1020,5070,83.3,40,24,60.0
0K,All Students,2018-19,16903,1427,15476,91.6,101,39,38.6
0K,All Students,2019-20,9282,784,8498,91.6,85,26,30.6
0K,All Students,2020-21,13479,1947,11532,85.6,83,37,44.6
0K,All Students,2021-22,15019,2121,12898,85.9,90,51,56.7
0K,All Students,2022-23,14138,1420,12718,90.0,89,38,42.7
1,All Students,2018-19,15539,1242,14297,92.0,100,37,37.0
1,All Students,2019-20,10164,720,9444,92.9,93,24,25.8
1,All Students,2020-21,13508,1402,12106,89.6,83,30,36.1
1,All Students,2021-22,12914,1769,11145,86.3,78,43,55.1
1,All Students,2022-23,14259,1665,12594,88.3,89,44,49.4
2,All Students,2018-19,18210,1066,17144,94.1,107,22,20.6
2,All Students,2019-20,9081,566,8515,93.8,82,14,17.1
2,All Students,2020-21,14767,1608,13159,89.1,87,34,39.1
2,All Students,2021-22,12770,1347,11423,89.5,78,34,43.6
2,All Students,2022-23,12273,1189,11084,90.3,79,30,38.0
3,All Students,2018-19,19580,1068,18512,94.5,115,17,14.8
3,All Students,2019-20,11837,711,11126,94.0,105,19,18.1
3,All Students,2020-21,13442,1681,11761,87.5,79,34,43.0
3,All Students,2021-22,15235,1754,13481,88.5,92,43,46.7
3,All Students,2022-23,12525,956,11569,92.4,76,21,27.6
4,All Students,2018-19,20046,970,19076,95.2,117,17,14.5
4,All Students,2019-20,12177,598,11579,95.1,108,16,14.8
4,All Students,2020-21,18047,1498,16549,91.7,106,25,23.6
4,All Students,2021-22,12507,1210,11297,90.3,76,31,40.8
4,All Students,2022-23,15434,1421,14013,90.8,91,33,36.3
5,All Students,2018-19,19389,1124,18265,94.2,111,18,16.2
5,All Students,2019-20,11884,533,11351,95.5,104,13,12.5
5,All Students,2020-21,18013,1185,16828,93.4,107,24,22.4
5,All Students,2021-22,16848,1425,15423,91.5,98,28,28.6
5,All Students,2022-23,12872,935,11937,92.7,77,19,24.7
6,All Students,2018-19,2,s,s,s,s,s,s
All Grades,All Students,2018-19,123686,7235,116451,94.2,733,145,19.8
All Grades,All Students,2019-20,75017,4666,70351,93.8,678,137,20.2
All Grades,All Students,2020-21,101806,8882,92924,91.3,604,183,30.3
All Grades,All Students,2021-22,84812,9100,75712,89.3,506,202,39.9
All Grades,All Students,2022-23,87497,8065,79432,90.8,528,191,36.2
PK in K-12 Schools,All Students,2018-19,2997,237,2760,92.1,18,8,44.4
PK in K-12 Schools,All Students,2019-20,2033,214,1819,89.5,19,7,36.8
PK in K-12 Schools,All Students,2020-21,2936,546,2390,81.4,18,12,66.7
PK in K-12 Schools,All Students,2021-22,4624,781,3843,83.1,32,21,65.6
PK in K-12 Schools,All Students,2022-23,5456,836,4620,84.7,34,21,61.8
0K,All Students,2018-19,15912,1221,14691,92.3,97,30,30.9
0K,All Students,2019-20,12703,1124,11579,91.2,115,44,38.3
0K,All Students,2020-21,12543,1691,10852,86.5,82,41,50.0
0K,All Students,2021-22,12327,1399,10928,88.7,74,35,47.3
0K,All Students,2022-23,13109,1355,11754,89.7,82,33,40.2
1,All Students,2018-19,20453,1411,19042,93.1,122,30,24.6
1,All Students,2019-20,10892,725,10167,93.3,99,21,21.2
1,All Students,2020-21,18742,2337,16405,87.5,109,43,39.4
1,All Students,2021-22,10935,1214,9721,88.9,64,27,42.2
1,All Students,2022-23,14007,1279,12728,90.9,83,30,36.1
2,All Students,2018-19,17062,1134,15928,93.4,103,23,22.3
2,All Students,2019-20,12640,795,11845,93.7,116,25,21.6
2,All Students,2020-21,16057,1355,14702,91.6,94,26,27.7
2,All Students,2021-22,15950,1774,14176,88.9,95,38,40.0
2,All Students,2022-23,12177,1237,10940,89.8,75,30,40.0
3,All Students,2018-19,22365,1060,21305,95.3,133,12,9.0
3,All Students,2019-20,10796,691,10105,93.6,97,19,19.6
3,All Students,2020-21,17503,1269,16234,92.7,104,25,24.0
3,All Students,2021-22,13227,1363,11864,89.7,77,30,39.0
3,All Students,2022-23,15237,1109,14128,92.7,92,25,27.2
4,All Students,2018-19,20276,1070,19206,94.7,118,19,16.1
4,All Students,2019-20,13098,555,12543,95.8,119,11,9.2
4,All Students,2020-21,15029,947,14082,93.7,88,22,25.0
4,All Students,2021-22,14621,1388,13233,90.5,86,29,33.7
4,All Students,2022-23,12560,1014,11546,91.9,73,24,32.9
5,All Students,2018-19,24621,1102,23519,95.5,142,23,16.2
5,All Students,2019-20,12855,562,12293,95.6,115,11,9.6
5,All Students,2020-21,18996,737,18259,96.1,109,14,12.8
5,All Students,2021-22,13128,1181,11947,91.0,78,22,28.2
5,All Students,2022-23,14951,1235,13716,91.7,89,28,31.5
All Grades,All Students,2018-19,99664,8540,91124,91.4,589,203,34.5
All Grades,All Students,2019-20,62744,5431,57313,91.3,586,206,35.2
All Grades,All Students,2020-21,89060,7916,81144,91.1,534,177,33.1
All Grades,All Students,2021-22,89376,12033,77343,86.5,554,328,59.2
All Grades,All Students,2022-23,90452,10752,79700,88.1,570,306,53.7
PK in K-12 Schools,All Students,2018-19,10469,1237,9232,88.2,63,31,49.2
PK in K-12 Schools,All Students,2019-20,6751,734,6017,89.1,65,29,44.6
PK in K-12 Schools,All Students,2020-21,8764,974,7790,88.9,52,24,46.2
PK in K-12 Schools,All Students,2021-22,8898,1462,7436,83.6,60,48,80.0
PK in K-12 Schools,All Students,2022-23,10608,1616,8992,84.8,70,52,74.3
0K,All Students,2018-19,11644,1045,10599,91.0,69,26,37.7
0K,All Students,2019-20,9178,981,8197,89.3,86,42,48.8
0K,All Students,2020-21,12751,1433,11318,88.8,80,36,45.0
0K,All Students,2021-22,13980,1936,12044,86.2,89,52,58.4
0K,All Students,2022-23,12059,1693,10366,86.0,78,52,66.7
1,All Students,2018-19,14848,1431,13417,90.4,88,39,44.3
1,All Students,2019-20,8527,812,7715,90.5,79,28,35.4
1,All Students,2020-21,13083,1251,11832,90.4,79,25,31.6
1,All Students,2021-22,13131,1755,11376,86.6,80,47,58.8
1,All Students,2022-23,14593,1710,12883,88.3,90,43,47.8
2,All Students,2018-19,17269,1416,15853,91.8,101,38,37.6
2,All Students,2019-20,8405,687,7718,91.8,80,23,28.8
2,All Students,2020-21,13210,1040,12170,92.1,78,24,30.8
2,All Students,2021-22,14021,1800,12221,87.2,87,47,54.0
2,All Students,2022-23,14523,1565,12958,89.2,91,45,49.5
3,All Students,2018-19,13917,1245,12672,91.1,85,27,31.8
3,All Students,2019-20,11100,877,10223,92.1,101,37,36.6
3,All Students,2020-21,12560,1034,11526,91.8,76,22,28.9
3,All Students,2021-22,10696,1379,9317,87.1,67,40,59.7
3,All Students,2022-23,13259,1426,11833,89.2,86,40,46.5
4,All Students,2018-19,16168,1112,15056,93.1,94,21,22.3
4,All Students,2019-20,8628,717,7911,91.7,84,29,34.5
4,All Students,2020-21,16387,1175,15212,92.8,97,25,25.8
4,All Students,2021-22,12780,1520,11260,88.1,76,39,51.3
4,All Students,2022-23,11438,1308,10130,88.6,68,35,51.5
5,All Students,2018-19,15349,1054,14295,93.1,89,21,23.6
5,All Students,2019-20,10155,623,9532,93.9,91,18,19.8
5,All Students,2020-21,12305,1009,11296,91.8,72,21,29.2
5,All Students,2021-22,15870,2181,13689,86.3,95,55,57.9
5,All Students,2022-23,13972,1434,12538,89.7,87,39,44.8
All Grades,All Students,2018-19,86663,5571,81092,93.6,497,97,19.5
All Grades,All Students,2019-20,55660,3784,51876,93.2,492,102,20.7
All Grades,All Students,2020-21,69511,2795,66716,96.0,417,32,7.7
All Grades,All Students,2021-22,56694,4724,51970,91.7,342,100,29.2
All Grades,All Students,2022-23,65219,5799,59420,91.1,383,127,33.2
PK in K-12 Schools,All Students,2018-19,3023,296,2727,90.2,17,7,41.2
PK in K-12 Schools,All Students,2019-20,1780,188,1592,89.4,16,9,56.3
PK in K-12 Schools,All Students,2020-21,2493,114,2379,95.4,16,3,18.8
PK in K-12 Schools,All Students,2021-22,1922,329,1593,82.9,12,8,66.7
PK in K-12 Schools,All Students,2022-23,3148,482,2666,84.7,18,13,72.2
0K,All Students,2018-19,12853,836,12017,93.5,74,14,18.9
0K,All Students,2019-20,8226,673,7553,91.8,73,20,27.4
0K,All Students,2020-21,9002,404,8598,95.5,56,9,16.1
0K,All Students,2021-22,9326,968,8358,89.6,57,23,40.4
0K,All Students,2022-23,11351,1229,10122,89.2,68,32,47.1
1,All Students,2018-19,13752,781,12971,94.3,78,13,16.7
1,All Students,2019-20,9043,597,8446,93.4,81,15,18.5
1,All Students,2020-21,11523,500,11023,95.7,71,4,5.6
1,All Students,2021-22,7625,529,7096,93.1,47,9,19.1
1,All Students,2022-23,11659,1041,10618,91.1,68,23,33.8
2,All Students,2018-19,14400,981,13419,93.2,84,19,22.6
2,All Students,2019-20,8970,600,8370,93.3,78,15,19.2
2,All Students,2020-21,11618,454,11164,96.1,70,4,5.7
2,All Students,2021-22,9738,777,8961,92.0,60,18,30.0
2,All Students,2022-23,9113,664,8449,92.7,53,14,26.4
3,All Students,2018-19,15428,1051,14377,93.2,87,15,17.2
3,All Students,2019-20,9007,611,8396,93.2,80,16,20.0
3,All Students,2020-21,11120,369,10751,96.7,66,1,1.5
3,All Students,2021-22,9630,770,8860,92.0,57,16,28.1
3,All Students,2022-23,10275,850,9425,91.7,58,13,22.4
4,All Students,2018-19,13758,820,12938,94.0,80,14,17.5
4,All Students,2019-20,10019,530,9489,94.7,88,9,10.2
4,All Students,2020-21,11440,307,11133,97.3,67,1,1.5
4,All Students,2021-22,8718,587,8131,93.3,54,10,18.5
4,All Students,2022-23,9922,784,9138,92.1,58,17,29.3
5,All Students,2018-19,13449,806,12643,94.0,77,15,19.5
5,All Students,2019-20,8615,585,8030,93.2,76,18,23.7
5,All Students,2020-21,12315,647,11668,94.7,71,10,14.1
5,All Students,2021-22,9735,764,8971,92.2,55,16,29.1
5,All Students,2022-23,9751,749,9002,92.3,60,15,25.0
All Grades,All Students,2018-19,139682,9543,130139,93.2,840,201,23.9
All Grades,All Students,2019-20,98201,7603,90598,92.3,894,255,28.5
All Grades,All Students,2020-21,150078,13738,136340,90.8,919,281,30.6
All Grades,All Students,2021-22,153303,15627,137676,89.8,938,385,41.0
All Grades,All Students,2022-23,174774,17707,157067,89.9,1057,448,42.4
PK in K-12 Schools,All Students,2018-19,12453,1251,11202,90.0,75,30,40.0
PK in K-12 Schools,All Students,2019-20,7995,1008,6987,87.4,74,34,45.9
PK in K-12 Schools,All Students,2020-21,9975,1711,8264,82.8,65,37,56.9
PK in K-12 Schools,All Students,2021-22,11833,2044,9789,82.7,75,56,74.7
PK in K-12 Schools,All Students,2022-23,11281,1700,9581,84.9,73,50,68.5
0K,All Students,2018-19,28313,2440,25873,91.4,171,62,36.3
0K,All Students,2019-20,18263,1699,16564,90.7,168,61,36.3
0K,All Students,2020-21,28669,2912,25757,89.8,175,65,37.1
0K,All Students,2021-22,22992,2741,20251,88.1,145,71,49.0
0K,All Students,2022-23,26963,3344,23619,87.6,166,93,56.0
1,All Students,2018-19,21252,1509,19743,92.9,130,36,27.7
1,All Students,2019-20,20370,1566,18804,92.3,183,60,32.8
1,All Students,2020-21,25435,2837,22598,88.8,159,61,38.4
1,All Students,2021-22,29168,3142,26026,89.2,178,80,44.9
1,All Students,2022-23,26688,2888,23800,89.2,165,76,46.1
2,All Students,2018-19,17104,1073,16031,93.7,103,21,20.4
2,All Students,2019-20,14088,1006,13082,92.9,130,34,26.2
2,All Students,2020-21,28470,2093,26377,92.6,174,41,23.6
2,All Students,2021-22,24401,2211,22190,90.9,151,53,35.1
2,All Students,2022-23,30873,3226,27647,89.6,181,76,42.0
3,All Students,2018-19,19928,1006,18922,95.0,117,13,11.1
3,All Students,2019-20,11228,795,10433,92.9,102,28,27.5
3,All Students,2020-21,20271,1210,19061,94.0,121,20,16.5
3,All Students,2021-22,27200,2310,24890,91.5,163,48,29.4
3,All Students,2022-23,25352,2233,23119,91.2,153,55,35.9
4,All Students,2018-19,19420,1031,18389,94.7,115,16,13.9
4,All Students,2019-20,12769,762,12007,94.0,116,17,14.7
4,All Students,2020-21,17913,1674,16239,90.7,108,33,30.6
4,All Students,2021-22,19841,1601,18240,91.9,120,40,33.3
4,All Students,2022-23,29732,2456,27276,91.7,179,59,33.0
5,All Students,2018-19,21212,1233,19979,94.2,129,23,17.8
5,All Students,2019-20,13488,767,12721,94.3,121,21,17.4
5,All Students,2020-21,19345,1301,18044,93.3,117,24,20.5
5,All Students,2021-22,17868,1578,16290,91.2,106,37,34.9
5,All Students,2022-23,23885,1860,22025,92.2,140,39,27.9
All Grades,All Students,2018-19,71900,6326,65574,91.2,446,142,31.8
All Grades,All Students,2019-20,44468,3316,41152,92.5,406,100,24.6
All Grades,All Students,2020-21,55955,6588,49367,88.2,334,140,41.9
All Grades,All Students,2021-22,53334,6901,46433,87.1,322,162,50.3
All Grades,All Students,2022-23,51573,6411,45162,87.6,322,149,46.3
PK in K-12 Schools,All Students,2018-19,5887,s,s,s,s,s,s
PK in K-12 Schools,All Students,2019-20,2943,312,2631,89.4,27,12,44.4
PK in K-12 Schools,All Students,2020-21,3521,429,3092,87.8,21,9,42.9
PK in K-12 Schools,All Students,2021-22,7214,1347,5867,81.3,43,28,65.1
PK in K-12 Schools,All Students,2022-23,6713,1123,5590,83.3,42,25,59.5
0K,All Students,2018-19,11627,1298,10329,88.8,73,33,45.2
0K,All Students,2019-20,5259,461,4798,91.2,49,14,28.6
0K,All Students,2020-21,6445,941,5504,85.4,38,20,52.6
0K,All Students,2021-22,6726,1020,5706,84.8,42,28,66.7
0K,All Students,2022-23,8028,1277,6751,84.1,50,29,58.0
1,All Students,2018-19,10514,991,9523,90.6,67,26,38.8
1,All Students,2019-20,8196,616,7580,92.5,75,19,25.3
1,All Students,2020-21,7453,1078,6375,85.5,47,25,53.2
1,All Students,2021-22,5966,667,5299,88.8,38,19,50.0
1,All Students,2022-23,7099,1174,5925,83.5,45,27,60.0
2,All Students,2018-19,10503,973,9530,90.7,65,19,29.2
2,All Students,2019-20,6659,429,6230,93.6,61,14,23.0
2,All Students,2020-21,11198,1145,10053,89.8,66,21,31.8
2,All Students,2021-22,7559,963,6596,87.3,46,25,54.3
2,All Students,2022-23,5159,434,4725,91.6,34,12,35.3
3,All Students,2018-19,10689,928,9761,91.3,65,19,29.2
3,All Students,2019-20,6582,482,6100,92.7,61,16,26.2
3,All Students,2020-21,9189,1122,8067,87.8,54,27,50.0
3,All Students,2021-22,9139,1069,8070,88.3,54,20,37.0
3,All Students,2022-23,7357,839,6518,88.6,47,23,48.9
4,All Students,2018-19,12372,698,11674,94.4,76,12,15.8
4,All Students,2019-20,6726,574,6152,91.5,61,17,27.9
4,All Students,2020-21,9026,841,8185,90.7,54,19,35.2
4,All Students,2021-22,8496,945,7551,88.9,49,19,38.8
4,All Students,2022-23,8661,835,7826,90.4,53,19,35.8
5,All Students,2018-19,10138,567,9571,94.4,60,11,18.3
5,All Students,2019-20,8103,442,7661,94.5,73,9,12.3
5,All Students,2020-21,9113,1032,8081,88.7,53,19,35.8
5,All Students,2021-22,8234,890,7344,89.2,50,23,46.0
5,All Students,2022-23,8556,729,7827,91.5,51,14,27.5
6,All Students,2018-19,170,s,s,s,s,s,s
All Grades,All Students,2018-19,119888,8437,111451,93.0,712,174,24.4
All Grades,All Students,2019-20,69296,5039,64257,92.7,644,170,26.4
All Grades,All Students,2020-21,94325,5537,88788,94.1,558,113,20.3
All Grades,All Students,2021-22,96827,11668,85159,87.9,596,282,47.3
All Grades,All Students,2022-23,89713,9914,79799,88.9,558,249,44.6
PK in K-12 Schools,All Students,2018-19,15556,1724,13832,88.9,93,43,46.2
PK in K-12 Schools,All Students,2019-20,9218,975,8243,89.4,87,35,40.2
PK in K-12 Schools,All Students,2020-21,9058,s,s,s,s,s,s
PK in K-12 Schools,All Students,2021-22,16601,2503,14098,84.9,104,61,58.7
PK in K-12 Schools,All Students,2022-23,14809,1909,12900,87.1,96,55,57.3
0K,All Students,2018-19,16737,1299,15438,92.2,98,26,26.5
0K,All Students,2019-20,8536,829,7707,90.3,79,35,44.3
0K,All Students,2020-21,13841,1273,12568,90.8,82,29,35.4
0K,All Students,2021-22,10750,1395,9355,87.0,69,40,58.0
0K,All Students,2022-23,12772,1658,11114,87.0,80,40,50.0
1,All Students,2018-19,13824,1136,12688,91.8,86,27,31.4
1,All Students,2019-20,9359,772,8587,91.8,90,29,32.2
1,All Students,2020-21,11996,594,11402,95.0,71,11,15.5
1,All Students,2021-22,13513,1916,11597,85.8,83,49,59.0
1,All Students,2022-23,9280,1016,8264,89.1,60,27,45.0
2,All Students,2018-19,20422,1328,19094,93.5,121,22,18.2
2,All Students,2019-20,8993,655,8338,92.7,82,19,23.2
2,All Students,2020-21,13084,938,12146,92.8,77,20,26.0
2,All Students,2021-22,11224,1166,10058,89.6,67,28,41.8
2,All Students,2022-23,12303,1405,10898,88.6,74,32,43.2
3,All Students,2018-19,17861,1087,16774,93.9,108,26,24.1
3,All Students,2019-20,12790,726,12064,94.3,118,17,14.4
3,All Students,2020-21,13557,695,12862,94.9,79,11,13.9
3,All Students,2021-22,13141,1492,11649,88.6,81,29,35.8
3,All Students,2022-23,14025,1453,12572,89.6,87,38,43.7
4,All Students,2018-19,17856,868,16988,95.1,103,13,12.6
4,All Students,2019-20,10065,539,9526,94.6,95,17,17.9
4,All Students,2020-21,18266,855,17411,95.3,108,19,17.6
4,All Students,2021-22,14649,1643,13006,88.8,89,40,44.9
4,All Students,2022-23,10841,903,9938,91.7,66,18,27.3
5,All Students,2018-19,17632,995,16637,94.4,103,17,16.5
5,All Students,2019-20,10335,543,9792,94.7,93,18,19.4
5,All Students,2020-21,14449,444,14005,96.9,83,7,8.4
5,All Students,2021-22,16949,1553,15396,90.8,103,35,34.0
5,All Students,2022-23,15683,1570,14113,90.0,95,39,41.1
6,All Students,2020-21,74,s,s,s,s,s,s
All Grades,All Students,2018-19,269288,11133,258155,95.9,1564,180,11.5
All Grades,All Students,2019-20,175494,8549,166945,95.1,1562,214,13.7
All Grades,All Students,2020-21,263929,7980,255949,97.0,1548,129,8.3
All Grades,All Students,2021-22,261304,20955,240349,92.0,1548,465,30.0
All Grades,All Students,2022-23,273030,22181,250849,91.9,1637,496,30.3
0K,All Students,2018-19,29830,1707,28123,94.3,174,32,18.4
0K,All Students,2019-20,18217,1334,16883,92.7,166,40,24.1
0K,All Students,2020-21,27624,1235,26389,95.5,164,26,15.9
0K,All Students,2021-22,25543,2752,22791,89.2,157,62,39.5
0K,All Students,2022-23,27860,3281,24579,88.2,175,83,47.4
1,All Students,2018-19,32652,1467,31185,95.5,190,21,11.1
1,All Students,2019-20,21241,1407,19834,93.4,188,36,19.1
1,All Students,2020-21,26319,913,25406,96.5,157,12,7.6
1,All Students,2021-22,29092,2448,26644,91.6,173,58,33.5
1,All Students,2022-23,29706,3122,26584,89.5,180,73,40.6
2,All Students,2018-19,31379,1315,30064,95.8,185,20,10.8
2,All Students,2019-20,20513,981,19532,95.2,185,22,11.9
2,All Students,2020-21,32655,1186,31469,96.4,191,17,8.9
2,All Students,2021-22,28046,2070,25976,92.6,166,44,26.5
2,All Students,2022-23,31559,2634,28925,91.7,191,58,30.4
3,All Students,2018-19,30478,1344,29134,95.6,181,19,10.5
3,All Students,2019-20,20955,978,19977,95.3,185,24,13.0
3,All Students,2020-21,30274,540,29734,98.2,179,8,4.5
3,All Students,2021-22,32401,2729,29672,91.6,197,64,32.5
3,All Students,2022-23,31031,2258,28773,92.7,185,50,27.0
4,All Students,2018-19,39333,1342,37991,96.6,229,22,9.6
4,All Students,2019-20,19882,1060,18822,94.7,179,32,17.9
4,All Students,2020-21,31363,798,30565,97.5,183,11,6.0
4,All Students,2021-22,32417,2125,30292,93.4,189,48,25.4
4,All Students,2022-23,34241,2451,31790,92.8,207,53,25.6
5,All Students,2018-19,33327,1331,31996,96.0,196,27,13.8
5,All Students,2019-20,25983,1037,24946,96.0,231,24,10.4
5,All Students,2020-21,32041,964,31077,97.0,189,16,8.5
5,All Students,2021-22,32267,2061,30206,93.6,191,45,23.6
5,All Students,2022-23,36263,2260,34003,93.8,214,47,22.0
6,All Students,2018-19,25652,757,24895,97.0,146,9,6.2
6,All Students,2019-20,17062,629,16433,96.3,150,12,8.0
6,All Students,2020-21,32780,823,31957,97.5,190,11,5.8
6,All Students,2021-22,25724,2630,23094,89.8,152,61,40.1
6,All Students,2022-23,26337,1693,24644,93.6,157,39,24.8
7,All Students,2018-19,25408,1039,24369,95.9,143,19,13.3
7,All Students,2019-20,16306,468,15838,97.1,144,7,4.9
7,All Students,2020-21,26009,827,25182,96.8,151,15,9.9
7,All Students,2021-22,31292,2227,29065,92.9,180,40,22.2
7,All Students,2022-23,25987,2387,23600,90.8,155,49,31.6
8,All Students,2018-19,21229,831,20398,96.1,120,11,9.2
8,All Students,2019-20,15335,655,14680,95.7,134,17,12.7
8,All Students,2020-21,24797,688,24109,97.2,143,13,9.1
8,All Students,2021-22,24522,1913,22609,92.2,143,43,30.1
8,All Students,2022-23,30046,2095,27951,93.0,173,44,25.4
All Grades,All Students,2018-19,206685,10621,196064,94.9,1190,179,15.0
All Grades,All Students,2019-20,124242,5687,118555,95.4,1104,129,11.7
All Grades,All Students,2020-21,177146,6102,171044,96.6,1042,104,10.0
All Grades,All Students,2021-22,163696,13832,149864,91.6,956,290,30.3
All Grades,All Students,2022-23,158338,12003,146335,92.4,927,257,27.7
PK in K-12 Schools,All Students,2018-19,3100,245,2855,92.1,19,7,36.8
PK in K-12 Schools,All Students,2019-20,1912,95,1817,95.0,19,4,21.1
PK in K-12 Schools,All Students,2020-21,3074,130,2944,95.8,18,1,5.6
PK in K-12 Schools,All Students,2021-22,3017,465,2552,84.6,18,11,61.1
PK in K-12 Schools,All Students,2022-23,3155,314,2841,90.0,19,8,42.1
0K,All Students,2018-19,19151,1494,17657,92.2,111,32,28.8
0K,All Students,2019-20,11988,831,11157,93.1,105,27,25.7
0K,All Students,2020-21,16147,793,15354,95.1,98,19,19.4
0K,All Students,2021-22,15895,1705,14190,89.3,97,41,42.3
0K,All Students,2022-23,13751,1473,12278,89.3,82,40,48.8
1,All Students,2018-19,19901,1051,18850,94.7,115,19,16.5
1,All Students,2019-20,11482,618,10864,94.6,104,15,14.4
1,All Students,2020-21,16983,827,16156,95.1,102,16,15.7
1,All Students,2021-22,14027,1234,12793,91.2,85,35,41.2
1,All Students,2022-23,15978,1543,14435,90.3,97,37,38.1
2,All Students,2018-19,20229,915,19314,95.5,118,14,11.9
2,All Students,2019-20,12695,487,12208,96.2,111,7,6.3
2,All Students,2020-21,16838,529,16309,96.9,100,6,6.0
2,All Students,2021-22,16451,1386,15065,91.6,96,28,29.2
2,All Students,2022-23,14569,1423,13146,90.2,88,37,42.0
3,All Students,2018-19,23474,1103,22371,95.3,136,18,13.2
3,All Students,2019-20,13085,632,12453,95.2,118,15,12.7
3,All Students,2020-21,18947,373,18574,98.0,112,6,5.4
3,All Students,2021-22,16434,1214,15220,92.6,96,26,27.1
3,All Students,2022-23,16594,1072,15522,93.5,98,19,19.4
4,All Students,2018-19,24360,1066,23294,95.6,140,18,12.9
4,All Students,2019-20,14796,587,14209,96.0,132,10,7.6
4,All Students,2020-21,19447,618,18829,96.8,114,10,8.8
4,All Students,2021-22,18890,1372,17518,92.7,110,26,23.6
4,All Students,2022-23,17627,1207,16420,93.2,101,23,22.8
5,All Students,2018-19,25149,1297,23852,94.8,148,22,14.9
5,All Students,2019-20,16072,661,15411,95.9,144,14,9.7
5,All Students,2020-21,22248,444,21804,98.0,130,5,3.8
5,All Students,2021-22,20334,1712,18622,91.6,118,35,29.7
5,All Students,2022-23,19790,1105,18685,94.4,114,21,18.4
6,All Students,2018-19,22676,1109,21567,95.1,128,16,12.5
6,All Students,2019-20,13873,641,13232,95.4,123,15,12.2
6,All Students,2020-21,22775,801,21974,96.5,133,14,10.5
6,All Students,2021-22,19304,1613,17691,91.6,111,27,24.3
6,All Students,2022-23,18689,1431,17258,92.3,108,31,28.7
7,All Students,2018-19,22593,962,21631,95.7,128,14,10.9
7,All Students,2019-20,13887,499,13388,96.4,122,10,8.2
7,All Students,2020-21,20187,832,19355,95.9,117,13,11.1
7,All Students,2021-22,20201,1320,18881,93.5,116,21,18.1
7,All Students,2022-23,18405,1232,17173,93.3,107,21,19.6
8,All Students,2018-19,26052,1379,24673,94.7,147,19,12.9
8,All Students,2019-20,14452,636,13816,95.6,126,12,9.5
8,All Students,2020-21,20500,755,19745,96.3,118,14,11.9
8,All Students,2021-22,19143,1811,17332,90.5,109,40,36.7
8,All Students,2022-23,19780,1203,18577,93.9,113,20,17.7
All Grades,All Students,2018-19,201629,14488,187141,92.8,1197,315,26.3
All Grades,All Students,2019-20,128639,9661,118978,92.5,1153,292,25.3
All Grades,All Students,2020-21,183229,15083,168146,91.8,1078,302,28.0
All Grades,All Students,2021-22,161865,18855,143010,88.4,965,420,43.5
All Grades,All Students,2022-23,158930,17146,141784,89.2,973,423,43.5
PK in K-12 Schools,All Students,2018-19,9420,1032,8388,89.0,61,30,49.2
PK in K-12 Schools,All Students,2019-20,6148,649,5499,89.4,55,22,40.0
PK in K-12 Schools,All Students,2020-21,9211,1222,7989,86.7,54,26,48.1
PK in K-12 Schools,All Students,2021-22,9234,1512,7722,83.6,59,31,52.5
PK in K-12 Schools,All Students,2022-23,9486,1419,8067,85.0,55,29,52.7
0K,All Students,2018-19,27858,2865,24993,89.7,168,71,42.3
0K,All Students,2019-20,21099,2185,18914,89.6,190,73,38.4
0K,All Students,2020-21,29875,3728,26147,87.5,178,81,45.5
0K,All Students,2021-22,23479,3357,20122,85.7,141,75,53.2
0K,All Students,2022-23,24930,3364,21566,86.5,157,89,56.7
1,All Students,2018-19,30391,2425,27966,92.0,182,50,27.5
1,All Students,2019-20,17702,1652,16050,90.7,159,62,39.0
1,All Students,2020-21,30062,2718,27344,91.0,179,55,30.7
1,All Students,2021-22,27707,3602,24105,87.0,168,85,50.6
1,All Students,2022-23,24003,2485,21518,89.6,145,65,44.8
2,All Students,2018-19,31448,2231,29217,92.9,183,43,23.5
2,All Students,2019-20,19114,1399,17715,92.7,172,42,24.4
2,All Students,2020-21,25667,1611,24056,93.7,152,28,18.4
2,All Students,2021-22,26081,3113,22968,88.1,151,65,43.0
2,All Students,2022-23,25592,2826,22766,89.0,155,66,42.6
3,All Students,2018-19,34279,1921,32358,94.4,205,42,20.5
3,All Students,2019-20,19342,1264,18078,93.5,174,29,16.7
3,All Students,2020-21,27105,2036,25069,92.5,161,43,26.7
3,All Students,2021-22,23558,2418,21140,89.7,138,55,39.9
3,All Students,2022-23,26485,2572,23913,90.3,162,66,40.7
4,All Students,2018-19,36988,2263,34725,93.9,214,46,21.5
4,All Students,2019-20,21623,1220,20403,94.4,191,27,14.1
4,All Students,2020-21,29277,2171,27106,92.6,169,42,24.9
4,All Students,2021-22,24753,2344,22409,90.5,148,57,38.5
4,All Students,2022-23,23953,2638,21315,89.0,146,62,42.5
5,All Students,2018-19,31245,1751,29494,94.4,184,33,17.9
5,All Students,2019-20,23611,1292,22319,94.5,212,37,17.5
5,All Students,2020-21,32032,1597,30435,95.0,185,27,14.6
5,All Students,2021-22,27053,2509,24544,90.7,160,52,32.5
5,All Students,2022-23,24481,1842,22639,92.5,153,46,30.1
All Grades,All Students,2018-19,157497,7480,150017,95.3,914,111,12.1
All Grades,All Students,2019-20,98653,5370,93283,94.6,875,128,14.6
All Grades,All Students,2020-21,134821,4913,129908,96.4,796,86,10.8
All Grades,All Students,2021-22,123591,7789,115802,93.7,715,136,19.0
All Grades,All Students,2022-23,121467,7728,113739,93.6,709,146,20.6
0K,All Students,2018-19,22022,1278,20744,94.2,133,24,18.0
0K,All Students,2019-20,16265,1063,15202,93.5,145,33,22.8
0K,All Students,2020-21,21182,667,20515,96.9,125,10,8.0
0K,All Students,2021-22,17475,1259,16216,92.8,103,21,20.4
0K,All Students,2022-23,18327,1340,16987,92.7,110,26,23.6
1,All Students,2018-19,26134,1290,24844,95.1,151,16,10.6
1,All Students,2019-20,14208,836,13372,94.1,126,17,13.5
1,All Students,2020-21,21132,1080,20052,94.9,128,23,18.0
1,All Students,2021-22,20316,1145,19171,94.4,117,20,17.1
1,All Students,2022-23,18350,1314,17036,92.8,107,26,24.3
2,All Students,2018-19,26170,1389,24781,94.7,153,22,14.4
2,All Students,2019-20,16990,818,16172,95.2,151,18,11.9
2,All Students,2020-21,20107,696,19411,96.5,117,14,12.0
2,All Students,2021-22,20459,1267,19192,93.8,118,21,17.8
2,All Students,2022-23,20631,1151,19480,94.4,121,19,15.7
3,All Students,2018-19,25809,1210,24599,95.3,148,20,13.5
3,All Students,2019-20,16467,1025,15442,93.8,146,24,16.4
3,All Students,2020-21,24251,599,23652,97.5,142,7,4.9
3,All Students,2021-22,20076,1232,18844,93.9,117,20,17.1
3,All Students,2022-23,20622,1123,19499,94.6,120,21,17.5
4,All Students,2018-19,28281,1166,27115,95.9,161,15,9.3
4,All Students,2019-20,16906,794,16112,95.3,149,17,11.4
4,All Students,2020-21,23501,1077,22424,95.4,139,17,12.2
4,All Students,2021-22,22800,1519,21281,93.3,131,33,25.2
4,All Students,2022-23,20005,1214,18791,93.9,115,18,15.7
5,All Students,2018-19,29081,1147,27934,96.1,168,14,8.3
5,All Students,2019-20,17817,834,16983,95.3,158,19,12.0
5,All Students,2020-21,24634,789,23845,96.8,144,14,9.7
5,All Students,2021-22,22465,1367,21098,93.9,129,21,16.3
5,All Students,2022-23,23532,1586,21946,93.3,136,36,26.5
All Grades,All Students,2018-19,311745,19922,291823,93.6,1782,358,20.1
All Grades,All Students,2019-20,179804,11069,168735,93.8,1594,312,19.6
All Grades,All Students,2020-21,245176,22899,222277,90.7,1433,391,27.3
All Grades,All Students,2021-22,229156,20049,209107,91.3,1346,398,29.6
All Grades,All Students,2022-23,238196,19642,218554,91.8,1382,392,28.4
5,All Students,2022-23,1,s,s,s,s,s,s
6,All Students,2018-19,96574,5039,91535,94.8,550,83,15.1
6,All Students,2019-20,52804,3020,49784,94.3,470,94,20.0
6,All Students,2020-21,74430,6879,67551,90.8,434,123,28.3
6,All Students,2021-22,78578,6230,72348,92.1,457,130,28.4
6,All Students,2022-23,79474,5808,73666,92.7,461,128,27.8
7,All Students,2018-19,101804,6151,95653,94.0,581,110,18.9
7,All Students,2019-20,62390,3724,58666,94.0,555,102,18.4
7,All Students,2020-21,79404,8909,70495,88.8,468,155,33.1
7,All Students,2021-22,74184,s,s,s,s,s,s
7,All Students,2022-23,81158,6548,74610,91.9,472,122,25.8
8,All Students,2018-19,113367,8732,104635,92.3,651,165,25.3
8,All Students,2019-20,64610,4325,60285,93.3,569,116,20.4
8,All Students,2020-21,91342,7111,84231,92.2,531,113,21.3
8,All Students,2021-22,76389,7653,68736,90.0,453,151,33.3
8,All Students,2022-23,77563,s,s,s,s,s,s
9,All Students,2021-22,5,s,s,s,s,s,s
All Grades,All Students,2018-19,98366,5726,92640,94.2,572,85,14.9
All Grades,All Students,2019-20,69399,4202,65197,93.9,612,118,19.3
All Grades,All Students,2020-21,97891,4492,93399,95.4,572,57,10.0
All Grades,All Students,2021-22,93470,7454,86016,92.0,545,165,30.3
All Grades,All Students,2022-23,100616,8221,92395,91.8,586,174,29.7
PK in K-12 Schools,All Students,2018-19,7029,661,6368,90.6,45,17,37.8
PK in K-12 Schools,All Students,2019-20,5654,481,5173,91.5,50,15,30.0
PK in K-12 Schools,All Students,2020-21,6665,534,6131,92.0,40,10,25.0
PK in K-12 Schools,All Students,2021-22,7870,771,7099,90.2,48,16,33.3
PK in K-12 Schools,All Students,2022-23,7378,919,6459,87.5,44,25,56.8
0K,All Students,2018-19,14898,880,14018,94.1,86,14,16.3
0K,All Students,2019-20,10779,800,9979,92.6,95,26,27.4
0K,All Students,2020-21,12180,585,11595,95.2,72,9,12.5
0K,All Students,2021-22,13021,1170,11851,91.0,77,30,39.0
0K,All Students,2022-23,15666,1450,14216,90.7,93,38,40.9
1,All Students,2018-19,15160,792,14368,94.8,88,8,9.1
1,All Students,2019-20,10638,613,10025,94.2,93,15,16.1
1,All Students,2020-21,15774,658,15116,95.8,91,9,9.9
1,All Students,2021-22,11700,862,10838,92.6,69,19,27.5
1,All Students,2022-23,16112,1486,14626,90.8,92,28,30.4
2,All Students,2018-19,15120,940,14180,93.8,88,15,17.0
2,All Students,2019-20,11569,684,10885,94.1,101,15,14.9
2,All Students,2020-21,15587,468,15119,97.0,90,5,5.6
2,All Students,2021-22,15443,1192,14251,92.3,91,26,28.6
2,All Students,2022-23,13295,1000,12295,92.5,80,20,25.0
3,All Students,2018-19,17053,976,16077,94.3,99,13,13.1
3,All Students,2019-20,10209,625,9584,93.9,92,21,22.8
3,All Students,2020-21,17720,896,16824,94.9,105,8,7.6
3,All Students,2021-22,15606,993,14613,93.6,89,18,20.2
3,All Students,2022-23,15606,1115,14491,92.9,89,21,23.6
4,All Students,2018-19,15049,734,14315,95.1,87,8,9.2
4,All Students,2019-20,11284,471,10813,95.8,100,11,11.0
4,All Students,2020-21,13786,552,13234,96.0,80,8,10.0
4,All Students,2021-22,16543,1194,15349,92.8,95,22,23.2
4,All Students,2022-23,16481,1171,15310,92.9,96,25,26.0
5,All Students,2018-19,14057,743,13314,94.7,79,10,12.7
5,All Students,2019-20,9266,528,8738,94.3,81,15,18.5
5,All Students,2020-21,16179,799,15380,95.1,94,8,8.5
5,All Students,2021-22,13287,1272,12015,90.4,76,34,44.7
5,All Students,2022-23,16078,1080,14998,93.3,92,17,18.5
All Grades,All Students,2018-19,121994,7993,114001,93.4,714,154,21.6
All Grades,All Students,2019-20,78072,5299,72773,93.2,708,149,21.0
All Grades,All Students,2020-21,101891,11450,90441,88.8,596,225,37.8
All Grades,All Students,2021-22,88130,10816,77314,87.7,533,251,47.1
All Grades,All Students,2022-23,76873,7611,69262,90.1,477,160,33.5
6,All Students,2018-19,37718,2368,35350,93.7,222,46,20.7
6,All Students,2019-20,26954,2022,24932,92.5,244,57,23.4
6,All Students,2020-21,27955,2711,25244,90.3,166,62,37.3
6,All Students,2021-22,22129,2700,19429,87.8,139,64,46.0
6,All Students,2022-23,23179,2389,20790,89.7,143,47,32.9
7,All Students,2018-19,42590,2550,40040,94.0,252,49,19.4
7,All Students,2019-20,24128,1536,22592,93.6,220,44,20.0
7,All Students,2020-21,38317,4920,33397,87.2,224,99,44.2
7,All Students,2021-22,27993,2906,25087,89.6,170,67,39.4
7,All Students,2022-23,24160,2696,21464,88.8,154,58,37.7
8,All Students,2018-19,41686,3075,38611,92.6,240,59,24.6
8,All Students,2019-20,26990,1741,25249,93.5,244,48,19.7
8,All Students,2020-21,35619,3819,31800,89.3,206,64,31.1
8,All Students,2021-22,38008,5210,32798,86.3,224,120,53.6
8,All Students,2022-23,29534,2526,27008,91.4,180,55,30.6
All Grades,All Students,2018-19,54733,2824,51909,94.8,320,53,16.6
All Grades,All Students,2019-20,30858,1513,29345,95.1,282,34,12.1
All Grades,All Students,2020-21,44835,3556,41279,92.1,260,75,28.8
All Grades,All Students,2021-22,43042,3462,39580,92.0,249,74,29.7
All Grades,All Students,2022-23,39787,3166,36621,92.0,235,67,28.5
PK in K-12 Schools,All Students,2018-19,3173,283,2890,91.1,18,6,33.3
PK in K-12 Schools,All Students,2019-20,1850,174,1676,90.6,19,6,31.6
PK in K-12 Schools,All Students,2020-21,2808,s,s,s,s,s,s
PK in K-12 Schools,All Students,2021-22,3099,355,2744,88.5,18,9,50.0
PK in K-12 Schools,All Students,2022-23,3004,364,2640,87.9,19,12,63.2
0K,All Students,2018-19,7719,539,7180,93.0,46,14,30.4
0K,All Students,2019-20,3850,263,3587,93.2,35,9,25.7
0K,All Students,2020-21,6047,744,5303,87.7,35,19,54.3
0K,All Students,2021-22,5991,547,5444,90.9,36,13,36.1
0K,All Students,2022-23,7099,679,6420,90.4,41,16,39.0
1,All Students,2018-19,9061,380,8681,95.8,52,5,9.6
1,All Students,2019-20,4667,307,4360,93.4,44,9,20.5
1,All Students,2020-21,6434,651,5783,89.9,38,16,42.1
1,All Students,2021-22,6178,578,5600,90.6,36,13,36.1
1,All Students,2022-23,4113,370,3743,91.0,26,7,26.9
2,All Students,2018-19,9803,442,9361,95.5,60,11,18.3
2,All Students,2019-20,5367,182,5185,96.6,48,1,2.1
2,All Students,2020-21,6300,417,5883,93.4,36,9,25.0
2,All Students,2021-22,6205,595,5610,90.4,36,13,36.1
2,All Students,2022-23,6429,509,5920,92.1,37,10,27.0
3,All Students,2018-19,8099,429,7670,94.7,47,7,14.9
3,All Students,2019-20,5531,202,5329,96.3,50,3,6.0
3,All Students,2020-21,7794,692,7102,91.1,45,14,31.1
3,All Students,2021-22,6137,417,5720,93.2,35,5,14.3
3,All Students,2022-23,6367,453,5914,92.9,37,10,27.0
4,All Students,2018-19,7439,304,7135,95.9,43,4,9.3
4,All Students,2019-20,4994,215,4779,95.7,46,3,6.5
4,All Students,2020-21,8573,294,8279,96.6,50,5,10.0
4,All Students,2021-22,7213,489,6724,93.2,41,12,29.3
4,All Students,2022-23,5524,323,5201,94.2,33,4,12.1
5,All Students,2018-19,9439,447,8992,95.3,54,6,11.1
5,All Students,2019-20,4599,170,4429,96.3,40,3,7.5
5,All Students,2020-21,6712,418,6294,93.8,39,4,10.3
5,All Students,2021-22,8219,481,7738,94.1,47,9,19.1
5,All Students,2022-23,7251,468,6783,93.5,42,8,19.0
6,All Students,2020-21,167,s,s,s,s,s,s
All Grades,All Students,2018-19,85203,8324,76879,90.2,517,173,33.5
All Grades,All Students,2019-20,49777,4609,45168,90.7,454,148,32.6
All Grades,All Students,2020-21,68316,9684,58632,85.8,408,187,45.8
All Grades,All Students,2021-22,59254,8471,50783,85.7,368,208,56.5
All Grades,All Students,2022-23,54491,6307,48184,88.4,342,159,46.5
PK in K-12 Schools,All Students,2018-19,8305,1167,7138,85.9,53,23,43.4
PK in K-12 Schools,All Students,2019-20,5410,675,4735,87.5,50,24,48.0
PK in K-12 Schools,All Students,2020-21,7500,1875,5625,75.0,45,36,80.0
PK in K-12 Schools,All Students,2021-22,4396,889,3507,79.8,30,23,76.7
PK in K-12 Schools,All Students,2022-23,6794,1000,5794,85.3,47,28,59.6
0K,All Students,2018-19,10308,1168,9140,88.7,67,25,37.3
0K,All Students,2019-20,6459,697,5762,89.2,59,22,37.3
0K,All Students,2020-21,9215,1115,8100,87.9,56,26,46.4
0K,All Students,2021-22,8682,1401,7281,83.9,54,35,64.8
0K,All Students,2022-23,5904,860,5044,85.4,38,18,47.4
1,All Students,2018-19,11206,1160,10046,89.6,69,27,39.1
1,All Students,2019-20,6934,700,6234,89.9,65,24,36.9
1,All Students,2020-21,9702,1297,8405,86.6,58,28,48.3
1,All Students,2021-22,9090,1129,7961,87.6,57,30,52.6
1,All Students,2022-23,7553,966,6587,87.2,48,27,56.3
2,All Students,2018-19,13270,1207,12063,90.9,77,26,33.8
2,All Students,2019-20,6717,629,6088,90.6,62,18,29.0
2,All Students,2020-21,9274,1257,8017,86.4,55,24,43.6
2,All Students,2021-22,8953,1540,7413,82.8,57,36,63.2
2,All Students,2022-23,8391,966,7425,88.5,52,24,46.2
3,All Students,2018-19,13772,1424,12348,89.7,82,31,37.8
3,All Students,2019-20,8139,721,7418,91.1,74,26,35.1
3,All Students,2020-21,9529,1159,8370,87.8,58,20,34.5
3,All Students,2021-22,8641,942,7699,89.1,52,19,36.5
3,All Students,2022-23,7803,981,6822,87.4,50,26,52.0
4,All Students,2018-19,13521,866,12655,93.6,81,15,18.5
4,All Students,2019-20,8225,676,7549,91.8,73,21,28.8
4,All Students,2020-21,11274,1724,9550,84.7,67,31,46.3
4,All Students,2021-22,8644,993,7651,88.5,54,27,50.0
4,All Students,2022-23,8737,706,8031,91.9,52,15,28.8
5,All Students,2018-19,14821,1332,13489,91.0,88,26,29.5
5,All Students,2019-20,7893,511,7382,93.5,73,15,20.5
5,All Students,2020-21,11822,1257,10565,89.4,69,22,31.9
5,All Students,2021-22,10848,1577,9271,85.5,64,38,59.4
5,All Students,2022-23,9309,828,8481,91.1,55,21,38.2
All Grades,All Students,2018-19,135940,7684,128256,94.3,790,151,19.1
All Grades,All Students,2019-20,85603,5340,80263,93.8,771,149,19.3
All Grades,All Students,2020-21,116918,7153,109765,93.9,697,135,19.4
All Grades,All Students,2021-22,110177,10156,100021,90.8,658,240,36.5
All Grades,All Students,2022-23,118821,10800,108021,90.9,746,266,35.7
PK in K-12 Schools,All Students,2022-23,2549,370,2179,85.5,16,10,62.5
0K,All Students,2018-19,21523,1661,19862,92.3,128,37,28.9
0K,All Students,2019-20,14390,1062,13328,92.6,130,37,28.5
0K,All Students,2020-21,15526,829,14697,94.7,94,13,13.8
0K,All Students,2021-22,17648,1781,15867,89.9,107,46,43.0
0K,All Students,2022-23,18568,2051,16517,89.0,126,54,42.9
1,All Students,2018-19,27894,1682,26212,94.0,163,34,20.9
1,All Students,2019-20,13897,948,12949,93.2,127,28,22.0
1,All Students,2020-21,20252,913,19339,95.5,123,16,13.0
1,All Students,2021-22,17689,1634,16055,90.8,106,40,37.7
1,All Students,2022-23,19468,1679,17789,91.4,123,40,32.5
2,All Students,2018-19,21637,1319,20318,93.9,126,29,23.0
2,All Students,2019-20,17411,1098,16313,93.7,156,26,16.7
2,All Students,2020-21,19267,1426,17841,92.6,115,29,25.2
2,All Students,2021-22,18598,1551,17047,91.7,109,31,28.4
2,All Students,2022-23,19509,1792,17717,90.8,120,48,40.0
3,All Students,2018-19,22248,951,21297,95.7,129,16,12.4
3,All Students,2019-20,13421,925,12496,93.1,120,26,21.7
3,All Students,2020-21,24095,1344,22751,94.4,141,28,19.9
3,All Students,2021-22,17498,1667,15831,90.5,103,42,40.8
3,All Students,2022-23,18399,1428,16971,92.2,115,35,30.4
4,All Students,2018-19,21526,1018,20508,95.3,124,14,11.3
4,All Students,2019-20,13942,658,13284,95.3,125,15,12.0
4,All Students,2020-21,18947,1688,17259,91.1,111,34,30.6
4,All Students,2021-22,22190,1984,20206,91.1,132,47,35.6
4,All Students,2022-23,18160,1491,16669,91.8,114,33,28.9
5,All Students,2018-19,21112,1053,20059,95.0,120,21,17.5
5,All Students,2019-20,12542,649,11893,94.8,113,17,15.0
5,All Students,2020-21,18831,953,17878,94.9,113,15,13.3
5,All Students,2021-22,16554,1539,15015,90.7,101,34,33.7
5,All Students,2022-23,22168,1989,20179,91.0,132,46,34.8
All Grades,All Students,2018-19,157426,9640,147786,93.9,914,197,21.6
All Grades,All Students,2019-20,99796,5791,94005,94.2,890,147,16.5
All Grades,All Students,2020-21,139792,9807,129985,93.0,831,184,22.1
All Grades,All Students,2021-22,137414,13278,124136,90.3,843,304,36.1
All Grades,All Students,2022-23,144706,13736,130970,90.5,862,320,37.1
PK in K-12 Schools,All Students,2018-19,11,s,s,s,s,s,s
0K,All Students,2018-19,21802,s,s,s,s,s,s
0K,All Students,2019-20,14390,932,13458,93.5,130,28,21.5
0K,All Students,2020-21,20233,1857,18376,90.8,122,35,28.7
0K,All Students,2021-22,23007,3114,19893,86.5,139,81,58.3
0K,All Students,2022-23,22718,s,s,s,s,s,s
1,All Students,2018-19,27116,1793,25323,93.4,157,37,23.6
1,All Students,2019-20,15213,989,14224,93.5,136,28,20.6
1,All Students,2020-21,20160,1519,18641,92.5,122,31,25.4
1,All Students,2021-22,21797,2106,19691,90.3,141,50,35.5
1,All Students,2022-23,23383,2645,20738,88.7,143,72,50.3
2,All Students,2018-19,28565,1834,26731,93.6,169,37,21.9
2,All Students,2019-20,17248,1047,16201,93.9,152,25,16.4
2,All Students,2020-21,22899,1781,21118,92.2,136,37,27.2
2,All Students,2021-22,20025,1819,18206,90.9,124,40,32.3
2,All Students,2022-23,22997,2169,20828,90.6,136,49,36.0
3,All Students,2018-19,27051,1538,25513,94.3,156,28,17.9
3,All Students,2019-20,18148,1049,17099,94.2,161,21,13.0
3,All Students,2020-21,25097,1896,23201,92.4,149,35,23.5
3,All Students,2021-22,22456,1925,20531,91.4,135,45,33.3
3,All Students,2022-23,23696,1979,21717,91.6,143,46,32.2
4,All Students,2018-19,25928,1493,24435,94.2,148,30,20.3
4,All Students,2019-20,17874,852,17022,95.2,158,19,12.0
4,All Students,2020-21,25158,1368,23790,94.6,147,23,15.6
4,All Students,2021-22,25824,2062,23762,92.0,156,43,27.6
4,All Students,2022-23,23854,1711,22143,92.8,138,37,26.8
5,All Students,2018-19,26953,1215,25738,95.5,156,20,12.8
5,All Students,2019-20,16923,922,16001,94.6,153,26,17.0
5,All Students,2020-21,26245,1386,24859,94.7,155,23,14.8
5,All Students,2021-22,24305,2252,22053,90.7,148,45,30.4
5,All Students,2022-23,28057,2069,25988,92.6,164,44,26.8
6,All Students,2022-23,1,s,s,s,s,s,s
All Grades,All Students,2018-19,76506,4126,72380,94.6,441,60,13.6
All Grades,All Students,2019-20,48073,2800,45273,94.2,428,66,15.4
All Grades,All Students,2020-21,63903,3053,60850,95.2,377,45,11.9
All Grades,All Students,2021-22,61819,4944,56875,92.0,362,106,29.3
All Grades,All Students,2022-23,57959,4186,53773,92.8,338,87,25.7
PK in K-12 Schools,All Students,2018-19,6175,508,5667,91.8,35,13,37.1
PK in K-12 Schools,All Students,2019-20,3758,241,3517,93.6,35,6,17.1
PK in K-12 Schools,All Students,2020-21,4326,152,4174,96.5,29,5,17.2
PK in K-12 Schools,All Students,2021-22,6245,529,5716,91.5,36,12,33.3
PK in K-12 Schools,All Students,2022-23,6360,716,5644,88.7,37,17,45.9
0K,All Students,2018-19,10796,605,10191,94.4,61,8,13.1
0K,All Students,2019-20,6879,554,6325,91.9,63,18,28.6
0K,All Students,2020-21,9391,391,9000,95.8,55,4,7.3
0K,All Students,2021-22,7362,655,6707,91.1,43,13,30.2
0K,All Students,2022-23,9289,744,8545,92.0,54,15,27.8
1,All Students,2018-19,10506,520,9986,95.1,61,5,8.2
1,All Students,2019-20,6822,376,6446,94.5,60,10,16.7
1,All Students,2020-21,8790,541,8249,93.8,53,10,18.9
1,All Students,2021-22,9450,659,8791,93.0,55,12,21.8
1,All Students,2022-23,8491,685,7806,91.9,49,18,36.7
2,All Students,2018-19,11079,587,10492,94.7,64,9,14.1
2,All Students,2019-20,6735,345,6390,94.9,59,4,6.8
2,All Students,2020-21,10167,623,9544,93.9,59,9,15.3
2,All Students,2021-22,8959,670,8289,92.5,55,13,23.6
2,All Students,2022-23,8731,497,8234,94.3,51,9,17.6
3,All Students,2018-19,11792,469,11323,96.0,67,4,6.0
3,All Students,2019-20,7345,396,6949,94.6,65,8,12.3
3,All Students,2020-21,9623,375,9248,96.1,55,5,9.1
3,All Students,2021-22,9985,863,9122,91.4,57,21,36.8
3,All Students,2022-23,7924,480,7444,93.9,47,9,19.1
4,All Students,2018-19,13227,699,12528,94.7,80,10,12.5
4,All Students,2019-20,7306,320,6986,95.6,65,6,9.2
4,All Students,2020-21,11206,618,10588,94.5,65,8,12.3
4,All Students,2021-22,9334,654,8680,93.0,56,17,30.4
4,All Students,2022-23,7876,578,7298,92.7,46,13,28.3
5,All Students,2018-19,12931,738,12193,94.3,73,11,15.1
5,All Students,2019-20,9228,568,8660,93.8,81,14,17.3
5,All Students,2020-21,10400,353,10047,96.6,61,4,6.6
5,All Students,2021-22,10484,914,9570,91.3,60,18,30.0
5,All Students,2022-23,9288,486,8802,94.8,54,6,11.1
All Grades,All Students,2018-19,213528,13263,200265,93.8,1233,228,18.5
All Grades,All Students,2019-20,139555,8296,131259,94.1,1231,221,18.0
All Grades,All Students,2020-21,218042,34278,183764,84.3,1265,656,51.9
All Grades,All Students,2021-22,210508,20589,189919,90.2,1238,433,35.0
All Grades,All Students,2022-23,192603,17488,175115,90.9,1130,358,31.7
6,All Students,2018-19,69849,3493,66356,95.0,405,51,12.6
6,All Students,2019-20,50833,2791,48042,94.5,451,76,16.9
6,All Students,2020-21,76541,12165,64376,84.1,448,243,54.2
6,All Students,2021-22,65918,5581,60337,91.5,393,121,30.8
6,All Students,2022-23,56349,4760,51589,91.6,332,100,30.1
7,All Students,2018-19,68972,4416,64556,93.6,399,92,23.1
7,All Students,2019-20,43755,2417,41338,94.5,384,53,13.8
7,All Students,2020-21,76537,12930,63607,83.1,442,235,53.2
7,All Students,2021-22,70125,6891,63234,90.2,413,144,34.9
7,All Students,2022-23,64183,5041,59142,92.1,380,109,28.7
8,All Students,2018-19,74707,5354,69353,92.8,429,85,19.8
8,All Students,2019-20,44967,3088,41879,93.1,396,92,23.2
8,All Students,2020-21,64961,s,s,s,s,s,s
8,All Students,2021-22,74465,8117,66348,89.1,432,168,38.9
8,All Students,2022-23,72071,7687,64384,89.3,418,149,35.6
12,All Students,2020-21,3,s,s,s,s,s,s
All Grades,All Students,2018-19,139037,8341,130696,94.0,817,141,17.3
All Grades,All Students,2019-20,84815,5252,79563,93.8,761,147,19.3
All Grades,All Students,2020-21,123443,8985,114458,92.7,729,172,23.6
All Grades,All Students,2021-22,113890,10564,103326,90.7,686,246,35.9
All Grades,All Students,2022-23,110947,10880,100067,90.2,659,244,37.0
PK in K-12 Schools,All Students,2018-19,12467,1050,11417,91.6,75,22,29.3
PK in K-12 Schools,All Students,2019-20,8109,786,7323,90.3,74,26,35.1
PK in K-12 Schools,All Students,2020-21,12627,1452,11175,88.5,78,32,41.0
PK in K-12 Schools,All Students,2021-22,13788,1731,12057,87.4,84,42,50.0
PK in K-12 Schools,All Students,2022-23,14767,2362,12405,84.0,94,58,61.7
0K,All Students,2018-19,19433,1241,18192,93.6,115,21,18.3
0K,All Students,2019-20,12115,977,11138,91.9,109,36,33.0
0K,All Students,2020-21,17237,1555,15682,91.0,105,31,29.5
0K,All Students,2021-22,15446,1543,13903,90.0,95,41,43.2
0K,All Students,2022-23,16300,1825,14475,88.8,100,45,45.0
1,All Students,2018-19,17348,904,16444,94.8,100,15,15.0
1,All Students,2019-20,10995,596,10399,94.6,100,15,15.0
1,All Students,2020-21,17031,1290,15741,92.4,99,26,26.3
1,All Students,2021-22,16347,1330,15017,91.9,101,30,29.7
1,All Students,2022-23,15379,1324,14055,91.4,88,31,35.2
2,All Students,2018-19,21550,1372,20178,93.6,130,24,18.5
2,All Students,2019-20,11628,595,11033,94.9,104,13,12.5
2,All Students,2020-21,16709,1117,15592,93.3,98,22,22.4
2,All Students,2021-22,15838,1499,14339,90.5,92,30,32.6
2,All Students,2022-23,15832,1421,14411,91.0,93,29,31.2
3,All Students,2018-19,22439,1265,21174,94.4,134,18,13.4
3,All Students,2019-20,14907,900,14007,94.0,133,25,18.8
3,All Students,2020-21,17320,884,16436,94.9,101,13,12.9
3,All Students,2021-22,16459,1295,15164,92.1,101,27,26.7
3,All Students,2022-23,15857,1494,14363,90.6,92,32,34.8
4,All Students,2018-19,23305,1324,21981,94.3,133,22,16.5
4,All Students,2019-20,13156,599,12557,95.4,116,12,10.3
4,All Students,2020-21,22225,1678,20547,92.4,132,33,25.0
4,All Students,2021-22,16269,1393,14876,91.4,96,34,35.4
4,All Students,2022-23,16470,1198,15272,92.7,97,23,23.7
5,All Students,2018-19,22495,1185,21310,94.7,130,19,14.6
5,All Students,2019-20,13905,799,13106,94.3,125,20,16.0
5,All Students,2020-21,20294,1009,19285,95.0,116,15,12.9
5,All Students,2021-22,19743,1773,17970,91.0,117,42,35.9
5,All Students,2022-23,16342,1256,15086,92.3,95,26,27.4
All Grades,All Students,2018-19,113699,7816,105883,93.1,689,171,24.8
All Grades,All Students,2019-20,72628,4756,67872,93.5,668,146,21.9
All Grades,All Students,2020-21,97183,13053,84130,86.6,582,243,41.8
All Grades,All Students,2021-22,95070,10532,84538,88.9,594,249,41.9
All Grades,All Students,2022-23,97497,9517,87980,90.2,592,228,38.5
PK in K-12 Schools,All Students,2018-19,6344,s,s,s,s,s,s
PK in K-12 Schools,All Students,2019-20,4076,286,3790,93.0,39,8,20.5
PK in K-12 Schools,All Students,2020-21,5446,603,4843,88.9,35,12,34.3
PK in K-12 Schools,All Students,2021-22,6051,765,5286,87.4,40,24,60.0
PK in K-12 Schools,All Students,2022-23,6300,847,5453,86.6,39,24,61.5
0K,All Students,2018-19,16176,1333,14843,91.8,100,30,30.0
0K,All Students,2019-20,11491,767,10724,93.3,105,28,26.7
0K,All Students,2020-21,14403,2121,12282,85.3,89,42,47.2
0K,All Students,2021-22,15534,2081,13453,86.6,95,50,52.6
0K,All Students,2022-23,15905,1962,13943,87.7,100,52,52.0
1,All Students,2018-19,18261,1329,16932,92.7,110,29,26.4
1,All Students,2019-20,10269,734,9535,92.9,101,26,25.7
1,All Students,2020-21,16429,2049,14380,87.5,99,38,38.4
1,All Students,2021-22,13288,1376,11912,89.6,86,34,39.5
1,All Students,2022-23,16186,1697,14489,89.5,97,38,39.2
2,All Students,2018-19,16738,1276,15462,92.4,102,30,29.4
2,All Students,2019-20,11521,767,10754,93.3,103,19,18.4
2,All Students,2020-21,12351,1348,11003,89.1,73,28,38.4
2,All Students,2021-22,16074,1792,14282,88.9,101,41,40.6
2,All Students,2022-23,13549,1242,12307,90.8,82,32,39.0
3,All Students,2018-19,15967,1062,14905,93.3,98,23,23.5
3,All Students,2019-20,9651,632,9019,93.5,91,21,23.1
3,All Students,2020-21,17419,2680,14739,84.6,102,45,44.1
3,All Students,2021-22,13192,1226,11966,90.7,81,24,29.6
3,All Students,2022-23,16572,1399,15173,91.6,98,32,32.7
4,All Students,2018-19,23116,1379,21737,94.0,137,28,20.4
4,All Students,2019-20,11139,720,10419,93.5,101,20,19.8
4,All Students,2020-21,14224,2242,11982,84.2,84,38,45.2
4,All Students,2021-22,16694,1637,15057,90.2,103,39,37.9
4,All Students,2022-23,12190,969,11221,92.1,75,21,28.0
5,All Students,2018-19,17095,938,16157,94.5,106,23,21.7
5,All Students,2019-20,14481,850,13631,94.1,131,26,19.8
5,All Students,2020-21,16863,2008,14855,88.1,99,40,40.4
5,All Students,2021-22,14237,1655,12582,88.4,88,37,42.0
5,All Students,2022-23,16795,1401,15394,91.7,101,29,28.7
6,All Students,2018-19,2,s,s,s,s,s,s
All Grades,All Students,2018-19,29804,1859,27945,93.8,176,36,20.5
All Grades,All Students,2019-20,16391,1168,15223,92.9,149,32,21.5
All Grades,All Students,2020-21,24447,2385,22062,90.2,142,42,29.6
All Grades,All Students,2021-22,26245,2540,23705,90.3,159,62,39.0
All Grades,All Students,2022-23,27452,2923,24529,89.4,168,64,38.1
PK in K-12 Schools,All Students,2018-19,5678,419,5259,92.6,34,11,32.4
PK in K-12 Schools,All Students,2019-20,3747,s,s,s,s,s,s
PK in K-12 Schools,All Students,2020-21,4375,507,3868,88.4,25,11,44.0
PK in K-12 Schools,All Students,2021-22,8610,983,7627,88.6,54,28,51.9
PK in K-12 Schools,All Students,2022-23,11469,1515,9954,86.8,74,33,44.6
0K,All Students,2018-19,7558,518,7040,93.1,47,13,27.7
0K,All Students,2019-20,4337,323,4014,92.6,39,10,25.6
0K,All Students,2020-21,8333,887,7446,89.4,49,14,28.6
0K,All Students,2021-22,5942,637,5305,89.3,38,19,50.0
0K,All Students,2022-23,5981,558,5423,90.7,36,13,36.1
1,All Students,2018-19,9199,513,8686,94.4,53,6,11.3
1,All Students,2019-20,4310,310,4000,92.8,40,9,22.5
1,All Students,2020-21,6039,522,5517,91.4,35,11,31.4
1,All Students,2021-22,6549,501,6048,92.3,37,9,24.3
1,All Students,2022-23,5073,559,4514,89.0,30,12,40.0
2,All Students,2018-19,7369,409,6960,94.4,42,6,14.3
2,All Students,2019-20,3995,200,3795,95.0,36,5,13.9
2,All Students,2020-21,5700,469,5231,91.8,33,6,18.2
2,All Students,2021-22,5144,419,4725,91.9,30,6,20.0
2,All Students,2022-23,4929,291,4638,94.1,28,6,21.4
3,All Students,2019-20,2,s,s,s,s,s,s
All Grades,All Students,2018-19,115337,10364,104973,91.0,713,250,35.1
All Grades,All Students,2019-20,64322,5437,58885,91.5,594,188,31.6
All Grades,All Students,2020-21,84956,14635,70321,82.8,513,277,54.0
All Grades,All Students,2021-22,76186,9667,66519,87.3,482,235,48.8
All Grades,All Students,2022-23,71097,7967,63130,88.8,448,207,46.2
PK in K-12 Schools,All Students,2018-19,8580,1188,7392,86.2,54,29,53.7
PK in K-12 Schools,All Students,2019-20,2727,307,2420,88.7,32,16,50.0
PK in K-12 Schools,All Students,2020-21,3286,750,2536,77.2,23,12,52.2
PK in K-12 Schools,All Students,2021-22,3691,533,3158,85.6,24,15,62.5
PK in K-12 Schools,All Students,2022-23,5373,665,4708,87.6,37,23,62.2
0K,All Students,2018-19,14601,1571,13030,89.2,92,41,44.6
0K,All Students,2019-20,8880,962,7918,89.2,87,40,46.0
0K,All Students,2020-21,9069,2300,6769,74.6,57,44,77.2
0K,All Students,2021-22,9447,1573,7874,83.3,60,40,66.7
0K,All Students,2022-23,9157,1178,7979,87.1,60,28,46.7
1,All Students,2018-19,21356,2106,19250,90.1,133,53,39.8
1,All Students,2019-20,10113,940,9173,90.7,92,31,33.7
1,All Students,2020-21,14985,2369,12616,84.2,90,52,57.8
1,All Students,2021-22,12235,1636,10599,86.6,77,39,50.6
1,All Students,2022-23,9232,1283,7949,86.1,58,38,65.5
2,All Students,2018-19,17097,1505,15592,91.2,105,34,32.4
2,All Students,2019-20,12084,1068,11016,91.2,111,33,29.7
2,All Students,2020-21,13189,2461,10728,81.3,81,48,59.3
2,All Students,2021-22,12002,1501,10501,87.5,77,41,53.2
2,All Students,2022-23,11223,1302,9921,88.4,71,29,40.8
3,All Students,2018-19,15341,996,14345,93.5,95,26,27.4
3,All Students,2019-20,9144,686,8458,92.5,84,23,27.4
3,All Students,2020-21,17100,2665,14435,84.4,102,55,53.9
3,All Students,2021-22,11458,1405,10053,87.7,76,36,47.4
3,All Students,2022-23,10878,1117,9761,89.7,68,32,47.1
4,All Students,2018-19,17128,1331,15797,92.2,105,29,27.6
4,All Students,2019-20,10524,644,9880,93.9,95,20,21.1
4,All Students,2020-21,12194,1637,10557,86.6,71,29,40.8
4,All Students,2021-22,15236,1558,13678,89.8,96,37,38.5
4,All Students,2022-23,10535,990,9545,90.6,65,23,35.4
5,All Students,2018-19,21234,1667,19567,92.1,129,38,29.5
5,All Students,2019-20,10850,830,10020,92.4,99,29,29.3
5,All Students,2020-21,15133,2453,12680,83.8,89,37,41.6
5,All Students,2021-22,12117,1461,10656,87.9,72,27,37.5
5,All Students,2022-23,14699,1432,13267,90.3,89,34,38.2
All Grades,All Students,2018-19,46835,2792,44043,94.0,281,65,23.1
All Grades,All Students,2019-20,33210,1867,31343,94.4,303,49,16.2
All Grades,All Students,2020-21,55267,5543,49724,90.0,320,104,32.5
All Grades,All Students,2021-22,57075,6181,50894,89.2,333,127,38.1
All Grades,All Students,2022-23,51722,5173,46549,90.0,307,109,35.5
6,All Students,2018-19,18826,1120,17706,94.1,117,32,27.4
6,All Students,2019-20,12824,665,12159,94.8,119,16,13.4
6,All Students,2020-21,19345,1253,18092,93.5,114,27,23.7
6,All Students,2021-22,20846,2145,18701,89.7,122,48,39.3
6,All Students,2022-23,13863,1064,12799,92.3,85,26,30.6
7,All Students,2018-19,11573,662,10911,94.3,70,15,21.4
7,All Students,2019-20,12592,812,11780,93.6,114,23,20.2
7,All Students,2020-21,18274,2133,16141,88.3,105,38,36.2
7,All Students,2021-22,17808,2220,15588,87.5,105,48,45.7
7,All Students,2022-23,19791,1772,18019,91.0,117,35,29.9
8,All Students,2018-19,16436,1010,15426,93.9,94,18,19.1
8,All Students,2019-20,7794,390,7404,95.0,70,10,14.3
8,All Students,2020-21,17648,2157,15491,87.8,101,39,38.6
8,All Students,2021-22,18421,1816,16605,90.1,106,31,29.2
8,All Students,2022-23,18068,2337,15731,87.1,105,48,45.7
All Grades,All Students,2018-19,683711,48798,634913,92.9,4174,858,20.6
All Grades,All Students,2019-20,444402,28592,415810,93.6,4062,732,18.0
All Grades,All Students,2020-21,711717,61479,650238,91.4,4122,910,22.1
All Grades,All Students,2021-22,677775,74796,602979,89.0,4049,1336,33.0
All Grades,All Students,2022-23,661197,61453,599744,90.7,4072,1146,28.1
9,All Students,2018-19,178143,10907,167236,93.9,1092,170,15.6
9,All Students,2019-20,113211,6239,106972,94.5,1034,136,13.2
9,All Students,2020-21,193824,16611,177213,91.4,1124,228,20.3
9,All Students,2021-22,183221,17402,165819,90.5,1100,280,25.5
9,All Students,2022-23,189077,16454,172623,91.3,1163,285,24.5
10,All Students,2018-19,181475,13141,168334,92.8,1114,212,19.0
10,All Students,2019-20,116948,7900,109048,93.2,1077,202,18.8
10,All Students,2020-21,177960,15020,162940,91.6,1032,211,20.4
10,All Students,2021-22,183430,19548,163882,89.3,1096,334,30.5
10,All Students,2022-23,177029,16419,160610,90.7,1097,284,25.9
11,All Students,2018-19,163356,9598,153758,94.1,994,168,16.9
11,All Students,2019-20,107269,6173,101096,94.2,974,147,15.1
11,All Students,2020-21,170615,13091,157524,92.3,985,183,18.6
11,All Students,2021-22,153559,14812,138747,90.4,915,272,29.7
11,All Students,2022-23,153903,11835,142068,92.3,944,221,23.4
12,All Students,2018-19,160737,15152,145585,90.6,974,308,31.6
12,All Students,2019-20,106974,8280,98694,92.3,977,247,25.3
12,All Students,2020-21,169318,16757,152561,90.1,981,288,29.4
12,All Students,2021-22,157565,23034,134531,85.4,938,450,48.0
12,All Students,2022-23,141188,16745,124443,88.1,868,356,41.0
All Grades,All Students,2018-19,628037,40929,587108,93.5,3879,535,13.8
All Grades,All Students,2019-20,425113,23622,401491,94.4,3963,519,13.1
All Grades,All Students,2020-21,667974,68940,599034,89.7,3893,988,25.4
All Grades,All Students,2021-22,589836,82934,506902,85.9,3607,1572,43.6
All Grades,All Students,2022-23,594695,72920,521775,87.7,3768,1356,36.0
8,All Students,2018-19,5,s,s,s,s,s,s
9,All Students,2018-19,192067,15977,176090,91.7,1191,189,15.9
9,All Students,2019-20,120389,8208,112181,93.2,1130,162,14.3
9,All Students,2020-21,154874,16515,138359,89.3,907,223,24.6
9,All Students,2021-22,130724,16777,113947,87.2,811,282,34.8
9,All Students,2022-23,163448,19261,144187,88.2,1044,352,33.7
10,All Students,2018-19,183139,10786,172353,94.1,1130,144,12.7
10,All Students,2019-20,118456,6762,111694,94.3,1104,156,14.1
10,All Students,2020-21,195203,23383,171820,88.0,1141,329,28.8
10,All Students,2021-22,153394,21618,131776,85.9,941,400,42.5
10,All Students,2022-23,141632,17159,124473,87.9,899,285,31.7
11,All Students,2018-19,123534,s,s,s,s,s,s
11,All Students,2019-20,98008,3469,94539,96.5,909,76,8.4
11,All Students,2020-21,155634,12060,143574,92.3,898,168,18.7
11,All Students,2021-22,156011,20752,135259,86.7,946,396,41.9
11,All Students,2022-23,140941,16308,124633,88.4,889,299,33.6
12,All Students,2018-19,129292,8905,120387,93.1,801,136,17.0
12,All Students,2019-20,88260,5183,83077,94.1,820,125,15.2
12,All Students,2020-21,162263,16982,145281,89.5,947,268,28.3
12,All Students,2021-22,149707,23787,125920,84.1,909,494,54.3
12,All Students,2022-23,148674,20192,128482,86.4,936,420,44.9
All Grades,All Students,2018-19,173724,8073,165651,95.4,1051,91,8.7
All Grades,All Students,2019-20,106977,4903,102074,95.4,979,89,9.1
All Grades,All Students,2020-21,171999,21085,150914,87.7,993,333,33.5
All Grades,All Students,2021-22,162201,12829,149372,92.1,979,215,22.0
All Grades,All Students,2022-23,157678,12344,145334,92.2,978,194,19.8
9,All Students,2018-19,49195,2037,47158,95.9,296,14,4.7
9,All Students,2019-20,18697,526,18171,97.2,172,3,1.7
9,All Students,2020-21,47616,6093,41523,87.2,276,103,37.3
9,All Students,2021-22,38899,3102,35797,92.0,236,51,21.6
9,All Students,2022-23,48647,3382,45265,93.0,300,52,17.3
10,All Students,2018-19,40981,1352,39629,96.7,249,17,6.8
10,All Students,2019-20,33003,1441,31562,95.6,301,23,7.6
10,All Students,2020-21,31594,3370,28224,89.3,183,50,27.3
10,All Students,2021-22,44648,2827,41821,93.7,273,46,16.8
10,All Students,2022-23,36824,2973,33851,91.9,235,49,20.9
11,All Students,2018-19,44304,1807,42497,95.9,269,18,6.7
11,All Students,2019-20,26562,1088,25474,95.9,244,25,10.2
11,All Students,2020-21,50793,5201,45592,89.8,295,78,26.4
11,All Students,2021-22,29646,1847,27799,93.8,180,28,15.6
11,All Students,2022-23,42495,2683,39812,93.7,260,39,15.0
12,All Students,2018-19,39244,2877,36367,92.7,237,42,17.7
12,All Students,2019-20,28715,1848,26867,93.6,262,38,14.5
12,All Students,2020-21,41996,6421,35575,84.7,239,102,42.7
12,All Students,2021-22,49008,5053,43955,89.7,290,90,31.0
12,All Students,2022-23,29712,3306,26406,88.9,183,54,29.5
All Grades,All Students,2018-19,108596,4765,103831,95.6,659,75,11.4
All Grades,All Students,2019-20,71746,3852,67894,94.6,654,99,15.1
All Grades,All Students,2020-21,113861,10567,103294,90.7,661,143,21.6
All Grades,All Students,2021-22,108730,6147,102583,94.3,649,96,14.8
All Grades,All Students,2022-23,102287,5098,97189,95.0,632,84,13.3
9,All Students,2018-19,30620,1176,29444,96.2,186,17,9.1
9,All Students,2019-20,18515,694,17821,96.3,170,14,8.2
9,All Students,2020-21,29038,2640,26398,90.9,168,34,20.2
9,All Students,2021-22,30285,2011,28274,93.4,181,29,16.0
9,All Students,2022-23,27380,1773,25607,93.5,170,37,21.8
10,All Students,2018-19,26811,1117,25694,95.8,165,20,12.1
10,All Students,2019-20,19658,821,18837,95.8,180,20,11.1
10,All Students,2020-21,29163,2916,26247,90.0,170,36,21.2
10,All Students,2021-22,25316,1924,23392,92.4,153,33,21.6
10,All Students,2022-23,27117,1532,25585,94.4,169,26,15.4
11,All Students,2018-19,24999,803,24196,96.8,151,10,6.6
11,All Students,2019-20,17190,850,16340,95.1,156,19,12.2
11,All Students,2020-21,29225,1491,27734,94.9,169,20,11.8
11,All Students,2021-22,25268,1334,23934,94.7,150,25,16.7
11,All Students,2022-23,23351,955,22396,95.9,144,14,9.7
12,All Students,2018-19,26166,1669,24497,93.6,157,28,17.8
12,All Students,2019-20,16383,1487,14896,90.9,148,46,31.1
12,All Students,2020-21,26435,3520,22915,86.7,154,53,34.4
12,All Students,2021-22,27861,878,26983,96.8,165,9,5.5
12,All Students,2022-23,24439,838,23601,96.6,149,7,4.7
All Grades,All Students,2018-19,70651,11552,59099,83.6,446,239,53.6
All Grades,All Students,2019-20,45090,6127,38963,86.4,434,204,47.0
All Grades,All Students,2020-21,71039,17927,53112,74.8,422,278,65.9
All Grades,All Students,2021-22,71313,13981,57332,80.4,469,307,65.5
All Grades,All Students,2022-23,73302,13678,59624,81.3,485,288,59.4
9,All Students,2018-19,18444,2147,16297,88.4,118,40,33.9
9,All Students,2019-20,11595,1467,10128,87.3,117,53,45.3
9,All Students,2020-21,21497,4942,16555,77.0,126,77,61.1
9,All Students,2021-22,20968,3193,17775,84.8,144,72,50.0
9,All Students,2022-23,20599,2820,17779,86.3,143,66,46.2
10,All Students,2018-19,16029,2493,13536,84.4,106,53,50.0
10,All Students,2019-20,12597,1592,11005,87.4,119,49,41.2
10,All Students,2020-21,18533,4992,13541,73.1,113,79,69.9
10,All Students,2021-22,18611,3775,14836,79.7,123,84,68.3
10,All Students,2022-23,20629,3640,16989,82.4,134,73,54.5
11,All Students,2018-19,17996,2608,15388,85.5,110,59,53.6
11,All Students,2019-20,9623,1472,8151,84.7,93,49,52.7
11,All Students,2020-21,16575,3666,12909,77.9,97,55,56.7
11,All Students,2021-22,16078,3507,12571,78.2,105,75,71.4
11,All Students,2022-23,18495,4048,14447,78.1,119,81,68.1
12,All Students,2018-19,18182,4304,13878,76.3,112,87,77.7
12,All Students,2019-20,11275,1596,9679,85.8,105,53,50.5
12,All Students,2020-21,14434,4327,10107,70.0,86,67,77.9
12,All Students,2021-22,15656,3506,12150,77.6,97,76,78.4
12,All Students,2022-23,13579,3170,10409,76.7,89,68,76.4
All Grades,All Students,2022-23,64064,12233,51831,80.9,387,281,72.6
PK in K-12 Schools,All Students,2022-23,64017,s,s,s,s,s,s
0K,All Students,2022-23,47,s,s,s,s,s,s
All Grades,All Students,2018-19,23832,1630,22202,93.2,139,31,22.3
All Grades,All Students,2019-20,22562,1722,20840,92.4,199,52,26.1
All Grades,All Students,2020-21,43740,3063,40677,93.0,261,60,23.0
All Grades,All Students,2021-22,55845,5270,50575,90.6,327,112,34.3
All Grades,All Students,2022-23,68579,5258,63321,92.3,404,104,25.7
PK in K-12 Schools,All Students,2018-19,6353,510,5843,92.0,36,10,27.8
PK in K-12 Schools,All Students,2019-20,4000,300,3700,92.5,36,7,19.4
PK in K-12 Schools,All Students,2020-21,6239,517,5722,91.7,36,8,22.2
PK in K-12 Schools,All Students,2021-22,6351,855,5496,86.5,37,24,64.9
PK in K-12 Schools,All Students,2022-23,6367,613,5754,90.4,36,11,30.6
0K,All Students,2018-19,8400,601,7799,92.8,50,11,22.0
0K,All Students,2019-20,8017,589,7428,92.7,71,17,23.9
0K,All Students,2020-21,10856,693,10163,93.6,68,14,20.6
0K,All Students,2021-22,11912,1253,10659,89.5,69,25,36.2
0K,All Students,2022-23,12769,1023,11746,92.0,76,21,27.6
1,All Students,2018-19,9079,519,8560,94.3,53,10,18.9
1,All Students,2019-20,4806,383,4423,92.0,43,13,30.2
1,All Students,2020-21,10850,649,10201,94.0,65,14,21.5
1,All Students,2021-22,11021,806,10215,92.7,65,14,21.5
1,All Students,2022-23,11957,962,10995,92.0,69,14,20.3
2,All Students,2019-20,5739,450,5289,92.2,50,16,32.0
2,All Students,2020-21,7581,702,6879,90.7,44,15,34.1
2,All Students,2021-22,10518,928,9590,91.2,62,19,30.6
2,All Students,2022-23,10373,629,9744,93.9,61,10,16.4
3,All Students,2020-21,8214,502,7712,93.9,48,9,18.8
3,All Students,2021-22,7879,767,7112,90.3,46,17,37.0
3,All Students,2022-23,10541,781,9760,92.6,64,19,29.7
4,All Students,2021-22,8164,661,7503,91.9,48,13,27.1
4,All Students,2022-23,8424,724,7700,91.4,50,15,30.0
5,All Students,2022-23,8148,526,7622,93.5,48,14,29.2
All Grades,All Students,2018-19,37543,1237,36306,96.7,214,10,4.7
All Grades,All Students,2019-20,33490,1228,32262,96.3,296,20,6.8
All Grades,All Students,2020-21,50718,4503,46215,91.1,293,87,29.7
All Grades,All Students,2021-22,50266,3612,46654,92.8,290,74,25.5
All Grades,All Students,2022-23,53825,3286,50539,93.9,305,56,18.4
6,All Students,2018-19,18300,691,17609,96.2,104,5,4.8
6,All Students,2019-20,10291,396,9895,96.2,92,6,6.5
6,All Students,2020-21,18457,1635,16822,91.1,108,29,26.9
6,All Students,2021-22,18604,1237,17367,93.4,108,27,25.0
6,All Students,2022-23,18614,1039,17575,94.4,105,18,17.1
7,All Students,2018-19,19243,546,18697,97.2,110,5,4.5
7,All Students,2019-20,11049,427,10622,96.1,98,9,9.2
7,All Students,2020-21,15537,1565,13972,89.9,89,32,36.0
7,All Students,2021-22,17205,1214,15991,92.9,100,24,24.0
7,All Students,2022-23,18453,1227,17226,93.4,105,22,21.0
8,All Students,2019-20,12150,405,11745,96.7,106,5,4.7
8,All Students,2020-21,16724,1303,15421,92.2,96,26,27.1
8,All Students,2021-22,14457,1161,13296,92.0,82,23,28.0
8,All Students,2022-23,16758,1020,15738,93.9,95,16,16.8
All Grades,All Students,2018-19,71314,9368,61946,86.9,449,232,51.7
All Grades,All Students,2019-20,37479,4483,32996,88.0,361,160,44.3
All Grades,All Students,2020-21,51311,4604,46707,91.0,305,99,32.5
All Grades,All Students,2021-22,44142,8299,35843,81.2,295,210,71.2
All Grades,All Students,2022-23,27585,3608,23977,86.9,185,112,60.5
PK in K-12 Schools,All Students,2022-23,22,s,s,s,s,s,s
0K,All Students,2018-19,4437,675,3762,84.8,28,16,57.1
0K,All Students,2019-20,2545,342,2203,86.6,27,12,44.4
0K,All Students,2020-21,4692,693,3999,85.2,29,12,41.4
0K,All Students,2021-22,4005,854,3151,78.7,27,22,81.5
0K,All Students,2022-23,3618,547,3071,84.9,27,16,59.3
1,All Students,2018-19,7651,1144,6507,85.0,49,29,59.2
1,All Students,2019-20,2928,467,2461,84.1,28,16,57.1
1,All Students,2020-21,3768,381,3387,89.9,22,8,36.4
1,All Students,2021-22,4683,856,3827,81.7,32,26,81.3
1,All Students,2022-23,4658,654,4004,86.0,29,22,75.9
2,All Students,2018-19,7414,1060,6354,85.7,48,27,56.3
2,All Students,2019-20,3988,572,3416,85.7,39,21,53.8
2,All Students,2020-21,3743,517,3226,86.2,23,11,47.8
2,All Students,2021-22,4161,811,3350,80.5,31,22,71.0
2,All Students,2022-23,5332,534,4798,90.0,36,19,52.8
3,All Students,2018-19,7067,913,6154,87.1,47,20,42.6
3,All Students,2019-20,3822,574,3248,85.0,35,21,60.0
3,All Students,2020-21,5696,582,5114,89.8,34,15,44.1
3,All Students,2021-22,3652,781,2871,78.6,24,18,75.0
3,All Students,2022-23,4579,616,3963,86.5,30,18,60.0
4,All Students,2018-19,8491,981,7510,88.4,54,26,48.1
4,All Students,2019-20,3589,360,3229,90.0,37,10,27.0
4,All Students,2020-21,5922,542,5380,90.8,35,12,34.3
4,All Students,2021-22,4800,912,3888,81.0,31,22,71.0
4,All Students,2022-23,3970,561,3409,85.9,25,15,60.0
5,All Students,2018-19,7020,717,6303,89.8,43,19,44.2
5,All Students,2019-20,4783,499,4284,89.6,45,21,46.7
5,All Students,2020-21,4719,221,4498,95.3,29,4,13.8
5,All Students,2021-22,4695,1121,3574,76.1,32,25,78.1
5,All Students,2022-23,5398,683,4715,87.3,37,21,56.8
6,All Students,2018-19,9044,1139,7905,87.4,57,30,52.6
6,All Students,2019-20,4326,434,3892,90.0,42,17,40.5
6,All Students,2020-21,7012,501,6511,92.9,41,15,36.6
6,All Students,2021-22,5044,590,4454,88.3,34,17,50.0
7,All Students,2018-19,8814,989,7825,88.8,57,26,45.6
7,All Students,2019-20,5912,697,5215,88.2,55,24,43.6
7,All Students,2020-21,6620,525,6095,92.1,39,10,25.6
7,All Students,2021-22,6311,1015,5296,83.9,40,26,65.0
8,All Students,2018-19,11376,1750,9626,84.6,66,39,59.1
8,All Students,2019-20,5586,538,5048,90.4,53,18,34.0
8,All Students,2020-21,9139,642,8497,93.0,53,12,22.6
8,All Students,2021-22,6791,1359,5432,80.0,44,32,72.7
9,All Students,2022-23,8,s,s,s,s,s,s
All Grades,All Students,2018-19,51239,5268,45971,89.7,308,113,36.7
All Grades,All Students,2019-20,22030,2330,19700,89.4,196,85,43.4
All Grades,All Students,2020-21,30208,5928,24280,80.4,175,94,53.7
All Grades,All Students,2021-22,27021,3918,23103,85.5,160,93,58.1
All Grades,All Students,2022-23,24458,3287,21171,86.6,152,82,53.9
PK in K-12 Schools,All Students,2018-19,5563,895,4668,83.9,34,17,50.0
PK in K-12 Schools,All Students,2019-20,3264,353,2911,89.2,29,13,44.8
PK in K-12 Schools,All Students,2020-21,4476,953,3523,78.7,26,15,57.7
PK in K-12 Schools,All Students,2021-22,4870,702,4168,85.6,29,18,62.1
PK in K-12 Schools,All Students,2022-23,5038,577,4461,88.5,33,13,39.4
0K,All Students,2018-19,3852,649,3203,83.2,26,14,53.8
0K,All Students,2019-20,3092,413,2679,86.6,27,17,63.0
0K,All Students,2020-21,3307,829,2478,74.9,19,13,68.4
0K,All Students,2021-22,3078,428,2650,86.1,20,12,60.0
0K,All Students,2022-23,3756,622,3134,83.4,23,19,82.6
1,All Students,2018-19,4923,421,4502,91.4,30,11,36.7
1,All Students,2019-20,2374,348,2026,85.3,23,12,52.2
1,All Students,2020-21,4135,1291,2844,68.8,24,15,62.5
1,All Students,2021-22,2479,353,2126,85.8,14,7,50.0
1,All Students,2022-23,2592,s,s,s,s,s,s
2,All Students,2018-19,5227,423,4804,91.9,32,10,31.3
2,All Students,2019-20,3238,256,2982,92.1,29,7,24.1
2,All Students,2020-21,3326,409,2917,87.7,19,8,42.1
2,All Students,2021-22,4171,635,3536,84.8,25,16,64.0
2,All Students,2022-23,2750,471,2279,82.9,17,11,64.7
3,All Students,2018-19,5145,656,4489,87.2,30,16,53.3
3,All Students,2019-20,2764,191,2573,93.1,24,8,33.3
3,All Students,2020-21,4984,963,4021,80.7,29,16,55.2
3,All Students,2021-22,3668,549,3119,85.0,21,10,47.6
3,All Students,2022-23,3458,540,2918,84.4,21,11,52.4
4,All Students,2018-19,6509,576,5933,91.2,39,13,33.3
4,All Students,2019-20,3569,453,3116,87.3,31,16,51.6
4,All Students,2020-21,4550,687,3863,84.9,26,10,38.5
4,All Students,2021-22,4507,679,3828,84.9,27,16,59.3
4,All Students,2022-23,3351,399,2952,88.1,20,9,45.0
5,All Students,2018-19,6092,439,5653,92.8,35,7,20.0
5,All Students,2019-20,3729,316,3413,91.5,33,12,36.4
5,All Students,2020-21,5430,796,4634,85.3,32,17,53.1
5,All Students,2021-22,4248,572,3676,86.5,24,14,58.3
5,All Students,2022-23,3484,374,3110,89.3,20,9,45.0
6,All Students,2018-19,3467,274,3193,92.1,22,7,31.8
7,All Students,2018-19,5655,443,5212,92.2,33,7,21.2
8,All Students,2018-19,4806,492,4314,89.8,27,11,40.7
8,All Students,2022-23,29,s,s,s,s,s,s
All Grades,All Students,2018-19,35993,4767,31226,86.8,240,123,51.3
All Grades,All Students,2019-20,21714,2609,19105,88.0,205,89,43.4
All Grades,All Students,2020-21,28313,3169,25144,88.8,167,62,37.1
All Grades,All Students,2021-22,27461,4188,23273,84.7,172,118,68.6
All Grades,All Students,2022-23,24983,3203,21780,87.2,158,89,56.3
PK in K-12 Schools,All Students,2018-19,6942,1490,5452,78.5,48,34,70.8
PK in K-12 Schools,All Students,2019-20,3785,577,3208,84.8,34,17,50.0
PK in K-12 Schools,All Students,2020-21,4089,424,3665,89.6,24,8,33.3
PK in K-12 Schools,All Students,2021-22,2878,487,2391,83.1,20,17,85.0
PK in K-12 Schools,All Students,2022-23,2634,482,2152,81.7,17,15,88.2
0K,All Students,2018-19,3909,591,3318,84.9,27,21,77.8
0K,All Students,2019-20,2777,365,2412,86.9,27,16,59.3
0K,All Students,2020-21,3637,442,3195,87.8,22,9,40.9
0K,All Students,2021-22,4316,634,3682,85.3,26,18,69.2
0K,All Students,2022-23,3142,511,2631,83.7,22,17,77.3
1,All Students,2018-19,4666,598,4068,87.2,32,14,43.8
1,All Students,2019-20,2488,368,2120,85.2,22,13,59.1
1,All Students,2020-21,4093,590,3503,85.6,24,10,41.7
1,All Students,2021-22,3751,502,3249,86.6,23,14,60.9
1,All Students,2022-23,4132,503,3629,87.8,28,13,46.4
2,All Students,2018-19,6450,809,5641,87.5,43,20,46.5
2,All Students,2019-20,3315,353,2962,89.4,34,13,38.2
2,All Students,2020-21,3675,467,3208,87.3,21,11,52.4
2,All Students,2021-22,4270,632,3638,85.2,28,19,67.9
2,All Students,2022-23,3632,419,3213,88.5,24,12,50.0
3,All Students,2018-19,4209,342,3867,91.9,28,9,32.1
3,All Students,2019-20,3496,396,3100,88.7,35,13,37.1
3,All Students,2020-21,4914,449,4465,90.9,28,7,25.0
3,All Students,2021-22,4139,763,3376,81.6,26,20,76.9
3,All Students,2022-23,3602,461,3141,87.2,22,13,59.1
4,All Students,2018-19,6352,661,5691,89.6,38,16,42.1
4,All Students,2019-20,2500,200,2300,92.0,23,5,21.7
4,All Students,2020-21,4392,342,4050,92.2,26,6,23.1
4,All Students,2021-22,4237,475,3762,88.8,25,13,52.0
4,All Students,2022-23,3234,376,2858,88.4,19,8,42.1
5,All Students,2018-19,3465,276,3189,92.0,24,9,37.5
5,All Students,2019-20,3353,350,3003,89.6,30,12,40.0
5,All Students,2020-21,3472,s,s,s,s,s,s
5,All Students,2021-22,3870,695,3175,82.0,24,17,70.8
5,All Students,2022-23,4607,451,4156,90.2,26,11,42.3
6,All Students,2020-21,41,s,s,s,s,s,s
All Grades,All Students,2018-19,78480,9646,68834,87.7,500,261,52.2
All Grades,All Students,2019-20,44501,4504,39997,89.9,422,161,38.2
All Grades,All Students,2020-21,59324,8869,50455,85.0,354,153,43.2
All Grades,All Students,2021-22,57158,8113,49045,85.8,368,207,56.3
All Grades,All Students,2022-23,56140,7602,48538,86.5,371,188,50.7
PK in K-12 Schools,All Students,2018-19,11031,1738,9293,84.2,72,51,70.8
PK in K-12 Schools,All Students,2019-20,6527,1049,5478,83.9,64,40,62.5
PK in K-12 Schools,All Students,2020-21,6508,1118,5390,82.8,41,24,58.5
PK in K-12 Schools,All Students,2021-22,6577,1182,5395,82.0,48,37,77.1
PK in K-12 Schools,All Students,2022-23,6779,1033,5746,84.8,46,27,58.7
0K,All Students,2018-19,6436,822,5614,87.2,42,25,59.5
0K,All Students,2019-20,4373,487,3886,88.9,43,20,46.5
0K,All Students,2020-21,4847,982,3865,79.7,30,17,56.7
0K,All Students,2021-22,5113,1043,4070,79.6,34,27,79.4
0K,All Students,2022-23,4729,984,3745,79.2,36,27,75.0
1,All Students,2018-19,7568,907,6661,88.0,51,27,52.9
1,All Students,2019-20,3823,350,3473,90.8,35,11,31.4
1,All Students,2020-21,6041,883,5158,85.4,36,18,50.0
1,All Students,2021-22,5352,752,4600,85.9,34,18,52.9
1,All Students,2022-23,5226,775,4451,85.2,34,21,61.8
2,All Students,2018-19,7224,810,6414,88.8,46,20,43.5
2,All Students,2019-20,4378,300,4078,93.1,39,9,23.1
2,All Students,2020-21,5713,438,5275,92.3,33,6,18.2
2,All Students,2021-22,6541,759,5782,88.4,39,16,41.0
2,All Students,2022-23,5228,576,4652,89.0,33,15,45.5
3,All Students,2018-19,9493,990,8503,89.6,59,30,50.8
3,All Students,2019-20,4073,346,3727,91.5,39,10,25.6
3,All Students,2020-21,6426,876,5550,86.4,39,16,41.0
3,All Students,2021-22,4842,532,4310,89.0,31,14,45.2
3,All Students,2022-23,5457,629,4828,88.5,36,19,52.8
4,All Students,2018-19,7383,538,6845,92.7,50,16,32.0
4,All Students,2019-20,5640,534,5106,90.5,56,25,44.6
4,All Students,2020-21,5706,584,5122,89.8,34,9,26.5
4,All Students,2021-22,5908,732,5176,87.6,36,20,55.6
4,All Students,2022-23,5273,485,4788,90.8,34,13,38.2
5,All Students,2018-19,5834,702,5132,88.0,36,21,58.3
5,All Students,2019-20,3050,223,2827,92.7,30,6,20.0
5,All Students,2020-21,8832,1543,7289,82.5,51,26,51.0
5,All Students,2021-22,5999,824,5175,86.3,39,19,48.7
5,All Students,2022-23,6055,678,5377,88.8,38,13,34.2
6,All Students,2018-19,6679,1001,5678,85.0,43,24,55.8
6,All Students,2019-20,3664,382,3282,89.6,33,14,42.4
6,All Students,2020-21,4966,586,4380,88.2,31,10,32.3
6,All Students,2021-22,7811,1115,6696,85.7,48,24,50.0
6,All Students,2022-23,5175,678,4497,86.9,34,12,35.3
7,All Students,2018-19,7505,915,6590,87.8,46,22,47.8
7,All Students,2019-20,4055,375,3680,90.8,38,13,34.2
7,All Students,2020-21,4681,1028,3653,78.0,27,14,51.9
7,All Students,2021-22,4530,639,3891,85.9,30,20,66.7
7,All Students,2022-23,7685,954,6731,87.6,47,23,48.9
8,All Students,2018-19,9327,1223,8104,86.9,55,25,45.5
8,All Students,2019-20,4918,458,4460,90.7,45,13,28.9
8,All Students,2020-21,5604,831,4773,85.2,32,13,40.6
8,All Students,2021-22,4485,535,3950,88.1,29,12,41.4
8,All Students,2022-23,4533,810,3723,82.1,33,18,54.5
All Grades,All Students,2018-19,114179,12207,101972,89.3,715,303,42.4
All Grades,All Students,2019-20,66755,6610,60145,90.1,626,248,39.6
All Grades,All Students,2020-21,91269,11780,79489,87.1,552,244,44.2
All Grades,All Students,2021-22,83403,11573,71830,86.1,519,303,58.4
All Grades,All Students,2022-23,85154,9566,75588,88.8,534,259,48.5
PK in K-12 Schools,All Students,2018-19,8608,1225,7383,85.8,52,31,59.6
PK in K-12 Schools,All Students,2019-20,5083,665,4418,86.9,50,24,48.0
PK in K-12 Schools,All Students,2020-21,4379,s,s,s,s,s,s
PK in K-12 Schools,All Students,2021-22,6015,895,5120,85.1,41,28,68.3
PK in K-12 Schools,All Students,2022-23,10565,1548,9017,85.3,67,46,68.7
0K,All Students,2018-19,16880,2260,14620,86.6,107,51,47.7
0K,All Students,2019-20,9547,1242,8305,87.0,91,54,59.3
0K,All Students,2020-21,11733,2210,9523,81.2,77,48,62.3
0K,All Students,2021-22,9297,1533,7764,83.5,60,44,73.3
0K,All Students,2022-23,9250,1132,8118,87.8,63,32,50.8
1,All Students,2018-19,16582,1883,14699,88.6,104,50,48.1
1,All Students,2019-20,9814,1033,8781,89.5,92,40,43.5
1,All Students,2020-21,13095,1962,11133,85.0,78,38,48.7
1,All Students,2021-22,12791,1883,10908,85.3,83,48,57.8
1,All Students,2022-23,11494,1670,9824,85.5,73,46,63.0
2,All Students,2018-19,17892,2043,15849,88.6,116,46,39.7
2,All Students,2019-20,9939,990,8949,90.0,93,35,37.6
2,All Students,2020-21,15058,1210,13848,92.0,90,27,30.0
2,All Students,2021-22,12561,1823,10738,85.5,80,48,60.0
2,All Students,2022-23,12814,1424,11390,88.9,80,39,48.8
3,All Students,2018-19,19117,1881,17236,90.2,122,47,38.5
3,All Students,2019-20,10504,893,9611,91.5,99,36,36.4
3,All Students,2020-21,14246,2011,12235,85.9,86,44,51.2
3,All Students,2021-22,14182,1729,12453,87.8,83,42,50.6
3,All Students,2022-23,12880,1430,11450,88.9,83,40,48.2
4,All Students,2018-19,16484,1616,14868,90.2,102,46,45.1
4,All Students,2019-20,12032,923,11109,92.3,109,30,27.5
4,All Students,2020-21,14910,1997,12913,86.6,89,38,42.7
4,All Students,2021-22,13347,1564,11783,88.3,78,38,48.7
4,All Students,2022-23,13238,1126,12112,91.5,81,28,34.6
5,All Students,2018-19,18616,1299,17317,93.0,112,32,28.6
5,All Students,2019-20,9836,864,8972,91.2,92,29,31.5
5,All Students,2020-21,17681,1979,15702,88.8,102,39,38.2
5,All Students,2021-22,15210,2146,13064,85.9,94,55,58.5
5,All Students,2022-23,14913,1236,13677,91.7,87,28,32.2
6,All Students,2020-21,167,s,s,s,s,s,s
All Grades,All Students,2018-19,50225,6766,43459,86.5,332,169,50.9
All Grades,All Students,2019-20,32564,4227,28337,87.0,313,141,45.0
All Grades,All Students,2020-21,41206,7334,33872,82.2,257,132,51.4
All Grades,All Students,2021-22,37925,6257,31668,83.5,251,166,66.1
All Grades,All Students,2022-23,34090,5101,28989,85.0,224,133,59.4
PK in K-12 Schools,All Students,2018-19,23083,3712,19371,83.9,160,97,60.6
PK in K-12 Schools,All Students,2019-20,16334,2522,13812,84.6,159,81,50.9
PK in K-12 Schools,All Students,2020-21,14469,2980,11489,79.4,97,61,62.9
PK in K-12 Schools,All Students,2021-22,10758,1987,8771,81.5,75,57,76.0
PK in K-12 Schools,All Students,2022-23,10237,1534,8703,85.0,70,44,62.9
0K,All Students,2018-19,4315,584,3731,86.5,29,13,44.8
0K,All Students,2019-20,2523,347,2176,86.2,25,10,40.0
0K,All Students,2020-21,6165,911,5254,85.2,38,18,47.4
0K,All Students,2021-22,6353,1004,5349,84.2,41,26,63.4
0K,All Students,2022-23,4119,683,3436,83.4,27,19,70.4
1,All Students,2018-19,4205,509,3696,87.9,27,11,40.7
1,All Students,2019-20,2975,294,2681,90.1,29,10,34.5
1,All Students,2020-21,3598,1048,2550,70.9,22,14,63.6
1,All Students,2021-22,5750,879,4871,84.7,39,22,56.4
1,All Students,2022-23,5535,901,4634,83.7,37,21,56.8
2,All Students,2018-19,4570,483,4087,89.4,28,13,46.4
2,All Students,2019-20,3086,361,2725,88.3,29,12,41.4
2,All Students,2020-21,4526,663,3863,85.4,27,10,37.0
2,All Students,2021-22,3484,675,2809,80.6,23,17,73.9
2,All Students,2022-23,4508,599,3909,86.7,30,16,53.3
3,All Students,2018-19,4516,530,3986,88.3,31,15,48.4
3,All Students,2019-20,2477,238,2239,90.4,24,9,37.5
3,All Students,2020-21,4725,693,4032,85.3,27,11,40.7
3,All Students,2021-22,3518,661,2857,81.2,23,18,78.3
3,All Students,2022-23,2614,531,2083,79.7,16,11,68.8
4,All Students,2018-19,4780,538,4242,88.7,28,12,42.9
4,All Students,2019-20,2527,231,2296,90.9,24,9,37.5
4,All Students,2020-21,3547,659,2888,81.4,22,12,54.5
4,All Students,2021-22,4343,545,3798,87.5,27,12,44.4
4,All Students,2022-23,3379,544,2835,83.9,21,14,66.7
5,All Students,2018-19,4756,410,4346,91.4,29,8,27.6
5,All Students,2019-20,2642,234,2408,91.1,24,10,41.7
5,All Students,2020-21,4176,380,3796,90.9,24,6,25.0
5,All Students,2021-22,3719,506,3213,86.4,23,14,60.9
5,All Students,2022-23,3698,309,3389,91.6,23,8,34.8
All Grades,All Students,2018-19,61273,8494,52779,86.1,408,218,53.4
All Grades,All Students,2019-20,36729,4560,32169,87.6,350,175,50.0
All Grades,All Students,2020-21,48649,6955,41694,85.7,302,118,39.1
All Grades,All Students,2021-22,49140,8152,40988,83.4,320,177,55.3
All Grades,All Students,2022-23,54233,8445,45788,84.4,367,207,56.4
PK in K-12 Schools,All Students,2018-19,12421,2279,10142,81.7,85,57,67.1
PK in K-12 Schools,All Students,2019-20,6941,912,6029,86.9,74,37,50.0
PK in K-12 Schools,All Students,2020-21,7658,1354,6304,82.3,50,28,56.0
PK in K-12 Schools,All Students,2021-22,8297,1800,6497,78.3,61,49,80.3
PK in K-12 Schools,All Students,2022-23,9440,2038,7402,78.4,70,56,80.0
0K,All Students,2018-19,4316,802,3514,81.4,28,19,67.9
0K,All Students,2019-20,2931,542,2389,81.5,26,21,80.8
0K,All Students,2020-21,3013,464,2549,84.6,21,8,38.1
0K,All Students,2021-22,4651,854,3797,81.6,28,14,50.0
0K,All Students,2022-23,4344,631,3713,85.5,30,16,53.3
1,All Students,2018-19,4062,682,3380,83.2,31,21,67.7
1,All Students,2019-20,2541,402,2139,84.2,26,16,61.5
1,All Students,2020-21,4133,1191,2942,71.2,25,18,72.0
1,All Students,2021-22,3376,456,2920,86.5,24,11,45.8
1,All Students,2022-23,4249,559,3690,86.8,28,14,50.0
2,All Students,2018-19,4391,681,3710,84.5,28,19,67.9
2,All Students,2019-20,2082,316,1766,84.8,21,12,57.1
2,All Students,2020-21,3999,900,3099,77.5,25,13,52.0
2,All Students,2021-22,4155,640,3515,84.6,27,18,66.7
2,All Students,2022-23,3275,352,2923,89.3,22,10,45.5
3,All Students,2018-19,4704,541,4163,88.5,30,15,50.0
3,All Students,2019-20,3302,363,2939,89.0,29,13,44.8
3,All Students,2020-21,2993,505,2488,83.1,19,9,47.4
3,All Students,2021-22,2942,s,s,s,s,s,s
3,All Students,2022-23,4592,671,3921,85.4,30,17,56.7
4,All Students,2018-19,7217,832,6385,88.5,47,19,40.4
4,All Students,2019-20,2640,332,2308,87.4,25,15,60.0
4,All Students,2020-21,4792,572,4220,88.1,30,9,30.0
4,All Students,2021-22,4543,1022,3521,77.5,27,15,55.6
4,All Students,2022-23,3991,635,3356,84.1,29,15,51.7
5,All Students,2018-19,4228,555,3673,86.9,28,10,35.7
5,All Students,2019-20,3773,363,3410,90.4,33,12,36.4
5,All Students,2020-21,3941,341,3600,91.3,25,8,32.0
5,All Students,2021-22,5443,690,4753,87.3,35,16,45.7
5,All Students,2022-23,4549,789,3760,82.7,32,19,59.4
6,All Students,2018-19,6894,880,6014,87.2,44,25,56.8
6,All Students,2019-20,3268,411,2857,87.4,31,14,45.2
6,All Students,2020-21,6351,480,5871,92.4,38,9,23.7
6,All Students,2021-22,5400,871,4529,83.9,36,19,52.8
6,All Students,2022-23,6477,872,5605,86.5,38,17,44.7
7,All Students,2018-19,6876,645,6231,90.6,46,18,39.1
7,All Students,2019-20,4522,497,4025,89.0,41,17,41.5
7,All Students,2020-21,4773,546,4227,88.6,28,6,21.4
7,All Students,2021-22,6811,969,5842,85.8,40,18,45.0
7,All Students,2022-23,6248,1091,5157,82.5,41,23,56.1
8,All Students,2018-19,6164,597,5567,90.3,41,15,36.6
8,All Students,2019-20,4729,422,4307,91.1,44,18,40.9
8,All Students,2020-21,6996,602,6394,91.4,41,10,24.4
8,All Students,2021-22,3493,483,3010,86.2,21,8,38.1
8,All Students,2022-23,7068,807,6261,88.6,47,20,42.6
9,All Students,2021-22,29,s,s,s,s,s,s
All Grades,All Students,2018-19,92417,11353,81064,87.7,581,293,50.4
All Grades,All Students,2019-20,59081,6156,52925,89.6,552,227,41.1
All Grades,All Students,2020-21,80128,11553,68575,85.6,474,240,50.6
All Grades,All Students,2021-22,77803,11773,66030,84.9,468,272,58.1
All Grades,All Students,2022-23,81132,12328,68804,84.8,515,318,61.7
PK in K-12 Schools,All Students,2018-19,4970,1145,3825,77.0,41,33,80.5
PK in K-12 Schools,All Students,2019-20,4774,687,4087,85.6,49,27,55.1
PK in K-12 Schools,All Students,2020-21,1590,256,1334,83.9,11,5,45.5
PK in K-12 Schools,All Students,2021-22,5785,s,s,s,s,s,s
PK in K-12 Schools,All Students,2022-23,3351,530,2821,84.2,25,16,64.0
0K,All Students,2018-19,10502,1501,9001,85.7,62,36,58.1
0K,All Students,2019-20,6490,974,5516,85.0,60,31,51.7
0K,All Students,2020-21,7706,1204,6502,84.4,51,32,62.7
0K,All Students,2021-22,6674,1097,5577,83.6,42,31,73.8
0K,All Students,2022-23,9621,1668,7953,82.7,60,44,73.3
1,All Students,2018-19,9147,1289,7858,85.9,61,30,49.2
1,All Students,2019-20,6315,744,5571,88.2,57,27,47.4
1,All Students,2020-21,8782,1363,7419,84.5,51,27,52.9
1,All Students,2021-22,7850,1213,6637,84.5,47,29,61.7
1,All Students,2022-23,8353,1387,6966,83.4,51,38,74.5
2,All Students,2018-19,8702,1051,7651,87.9,55,30,54.5
2,All Students,2019-20,5788,556,5232,90.4,55,21,38.2
2,All Students,2020-21,8946,1230,7716,86.3,52,27,51.9
2,All Students,2021-22,7578,1333,6245,82.4,46,32,69.6
2,All Students,2022-23,6773,958,5815,85.9,45,27,60.0
3,All Students,2018-19,12975,1494,11481,88.5,78,40,51.3
3,All Students,2019-20,6109,555,5554,90.9,57,24,42.1
3,All Students,2020-21,7471,885,6586,88.2,43,19,44.2
3,All Students,2021-22,7713,1311,6402,83.0,46,24,52.2
3,All Students,2022-23,8010,1385,6625,82.7,47,32,68.1
4,All Students,2018-19,9496,901,8595,90.5,58,22,37.9
4,All Students,2019-20,7083,656,6427,90.7,64,21,32.8
4,All Students,2020-21,9091,1161,7930,87.2,52,26,50.0
4,All Students,2021-22,7771,906,6865,88.3,45,22,48.9
4,All Students,2022-23,7929,1322,6607,83.3,55,36,65.5
5,All Students,2018-19,10235,1122,9113,89.0,63,29,46.0
5,All Students,2019-20,5734,378,5356,93.4,52,15,28.8
5,All Students,2020-21,9304,1373,7931,85.2,55,29,52.7
5,All Students,2021-22,9456,1163,8293,87.7,55,27,49.1
5,All Students,2022-23,8697,1022,7675,88.2,54,29,53.7
6,All Students,2018-19,8730,954,7776,89.1,55,23,41.8
6,All Students,2019-20,6395,652,5743,89.8,62,28,45.2
6,All Students,2020-21,8871,1074,7797,87.9,52,19,36.5
6,All Students,2021-22,8074,1265,6809,84.3,48,25,52.1
6,All Students,2022-23,10157,1531,8626,84.9,66,38,57.6
7,All Students,2018-19,8091,844,7247,89.6,49,24,49.0
7,All Students,2019-20,5637,480,5157,91.5,53,18,34.0
7,All Students,2020-21,9792,1604,8188,83.6,56,35,62.5
7,All Students,2021-22,8275,960,7315,88.4,50,24,48.0
7,All Students,2022-23,8389,1381,7008,83.5,53,33,62.3
8,All Students,2018-19,9569,1052,8517,89.0,59,26,44.1
8,All Students,2019-20,4755,s,s,s,s,s,s
8,All Students,2020-21,8575,1403,7172,83.6,51,21,41.2
8,All Students,2021-22,8625,1236,7389,85.7,53,28,52.8
8,All Students,2022-23,9852,1144,8708,88.4,59,25,42.4
9,All Students,2019-20,1,s,s,s,s,s,s
9,All Students,2021-22,2,s,s,s,s,s,s
All Grades,All Students,2018-19,52109,5278,46831,89.9,331,131,39.6
All Grades,All Students,2019-20,32560,3485,29075,89.3,308,123,39.9
All Grades,All Students,2020-21,45910,3670,42240,92.0,273,67,24.5
All Grades,All Students,2021-22,41936,6863,35073,83.6,255,160,62.7
All Grades,All Students,2022-23,41856,5027,36829,88.0,252,125,49.6
PK in K-12 Schools,All Students,2018-19,8232,1053,7179,87.2,58,29,50.0
PK in K-12 Schools,All Students,2019-20,6074,917,5157,84.9,62,35,56.5
PK in K-12 Schools,All Students,2020-21,6881,952,5929,86.2,41,20,48.8
PK in K-12 Schools,All Students,2021-22,5999,1122,4877,81.3,40,29,72.5
PK in K-12 Schools,All Students,2022-23,7107,979,6128,86.2,44,21,47.7
0K,All Students,2018-19,5969,835,5134,86.0,41,22,53.7
0K,All Students,2019-20,3352,391,2961,88.3,32,13,40.6
0K,All Students,2020-21,6546,769,5777,88.3,40,15,37.5
0K,All Students,2021-22,5766,790,4976,86.3,36,21,58.3
0K,All Students,2022-23,5186,726,4460,86.0,33,24,72.7
1,All Students,2018-19,6640,792,5848,88.1,43,24,55.8
1,All Students,2019-20,4029,476,3553,88.2,36,17,47.2
1,All Students,2020-21,5448,s,s,s,s,s,s
1,All Students,2021-22,6855,1259,5596,81.6,41,29,70.7
1,All Students,2022-23,5524,619,4905,88.8,33,13,39.4
2,All Students,2018-19,7421,617,6804,91.7,46,15,32.6
2,All Students,2019-20,4144,440,3704,89.4,39,18,46.2
2,All Students,2020-21,5973,519,5454,91.3,35,6,17.1
2,All Students,2021-22,5623,836,4787,85.1,33,17,51.5
2,All Students,2022-23,5836,613,5223,89.5,33,14,42.4
3,All Students,2018-19,7515,690,6825,90.8,47,14,29.8
3,All Students,2019-20,4603,392,4211,91.5,44,16,36.4
3,All Students,2020-21,6240,504,5736,91.9,38,9,23.7
3,All Students,2021-22,5329,869,4460,83.7,33,19,57.6
3,All Students,2022-23,6161,705,5456,88.6,37,17,45.9
4,All Students,2018-19,8672,729,7943,91.6,52,17,32.7
4,All Students,2019-20,4825,420,4405,91.3,45,13,28.9
4,All Students,2020-21,7321,149,7172,98.0,43,3,7.0
4,All Students,2021-22,5814,1050,4764,81.9,34,23,67.6
4,All Students,2022-23,5879,652,5227,88.9,36,18,50.0
5,All Students,2018-19,7660,562,7098,92.7,44,10,22.7
5,All Students,2019-20,5533,449,5084,91.9,50,11,22.0
5,All Students,2020-21,7432,321,7111,95.7,43,4,9.3
5,All Students,2021-22,6550,937,5613,85.7,38,22,57.9
5,All Students,2022-23,6163,733,5430,88.1,36,18,50.0
8,All Students,2020-21,69,s,s,s,s,s,s
All Grades,All Students,2018-19,50544,5242,45302,89.6,322,134,41.6
All Grades,All Students,2019-20,34961,3923,31038,88.8,325,140,43.1
All Grades,All Students,2020-21,49786,4572,45214,90.8,305,96,31.5
All Grades,All Students,2021-22,54103,7611,46492,85.9,343,180,52.5
All Grades,All Students,2022-23,60568,7717,52851,87.3,397,183,46.1
PK in K-12 Schools,All Students,2018-19,11081,1588,9493,85.7,72,43,59.7
PK in K-12 Schools,All Students,2019-20,7145,1308,5837,81.7,66,42,63.6
PK in K-12 Schools,All Students,2020-21,8270,1462,6808,82.3,51,28,54.9
PK in K-12 Schools,All Students,2021-22,10327,2327,8000,77.5,67,51,76.1
PK in K-12 Schools,All Students,2022-23,11344,2000,9344,82.4,78,51,65.4
0K,All Students,2018-19,6735,869,5866,87.1,43,26,60.5
0K,All Students,2019-20,4361,499,3862,88.6,43,21,48.8
0K,All Students,2020-21,7855,937,6918,88.1,50,21,42.0
0K,All Students,2021-22,7623,1314,6309,82.8,50,36,72.0
0K,All Students,2022-23,8425,1350,7075,84.0,53,34,64.2
1,All Students,2018-19,7011,708,6303,89.9,45,15,33.3
1,All Students,2019-20,4591,485,4106,89.4,41,17,41.5
1,All Students,2020-21,6620,456,6164,93.1,39,13,33.3
1,All Students,2021-22,8503,824,7679,90.3,54,19,35.2
1,All Students,2022-23,8481,965,7516,88.6,52,23,44.2
2,All Students,2018-19,7943,775,7168,90.2,51,19,37.3
2,All Students,2019-20,4980,489,4491,90.2,48,21,43.8
2,All Students,2020-21,6673,255,6418,96.2,41,4,9.8
2,All Students,2021-22,6795,828,5967,87.8,44,23,52.3
2,All Students,2022-23,8549,808,7741,90.5,55,16,29.1
3,All Students,2018-19,4846,409,4437,91.6,33,11,33.3
3,All Students,2019-20,4587,377,4210,91.8,43,14,32.6
3,All Students,2020-21,7646,341,7305,95.5,48,7,14.6
3,All Students,2021-22,6921,789,6132,88.6,43,17,39.5
3,All Students,2022-23,7758,689,7069,91.1,50,14,28.0
4,All Students,2018-19,7557,534,7023,92.9,44,11,25.0
4,All Students,2019-20,3900,363,3537,90.7,35,11,31.4
4,All Students,2020-21,6604,416,6188,93.7,39,7,17.9
4,All Students,2021-22,6380,778,5602,87.8,39,18,46.2
4,All Students,2022-23,7513,894,6619,88.1,50,20,40.0
5,All Students,2018-19,5371,359,5012,93.3,34,9,26.5
5,All Students,2019-20,5397,402,4995,92.6,49,14,28.6
5,All Students,2020-21,6118,705,5413,88.5,37,16,43.2
5,All Students,2021-22,7554,751,6803,90.1,46,16,34.8
5,All Students,2022-23,8498,1011,7487,88.1,59,25,42.4
All Grades,All Students,2018-19,109173,12860,96313,88.2,665,299,45.0
All Grades,All Students,2019-20,64626,7630,56996,88.2,607,272,44.8
All Grades,All Students,2020-21,87964,13296,74668,84.9,520,234,45.0
All Grades,All Students,2021-22,90819,13145,77674,85.5,565,292,51.7
All Grades,All Students,2022-23,92719,10471,82248,88.7,603,256,42.5
PK in K-12 Schools,All Students,2018-19,11476,1613,9863,85.9,72,42,58.3
PK in K-12 Schools,All Students,2019-20,7127,904,6223,87.3,67,37,55.2
PK in K-12 Schools,All Students,2020-21,6296,499,5797,92.1,37,9,24.3
PK in K-12 Schools,All Students,2021-22,9328,1686,7642,81.9,66,41,62.1
PK in K-12 Schools,All Students,2022-23,10610,1267,9343,88.1,74,36,48.6
0K,All Students,2018-19,8294,1290,7004,84.4,53,29,54.7
0K,All Students,2019-20,4718,645,4073,86.3,49,24,49.0
0K,All Students,2020-21,7559,1288,6271,83.0,47,21,44.7
0K,All Students,2021-22,8198,1257,6941,84.7,51,31,60.8
0K,All Students,2022-23,6590,s,s,s,s,s,s
1,All Students,2018-19,9887,1297,8590,86.9,60,34,56.7
1,All Students,2019-20,4966,776,4190,84.4,49,27,55.1
1,All Students,2020-21,7079,1400,5679,80.2,42,23,54.8
1,All Students,2021-22,9148,1774,7374,80.6,57,39,68.4
1,All Students,2022-23,7882,797,7085,89.9,53,23,43.4
2,All Students,2018-19,10742,1137,9605,89.4,69,27,39.1
2,All Students,2019-20,6077,671,5406,89.0,56,23,41.1
2,All Students,2020-21,6500,1422,5078,78.1,40,26,65.0
2,All Students,2021-22,7152,931,6221,87.0,43,18,41.9
2,All Students,2022-23,9670,989,8681,89.8,59,24,40.7
3,All Students,2018-19,9585,1253,8332,86.9,59,29,49.2
3,All Students,2019-20,6176,691,5485,88.8,58,24,41.4
3,All Students,2020-21,8755,717,8038,91.8,52,15,28.8
3,All Students,2021-22,7417,1204,6213,83.8,49,28,57.1
3,All Students,2022-23,8137,780,7357,90.4,51,16,31.4
4,All Students,2018-19,9047,891,8156,90.2,56,22,39.3
4,All Students,2019-20,6017,607,5410,89.9,58,26,44.8
4,All Students,2020-21,8767,1212,7555,86.2,52,27,51.9
4,All Students,2021-22,7963,1010,6953,87.3,47,19,40.4
4,All Students,2022-23,8560,949,7611,88.9,56,22,39.3
5,All Students,2018-19,11786,997,10789,91.5,71,27,38.0
5,All Students,2019-20,5404,493,4911,90.9,51,17,33.3
5,All Students,2020-21,8101,1286,6815,84.1,47,22,46.8
5,All Students,2021-22,9286,1179,8107,87.3,60,25,41.7
5,All Students,2022-23,8748,814,7934,90.7,55,14,25.5
6,All Students,2018-19,13145,1257,11888,90.4,75,27,36.0
6,All Students,2019-20,7780,739,7041,90.5,69,25,36.2
6,All Students,2020-21,10860,1586,9274,85.4,64,28,43.8
6,All Students,2021-22,11846,1464,10382,87.6,69,31,44.9
6,All Students,2022-23,10512,1227,9285,88.3,68,28,41.2
7,All Students,2018-19,13275,1808,11467,86.4,78,31,39.7
7,All Students,2019-20,8282,813,7469,90.2,76,30,39.5
7,All Students,2020-21,11426,2828,8598,75.2,66,38,57.6
7,All Students,2021-22,10312,1366,8946,86.8,65,34,52.3
7,All Students,2022-23,11769,1609,10160,86.3,74,40,54.1
8,All Students,2018-19,11936,1317,10619,89.0,72,31,43.1
8,All Students,2019-20,8079,1291,6788,84.0,74,39,52.7
8,All Students,2020-21,12621,1058,11563,91.6,73,25,34.2
8,All Students,2021-22,10169,1274,8895,87.5,58,26,44.8
8,All Students,2022-23,10227,1236,8991,87.9,68,30,44.1
9,All Students,2022-23,14,s,s,s,s,s,s
All Grades,All Students,2018-19,52375,6876,45499,86.9,355,192,54.1
All Grades,All Students,2019-20,33463,3594,29869,89.3,312,140,44.9
All Grades,All Students,2020-21,45934,2068,43866,95.5,277,36,13.0
All Grades,All Students,2021-22,39663,5974,33689,84.9,259,163,62.9
All Grades,All Students,2022-23,46590,7156,39434,84.6,301,185,61.5
PK in K-12 Schools,All Students,2018-19,12487,2010,10477,83.9,88,61,69.3
PK in K-12 Schools,All Students,2019-20,8946,1005,7941,88.8,84,46,54.8
PK in K-12 Schools,All Students,2020-21,9288,275,9013,97.0,58,3,5.2
PK in K-12 Schools,All Students,2021-22,7941,1153,6788,85.5,54,36,66.7
PK in K-12 Schools,All Students,2022-23,9635,1731,7904,82.0,66,49,74.2
0K,All Students,2018-19,6500,873,5627,86.6,47,24,51.1
0K,All Students,2019-20,4990,603,4387,87.9,47,26,55.3
0K,All Students,2020-21,6721,152,6569,97.7,42,1,2.4
0K,All Students,2021-22,4506,689,3817,84.7,31,24,77.4
0K,All Students,2022-23,7666,1339,6327,82.5,49,31,63.3
1,All Students,2018-19,6853,1037,5816,84.9,50,31,62.0
1,All Students,2019-20,4744,538,4206,88.7,43,16,37.2
1,All Students,2020-21,7233,461,6772,93.6,44,10,22.7
1,All Students,2021-22,6224,789,5435,87.3,42,23,54.8
1,All Students,2022-23,5117,672,4445,86.9,34,22,64.7
2,All Students,2018-19,5835,732,5103,87.5,34,18,52.9
2,All Students,2019-20,4004,529,3475,86.8,37,18,48.6
2,All Students,2020-21,6508,297,6211,95.4,39,4,10.3
2,All Students,2021-22,5980,961,5019,83.9,38,23,60.5
2,All Students,2022-23,6420,752,5668,88.3,42,21,50.0
3,All Students,2018-19,6978,707,6271,89.9,47,19,40.4
3,All Students,2019-20,3098,278,2820,91.0,29,11,37.9
3,All Students,2020-21,5941,453,5488,92.4,35,11,31.4
3,All Students,2021-22,5853,991,4862,83.1,37,23,62.2
3,All Students,2022-23,6549,1082,5467,83.5,42,28,66.7
4,All Students,2018-19,6278,798,5480,87.3,40,19,47.5
4,All Students,2019-20,3899,271,3628,93.0,36,9,25.0
4,All Students,2020-21,4298,188,4110,95.6,25,4,16.0
4,All Students,2021-22,5052,944,4108,81.3,32,22,68.8
4,All Students,2022-23,5255,759,4496,85.6,32,17,53.1
5,All Students,2018-19,7444,719,6725,90.3,49,20,40.8
5,All Students,2019-20,3782,370,3412,90.2,36,14,38.9
5,All Students,2020-21,5945,242,5703,95.9,34,3,8.8
5,All Students,2021-22,4107,447,3660,89.1,25,12,48.0
5,All Students,2022-23,5948,821,5127,86.2,36,17,47.2
All Grades,All Students,2018-19,50432,6763,43669,86.6,302,162,53.6
All Grades,All Students,2019-20,31278,3518,27760,88.8,287,121,42.2
All Grades,All Students,2020-21,46211,3496,42715,92.4,271,79,29.2
All Grades,All Students,2021-22,46470,5920,40550,87.3,292,148,50.7
All Grades,All Students,2022-23,49606,5281,44325,89.4,310,126,40.6
6,All Students,2018-19,16020,1814,14206,88.7,99,45,45.5
6,All Students,2019-20,9180,1021,8159,88.9,85,37,43.5
6,All Students,2020-21,15383,1562,13821,89.8,91,34,37.4
6,All Students,2021-22,14330,1796,12534,87.5,94,51,54.3
6,All Students,2022-23,15190,s,s,s,s,s,s
7,All Students,2018-19,18479,2653,15826,85.6,109,60,55.0
7,All Students,2019-20,10456,1107,9349,89.4,96,37,38.5
7,All Students,2020-21,14469,1597,12872,89.0,85,42,49.4
7,All Students,2021-22,17769,2146,15623,87.9,110,48,43.6
7,All Students,2022-23,16289,1602,14687,90.2,99,42,42.4
8,All Students,2018-19,15923,s,s,s,s,s,s
8,All Students,2019-20,11642,1390,10252,88.1,106,47,44.3
8,All Students,2020-21,16359,337,16022,97.9,95,3,3.2
8,All Students,2021-22,14371,1978,12393,86.2,88,49,55.7
8,All Students,2022-23,18109,1828,16281,89.9,116,40,34.5
9,All Students,2018-19,10,s,s,s,s,s,s
9,All Students,2022-23,18,s,s,s,s,s,s
All Grades,All Students,2018-19,54596,2640,51956,95.2,313,37,11.8
All Grades,All Students,2019-20,37066,2019,35047,94.6,326,56,17.2
All Grades,All Students,2020-21,55834,3830,52004,93.1,327,77,23.5
All Grades,All Students,2021-22,57854,5311,52543,90.8,336,117,34.8
All Grades,All Students,2022-23,55364,4379,50985,92.1,318,89,28.0
6,All Students,2018-19,18670,976,17694,94.8,109,15,13.8
6,All Students,2019-20,13820,922,12898,93.3,121,26,21.5
6,All Students,2020-21,18897,1380,17517,92.7,112,23,20.5
6,All Students,2021-22,18714,1505,17209,92.0,110,32,29.1
6,All Students,2022-23,18370,1414,16956,92.3,107,31,29.0
7,All Students,2018-19,19139,879,18260,95.4,108,15,13.9
7,All Students,2019-20,11287,623,10664,94.5,101,18,17.8
7,All Students,2020-21,20993,1456,19537,93.1,122,34,27.9
7,All Students,2021-22,17969,1530,16439,91.5,106,38,35.8
7,All Students,2022-23,19136,1539,17597,92.0,110,28,25.5
8,All Students,2018-19,16787,785,16002,95.3,96,7,7.3
8,All Students,2019-20,11959,474,11485,96.0,104,12,11.5
8,All Students,2020-21,15944,994,14950,93.8,93,20,21.5
8,All Students,2021-22,21171,2276,18895,89.2,120,47,39.2
8,All Students,2022-23,17856,s,s,s,s,s,s
9,All Students,2022-23,2,s,s,s,s,s,s
All Grades,All Students,2018-19,55329,8376,46953,84.9,374,225,60.2
All Grades,All Students,2019-20,36375,4781,31594,86.9,360,195,54.2
All Grades,All Students,2020-21,49268,8002,41266,83.8,300,144,48.0
All Grades,All Students,2021-22,44009,5062,38947,88.5,305,139,45.6
All Grades,All Students,2022-23,43052,4586,38466,89.3,335,150,44.8
PK in K-12 Schools,All Students,2018-19,13866,2400,11466,82.7,101,68,67.3
PK in K-12 Schools,All Students,2019-20,9666,1275,8391,86.8,104,57,54.8
PK in K-12 Schools,All Students,2020-21,9611,1233,8378,87.2,61,23,37.7
PK in K-12 Schools,All Students,2021-22,9573,1061,8512,88.9,72,28,38.9
PK in K-12 Schools,All Students,2022-23,11067,1295,9772,88.3,95,44,46.3
0K,All Students,2018-19,5692,941,4751,83.5,40,26,65.0
0K,All Students,2019-20,4430,727,3703,83.6,44,34,77.3
0K,All Students,2020-21,6672,1074,5598,83.9,43,20,46.5
0K,All Students,2021-22,5815,542,5273,90.7,44,19,43.2
0K,All Students,2022-23,5837,678,5159,88.4,49,27,55.1
1,All Students,2018-19,6409,1006,5403,84.3,44,27,61.4
1,All Students,2019-20,4150,547,3603,86.8,40,21,52.5
1,All Students,2020-21,6951,1225,5726,82.4,43,21,48.8
1,All Students,2021-22,6016,778,5238,87.1,41,20,48.8
1,All Students,2022-23,6032,529,5503,91.2,48,19,39.6
2,All Students,2018-19,7811,1081,6730,86.2,50,29,58.0
2,All Students,2019-20,4584,584,4000,87.3,43,22,51.2
2,All Students,2020-21,5466,836,4630,84.7,33,16,48.5
2,All Students,2021-22,5817,745,5072,87.2,39,19,48.7
2,All Students,2022-23,5662,596,5066,89.5,43,22,51.2
3,All Students,2018-19,8769,1397,7372,84.1,53,33,62.3
3,All Students,2019-20,4087,528,3559,87.1,41,20,48.8
3,All Students,2020-21,6816,1237,5579,81.9,39,23,59.0
3,All Students,2021-22,4592,524,4068,88.6,32,14,43.8
3,All Students,2022-23,4595,563,4032,87.7,32,14,43.8
4,All Students,2018-19,7502,891,6611,88.1,53,25,47.2
4,All Students,2019-20,5364,701,4663,86.9,51,26,51.0
4,All Students,2020-21,6114,1372,4742,77.6,36,22,61.1
4,All Students,2021-22,6093,800,5293,86.9,40,20,50.0
4,All Students,2022-23,4056,409,3647,89.9,30,10,33.3
5,All Students,2018-19,5280,660,4620,87.5,33,17,51.5
5,All Students,2019-20,4094,419,3675,89.8,37,15,40.5
5,All Students,2020-21,7638,1025,6613,86.6,45,19,42.2
5,All Students,2021-22,6103,612,5491,90.0,37,19,51.4
5,All Students,2022-23,5803,516,5287,91.1,38,14,36.8
All Grades,All Students,2018-19,68452,8812,59640,87.1,431,225,52.2
All Grades,All Students,2019-20,41124,5102,36022,87.6,371,172,46.4
All Grades,All Students,2020-21,54160,4660,49500,91.4,330,80,24.2
All Grades,All Students,2021-22,50911,6793,44118,86.7,312,150,48.1
All Grades,All Students,2022-23,52972,5453,47519,89.7,323,143,44.3
PK in K-12 Schools,All Students,2018-19,13560,2500,11060,81.6,85,62,72.9
PK in K-12 Schools,All Students,2019-20,7905,1312,6593,83.4,72,48,66.7
PK in K-12 Schools,All Students,2020-21,9320,926,8394,90.1,62,19,30.6
PK in K-12 Schools,All Students,2021-22,8658,1283,7375,85.2,53,32,60.4
PK in K-12 Schools,All Students,2022-23,9927,1375,8552,86.1,62,41,66.1
0K,All Students,2018-19,8491,1346,7145,84.1,54,34,63.0
0K,All Students,2019-20,5018,802,4216,84.0,47,25,53.2
0K,All Students,2020-21,6877,636,6241,90.8,42,9,21.4
0K,All Students,2021-22,7420,1252,6168,83.1,46,26,56.5
0K,All Students,2022-23,8560,881,7679,89.7,52,22,42.3
1,All Students,2018-19,7390,846,6544,88.6,47,25,53.2
1,All Students,2019-20,5153,761,4392,85.2,46,24,52.2
1,All Students,2020-21,6743,295,6448,95.6,42,3,7.1
1,All Students,2021-22,7340,821,6519,88.8,45,19,42.2
1,All Students,2022-23,6213,576,5637,90.7,39,16,41.0
2,All Students,2018-19,8678,830,7848,90.4,54,21,38.9
2,All Students,2019-20,5163,546,4617,89.4,45,20,44.4
2,All Students,2020-21,7731,756,6975,90.2,46,12,26.1
2,All Students,2021-22,6221,1036,5185,83.3,39,22,56.4
2,All Students,2022-23,7030,698,6332,90.1,43,17,39.5
3,All Students,2018-19,9574,861,8713,91.0,61,23,37.7
3,All Students,2019-20,5620,494,5126,91.2,51,14,27.5
3,All Students,2020-21,8338,777,7561,90.7,48,12,25.0
3,All Students,2021-22,6627,684,5943,89.7,40,14,35.0
3,All Students,2022-23,6803,674,6129,90.1,41,17,41.5
4,All Students,2018-19,11056,1280,9776,88.4,70,31,44.3
4,All Students,2019-20,5438,458,4980,91.6,49,15,30.6
4,All Students,2020-21,7780,724,7056,90.7,47,14,29.8
4,All Students,2021-22,7766,878,6888,88.7,48,19,39.6
4,All Students,2022-23,6613,573,6040,91.3,39,13,33.3
5,All Students,2018-19,9703,1149,8554,88.2,60,29,48.3
5,All Students,2019-20,6827,729,6098,89.3,61,26,42.6
5,All Students,2020-21,7371,546,6825,92.6,43,11,25.6
5,All Students,2021-22,6879,839,6040,87.8,41,18,43.9
5,All Students,2022-23,7826,676,7150,91.4,47,17,36.2
All Grades,All Students,2018-19,41704,6706,34998,83.9,291,147,50.5
All Grades,All Students,2019-20,33898,5713,28185,83.1,331,162,48.9
All Grades,All Students,2020-21,62090,14024,48066,77.4,369,196,53.1
All Grades,All Students,2021-22,64405,11917,52488,81.5,407,265,65.1
All Grades,All Students,2022-23,68868,11063,57805,83.9,464,261,56.3
9,All Students,2018-19,12352,2501,9851,79.8,97,59,60.8
9,All Students,2019-20,11577,2312,9265,80.0,117,57,48.7
9,All Students,2020-21,23146,5259,17887,77.3,136,67,49.3
9,All Students,2021-22,19649,3779,15870,80.8,124,79,63.7
9,All Students,2022-23,20598,3361,17237,83.7,146,80,54.8
10,All Students,2018-19,9850,1558,8292,84.2,65,27,41.5
10,All Students,2019-20,8040,1345,6695,83.3,77,38,49.4
10,All Students,2020-21,15275,4019,11256,73.7,91,58,63.7
10,All Students,2021-22,19681,3895,15786,80.2,125,86,68.8
10,All Students,2022-23,22381,3845,18536,82.8,146,88,60.3
11,All Students,2018-19,11180,1359,9821,87.8,73,31,42.5
11,All Students,2019-20,6488,829,5659,87.2,63,26,41.3
11,All Students,2020-21,13403,2573,10830,80.8,81,39,48.1
11,All Students,2021-22,13066,2244,10822,82.8,83,52,62.7
11,All Students,2022-23,13534,2059,11475,84.8,96,47,49.0
12,All Students,2018-19,8322,1288,7034,84.5,56,30,53.6
12,All Students,2019-20,7793,1227,6566,84.3,74,41,55.4
12,All Students,2020-21,10266,2173,8093,78.8,61,32,52.5
12,All Students,2021-22,12009,1999,10010,83.4,75,48,64.0
12,All Students,2022-23,12355,1798,10557,85.4,76,46,60.5
All Grades,All Students,2018-19,24685,3343,21342,86.5,164,70,42.7
All Grades,All Students,2019-20,15456,1361,14095,91.2,147,41,27.9
All Grades,All Students,2020-21,24175,2616,21559,89.2,146,44,30.1
All Grades,All Students,2021-22,28157,1309,26848,95.4,184,27,14.7
All Grades,All Students,2022-23,36320,3151,33169,91.3,261,84,32.2
9,All Students,2018-19,8515,1233,7282,85.5,56,20,35.7
9,All Students,2019-20,4250,575,3675,86.5,42,14,33.3
9,All Students,2020-21,5759,965,4794,83.2,33,10,30.3
9,All Students,2021-22,12313,588,11725,95.2,82,12,14.6
9,All Students,2022-23,14579,1540,13039,89.4,109,39,35.8
10,All Students,2018-19,6258,1026,5232,83.6,42,15,35.7
10,All Students,2019-20,5385,327,5058,93.9,51,11,21.6
10,All Students,2020-21,7389,837,6552,88.7,43,17,39.5
10,All Students,2021-22,4197,249,3948,94.1,28,7,25.0
10,All Students,2022-23,12863,1003,11860,92.2,90,28,31.1
11,All Students,2018-19,4344,446,3898,89.7,27,12,44.4
11,All Students,2019-20,3412,259,3153,92.4,31,9,29.0
11,All Students,2020-21,7791,458,7333,94.1,46,8,17.4
11,All Students,2021-22,5488,233,5255,95.8,35,4,11.4
11,All Students,2022-23,4144,284,3860,93.1,32,8,25.0
12,All Students,2018-19,5568,638,4930,88.5,39,23,59.0
12,All Students,2019-20,2409,200,2209,91.7,23,7,30.4
12,All Students,2020-21,3236,356,2880,89.0,24,9,37.5
12,All Students,2021-22,6159,239,5920,96.1,39,4,10.3
12,All Students,2022-23,4734,324,4410,93.2,30,9,30.0
All Grades,All Students,2018-19,34396,3203,31193,90.7,196,69,35.2
All Grades,All Students,2019-20,20110,1413,18697,93.0,186,48,25.8
All Grades,All Students,2020-21,23155,1919,21236,91.7,134,33,24.6
All Grades,All Students,2021-22,16615,1518,15097,90.9,102,36,35.3
All Grades,All Students,2022-23,15664,1388,14276,91.1,106,43,40.6
6,All Students,2018-19,10889,872,10017,92.0,63,18,28.6
6,All Students,2019-20,5524,409,5115,92.6,52,18,34.6
6,All Students,2020-21,5008,304,4704,93.9,30,6,20.0
6,All Students,2021-22,3694,s,s,s,s,s,s
6,All Students,2022-23,3800,s,s,s,s,s,s
7,All Students,2018-19,12037,998,11039,91.7,68,22,32.4
7,All Students,2019-20,6564,537,6027,91.8,61,20,32.8
7,All Students,2020-21,8347,577,7770,93.1,48,7,14.6
7,All Students,2021-22,5269,428,4841,91.9,35,13,37.1
7,All Students,2022-23,5186,499,4687,90.4,35,15,42.9
8,All Students,2018-19,11470,1333,10137,88.4,65,29,44.6
8,All Students,2019-20,8022,467,7555,94.2,73,10,13.7
8,All Students,2020-21,9800,1038,8762,89.4,56,20,35.7
8,All Students,2021-22,7547,598,6949,92.1,44,13,29.5
8,All Students,2022-23,6171,517,5654,91.6,39,14,35.9
9,All Students,2021-22,105,s,s,s,s,s,s
9,All Students,2022-23,507,s,s,s,s,s,s
All Grades,All Students,2018-19,30732,2976,27756,90.3,182,67,36.8
All Grades,All Students,2019-20,16975,1034,15941,93.9,150,25,16.7
All Grades,All Students,2020-21,22987,1152,21835,95.0,135,20,14.8
All Grades,All Students,2021-22,16644,1799,14845,89.2,99,39,39.4
All Grades,All Students,2022-23,22396,2800,19596,87.5,146,67,45.9
6,All Students,2018-19,11870,1100,10770,90.7,70,28,40.0
6,All Students,2019-20,4060,309,3751,92.4,36,10,27.8
6,All Students,2020-21,6162,320,5842,94.8,37,7,18.9
6,All Students,2021-22,5039,520,4519,89.7,30,10,33.3
6,All Students,2022-23,6298,1157,5141,81.6,45,26,57.8
7,All Students,2018-19,8912,846,8066,90.5,53,17,32.1
7,All Students,2019-20,7103,324,6779,95.4,62,10,16.1
7,All Students,2020-21,6142,544,5598,91.1,36,7,19.4
7,All Students,2021-22,5541,534,5007,90.4,33,13,39.4
7,All Students,2022-23,7392,735,6657,90.1,47,20,42.6
8,All Students,2018-19,9950,1030,8920,89.6,59,22,37.3
8,All Students,2019-20,5812,401,5411,93.1,52,5,9.6
8,All Students,2020-21,10683,288,10395,97.3,62,6,9.7
8,All Students,2021-22,6064,745,5319,87.7,36,16,44.4
8,All Students,2022-23,8706,908,7798,89.6,54,21,38.9
All Grades,All Students,2018-19,68282,5306,62976,92.2,409,126,30.8
All Grades,All Students,2019-20,46925,3616,43309,92.3,433,119,27.5
All Grades,All Students,2020-21,71158,8322,62836,88.3,419,135,32.2
All Grades,All Students,2021-22,69026,7659,61367,88.9,421,179,42.5
All Grades,All Students,2022-23,70640,7283,63357,89.7,427,184,43.1
PK in K-12 Schools,All Students,2018-19,7791,698,7093,91.0,47,20,42.6
PK in K-12 Schools,All Students,2019-20,5423,415,5008,92.3,51,13,25.5
PK in K-12 Schools,All Students,2020-21,7549,s,s,s,s,s,s
PK in K-12 Schools,All Students,2021-22,8414,859,7555,89.8,51,25,49.0
PK in K-12 Schools,All Students,2022-23,8101,991,7110,87.8,49,26,53.1
0K,All Students,2018-19,11049,1017,10032,90.8,68,27,39.7
0K,All Students,2019-20,7093,684,6409,90.4,67,24,35.8
0K,All Students,2020-21,11526,1676,9850,85.5,69,26,37.7
0K,All Students,2021-22,10293,1134,9159,89.0,66,29,43.9
0K,All Students,2022-23,10717,1025,9692,90.4,64,31,48.4
1,All Students,2018-19,10225,736,9489,92.8,62,18,29.0
1,All Students,2019-20,6750,650,6100,90.4,62,26,41.9
1,All Students,2020-21,9894,955,8939,90.3,58,16,27.6
1,All Students,2021-22,10702,1400,9302,86.9,66,28,42.4
1,All Students,2022-23,10042,1163,8879,88.4,62,31,50.0
2,All Students,2018-19,8247,639,7608,92.3,51,17,33.3
2,All Students,2019-20,6547,421,6126,93.6,59,11,18.6
2,All Students,2020-21,9702,1383,8319,85.7,57,21,36.8
2,All Students,2021-22,9585,1069,8516,88.8,57,21,36.8
2,All Students,2022-23,10418,1078,9340,89.7,61,22,36.1
3,All Students,2018-19,11482,740,10742,93.6,67,15,22.4
3,All Students,2019-20,6782,429,6353,93.7,62,12,19.4
3,All Students,2020-21,10571,1180,9391,88.8,63,19,30.2
3,All Students,2021-22,8947,1076,7871,88.0,56,25,44.6
3,All Students,2022-23,11292,1232,10060,89.1,68,31,45.6
4,All Students,2018-19,11436,880,10556,92.3,67,16,23.9
4,All Students,2019-20,7624,582,7042,92.4,71,18,25.4
4,All Students,2020-21,10684,765,9919,92.8,62,14,22.6
4,All Students,2021-22,10624,1049,9575,90.1,61,21,34.4
4,All Students,2022-23,8804,811,7993,90.8,54,19,35.2
5,All Students,2018-19,8052,596,7456,92.6,47,13,27.7
5,All Students,2019-20,6706,435,6271,93.5,61,15,24.6
5,All Students,2020-21,10731,944,9787,91.2,61,10,16.4
5,All Students,2021-22,10461,1072,9389,89.8,64,30,46.9
5,All Students,2022-23,11266,983,10283,91.3,69,24,34.8
6,All Students,2020-21,501,s,s,s,s,s,s
All Grades,All Students,2018-19,114814,10435,104379,90.9,666,156,23.4
All Grades,All Students,2019-20,70605,6446,64159,90.9,651,170,26.1
All Grades,All Students,2020-21,108621,4406,104215,95.9,636,51,8.0
All Grades,All Students,2021-22,102777,11649,91128,88.7,634,241,38.0
All Grades,All Students,2022-23,104939,9617,95322,90.8,643,186,28.9
6,All Students,2018-19,16516,866,15650,94.8,97,13,13.4
6,All Students,2019-20,9445,478,8967,94.9,85,15,17.6
6,All Students,2020-21,11106,444,10662,96.0,70,9,12.9
6,All Students,2021-22,8776,786,7990,91.0,55,17,30.9
6,All Students,2022-23,12627,1249,11378,90.1,79,33,41.8
7,All Students,2018-19,17384,1211,16173,93.0,100,15,15.0
7,All Students,2019-20,11112,507,10605,95.4,99,10,10.1
7,All Students,2020-21,14078,448,13630,96.8,80,3,3.8
7,All Students,2021-22,11593,911,10682,92.1,75,28,37.3
7,All Students,2022-23,9742,857,8885,91.2,60,19,31.7
8,All Students,2018-19,17682,1327,16355,92.5,104,22,21.2
8,All Students,2019-20,10841,899,9942,91.7,98,20,20.4
8,All Students,2020-21,16895,239,16656,98.6,98,3,3.1
8,All Students,2021-22,13417,1313,12104,90.2,83,32,38.6
8,All Students,2022-23,12402,1250,11152,89.9,77,27,35.1
9,All Students,2018-19,17171,1787,15384,89.6,103,28,27.2
9,All Students,2019-20,10563,1213,9350,88.5,103,42,40.8
9,All Students,2020-21,19470,627,18843,96.8,116,8,6.9
9,All Students,2021-22,19651,1934,17717,90.2,117,42,35.9
9,All Students,2022-23,19027,1599,17428,91.6,117,23,19.7
10,All Students,2018-19,15465,1356,14109,91.2,92,22,23.9
10,All Students,2019-20,9260,804,8456,91.3,88,16,18.2
10,All Students,2020-21,17047,851,16196,95.0,100,12,12.0
10,All Students,2021-22,19800,2588,17212,86.9,126,54,42.9
10,All Students,2022-23,20353,1693,18660,91.7,125,29,23.2
11,All Students,2018-19,16567,1621,14946,90.2,94,31,33.0
11,All Students,2019-20,8859,908,7951,89.8,86,30,34.9
11,All Students,2020-21,15337,725,14612,95.3,88,9,10.2
11,All Students,2021-22,15086,2034,13052,86.5,91,37,40.7
11,All Students,2022-23,15602,1736,13866,88.9,93,29,31.2
12,All Students,2018-19,14029,2267,11762,83.8,76,25,32.9
12,All Students,2019-20,10525,1637,8888,84.4,92,37,40.2
12,All Students,2020-21,14688,1072,13616,92.7,84,7,8.3
12,All Students,2021-22,14454,2083,12371,85.6,87,31,35.6
12,All Students,2022-23,15186,1233,13953,91.9,92,26,28.3
All Grades,All Students,2018-19,18253,2346,15907,87.1,114,53,46.5
All Grades,All Students,2019-20,20771,2070,18701,90.0,193,71,36.8
All Grades,All Students,2020-21,30196,2316,27880,92.3,180,41,22.8
All Grades,All Students,2021-22,27012,3335,23677,87.7,169,72,42.6
All Grades,All Students,2022-23,29617,2684,26933,90.9,184,49,26.6
6,All Students,2018-19,6168,754,5414,87.8,38,19,50.0
6,All Students,2019-20,6125,554,5571,91.0,56,22,39.3
6,All Students,2020-21,10279,805,9474,92.2,63,13,20.6
6,All Students,2021-22,9261,1149,8112,87.6,56,24,42.9
6,All Students,2022-23,9309,920,8389,90.1,60,18,30.0
7,All Students,2018-19,6486,725,5761,88.8,40,16,40.0
7,All Students,2019-20,7114,782,6332,89.0,66,29,43.9
7,All Students,2020-21,9277,586,8691,93.7,55,11,20.0
7,All Students,2021-22,9016,1147,7869,87.3,59,25,42.4
7,All Students,2022-23,9652,758,8894,92.1,59,16,27.1
8,All Students,2018-19,5599,867,4732,84.5,36,18,50.0
8,All Students,2019-20,7532,734,6798,90.3,71,20,28.2
8,All Students,2020-21,10640,925,9715,91.3,62,17,27.4
8,All Students,2021-22,8735,1039,7696,88.1,54,23,42.6
8,All Students,2022-23,10656,1006,9650,90.6,65,15,23.1
All Grades,All Students,2018-19,23836,3079,20757,87.1,150,74,49.3
All Grades,All Students,2019-20,16610,2424,14186,85.4,151,84,55.6
All Grades,All Students,2020-21,21654,2557,19097,88.2,126,49,38.9
All Grades,All Students,2021-22,22235,2975,19260,86.6,140,75,53.6
All Grades,All Students,2022-23,21089,2180,18909,89.7,133,49,36.8
6,All Students,2018-19,7937,864,7073,89.1,48,25,52.1
6,All Students,2019-20,5539,765,4774,86.2,52,25,48.1
6,All Students,2020-21,5985,834,5151,86.1,35,15,42.9
6,All Students,2021-22,7543,837,6706,88.9,46,20,43.5
6,All Students,2022-23,5925,451,5474,92.4,38,10,26.3
7,All Students,2018-19,8296,1409,6887,83.0,52,30,57.7
7,All Students,2019-20,5536,638,4898,88.5,49,25,51.0
7,All Students,2020-21,8082,965,7117,88.1,46,19,41.3
7,All Students,2021-22,7217,s,s,s,s,s,s
7,All Students,2022-23,7884,650,7234,91.8,46,17,37.0
8,All Students,2018-19,7603,806,6797,89.4,50,19,38.0
8,All Students,2019-20,5535,1021,4514,81.6,50,34,68.0
8,All Students,2020-21,7587,758,6829,90.0,45,15,33.3
8,All Students,2021-22,7419,996,6423,86.6,47,27,57.4
8,All Students,2022-23,7280,1079,6201,85.2,49,22,44.9
9,All Students,2021-22,56,s,s,s,s,s,s
All Grades,All Students,2018-19,35021,3205,31816,90.8,207,74,35.7
All Grades,All Students,2019-20,23732,1968,21764,91.7,219,71,32.4
All Grades,All Students,2020-21,35383,3092,32291,91.3,207,56,27.1
All Grades,All Students,2021-22,32569,4252,28317,86.9,199,100,50.3
All Grades,All Students,2022-23,29805,4535,25270,84.8,195,112,57.4
6,All Students,2018-19,13614,1352,12262,90.1,81,34,42.0
6,All Students,2019-20,8537,542,7995,93.7,77,17,22.1
6,All Students,2020-21,11529,1089,10440,90.6,68,18,26.5
6,All Students,2021-22,10519,s,s,s,s,s,s
6,All Students,2022-23,7790,913,6877,88.3,55,28,50.9
7,All Students,2018-19,11740,1116,10624,90.5,68,25,36.8
7,All Students,2019-20,8318,805,7513,90.3,79,32,40.5
7,All Students,2020-21,12433,1116,11317,91.0,72,22,30.6
7,All Students,2021-22,10633,1312,9321,87.7,68,32,47.1
7,All Students,2022-23,9856,1672,8184,83.0,62,39,62.9
8,All Students,2018-19,9667,737,8930,92.4,58,15,25.9
8,All Students,2019-20,6857,s,s,s,s,s,s
8,All Students,2020-21,11375,s,s,s,s,s,s
8,All Students,2021-22,11394,1613,9781,85.8,67,36,53.7
8,All Students,2022-23,12159,1950,10209,84.0,78,45,57.7
9,All Students,2019-20,20,s,s,s,s,s,s
9,All Students,2020-21,25,s,s,s,s,s,s
9,All Students,2021-22,23,s,s,s,s,s,s
All Grades,All Students,2018-19,33699,7228,26471,78.6,229,135,59.0
All Grades,All Students,2019-20,17939,4177,13762,76.7,174,111,63.8
All Grades,All Students,2020-21,27088,5149,21939,81.0,163,85,52.1
All Grades,All Students,2021-22,25752,6934,18818,73.1,187,136,72.7
1,All Students,2021-22,32451,2960,29491,90.9,203,71,35.0
All Grades,All Students,2022-23,31953,6229,25724,80.5,229,135,59.0
8,All Students,2018-19,2763,469,2294,83.0,17,14,82.4
9,All Students,2018-19,7167,1128,6039,84.3,50,23,46.0
9,All Students,2019-20,3493,587,2906,83.2,39,25,64.1
9,All Students,2020-21,5138,802,4336,84.4,33,14,42.4
9,All Students,2021-22,7942,1777,6165,77.6,65,46,70.8
9,All Students,2022-23,8331,1522,6809,81.7,63,38,60.3
10,All Students,2018-19,6624,1612,5012,75.7,49,28,57.1
10,All Students,2019-20,4641,925,3716,80.1,44,31,70.5
10,All Students,2020-21,5923,1094,4829,81.5,36,22,61.1
10,All Students,2021-22,4512,951,3561,78.9,36,21,58.3
10,All Students,2022-23,12098,2728,9370,77.5,86,54,62.8
11,All Students,2018-19,8179,2447,5732,70.1,57,39,68.4
11,All Students,2019-20,4519,1014,3505,77.6,41,21,51.2
11,All Students,2020-21,7915,1261,6654,84.1,46,23,50.0
11,All Students,2021-22,6408,2032,4376,68.3,43,37,86.0
11,All Students,2022-23,6109,941,5168,84.6,42,22,52.4
12,All Students,2018-19,8966,1572,7394,82.5,56,31,55.4
12,All Students,2019-20,5286,1651,3635,68.8,50,34,68.0
12,All Students,2020-21,8112,1992,6120,75.4,48,26,54.2
12,All Students,2021-22,6890,2174,4716,68.4,43,32,74.4
12,All Students,2022-23,5415,1038,4377,80.8,38,21,55.3
All Grades,All Students,2018-19,318702,13121,305581,95.9,1857,209,11.3
All Grades,All Students,2019-20,201964,7751,194213,96.2,1809,171,9.5
All Grades,All Students,2020-21,288037,22028,266009,92.4,1673,386,23.1
All Grades,All Students,2021-22,275707,23133,252574,91.6,1626,485,29.8
All Grades,All Students,2022-23,248339,18191,230148,92.7,1469,372,25.3
6,All Students,2018-19,108192,4032,104160,96.3,633,66,10.4
6,All Students,2019-20,65578,2341,63237,96.4,591,52,8.8
6,All Students,2020-21,87151,6105,81046,93.0,511,113,22.1
6,All Students,2021-22,89651,8052,81599,91.0,533,165,31.0
6,All Students,2022-23,67908,4871,63037,92.8,403,103,25.6
7,All Students,2018-19,101980,4064,97916,96.0,595,64,10.8
7,All Students,2019-20,69605,2728,66877,96.1,623,60,9.6
7,All Students,2020-21,96813,7186,89627,92.6,561,118,21.0
7,All Students,2021-22,87871,7462,80409,91.5,521,157,30.1
7,All Students,2022-23,91068,6625,84443,92.7,549,133,24.2
8,All Students,2018-19,108530,5025,103505,95.4,629,79,12.6
8,All Students,2019-20,66781,2682,64099,96.0,595,59,9.9
8,All Students,2020-21,104073,8737,95336,91.6,601,155,25.8
8,All Students,2021-22,98185,7619,90566,92.2,572,163,28.5
8,All Students,2022-23,89363,6695,82668,92.5,517,136,26.3
All Grades,All Students,2018-19,244400,10978,233422,95.5,1443,186,12.9
All Grades,All Students,2019-20,153285,7987,145298,94.8,1375,202,14.7
All Grades,All Students,2020-21,218869,13668,205201,93.8,1300,254,19.5
All Grades,All Students,2021-22,209685,16590,193095,92.1,1266,367,29.0
All Grades,All Students,2022-23,214258,17119,197139,92.0,1308,377,28.8
PK in K-12 Schools,All Students,2018-19,9023,669,8354,92.6,57,19,33.3
PK in K-12 Schools,All Students,2019-20,5904,623,5281,89.4,56,25,44.6
PK in K-12 Schools,All Students,2020-21,9183,912,8271,90.1,54,14,25.9
PK in K-12 Schools,All Students,2021-22,9474,1050,8424,88.9,55,26,47.3
PK in K-12 Schools,All Students,2022-23,9314,1709,7605,81.7,59,40,67.8
0K,All Students,2018-19,38066,2205,35861,94.2,228,38,16.7
0K,All Students,2019-20,25173,1902,23271,92.4,228,57,25.0
0K,All Students,2020-21,36339,3220,33119,91.1,219,70,32.0
0K,All Students,2021-22,34839,3555,31284,89.8,211,89,42.2
0K,All Students,2022-23,34935,3677,31258,89.5,220,97,44.1
1,All Students,2018-19,41372,1918,39454,95.4,249,25,10.0
1,All Students,2019-20,23292,1230,22062,94.7,207,29,14.0
1,All Students,2020-21,36148,2507,33641,93.1,217,46,21.2
1,All Students,2022-23,32248,2801,29447,91.3,194,60,30.9
2,All Students,2018-19,39145,1920,37225,95.1,228,35,15.4
2,All Students,2019-20,25908,1368,24540,94.7,229,29,12.7
2,All Students,2020-21,32396,1526,30870,95.3,191,29,15.2
2,All Students,2021-22,35325,2905,32420,91.8,211,62,29.4
2,All Students,2022-23,31363,2631,28732,91.6,192,59,30.7
3,All Students,2018-19,39120,1539,37581,96.1,227,27,11.9
3,All Students,2019-20,24089,1014,23075,95.8,217,23,10.6
3,All Students,2020-21,37711,1589,36122,95.8,224,30,13.4
3,All Students,2021-22,32750,2116,30634,93.5,200,41,20.5
3,All Students,2022-23,39668,2776,36892,93.0,249,58,23.3
4,All Students,2018-19,38583,1299,37284,96.6,224,21,9.4
4,All Students,2019-20,25080,1052,24028,95.8,227,27,11.9
4,All Students,2020-21,33897,2232,31665,93.4,200,40,20.0
4,All Students,2021-22,35628,2173,33455,93.9,212,40,18.9
4,All Students,2022-23,32576,1862,30714,94.3,196,35,17.9
5,All Students,2018-19,39091,1428,37663,96.3,230,21,9.1
5,All Students,2019-20,23839,798,23041,96.7,211,12,5.7
5,All Students,2020-21,33195,1682,31513,94.9,195,25,12.8
5,All Students,2021-22,29218,1831,27387,93.7,174,38,21.8
5,All Students,2022-23,34154,1663,32491,95.1,198,28,14.1
All Grades,All Students,2018-19,204913,8586,196327,95.8,1204,133,11.0
All Grades,All Students,2019-20,129271,6134,123137,95.3,1169,147,12.6
All Grades,All Students,2020-21,186704,6082,180622,96.7,1095,92,8.4
All Grades,All Students,2021-22,166331,12424,153907,92.5,1002,276,27.5
All Grades,All Students,2022-23,152423,10385,142038,93.2,912,218,23.9
0K,All Students,2018-19,34464,1944,32520,94.4,201,39,19.4
0K,All Students,2019-20,21373,1385,19988,93.5,199,40,20.1
0K,All Students,2020-21,31788,1473,30315,95.4,188,22,11.7
0K,All Students,2021-22,22288,1974,20314,91.1,137,47,34.3
0K,All Students,2022-23,22196,2148,20048,90.3,135,51,37.8
1,All Students,2018-19,33516,1598,31918,95.2,199,23,11.6
1,All Students,2019-20,21722,1253,20469,94.2,196,36,18.4
1,All Students,2020-21,29968,913,29055,97.0,176,16,9.1
1,All Students,2021-22,28989,2229,26760,92.3,173,53,30.6
1,All Students,2022-23,20890,1656,19234,92.1,126,41,32.5
2,All Students,2018-19,32844,1487,31357,95.5,198,28,14.1
2,All Students,2019-20,20282,1013,19269,95.0,182,20,11.0
2,All Students,2020-21,30466,1013,29453,96.7,181,17,9.4
2,All Students,2021-22,27132,2045,25087,92.5,165,48,29.1
2,All Students,2022-23,28662,2086,26576,92.7,174,47,27.0
3,All Students,2018-19,34233,1208,33025,96.5,199,13,6.5
3,All Students,2019-20,21195,952,20243,95.5,192,19,9.9
3,All Students,2020-21,30751,1203,29548,96.1,180,19,10.6
3,All Students,2021-22,27944,2071,25873,92.6,171,39,22.8
3,All Students,2022-23,26491,1685,24806,93.6,156,30,19.2
4,All Students,2018-19,36863,1235,35628,96.6,217,15,6.9
4,All Students,2019-20,21947,725,21222,96.7,194,15,7.7
4,All Students,2020-21,31387,780,30607,97.5,182,9,4.9
4,All Students,2021-22,29164,1916,27248,93.4,175,44,25.1
4,All Students,2022-23,25907,1407,24500,94.6,150,23,15.3
5,All Students,2018-19,32993,1114,31879,96.6,190,15,7.9
5,All Students,2019-20,22752,806,21946,96.5,206,17,8.3
5,All Students,2020-21,32344,700,31644,97.8,188,9,4.8
5,All Students,2021-22,30814,2189,28625,92.9,181,45,24.9
5,All Students,2022-23,28277,1403,26874,95.0,171,26,15.2
All Grades,All Students,2018-19,268368,13463,254905,95.0,1582,235,14.9
All Grades,All Students,2019-20,159483,8240,151243,94.8,1450,226,15.6
All Grades,All Students,2020-21,216962,10402,206560,95.2,1286,192,14.9
All Grades,All Students,2021-22,195257,15865,179392,91.9,1191,380,31.9
All Grades,All Students,2022-23,180380,14604,165776,91.9,1122,348,31.0
PK in K-12 Schools,All Students,2021-22,2548,466,2082,81.7,15,10,66.7
PK in K-12 Schools,All Students,2022-23,5518,603,4915,89.1,36,20,55.6
0K,All Students,2018-19,40507,2760,37747,93.2,244,56,23.0
0K,All Students,2019-20,25037,1711,23326,93.2,235,57,24.3
0K,All Students,2020-21,34204,1728,32476,94.9,204,36,17.6
0K,All Students,2021-22,30315,3279,27036,89.2,191,87,45.5
0K,All Students,2022-23,28883,3137,25746,89.1,184,83,45.1
1,All Students,2018-19,42094,2326,39768,94.5,247,43,17.4
1,All Students,2019-20,25607,1544,24063,94.0,234,46,19.7
1,All Students,2020-21,32722,1878,30844,94.3,194,37,19.1
1,All Students,2021-22,30865,2884,27981,90.7,191,75,39.3
1,All Students,2022-23,27101,2723,24378,90.0,166,71,42.8
2,All Students,2018-19,45352,2329,43023,94.9,267,42,15.7
2,All Students,2019-20,25791,1206,24585,95.3,233,34,14.6
2,All Students,2020-21,36070,1825,34245,94.9,216,37,17.1
2,All Students,2021-22,31682,2359,29323,92.6,195,66,33.8
2,All Students,2022-23,25339,2026,23313,92.0,166,52,31.3
3,All Students,2018-19,45868,2318,43550,94.9,269,36,13.4
3,All Students,2019-20,28285,1360,26925,95.2,254,33,13.0
3,All Students,2020-21,38276,1367,36909,96.4,226,24,10.6
3,All Students,2021-22,35392,2482,32910,93.0,208,50,24.0
3,All Students,2022-23,30739,2112,28627,93.1,190,51,26.8
4,All Students,2018-19,49567,1983,47584,96.0,290,31,10.7
4,All Students,2019-20,27953,1443,26510,94.8,256,36,14.1
4,All Students,2020-21,39576,1884,37692,95.2,236,31,13.1
4,All Students,2021-22,35061,2419,32642,93.1,213,52,24.4
4,All Students,2022-23,34038,2145,31893,93.7,204,39,19.1
5,All Students,2018-19,44980,1747,43233,96.1,265,27,10.2
5,All Students,2019-20,26810,976,25834,96.4,238,20,8.4
5,All Students,2020-21,36114,1720,34394,95.2,210,27,12.9
5,All Students,2021-22,29394,1976,27418,93.3,178,40,22.5
5,All Students,2022-23,28762,1858,26904,93.5,176,32,18.2
All Grades,All Students,2018-19,277514,16404,261110,94.1,1673,315,18.8
All Grades,All Students,2019-20,159638,8645,150993,94.6,1449,235,16.2
All Grades,All Students,2020-21,225905,21067,204838,90.7,1337,425,31.8
All Grades,All Students,2021-22,201208,20410,180798,89.9,1240,485,39.1
All Grades,All Students,2022-23,191781,18681,173100,90.3,1193,446,37.4
0K,All Students,2018-19,33377,3038,30339,90.9,206,82,39.8
0K,All Students,2019-20,17962,1462,16500,91.9,165,55,33.3
0K,All Students,2020-21,31684,2965,28719,90.6,191,65,34.0
0K,All Students,2021-22,25079,3040,22039,87.9,156,78,50.0
0K,All Students,2022-23,26633,3461,23172,87.0,169,86,50.9
1,All Students,2018-19,37638,2133,35505,94.3,231,44,19.0
1,All Students,2019-20,21728,1197,20531,94.5,199,29,14.6
1,All Students,2020-21,26224,2985,23239,88.6,158,61,38.6
1,All Students,2021-22,31589,3280,28309,89.6,197,73,37.1
1,All Students,2022-23,24626,s,s,s,s,s,s
2,All Students,2018-19,43036,2653,40383,93.8,267,51,19.1
2,All Students,2019-20,25447,1257,24190,95.1,234,25,10.7
2,All Students,2020-21,32858,3042,29816,90.7,196,66,33.7
2,All Students,2021-22,28070,2770,25300,90.1,174,68,39.1
2,All Students,2022-23,31076,2725,28351,91.2,194,65,33.5
3,All Students,2018-19,55245,3038,52207,94.5,329,59,17.9
3,All Students,2019-20,30719,1638,29081,94.7,278,42,15.1
3,All Students,2020-21,43730,4449,39281,89.8,257,86,33.5
3,All Students,2021-22,37401,3998,33403,89.3,235,103,43.8
3,All Students,2022-23,32872,3485,29387,89.4,209,88,42.1
4,All Students,2018-19,51060,2450,48610,95.2,306,33,10.8
4,All Students,2019-20,34608,1808,32800,94.8,315,56,17.8
4,All Students,2020-21,45112,3828,41284,91.5,265,79,29.8
4,All Students,2021-22,42799,3632,39167,91.5,256,81,31.6
4,All Students,2022-23,37154,3190,33964,91.4,227,75,33.0
5,All Students,2018-19,57158,3092,54066,94.6,334,46,13.8
5,All Students,2019-20,29174,1283,27891,95.6,258,28,10.9
5,All Students,2020-21,46297,3798,42499,91.8,270,68,25.2
5,All Students,2021-22,36270,3690,32580,89.8,222,82,36.9
5,All Students,2022-23,39415,3360,36055,91.5,239,67,28.0
6,All Students,2022-23,5,s,s,s,s,s,s
All Grades,All Students,2018-19,268535,11510,257025,95.7,1559,162,10.4
All Grades,All Students,2019-20,161624,7738,153886,95.2,1436,180,12.5
All Grades,All Students,2020-21,226083,12873,213210,94.3,1324,225,17.0
All Grades,All Students,2021-22,206336,15213,191123,92.6,1220,312,25.6
All Grades,All Students,2022-23,190426,12984,177442,93.2,1133,265,23.4
0K,All Students,2018-19,29119,1526,27593,94.8,167,24,14.4
0K,All Students,2019-20,18532,s,s,s,s,s,s
0K,All Students,2020-21,27683,2311,25372,91.7,164,34,20.7
0K,All Students,2021-22,23845,2085,21760,91.3,144,50,34.7
0K,All Students,2022-23,24383,2110,22273,91.3,146,52,35.6
1,All Students,2018-19,32632,1504,31128,95.4,189,21,11.1
1,All Students,2019-20,19298,835,18463,95.7,173,14,8.1
1,All Students,2020-21,26962,s,s,s,s,s,s
1,All Students,2021-22,28067,2350,25717,91.6,167,37,22.2
1,All Students,2022-23,23836,1767,22069,92.6,146,43,29.5
2,All Students,2018-19,38417,1860,36557,95.2,226,32,14.2
2,All Students,2019-20,21123,1003,20120,95.3,188,19,10.1
2,All Students,2020-21,28565,1394,27171,95.1,169,25,14.8
2,All Students,2021-22,27336,2039,25297,92.5,164,45,27.4
2,All Students,2022-23,28041,2046,25995,92.7,169,38,22.5
3,All Students,2018-19,61786,2528,59258,95.9,360,34,9.4
3,All Students,2019-20,33668,1551,32117,95.4,299,34,11.4
3,All Students,2020-21,40997,2097,38900,94.9,239,39,16.3
3,All Students,2021-22,43787,2967,40820,93.2,256,62,24.2
3,All Students,2022-23,33294,2321,30973,93.0,198,48,24.2
4,All Students,2018-19,54808,2048,52760,96.3,317,24,7.6
4,All Students,2019-20,39030,1841,37189,95.3,345,50,14.5
4,All Students,2020-21,47888,2901,44987,93.9,282,47,16.7
4,All Students,2021-22,40045,2633,37412,93.4,238,59,24.8
4,All Students,2022-23,42747,2462,40285,94.2,252,42,16.7
5,All Students,2018-19,51773,2044,49729,96.1,300,27,9.0
5,All Students,2019-20,29970,1242,28728,95.9,263,28,10.6
5,All Students,2020-21,53979,2622,51357,95.1,312,47,15.1
5,All Students,2021-22,43256,3139,40117,92.7,251,59,23.5
5,All Students,2022-23,38125,2278,35847,94.0,222,42,18.9
6,All Students,2019-20,3,s,s,s,s,s,s
6,All Students,2020-21,9,s,s,s,s,s,s
All Grades,All Students,2018-19,335680,14819,320861,95.6,1957,212,10.8
All Grades,All Students,2019-20,211861,9222,202639,95.6,1881,224,11.9
All Grades,All Students,2020-21,298818,15088,283730,95.0,1756,293,16.7
All Grades,All Students,2021-22,298082,22091,275991,92.6,1767,476,26.9
All Grades,All Students,2022-23,294360,19313,275047,93.4,1754,391,22.3
PK in K-12 Schools,All Students,2019-20,8186,484,7702,94.1,74,14,18.9
PK in K-12 Schools,All Students,2020-21,12360,801,11559,93.5,74,19,25.7
PK in K-12 Schools,All Students,2021-22,12673,1330,11343,89.5,73,30,41.1
PK in K-12 Schools,All Students,2022-23,12738,1002,11736,92.1,73,19,26.0
0K,All Students,2018-19,56546,3282,53264,94.2,335,57,17.0
0K,All Students,2019-20,29861,1853,28008,93.8,268,57,21.3
0K,All Students,2020-21,42765,3004,39761,93.0,255,59,23.1
0K,All Students,2021-22,45444,4012,41432,91.2,274,92,33.6
0K,All Students,2022-23,45495,3490,42005,92.3,277,82,29.6
1,All Students,2018-19,57745,2434,55311,95.8,337,33,9.8
1,All Students,2019-20,37203,1645,35558,95.6,331,45,13.6
1,All Students,2020-21,42531,2035,40496,95.2,251,43,17.1
1,All Students,2021-22,44142,3119,41023,92.9,261,65,24.9
1,All Students,2022-23,43787,2985,40802,93.2,261,58,22.2
2,All Students,2018-19,53110,2516,50594,95.3,312,38,12.2
2,All Students,2019-20,34740,1418,33322,95.9,310,30,9.7
2,All Students,2020-21,54777,2828,51949,94.8,321,51,15.9
2,All Students,2021-22,44277,3310,40967,92.5,269,73,27.1
2,All Students,2022-23,43926,2657,41269,94.0,262,52,19.8
3,All Students,2018-19,53394,2345,51049,95.6,309,34,11.0
3,All Students,2019-20,33188,1284,31904,96.1,292,26,8.9
3,All Students,2020-21,51758,1955,49803,96.2,302,33,10.9
3,All Students,2021-22,53489,3785,49704,92.9,312,79,25.3
3,All Students,2022-23,45741,2923,42818,93.6,272,58,21.3
4,All Students,2018-19,59382,2079,57303,96.5,346,27,7.8
4,All Students,2019-20,34064,1244,32820,96.3,301,25,8.3
4,All Students,2020-21,47254,2430,44824,94.9,276,47,17.0
4,All Students,2021-22,51663,3201,48462,93.8,304,58,19.1
4,All Students,2022-23,52345,3282,49063,93.7,309,64,20.7
5,All Students,2018-19,55503,2163,53340,96.1,318,23,7.2
5,All Students,2019-20,34619,1294,33325,96.3,305,27,8.9
5,All Students,2020-21,47373,2035,45338,95.7,277,41,14.8
5,All Students,2021-22,46394,3334,43060,92.8,274,79,28.8
5,All Students,2022-23,50328,2974,47354,94.1,300,58,19.3
All Grades,All Students,2018-19,84309,4234,80075,95.0,497,75,15.1
All Grades,All Students,2019-20,53699,3054,50645,94.3,482,86,17.8
All Grades,All Students,2020-21,74795,5666,69129,92.4,439,103,23.5
All Grades,All Students,2021-22,66904,6033,60871,91.0,409,145,35.5
All Grades,All Students,2022-23,56451,4671,51780,91.7,350,109,31.1
PK in K-12 Schools,All Students,2018-19,2394,205,2189,91.4,15,5,33.3
PK in K-12 Schools,All Students,2019-20,1857,194,1663,89.6,17,9,52.9
PK in K-12 Schools,All Students,2020-21,2085,123,1962,94.1,12,2,16.7
PK in K-12 Schools,All Students,2021-22,2122,215,1907,89.9,12,5,41.7
PK in K-12 Schools,All Students,2022-23,2557,s,s,s,s,s,s
0K,All Students,2018-19,27595,1675,25920,93.9,165,38,23.0
0K,All Students,2019-20,18426,1243,17183,93.3,164,37,22.6
0K,All Students,2020-21,23194,2235,20959,90.4,139,43,30.9
0K,All Students,2021-22,19476,2236,17240,88.5,120,55,45.8
0K,All Students,2022-23,16153,1446,14707,91.0,105,38,36.2
1,All Students,2018-19,26964,1192,25772,95.6,160,15,9.4
1,All Students,2019-20,16493,861,15632,94.8,150,24,16.0
1,All Students,2020-21,26373,1612,24761,93.9,154,29,18.8
1,All Students,2021-22,22741,1942,20799,91.5,140,47,33.6
1,All Students,2022-23,17426,1461,15965,91.6,104,30,28.8
2,All Students,2018-19,27356,1162,26194,95.8,157,17,10.8
2,All Students,2019-20,16923,756,16167,95.5,151,16,10.6
2,All Students,2020-21,23143,1696,21447,92.7,134,29,21.6
2,All Students,2021-22,22565,1640,20925,92.7,137,38,27.7
2,All Students,2022-23,20313,1494,18819,92.6,123,32,26.0
3,All Students,2022-23,2,s,s,s,s,s,s
All Grades,All Students,2018-19,214427,9763,204664,95.4,1227,139,11.3
All Grades,All Students,2019-20,137810,6576,131234,95.2,1228,156,12.7
All Grades,All Students,2020-21,201032,9822,191210,95.1,1185,162,13.7
All Grades,All Students,2021-22,205374,12179,193195,94.1,1227,241,19.6
All Grades,All Students,2022-23,210704,14037,196667,93.3,1235,263,21.3
0K,All Students,2018-19,21704,1410,20294,93.5,126,26,20.6
0K,All Students,2019-20,13239,940,12299,92.9,119,28,23.5
0K,All Students,2020-21,20459,1536,18923,92.5,123,28,22.8
0K,All Students,2021-22,24165,1709,22456,92.9,143,34,23.8
0K,All Students,2022-23,20135,1816,18319,91.0,120,40,33.3
1,All Students,2018-19,23530,1221,22309,94.8,137,20,14.6
1,All Students,2019-20,14069,838,13231,94.0,126,20,15.9
1,All Students,2020-21,18749,844,17905,95.5,115,15,13.0
1,All Students,2021-22,21460,1449,20011,93.2,127,29,22.8
1,All Students,2022-23,28351,2098,26253,92.6,164,43,26.2
2,All Students,2018-19,23340,1051,22289,95.5,133,13,9.8
2,All Students,2019-20,14988,842,14146,94.4,132,21,15.9
2,All Students,2020-21,21231,1210,20021,94.3,123,20,16.3
2,All Students,2021-22,19159,1102,18057,94.2,120,23,19.2
2,All Students,2022-23,22821,1610,21211,92.9,135,32,23.7
3,All Students,2018-19,22638,869,21769,96.2,130,6,4.6
3,All Students,2019-20,15000,706,14294,95.3,136,17,12.5
3,All Students,2020-21,21963,775,21188,96.5,133,11,8.3
3,All Students,2021-22,21180,1059,20121,95.0,126,17,13.5
3,All Students,2022-23,21024,1324,19700,93.7,126,26,20.6
4,All Students,2018-19,23491,1086,22405,95.4,133,12,9.0
4,All Students,2019-20,14700,518,14182,96.5,131,8,6.1
4,All Students,2020-21,22576,510,22066,97.7,132,6,4.5
4,All Students,2021-22,22508,1131,21377,95.0,135,18,13.3
4,All Students,2022-23,23039,1371,21668,94.0,138,24,17.4
5,All Students,2018-19,24250,1033,23217,95.7,138,15,10.9
5,All Students,2019-20,14591,624,13967,95.7,129,12,9.3
5,All Students,2020-21,21393,686,20707,96.8,127,11,8.7
5,All Students,2021-22,22362,1246,21116,94.4,134,32,23.9
5,All Students,2022-23,23367,1203,22164,94.9,135,14,10.4
6,All Students,2018-19,25311,1005,24306,96.0,144,11,7.6
6,All Students,2019-20,19510,906,18604,95.4,173,21,12.1
6,All Students,2020-21,21455,846,20609,96.1,125,15,12.0
6,All Students,2021-22,22996,1104,21892,95.2,138,18,13.0
6,All Students,2022-23,24077,1616,22461,93.3,139,31,22.3
7,All Students,2018-19,24607,823,23784,96.7,139,13,9.4
7,All Students,2019-20,16043,547,15496,96.6,144,16,11.1
7,All Students,2020-21,29133,1615,27518,94.5,169,32,18.9
7,All Students,2021-22,22678,1467,21211,93.5,134,32,23.9
7,All Students,2022-23,24179,1172,23007,95.2,140,15,10.7
8,All Students,2018-19,25556,1265,24291,95.1,147,23,15.6
8,All Students,2019-20,15670,655,15015,95.8,138,13,9.4
8,All Students,2020-21,24073,1800,22273,92.5,138,24,17.4
8,All Students,2021-22,28866,1912,26954,93.4,170,38,22.4
8,All Students,2022-23,23711,1827,21884,92.3,138,38,27.5
All Grades,All Students,2018-19,182036,8175,173861,95.5,1077,136,12.6
All Grades,All Students,2019-20,111135,5176,105959,95.3,991,139,14.0
All Grades,All Students,2020-21,161236,8223,153013,94.9,942,140,14.9
All Grades,All Students,2021-22,147938,9886,138052,93.3,878,194,22.1
All Grades,All Students,2022-23,142121,9882,132239,93.0,859,213,24.8
PK in K-12 Schools,All Students,2018-19,6320,s,s,s,s,s,s
PK in K-12 Schools,All Students,2019-20,4099,325,3774,92.1,36,11,30.6
PK in K-12 Schools,All Students,2020-21,6292,610,5682,90.3,36,13,36.1
PK in K-12 Schools,All Students,2021-22,6367,618,5749,90.3,36,13,36.1
PK in K-12 Schools,All Students,2022-23,6352,s,s,s,s,s,s
0K,All Students,2018-19,25649,1511,24138,94.1,153,24,15.7
0K,All Students,2019-20,14055,984,13071,93.0,127,25,19.7
0K,All Students,2020-21,19346,1305,18041,93.3,117,21,17.9
0K,All Students,2021-22,20181,1579,18602,92.2,122,33,27.0
0K,All Students,2022-23,17062,1677,15385,90.2,102,39,38.2
1,All Students,2018-19,23980,1153,22827,95.2,142,21,14.8
1,All Students,2019-20,14959,730,14229,95.1,133,19,14.3
1,All Students,2020-21,21014,839,20175,96.0,124,15,12.1
1,All Students,2021-22,18290,1622,16668,91.1,112,37,33.0
1,All Students,2022-23,20101,1517,18584,92.5,124,32,25.8
2,All Students,2018-19,26552,1182,25370,95.5,157,19,12.1
2,All Students,2019-20,15859,656,15203,95.9,142,16,11.3
2,All Students,2020-21,22894,1156,21738,95.0,135,20,14.8
2,All Students,2021-22,21449,1442,20007,93.3,128,28,21.9
2,All Students,2022-23,17939,1270,16669,92.9,108,27,25.0
3,All Students,2018-19,23734,805,22929,96.6,138,12,8.7
3,All Students,2019-20,17703,680,17023,96.2,158,18,11.4
3,All Students,2020-21,22848,959,21889,95.8,133,16,12.0
3,All Students,2021-22,20658,1170,19488,94.3,123,24,19.5
3,All Students,2022-23,21367,1398,19969,93.5,129,27,20.9
4,All Students,2018-19,25833,953,24880,96.3,151,15,9.9
4,All Students,2019-20,16062,630,15432,96.1,141,17,12.1
4,All Students,2020-21,25558,931,24627,96.4,148,14,9.5
4,All Students,2021-22,22457,1167,21290,94.8,133,17,12.8
4,All Students,2022-23,21253,1204,20049,94.3,130,28,21.5
5,All Students,2018-19,25854,988,24866,96.2,153,14,9.2
5,All Students,2019-20,16197,705,15492,95.6,145,20,13.8
5,All Students,2020-21,23342,1282,22060,94.5,134,20,14.9
5,All Students,2021-22,23387,1383,22004,94.1,137,22,16.1
5,All Students,2022-23,23301,1191,22110,94.9,141,21,14.9
6,All Students,2018-19,24099,1093,23006,95.5,143,18,12.6
6,All Students,2019-20,12201,466,11735,96.2,109,13,11.9
6,All Students,2020-21,19942,1141,18801,94.3,115,21,18.3
6,All Students,2021-22,15149,905,14244,94.0,87,20,23.0
6,All Students,2022-23,14744,1007,13737,93.2,88,25,28.4
7,All Students,2022-23,2,s,s,s,s,s,s
10,All Students,2018-19,15,s,s,s,s,s,s
All Grades,All Students,2018-19,400992,23924,377068,94.0,2363,431,18.2
All Grades,All Students,2019-20,261433,15545,245888,94.1,2346,423,18.0
All Grades,All Students,2020-21,376064,43179,332885,88.5,2224,741,33.3
All Grades,All Students,2021-22,372430,35650,336780,90.4,2233,770,34.5
All Grades,All Students,2022-23,380842,34652,346190,90.9,2322,769,33.1
4,All Students,2020-21,40,s,s,s,s,s,s
5,All Students,2022-23,23,s,s,s,s,s,s
6,All Students,2018-19,128670,s,s,s,s,s,s
6,All Students,2019-20,87242,4766,82476,94.5,790,122,15.4
6,All Students,2020-21,115485,11517,103968,90.0,686,216,31.5
6,All Students,2021-22,118285,10808,107477,90.9,719,230,32.0
6,All Students,2022-23,122769,s,s,s,s,s,s
7,All Students,2018-19,137602,7891,129711,94.3,803,141,17.6
7,All Students,2019-20,84847,5042,79805,94.1,761,146,19.2
7,All Students,2020-21,132503,15611,116892,88.2,788,273,34.6
7,All Students,2021-22,119100,10952,108148,90.8,712,239,33.6
7,All Students,2022-23,130086,12130,117956,90.7,789,266,33.7
8,All Students,2018-19,134577,9150,125427,93.2,797,170,21.3
8,All Students,2019-20,89344,5737,83607,93.6,795,155,19.5
8,All Students,2020-21,128023,15999,112024,87.5,750,252,33.6
8,All Students,2021-22,135045,13890,121155,89.7,802,301,37.5
8,All Students,2022-23,127964,12561,115403,90.2,747,266,35.6
9,All Students,2018-19,143,s,s,s,s,s,s
9,All Students,2020-21,13,s,s,s,s,s,s
All Grades,All Students,2018-19,105807,7585,98222,92.8,627,159,25.4
All Grades,All Students,2019-20,61560,4074,57486,93.4,558,123,22.0
All Grades,All Students,2020-21,84877,7315,77562,91.4,513,169,32.9
All Grades,All Students,2021-22,90033,9705,80328,89.2,562,257,45.7
All Grades,All Students,2022-23,87318,8704,78614,90.0,540,214,39.6
PK in K-12 Schools,All Students,2018-19,9386,1040,8346,88.9,55,25,45.5
PK in K-12 Schools,All Students,2019-20,6810,593,6217,91.3,63,21,33.3
PK in K-12 Schools,All Students,2020-21,6427,731,5696,88.6,39,17,43.6
PK in K-12 Schools,All Students,2021-22,12501,2032,10469,83.7,93,70,75.3
PK in K-12 Schools,All Students,2022-23,13195,2121,11074,83.9,85,60,70.6
0K,All Students,2018-19,14793,1272,13521,91.4,92,28,30.4
0K,All Students,2019-20,9482,752,8730,92.1,87,28,32.2
0K,All Students,2020-21,14202,1402,12800,90.1,88,31,35.2
0K,All Students,2021-22,12621,1546,11075,87.8,77,41,53.2
0K,All Students,2022-23,12253,1418,10835,88.4,78,38,48.7
1,All Students,2018-19,15558,1016,14542,93.5,92,17,18.5
1,All Students,2019-20,9265,630,8635,93.2,85,20,23.5
1,All Students,2020-21,12942,1418,11524,89.0,77,34,44.2
1,All Students,2021-22,13543,1368,12175,89.9,83,31,37.3
1,All Students,2022-23,11803,1238,10565,89.5,75,29,38.7
2,All Students,2018-19,12627,964,11663,92.4,75,23,30.7
2,All Students,2019-20,9336,537,8799,94.2,84,16,19.0
2,All Students,2020-21,12985,996,11989,92.3,78,22,28.2
2,All Students,2021-22,12684,1269,11415,90.0,79,33,41.8
2,All Students,2022-23,12780,1034,11746,91.9,76,25,32.9
3,All Students,2018-19,16831,1101,15730,93.5,101,23,22.8
3,All Students,2019-20,7999,537,7462,93.3,73,18,24.7
3,All Students,2020-21,12867,739,12128,94.3,80,18,22.5
3,All Students,2021-22,12716,1103,11613,91.3,77,25,32.5
3,All Students,2022-23,12249,968,11281,92.1,77,24,31.2
4,All Students,2018-19,14420,1015,13405,93.0,85,24,28.2
4,All Students,2019-20,9709,495,9214,94.9,86,10,11.6
4,All Students,2020-21,11859,956,10903,91.9,71,20,28.2
4,All Students,2021-22,12745,1038,11707,91.9,75,25,33.3
4,All Students,2022-23,12562,930,11632,92.6,75,19,25.3
5,All Students,2018-19,22192,1177,21015,94.7,127,19,15.0
5,All Students,2019-20,8959,530,8429,94.1,80,10,12.5
5,All Students,2020-21,13595,1073,12522,92.1,80,27,33.8
5,All Students,2021-22,13223,1349,11874,89.8,78,32,41.0
5,All Students,2022-23,12476,995,11481,92.0,74,19,25.7
All Grades,All Students,2018-19,124621,10477,114144,91.6,733,222,30.3
All Grades,All Students,2019-20,77489,6570,70919,91.5,701,219,31.2
All Grades,All Students,2020-21,110344,8538,101806,92.3,685,175,25.5
All Grades,All Students,2021-22,100935,10468,90467,89.6,626,273,43.6
All Grades,All Students,2022-23,98400,9989,88411,89.8,614,242,39.4
PK in K-12 Schools,All Students,2018-19,10808,1595,9213,85.2,68,42,61.8
PK in K-12 Schools,All Students,2019-20,6968,980,5988,85.9,68,38,55.9
PK in K-12 Schools,All Students,2020-21,6958,1304,5654,81.3,44,24,54.5
PK in K-12 Schools,All Students,2021-22,8671,s,s,s,s,s,s
PK in K-12 Schools,All Students,2022-23,13035,2217,10818,83.0,86,57,66.3
0K,All Students,2018-19,21028,1808,19220,91.4,120,36,30.0
0K,All Students,2019-20,11542,1174,10368,89.8,103,43,41.7
0K,All Students,2020-21,17068,1657,15411,90.3,104,30,28.8
0K,All Students,2021-22,10679,1308,9371,87.8,70,37,52.9
0K,All Students,2022-23,11103,1301,9802,88.3,69,37,53.6
1,All Students,2018-19,20557,1584,18973,92.3,121,37,30.6
1,All Students,2019-20,13683,1151,12532,91.6,125,39,31.2
1,All Students,2020-21,16678,1216,15462,92.7,104,26,25.0
1,All Students,2021-22,15085,1580,13505,89.5,93,40,43.0
1,All Students,2022-23,10397,1106,9291,89.4,68,25,36.8
2,All Students,2018-19,15608,1178,14430,92.5,91,24,26.4
2,All Students,2019-20,13289,950,12339,92.9,120,28,23.3
2,All Students,2020-21,19594,1220,18374,93.8,119,26,21.8
2,All Students,2021-22,17376,1515,15861,91.3,107,37,34.6
2,All Students,2022-23,13404,1194,12210,91.1,83,32,38.6
3,All Students,2018-19,17945,1295,16650,92.8,108,21,19.4
3,All Students,2019-20,10243,632,9611,93.8,91,14,15.4
3,All Students,2020-21,18551,1087,17464,94.1,117,27,23.1
3,All Students,2021-22,17085,1727,15358,89.9,104,45,43.3
3,All Students,2022-23,17384,1545,15839,91.1,109,36,33.0
4,All Students,2018-19,16245,1423,14822,91.2,94,29,30.9
4,All Students,2019-20,11821,869,10952,92.6,105,29,27.6
4,All Students,2020-21,15068,1006,14062,93.3,93,20,21.5
4,All Students,2021-22,17456,1602,15854,90.8,106,40,37.7
4,All Students,2022-23,16959,1470,15489,91.3,102,33,32.4
5,All Students,2018-19,22430,1594,20836,92.9,131,33,25.2
5,All Students,2019-20,9943,814,9129,91.8,89,28,31.5
5,All Students,2020-21,16427,1048,15379,93.6,104,22,21.2
5,All Students,2021-22,14581,1420,13161,90.3,93,39,41.9
5,All Students,2022-23,16118,1156,14962,92.8,97,22,22.7
6,All Students,2021-22,2,s,s,s,s,s,s
All Grades,All Students,2018-19,348587,15124,333463,95.7,2025,238,11.8
All Grades,All Students,2019-20,231320,10687,220633,95.4,2046,277,13.5
All Grades,All Students,2020-21,361886,22316,339570,93.8,2103,407,19.4
All Grades,All Students,2021-22,347572,25546,322026,92.7,2046,532,26.0
All Grades,All Students,2022-23,322654,23623,299031,92.7,1902,502,26.4
6,All Students,2018-19,106921,4472,102449,95.8,628,79,12.6
6,All Students,2019-20,62201,2908,59293,95.3,554,68,12.3
6,All Students,2020-21,103227,4930,98297,95.2,602,80,13.3
6,All Students,2021-22,92792,6913,85879,92.6,550,137,24.9
6,All Students,2022-23,76297,5407,70890,92.9,453,123,27.2
7,All Students,2018-19,119661,4570,115091,96.2,696,65,9.3
7,All Students,2019-20,90335,4103,86232,95.5,796,113,14.2
7,All Students,2020-21,123259,9240,114019,92.5,718,173,24.1
7,All Students,2021-22,130573,8525,122048,93.5,771,181,23.5
7,All Students,2022-23,114437,8207,106230,92.8,674,174,25.8
8,All Students,2018-19,122005,6082,115923,95.0,701,94,13.4
8,All Students,2019-20,78784,3676,75108,95.3,696,96,13.8
8,All Students,2020-21,135400,8146,127254,94.0,783,154,19.7
8,All Students,2021-22,124207,10108,114099,91.9,725,214,29.5
8,All Students,2022-23,131920,10009,121911,92.4,775,205,26.5
All Grades,All Students,2018-19,165639,12713,152926,92.3,980,253,25.8
All Grades,All Students,2019-20,100828,7289,93539,92.8,901,217,24.1
All Grades,All Students,2020-21,135343,11440,123903,91.5,804,192,23.9
All Grades,All Students,2021-22,128288,13839,114449,89.2,770,323,41.9
All Grades,All Students,2022-23,114647,10309,104338,91.0,688,216,31.4
6,All Students,2018-19,46838,3715,43123,92.1,276,70,25.4
6,All Students,2019-20,29198,s,s,s,s,s,s
6,All Students,2020-21,40337,3845,36492,90.5,239,67,28.0
6,All Students,2021-22,35203,s,s,s,s,s,s
6,All Students,2022-23,34716,2347,32369,93.2,210,49,23.3
7,All Students,2018-19,56991,4290,52701,92.5,333,93,27.9
7,All Students,2019-20,33516,2377,31139,92.9,300,74,24.7
7,All Students,2020-21,44337,4188,40149,90.6,266,72,27.1
7,All Students,2021-22,42249,5221,37028,87.6,249,113,45.4
7,All Students,2022-23,36720,3350,33370,90.9,219,66,30.1
8,All Students,2018-19,61810,4708,57102,92.4,371,90,24.3
8,All Students,2019-20,38113,3271,34842,91.4,341,104,30.5
8,All Students,2020-21,50669,3407,47262,93.3,299,53,17.7
8,All Students,2021-22,50831,5039,45792,90.1,309,127,41.1
8,All Students,2022-23,43211,4612,38599,89.3,259,101,39.0
9,All Students,2019-20,1,s,s,s,s,s,s
9,All Students,2021-22,5,s,s,s,s,s,s
All Grades,All Students,2018-19,115141,6193,108948,94.6,691,121,17.5
All Grades,All Students,2019-20,71580,4981,66599,93.0,643,150,23.3
All Grades,All Students,2020-21,103026,13038,89988,87.3,622,253,40.7
All Grades,All Students,2021-22,123752,11346,112406,90.8,748,261,34.9
All Grades,All Students,2022-23,128928,12715,116213,90.1,807,311,38.5
PK in K-12 Schools,All Students,2018-19,8432,875,7557,89.6,53,24,45.3
PK in K-12 Schools,All Students,2019-20,6083,s,s,s,s,s,s
PK in K-12 Schools,All Students,2020-21,6783,s,s,s,s,s,s
PK in K-12 Schools,All Students,2021-22,11756,s,s,s,s,s,s
PK in K-12 Schools,All Students,2022-23,13192,2182,11010,83.5,89,60,67.4
0K,All Students,2018-19,15740,1083,14657,93.1,95,24,25.3
0K,All Students,2019-20,9802,843,8959,91.4,88,31,35.2
0K,All Students,2020-21,15571,3038,12533,80.5,93,47,50.5
0K,All Students,2021-22,15686,1704,13982,89.1,95,38,40.0
0K,All Students,2022-23,17469,2052,15417,88.3,113,51,45.1
1,All Students,2018-19,17698,984,16714,94.4,111,22,19.8
1,All Students,2019-20,10186,604,9582,94.1,91,12,13.2
1,All Students,2020-21,14927,2586,12341,82.7,90,51,56.7
1,All Students,2021-22,19493,1639,17854,91.6,118,35,29.7
1,All Students,2022-23,16953,1763,15190,89.6,107,46,43.0
2,All Students,2018-19,17325,906,16419,94.8,103,14,13.6
2,All Students,2019-20,12279,800,11479,93.5,110,22,20.0
2,All Students,2020-21,15189,1372,13817,91.0,94,26,27.7
2,All Students,2021-22,19456,1791,17665,90.8,114,43,37.7
2,All Students,2022-23,20944,1797,19147,91.4,132,40,30.3
3,All Students,2018-19,16510,778,15732,95.3,96,16,16.7
3,All Students,2019-20,10996,645,10351,94.1,98,23,23.5
3,All Students,2020-21,18733,1540,17193,91.8,112,36,32.1
3,All Students,2021-22,16759,1319,15440,92.1,99,25,25.3
3,All Students,2022-23,19363,1661,17702,91.4,118,41,34.7
4,All Students,2018-19,18334,762,17572,95.8,107,10,9.3
4,All Students,2019-20,10829,551,10278,94.9,97,15,15.5
4,All Students,2020-21,16222,1928,14294,88.1,98,40,40.8
4,All Students,2021-22,22169,1705,20464,92.3,130,38,29.2
4,All Students,2022-23,17339,1246,16093,92.8,106,27,25.5
5,All Students,2018-19,21102,805,20297,96.2,126,11,8.7
5,All Students,2019-20,11403,564,10839,95.1,102,14,13.7
5,All Students,2020-21,15596,1482,14114,90.5,92,29,31.5
5,All Students,2021-22,18423,1339,17084,92.7,111,26,23.4
5,All Students,2022-23,23668,2014,21654,91.5,142,46,32.4
6,All Students,2019-20,2,s,s,s,s,s,s
6,All Students,2020-21,5,s,s,s,s,s,s
6,All Students,2021-22,10,s,s,s,s,s,s
All Grades,All Students,2018-19,109507,7920,101587,92.8,645,142,22.0
All Grades,All Students,2019-20,69803,4973,64830,92.9,631,154,24.4
All Grades,All Students,2020-21,97533,6024,91509,93.8,577,114,19.8
All Grades,All Students,2021-22,94252,9944,84308,89.4,573,241,42.1
All Grades,All Students,2022-23,92662,9351,83311,89.9,570,236,41.4
PK in K-12 Schools,All Students,2018-19,12491,1094,11397,91.2,73,20,27.4
PK in K-12 Schools,All Students,2019-20,7832,764,7068,90.2,70,29,41.4
PK in K-12 Schools,All Students,2020-21,7114,571,6543,92.0,48,16,33.3
PK in K-12 Schools,All Students,2021-22,7747,1146,6601,85.2,49,35,71.4
PK in K-12 Schools,All Students,2022-23,7607,1117,6490,85.3,47,33,70.2
0K,All Students,2018-19,10587,737,9850,93.0,62,12,19.4
0K,All Students,2019-20,7990,648,7342,91.9,72,19,26.4
0K,All Students,2020-21,9906,936,8970,90.6,60,20,33.3
0K,All Students,2021-22,7937,1025,6912,87.1,49,22,44.9
0K,All Students,2022-23,8745,1128,7617,87.1,53,32,60.4
1,All Students,2018-19,11432,863,10569,92.5,68,16,23.5
1,All Students,2019-20,6300,353,5947,94.4,58,10,17.2
1,All Students,2020-21,10604,641,9963,94.0,61,13,21.3
1,All Students,2021-22,9462,1009,8453,89.3,58,28,48.3
1,All Students,2022-23,7007,786,6221,88.8,41,15,36.6
2,All Students,2018-19,9608,622,8986,93.5,55,8,14.5
2,All Students,2019-20,6707,415,6292,93.8,60,14,23.3
2,All Students,2020-21,9098,623,8475,93.2,53,10,18.9
2,All Students,2021-22,9529,940,8589,90.1,58,25,43.1
2,All Students,2022-23,9677,907,8770,90.6,61,24,39.3
3,All Students,2018-19,9075,482,8593,94.7,52,5,9.6
3,All Students,2019-20,6637,375,6262,94.3,62,12,19.4
3,All Students,2020-21,9754,399,9355,95.9,57,6,10.5
3,All Students,2021-22,8213,666,7547,91.9,49,13,26.5
3,All Students,2022-23,10793,924,9869,91.4,65,22,33.8
4,All Students,2018-19,10003,689,9314,93.1,58,11,19.0
4,All Students,2019-20,6395,420,5975,93.4,56,12,21.4
4,All Students,2020-21,9560,512,9048,94.6,57,13,22.8
4,All Students,2021-22,9692,858,8834,91.1,57,17,29.8
4,All Students,2022-23,8348,692,7656,91.7,52,17,32.7
5,All Students,2018-19,12604,981,11623,92.2,74,21,28.4
5,All Students,2019-20,6767,439,6328,93.5,61,13,21.3
5,All Students,2020-21,10029,492,9537,95.1,58,6,10.3
5,All Students,2021-22,9504,979,8525,89.7,55,19,34.5
5,All Students,2022-23,8625,749,7876,91.3,52,17,32.7
6,All Students,2018-19,9825,538,9287,94.5,62,8,12.9
6,All Students,2019-20,7990,611,7379,92.4,71,18,25.4
6,All Students,2020-21,10258,705,9553,93.1,60,14,23.3
6,All Students,2021-22,10806,1038,9768,90.4,66,29,43.9
6,All Students,2022-23,10269,1025,9244,90.0,62,25,40.3
7,All Students,2018-19,9732,617,9115,93.7,58,11,19.0
7,All Students,2019-20,6911,416,6495,94.0,63,12,19.0
7,All Students,2020-21,11410,590,10820,94.8,67,8,11.9
7,All Students,2021-22,10021,1064,8957,89.4,63,23,36.5
7,All Students,2022-23,10803,930,9873,91.4,66,22,33.3
8,All Students,2018-19,14150,1297,12853,90.8,83,30,36.1
8,All Students,2019-20,6274,532,5742,91.5,58,15,25.9
8,All Students,2020-21,9800,555,9245,94.3,56,8,14.3
8,All Students,2021-22,11341,1219,10122,89.3,69,30,43.5
8,All Students,2022-23,10788,1093,9695,89.9,71,29,40.8
All Grades,All Students,2018-19,152402,10883,141519,92.9,900,233,25.9
All Grades,All Students,2019-20,90989,6505,84484,92.9,830,208,25.1
All Grades,All Students,2020-21,121641,8376,113265,93.1,737,163,22.1
All Grades,All Students,2021-22,119407,12764,106643,89.3,719,304,42.3
All Grades,All Students,2022-23,120168,12142,108026,89.9,718,273,38.0
PK in K-12 Schools,All Students,2018-19,6270,562,5708,91.0,38,13,34.2
PK in K-12 Schools,All Students,2019-20,5104,652,4452,87.2,54,27,50.0
PK in K-12 Schools,All Students,2020-21,7136,945,6191,86.8,46,18,39.1
PK in K-12 Schools,All Students,2021-22,11630,2174,9456,81.3,82,66,80.5
PK in K-12 Schools,All Students,2022-23,13413,2214,11199,83.5,83,60,72.3
0K,All Students,2018-19,19899,1666,18233,91.6,120,36,30.0
0K,All Students,2019-20,13587,1150,12437,91.5,126,40,31.7
0K,All Students,2020-21,18604,1495,17109,92.0,111,32,28.8
0K,All Students,2021-22,17996,1976,16020,89.0,108,46,42.6
0K,All Students,2022-23,17106,2096,15010,87.7,102,43,42.2
1,All Students,2018-19,21805,1891,19914,91.3,132,45,34.1
1,All Students,2019-20,12794,887,11907,93.1,116,28,24.1
1,All Students,2020-21,18362,1388,16974,92.4,117,34,29.1
1,All Students,2021-22,18355,1706,16649,90.7,111,36,32.4
1,All Students,2022-23,19207,2007,17200,89.6,113,44,38.9
2,All Students,2018-19,22904,1409,21495,93.8,132,27,20.5
2,All Students,2019-20,12797,966,11831,92.5,115,34,29.6
2,All Students,2020-21,18051,1012,17039,94.4,109,21,19.3
2,All Students,2021-22,17757,1664,16093,90.6,103,36,35.0
2,All Students,2022-23,17904,1481,16423,91.7,109,33,30.3
3,All Students,2018-19,24739,1501,23238,93.9,144,28,19.4
3,All Students,2019-20,14083,833,13250,94.1,127,21,16.5
3,All Students,2020-21,16871,1215,15656,92.8,99,24,24.2
3,All Students,2021-22,16969,1689,15280,90.0,99,35,35.4
3,All Students,2022-23,18483,1419,17064,92.3,108,28,25.9
4,All Students,2018-19,28717,1987,26730,93.1,169,43,25.4
4,All Students,2019-20,14818,872,13946,94.1,133,28,21.1
4,All Students,2020-21,21151,1143,20008,94.6,127,17,13.4
4,All Students,2021-22,16808,1758,15050,89.5,99,39,39.4
4,All Students,2022-23,16694,1380,15314,91.7,99,31,31.3
5,All Students,2018-19,28068,1867,26201,93.3,165,41,24.8
5,All Students,2019-20,17806,1145,16661,93.6,159,30,18.9
5,All Students,2020-21,21466,1178,20288,94.5,128,17,13.3
5,All Students,2021-22,19892,1797,18095,91.0,117,46,39.3
5,All Students,2022-23,17361,1545,15816,91.1,104,34,32.7
All Grades,All Students,2018-19,322449,15444,307005,95.2,1894,255,13.5
All Grades,All Students,2019-20,196212,10318,185894,94.7,1756,273,15.5
All Grades,All Students,2020-21,266867,20769,246098,92.2,1590,380,23.9
All Grades,All Students,2021-22,244179,19673,224506,91.9,1455,452,31.1
All Grades,All Students,2022-23,220359,19045,201314,91.4,1316,428,32.5
0K,All Students,2018-19,44686,3171,41515,92.9,268,64,23.9
0K,All Students,2019-20,28740,s,s,s,s,s,s
0K,All Students,2020-21,36635,3412,33223,90.7,224,67,29.9
0K,All Students,2021-22,31867,3147,28720,90.1,195,89,45.6
0K,All Students,2022-23,32813,3583,29230,89.1,196,83,42.3
1,All Students,2018-19,51466,2690,48776,94.8,310,43,13.9
1,All Students,2019-20,29066,1865,27201,93.6,261,51,19.5
1,All Students,2020-21,41483,4756,36727,88.5,247,89,36.0
1,All Students,2021-22,38981,3522,35459,91.0,230,80,34.8
1,All Students,2022-23,31880,2917,28963,90.9,194,76,39.2
2,All Students,2018-19,52614,2655,49959,95.0,307,45,14.7
2,All Students,2019-20,32002,1622,30380,94.9,286,40,14.0
2,All Students,2020-21,40782,3008,37774,92.6,243,58,23.9
2,All Students,2021-22,39376,3119,36257,92.1,234,67,28.6
2,All Students,2022-23,36769,3413,33356,90.7,224,79,35.3
3,All Students,2018-19,56797,2585,54212,95.4,330,45,13.6
3,All Students,2019-20,33919,1693,32226,95.0,306,49,16.0
3,All Students,2020-21,48420,3842,44578,92.1,292,69,23.6
3,All Students,2021-22,40531,3130,37401,92.3,242,69,28.5
3,All Students,2022-23,37005,2974,34031,92.0,220,66,30.0
4,All Students,2018-19,59962,2362,57600,96.1,350,33,9.4
4,All Students,2019-20,36534,1550,34984,95.8,323,34,10.5
4,All Students,2020-21,49669,2939,46730,94.1,295,54,18.3
4,All Students,2021-22,47604,3344,44260,93.0,283,75,26.5
4,All Students,2022-23,39653,3165,36488,92.0,236,67,28.4
5,All Students,2018-19,56924,1981,54943,96.5,329,25,7.6
5,All Students,2019-20,35870,1431,34439,96.0,320,31,9.7
5,All Students,2020-21,49878,2812,47066,94.4,289,43,14.9
5,All Students,2021-22,45820,3411,42409,92.6,271,72,26.6
5,All Students,2022-23,42239,2993,39246,92.9,246,57,23.2
6,All Students,2019-20,81,s,s,s,s,s,s
All Grades,All Students,2018-19,133108,10892,122216,91.8,786,247,31.4
All Grades,All Students,2019-20,89792,7107,82685,92.1,805,218,27.1
All Grades,All Students,2020-21,129631,8100,121531,93.8,797,157,19.7
All Grades,All Students,2021-22,140092,15368,124724,89.0,839,348,41.5
All Grades,All Students,2022-23,144695,15920,128775,89.0,871,360,41.3
PK in K-12 Schools,All Students,2018-19,14646,1599,13047,89.1,93,39,41.9
PK in K-12 Schools,All Students,2019-20,11255,1293,9962,88.5,103,44,42.7
PK in K-12 Schools,All Students,2020-21,12540,655,11885,94.8,79,13,16.5
PK in K-12 Schools,All Students,2021-22,19122,2550,16572,86.7,114,57,50.0
PK in K-12 Schools,All Students,2022-23,19386,2558,16828,86.8,117,65,55.6
0K,All Students,2018-19,21409,2102,19307,90.2,126,56,44.4
0K,All Students,2019-20,12910,1068,11842,91.7,117,37,31.6
0K,All Students,2020-21,19099,1173,17926,93.9,116,24,20.7
0K,All Students,2021-22,19565,2122,17443,89.2,118,52,44.1
0K,All Students,2022-23,22245,2692,19553,87.9,138,70,50.7
1,All Students,2018-19,20686,1758,18928,91.5,123,38,30.9
1,All Students,2019-20,14041,1271,12770,90.9,128,45,35.2
1,All Students,2020-21,17898,1378,16520,92.3,111,25,22.5
1,All Students,2021-22,19731,2115,17616,89.3,120,49,40.8
1,All Students,2022-23,21099,2245,18854,89.4,126,54,42.9
2,All Students,2018-19,20230,1658,18572,91.8,117,39,33.3
2,All Students,2019-20,13302,1006,12296,92.4,117,28,23.9
2,All Students,2020-21,21101,1390,19711,93.4,130,27,20.8
2,All Students,2021-22,17378,1761,15617,89.9,102,39,38.2
2,All Students,2022-23,20235,2195,18040,89.2,121,46,38.0
3,All Students,2018-19,20977,1582,19395,92.5,121,27,22.3
3,All Students,2019-20,13089,935,12154,92.9,116,23,19.8
3,All Students,2020-21,20457,1387,19070,93.2,126,24,19.0
3,All Students,2021-22,22382,2524,19858,88.7,133,59,44.4
3,All Students,2022-23,18757,1961,16796,89.5,114,40,35.1
4,All Students,2018-19,18157,988,17169,94.6,105,19,18.1
4,All Students,2019-20,13505,887,12618,93.4,120,24,20.0
4,All Students,2020-21,19753,918,18835,95.4,121,16,13.2
4,All Students,2021-22,20047,1986,18061,90.1,122,41,33.6
4,All Students,2022-23,22514,2290,20224,89.8,135,52,38.5
5,All Students,2018-19,17003,1205,15798,92.9,101,29,28.7
5,All Students,2019-20,11690,647,11043,94.5,104,17,16.3
5,All Students,2020-21,18783,1199,17584,93.6,114,28,24.6
5,All Students,2021-22,21867,2310,19557,89.4,130,51,39.2
5,All Students,2022-23,20459,1979,18480,90.3,120,33,27.5
All Grades,All Students,2018-19,200805,11405,189400,94.3,1177,191,16.2
All Grades,All Students,2019-20,132809,7749,125060,94.2,1183,194,16.4
All Grades,All Students,2020-21,187536,14128,173408,92.5,1119,252,22.5
All Grades,All Students,2021-22,180468,17353,163115,90.4,1069,370,34.6
All Grades,All Students,2022-23,181964,16094,165870,91.2,1105,331,30.0
5,All Students,2018-19,2,s,s,s,s,s,s
5,All Students,2019-20,4,s,s,s,s,s,s
6,All Students,2018-19,68513,3520,64993,94.9,404,60,14.9
6,All Students,2019-20,42072,s,s,s,s,s,s
6,All Students,2020-21,55234,4342,50892,92.1,330,71,21.5
6,All Students,2021-22,54791,5055,49736,90.8,330,111,33.6
6,All Students,2022-23,60222,4976,55246,91.7,363,107,29.5
7,All Students,2018-19,68360,4331,64029,93.7,401,76,19.0
7,All Students,2019-20,46581,2647,43934,94.3,420,72,17.1
7,All Students,2020-21,65007,5278,59729,91.9,388,96,24.7
7,All Students,2021-22,57872,5872,52000,89.9,348,128,36.8
7,All Students,2022-23,58714,4931,53783,91.6,352,104,29.5
8,All Students,2018-19,63930,s,s,s,s,s,s
8,All Students,2019-20,44152,2861,41291,93.5,390,60,15.4
8,All Students,2020-21,67295,4508,62787,93.3,401,85,21.2
8,All Students,2021-22,67805,6426,61379,90.5,391,131,33.5
8,All Students,2022-23,63028,6187,56841,90.2,390,120,30.8
All Grades,All Students,2018-19,233112,9174,223938,96.1,1389,157,11.3
All Grades,All Students,2019-20,147226,6674,140552,95.5,1335,184,13.8
All Grades,All Students,2020-21,215537,8734,206803,95.9,1280,155,12.1
All Grades,All Students,2021-22,215954,17033,198921,92.1,1307,346,26.5
All Grades,All Students,2022-23,209772,13919,195853,93.4,1274,300,23.5
PK in K-12 Schools,All Students,2018-19,7005,509,6496,92.7,40,11,27.5
PK in K-12 Schools,All Students,2019-20,4079,290,3789,92.9,36,8,22.2
PK in K-12 Schools,All Students,2020-21,6178,s,s,s,s,s,s
PK in K-12 Schools,All Students,2021-22,6363,757,5606,88.1,36,21,58.3
PK in K-12 Schools,All Students,2022-23,6210,s,s,s,s,s,s
0K,All Students,2018-19,22754,1237,21517,94.6,141,22,15.6
0K,All Students,2019-20,13928,1061,12867,92.4,133,35,26.3
0K,All Students,2020-21,20091,754,19337,96.2,124,15,12.1
0K,All Students,2021-22,20065,2115,17950,89.5,125,47,37.6
0K,All Students,2022-23,20105,1781,18324,91.1,128,42,32.8
1,All Students,2018-19,23286,1117,22169,95.2,141,22,15.6
1,All Students,2019-20,15597,863,14734,94.5,142,26,18.3
1,All Students,2020-21,21382,1129,20253,94.7,132,24,18.2
1,All Students,2021-22,21737,1946,19791,91.0,132,43,32.6
1,All Students,2022-23,21013,1743,19270,91.7,124,40,32.3
2,All Students,2018-19,20477,755,19722,96.3,125,13,10.4
2,All Students,2019-20,15226,749,14477,95.1,142,26,18.3
2,All Students,2020-21,22144,757,21387,96.6,131,12,9.2
2,All Students,2021-22,21702,1614,20088,92.6,135,34,25.2
2,All Students,2022-23,19242,1221,18021,93.7,119,27,22.7
3,All Students,2018-19,23292,1023,22269,95.6,142,18,12.7
3,All Students,2019-20,14636,630,14006,95.7,134,14,10.4
3,All Students,2020-21,23099,799,22300,96.5,137,17,12.4
3,All Students,2021-22,22668,1633,21035,92.8,137,30,21.9
3,All Students,2022-23,23469,1364,22105,94.2,143,28,19.6
4,All Students,2018-19,27223,932,26291,96.6,164,13,7.9
4,All Students,2019-20,14599,611,13988,95.8,132,16,12.1
4,All Students,2020-21,21443,862,20581,96.0,127,12,9.4
4,All Students,2021-22,22427,1552,20875,93.1,136,26,19.1
4,All Students,2022-23,23398,1316,22082,94.4,143,31,21.7
5,All Students,2018-19,30582,1067,29515,96.5,179,13,7.3
5,All Students,2019-20,17781,717,17064,96.0,162,19,11.7
5,All Students,2020-21,23000,1016,21984,95.6,134,15,11.2
5,All Students,2021-22,21932,1625,20307,92.6,128,28,21.9
5,All Students,2022-23,22167,1291,20876,94.2,133,26,19.5
6,All Students,2018-19,26561,863,25698,96.8,151,15,9.9
6,All Students,2019-20,18476,659,17817,96.4,161,12,7.5
6,All Students,2020-21,26169,997,25172,96.2,152,14,9.2
6,All Students,2021-22,25194,1899,23295,92.5,154,39,25.3
6,All Students,2022-23,21397,1423,19974,93.3,129,26,20.2
7,All Students,2018-19,25238,760,24478,97.0,151,14,9.3
7,All Students,2019-20,16398,599,15799,96.3,147,16,10.9
7,All Students,2020-21,27485,761,26724,97.2,160,10,6.3
7,All Students,2021-22,26453,2126,24327,92.0,160,44,27.5
7,All Students,2022-23,25577,1473,24104,94.2,154,29,18.8
8,All Students,2018-19,26694,911,25783,96.6,155,16,10.3
8,All Students,2019-20,16506,495,16011,97.0,146,12,8.2
8,All Students,2020-21,24377,1275,23102,94.8,143,26,18.2
8,All Students,2021-22,27413,1766,25647,93.6,164,34,20.7
8,All Students,2022-23,27192,1701,25491,93.7,161,31,19.3
9,All Students,2020-21,149,s,s,s,s,s,s
9,All Students,2022-23,2,s,s,s,s,s,s
All Grades,All Students,2018-19,159422,8053,151369,94.9,925,122,13.2
All Grades,All Students,2019-20,111759,5574,106185,95.0,1001,141,14.1
All Grades,All Students,2020-21,166739,16827,149912,89.9,994,322,32.4
All Grades,All Students,2021-22,160781,13671,147110,91.5,962,307,31.9
All Grades,All Students,2022-23,152664,11824,140840,92.3,925,269,29.1
0K,All Students,2018-19,29469,1839,27630,93.8,170,33,19.4
0K,All Students,2019-20,17900,1199,16701,93.3,159,30,18.9
0K,All Students,2020-21,27238,3397,23841,87.5,162,61,37.7
0K,All Students,2021-22,26240,2695,23545,89.7,164,64,39.0
0K,All Students,2022-23,22605,1993,20612,91.2,142,54,38.0
1,All Students,2018-19,31519,1771,29748,94.4,184,27,14.7
1,All Students,2019-20,18776,982,17794,94.8,169,29,17.2
1,All Students,2020-21,24251,2740,21511,88.7,147,53,36.1
1,All Students,2021-22,26474,2216,24258,91.6,159,48,30.2
1,All Students,2022-23,24689,2222,22467,91.0,149,51,34.2
2,All Students,2018-19,31686,1542,30144,95.1,183,21,11.5
2,All Students,2019-20,19431,1062,18369,94.5,176,21,11.9
2,All Students,2020-21,27344,3093,24251,88.7,162,57,35.2
2,All Students,2021-22,23352,1941,21411,91.7,138,46,33.3
2,All Students,2022-23,27072,2005,25067,92.6,166,43,25.9
3,All Students,2018-19,33269,1485,31784,95.5,192,19,9.9
3,All Students,2019-20,20143,871,19272,95.7,182,23,12.6
3,All Students,2020-21,28625,2715,25910,90.5,171,59,34.5
3,All Students,2021-22,28723,2435,26288,91.5,171,55,32.2
3,All Students,2022-23,22903,1665,21238,92.7,137,34,24.8
4,All Students,2018-19,23828,1045,22783,95.6,139,16,11.5
4,All Students,2019-20,21909,928,20981,95.8,193,26,13.5
4,All Students,2020-21,29908,2571,27337,91.4,178,49,27.5
4,All Students,2021-22,29700,2571,27129,91.3,175,57,32.6
4,All Students,2022-23,28676,2126,26550,92.6,170,46,27.1
5,All Students,2018-19,9651,371,9280,96.2,57,6,10.5
5,All Students,2019-20,13600,532,13068,96.1,122,12,9.8
5,All Students,2020-21,29306,2309,26997,92.1,173,43,24.9
5,All Students,2021-22,26292,1813,24479,93.1,155,37,23.9
5,All Students,2022-23,26719,1813,24906,93.2,161,41,25.5
All Grades,All Students,2018-19,156780,7556,149224,95.2,903,104,11.5
All Grades,All Students,2019-20,99514,4750,94764,95.2,880,108,12.3
All Grades,All Students,2020-21,145054,4769,140285,96.7,847,56,6.6
All Grades,All Students,2021-22,140629,8254,132375,94.1,833,151,18.1
All Grades,All Students,2022-23,144316,9459,134857,93.4,852,157,18.4
PK in K-12 Schools,All Students,2018-19,5956,354,5602,94.1,35,6,17.1
PK in K-12 Schools,All Students,2019-20,3700,263,3437,92.9,33,10,30.3
PK in K-12 Schools,All Students,2020-21,5872,308,5564,94.8,35,3,8.6
PK in K-12 Schools,All Students,2021-22,6056,488,5568,91.9,36,9,25.0
PK in K-12 Schools,All Students,2022-23,6114,704,5410,88.5,37,19,51.4
0K,All Students,2018-19,15719,1077,14642,93.1,91,23,25.3
0K,All Students,2019-20,9479,533,8946,94.4,84,12,14.3
0K,All Students,2020-21,14926,607,14319,95.9,87,7,8.0
0K,All Students,2021-22,14231,1013,13218,92.9,87,19,21.8
0K,All Students,2022-23,13467,1210,12257,91.0,78,24,30.8
1,All Students,2018-19,16844,1004,15840,94.0,96,16,16.7
1,All Students,2019-20,10018,525,9493,94.8,89,12,13.5
1,All Students,2020-21,13604,568,13036,95.8,79,7,8.9
1,All Students,2021-22,13200,785,12415,94.1,79,14,17.7
1,All Students,2022-23,14627,975,13652,93.3,86,13,15.1
2,All Students,2018-19,15975,836,15139,94.8,93,11,11.8
2,All Students,2019-20,10495,567,9928,94.6,94,14,14.9
2,All Students,2020-21,14590,576,14014,96.1,86,12,14.0
2,All Students,2021-22,12466,634,11832,94.9,77,8,10.4
2,All Students,2022-23,14573,956,13617,93.4,84,13,15.5
3,All Students,2018-19,15004,626,14378,95.8,88,7,8.0
3,All Students,2019-20,10795,479,10316,95.6,94,10,10.6
3,All Students,2020-21,15526,601,14925,96.1,92,8,8.7
3,All Students,2021-22,14595,933,13662,93.6,84,20,23.8
3,All Students,2022-23,13474,733,12741,94.6,80,8,10.0
4,All Students,2018-19,16942,649,16293,96.2,97,5,5.2
4,All Students,2019-20,9875,376,9499,96.2,87,5,5.7
4,All Students,2020-21,15208,290,14918,98.1,89,2,2.2
4,All Students,2021-22,14519,840,13679,94.2,87,15,17.2
4,All Students,2022-23,14868,985,13883,93.4,86,18,20.9
5,All Students,2018-19,16150,788,15362,95.1,95,9,9.5
5,All Students,2019-20,10975,447,10528,95.9,97,9,9.3
5,All Students,2020-21,15175,433,14742,97.1,88,4,4.5
5,All Students,2021-22,16039,736,15303,95.4,92,11,12.0
5,All Students,2022-23,14923,936,13987,93.7,91,16,17.6
6,All Students,2018-19,18666,770,17896,95.9,107,7,6.5
6,All Students,2019-20,11078,454,10624,95.9,99,9,9.1
6,All Students,2020-21,16577,331,16246,98.0,97,1,1.0
6,All Students,2021-22,17962,985,16977,94.5,104,18,17.3
6,All Students,2022-23,18323,907,17416,95.0,106,11,10.4
7,All Students,2018-19,17794,659,17135,96.3,100,9,9.0
7,All Students,2019-20,11531,530,11001,95.4,101,14,13.9
7,All Students,2020-21,15929,352,15577,97.8,92,3,3.3
7,All Students,2021-22,15832,865,14967,94.5,96,19,19.8
7,All Students,2022-23,17596,898,16698,94.9,105,13,12.4
8,All Students,2018-19,17730,793,16937,95.5,101,11,10.9
8,All Students,2019-20,11568,576,10992,95.0,102,13,12.7
8,All Students,2020-21,17647,703,16944,96.0,102,9,8.8
8,All Students,2021-22,15729,975,14754,93.8,91,18,19.8
8,All Students,2022-23,16351,1155,15196,92.9,99,22,22.2
All Grades,All Students,2018-19,226786,9550,217236,95.8,1311,135,10.3
All Grades,All Students,2019-20,151437,6480,144957,95.7,1344,132,9.8
All Grades,All Students,2020-21,217815,6952,210863,96.8,1288,93,7.2
All Grades,All Students,2021-22,213692,13938,199754,93.5,1255,250,19.9
All Grades,All Students,2022-23,215720,14571,201149,93.2,1278,278,21.8
0K,All Students,2018-19,15605,755,14850,95.2,93,10,10.8
0K,All Students,2019-20,10692,559,10133,94.8,95,11,11.6
0K,All Students,2020-21,13158,269,12889,98.0,77,2,2.6
0K,All Students,2021-22,13631,1226,12405,91.0,82,23,28.0
0K,All Students,2022-23,13258,1068,12190,91.9,78,23,29.5
1,All Students,2018-19,19706,870,18836,95.6,114,13,11.4
1,All Students,2019-20,11979,516,11463,95.7,108,8,7.4
1,All Students,2020-21,17314,534,16780,96.9,103,7,6.8
1,All Students,2021-22,13877,1184,12693,91.5,84,22,26.2
1,All Students,2022-23,16001,1131,14870,92.9,96,14,14.6
2,All Students,2018-19,18222,569,17653,96.9,105,4,3.8
2,All Students,2019-20,12491,453,12038,96.4,110,6,5.5
2,All Students,2020-21,16947,178,16769,98.9,99,1,1.0
2,All Students,2021-22,17553,1107,16446,93.7,100,18,18.0
2,All Students,2022-23,16858,1157,15701,93.1,98,21,21.4
3,All Students,2018-19,20604,664,19940,96.8,117,3,2.6
3,All Students,2019-20,11728,279,11449,97.6,104,3,2.9
3,All Students,2020-21,16702,251,16451,98.5,100,0,0.0
3,All Students,2021-22,16857,639,16218,96.2,98,6,6.1
3,All Students,2022-23,19028,1053,17975,94.5,112,17,15.2
4,All Students,2018-19,21303,803,20500,96.2,124,9,7.3
4,All Students,2019-20,13576,443,13133,96.7,119,8,6.7
4,All Students,2020-21,17343,165,17178,99.0,102,2,2.0
4,All Students,2021-22,19320,1009,18311,94.8,114,17,14.9
4,All Students,2022-23,17036,738,16298,95.7,99,14,14.1
5,All Students,2018-19,20772,727,20045,96.5,119,9,7.6
5,All Students,2019-20,13271,460,12811,96.5,120,7,5.8
5,All Students,2020-21,19294,694,18600,96.4,115,9,7.8
5,All Students,2021-22,18717,931,17786,95.0,111,15,13.5
5,All Students,2022-23,20830,1086,19744,94.8,126,17,13.5
6,All Students,2018-19,40769,1957,38812,95.2,238,28,11.8
6,All Students,2019-20,26371,1246,25125,95.3,234,28,12.0
6,All Students,2020-21,40138,1722,38416,95.7,241,28,11.6
6,All Students,2021-22,36275,2660,33615,92.7,215,51,23.7
6,All Students,2022-23,40369,3024,37345,92.5,240,64,26.7
7,All Students,2018-19,38888,1841,37047,95.3,222,35,15.8
7,All Students,2019-20,26254,1354,24900,94.8,232,33,14.2
7,All Students,2020-21,38366,1738,36628,95.5,227,28,12.3
7,All Students,2021-22,39295,2507,36788,93.6,229,51,22.3
7,All Students,2022-23,34621,2675,31946,92.3,204,54,26.5
8,All Students,2018-19,30917,1364,29553,95.6,179,24,13.4
8,All Students,2019-20,25075,1170,23905,95.3,222,28,12.6
8,All Students,2020-21,38553,1401,37152,96.4,224,16,7.1
8,All Students,2021-22,38167,2675,35492,93.0,222,47,21.2
8,All Students,2022-23,37719,2639,35080,93.0,225,54,24.0
All Grades,All Students,2018-19,268803,12826,255977,95.2,1559,201,12.9
All Grades,All Students,2019-20,167272,7398,159874,95.6,1493,178,11.9
All Grades,All Students,2020-21,240578,22400,218178,90.7,1402,546,38.9
All Grades,All Students,2021-22,266934,18714,248220,93.0,1575,386,24.5
All Grades,All Students,2022-23,264581,20388,244193,92.3,1576,431,27.3
5,All Students,2018-19,2,s,s,s,s,s,s
6,All Students,2018-19,66829,s,s,s,s,s,s
6,All Students,2019-20,42863,1720,41143,96.0,383,39,10.2
6,All Students,2020-21,61304,6860,54444,88.8,360,178,49.4
6,All Students,2021-22,83305,5453,77852,93.5,497,107,21.5
6,All Students,2022-23,69015,s,s,s,s,s,s
7,All Students,2018-19,100504,4549,95955,95.5,583,74,12.7
7,All Students,2019-20,58931,2634,56297,95.5,523,62,11.9
7,All Students,2020-21,89670,8588,81082,90.4,520,204,39.2
7,All Students,2021-22,89240,6243,82997,93.0,526,128,24.3
7,All Students,2022-23,105060,8151,96909,92.2,627,173,27.6
8,All Students,2018-19,101468,5698,95770,94.4,583,88,15.1
8,All Students,2019-20,65478,3044,62434,95.4,587,77,13.1
8,All Students,2020-21,89604,6952,82652,92.2,522,164,31.4
8,All Students,2021-22,94389,7018,87371,92.6,552,151,27.4
8,All Students,2022-23,90492,7215,83277,92.0,529,152,28.7
9,All Students,2022-23,14,s,s,s,s,s,s
All Grades,All Students,2018-19,169230,7428,161802,95.6,969,87,9.0
All Grades,All Students,2019-20,110112,4990,105122,95.5,972,98,10.1
All Grades,All Students,2020-21,145762,4332,141430,97.0,856,46,5.4
All Grades,All Students,2021-22,119791,7306,112485,93.9,709,132,18.6
All Grades,All Students,2022-23,113648,7984,105664,93.0,665,167,25.1
0K,All Students,2018-19,14315,775,13540,94.6,82,10,12.2
0K,All Students,2019-20,11042,694,10348,93.7,99,17,17.2
0K,All Students,2020-21,11890,406,11484,96.6,70,4,5.7
0K,All Students,2021-22,9548,663,8885,93.1,58,13,22.4
0K,All Students,2022-23,10643,842,9801,92.1,61,23,37.7
1,All Students,2018-19,14078,829,13249,94.1,82,13,15.9
1,All Students,2019-20,9494,520,8974,94.5,83,14,16.9
1,All Students,2020-21,14061,260,13801,98.2,85,2,2.4
1,All Students,2021-22,10966,699,10267,93.6,65,12,18.5
1,All Students,2022-23,9309,843,8466,90.9,54,18,33.3
2,All Students,2018-19,19585,950,18635,95.1,112,10,8.9
2,All Students,2019-20,9010,441,8569,95.1,80,8,10.0
2,All Students,2020-21,13163,303,12860,97.7,77,2,2.6
2,All Students,2021-22,12313,690,11623,94.4,74,11,14.9
2,All Students,2022-23,11311,736,10575,93.5,67,14,20.9
3,All Students,2018-19,17251,715,16536,95.9,100,8,8.0
3,All Students,2019-20,13220,523,12697,96.0,115,7,6.1
3,All Students,2020-21,11225,348,10877,96.9,66,6,9.1
3,All Students,2021-22,12356,644,11712,94.8,71,9,12.7
3,All Students,2022-23,11827,707,11120,94.0,68,11,16.2
4,All Students,2018-19,17847,592,17255,96.7,101,6,5.9
4,All Students,2019-20,11313,384,10929,96.6,100,8,8.0
4,All Students,2020-21,19433,530,18903,97.3,114,4,3.5
4,All Students,2021-22,10571,692,9879,93.5,61,15,24.6
4,All Students,2022-23,12052,635,11417,94.7,69,7,10.1
5,All Students,2018-19,22191,749,21442,96.6,129,6,4.7
5,All Students,2019-20,12519,488,12031,96.1,111,7,6.3
5,All Students,2020-21,15275,566,14709,96.3,89,7,7.9
5,All Students,2021-22,15061,808,14253,94.6,93,14,15.1
5,All Students,2022-23,11012,713,10299,93.5,66,15,22.7
6,All Students,2018-19,22818,929,21889,95.9,130,10,7.7
6,All Students,2019-20,13785,534,13251,96.1,122,8,6.6
6,All Students,2020-21,18695,634,18061,96.6,109,7,6.4
6,All Students,2021-22,13779,963,12816,93.0,81,19,23.5
6,All Students,2022-23,16207,1135,15072,93.0,93,18,19.4
7,All Students,2018-19,23398,1032,22366,95.6,133,14,10.5
7,All Students,2019-20,14751,528,14223,96.4,130,7,5.4
7,All Students,2020-21,19537,786,18751,96.0,116,12,10.3
7,All Students,2021-22,17026,971,16055,94.3,102,19,18.6
7,All Students,2022-23,13798,958,12840,93.1,84,25,29.8
8,All Students,2018-19,17747,857,16890,95.2,100,10,10.0
8,All Students,2019-20,14978,878,14100,94.1,132,22,16.7
8,All Students,2020-21,22483,499,21984,97.8,130,2,1.5
8,All Students,2021-22,18171,1176,16995,93.5,104,20,19.2
8,All Students,2022-23,17489,1415,16074,91.9,103,36,35.0
All Grades,All Students,2018-19,241450,14588,226862,94.0,1443,291,20.2
All Grades,All Students,2019-20,147705,8468,139237,94.3,1355,242,17.9
All Grades,All Students,2020-21,226215,19309,206906,91.5,1369,410,29.9
All Grades,All Students,2021-22,245335,20395,224940,91.7,1466,438,29.9
All Grades,All Students,2022-23,265421,22607,242814,91.5,1647,549,33.3
PK in K-12 Schools,All Students,2021-22,2579,s,s,s,s,s,s
PK in K-12 Schools,All Students,2022-23,5722,724,4998,87.3,33,16,48.5
0K,All Students,2018-19,40611,2896,37715,92.9,251,68,27.1
0K,All Students,2019-20,24194,1800,22394,92.6,229,61,26.6
0K,All Students,2020-21,39704,3887,35817,90.2,249,89,35.7
0K,All Students,2021-22,37793,3718,34075,90.2,229,85,37.1
0K,All Students,2022-23,38921,4390,34531,88.7,248,127,51.2
1,All Students,2018-19,34126,2658,31468,92.2,209,60,28.7
1,All Students,2019-20,24987,1688,23299,93.2,228,47,20.6
1,All Students,2020-21,36379,2939,33440,91.9,221,52,23.5
1,All Students,2021-22,42127,3855,38272,90.8,254,93,36.6
1,All Students,2022-23,41256,3632,37624,91.2,264,99,37.5
2,All Students,2018-19,34491,2266,32225,93.4,208,46,22.1
2,All Students,2019-20,21452,1488,19964,93.1,196,52,26.5
2,All Students,2020-21,38100,2766,35334,92.7,229,57,24.9
2,All Students,2021-22,39688,3400,36288,91.4,243,69,28.4
2,All Students,2022-23,46389,3993,42396,91.4,284,86,30.3
3,All Students,2018-19,44797,2405,42392,94.6,264,51,19.3
3,All Students,2019-20,25222,1220,24002,95.2,234,32,13.7
3,All Students,2020-21,38478,2599,35879,93.2,232,48,20.7
3,All Students,2021-22,44236,3059,41177,93.1,264,62,23.5
3,All Students,2022-23,46603,3831,42772,91.8,285,80,28.1
4,All Students,2018-19,42679,2158,40521,94.9,251,38,15.1
4,All Students,2019-20,28287,1284,27003,95.5,254,33,13.0
4,All Students,2020-21,37221,3438,33783,90.8,221,77,34.8
4,All Students,2021-22,41125,3146,37979,92.4,238,66,27.7
4,All Students,2022-23,46533,3296,43237,92.9,284,74,26.1
5,All Students,2018-19,44746,2205,42541,95.1,260,28,10.8
5,All Students,2019-20,23563,988,22575,95.8,214,17,7.9
5,All Students,2020-21,36333,3680,32653,89.9,217,87,40.1
5,All Students,2021-22,37784,2734,35050,92.8,223,51,22.9
5,All Students,2022-23,39997,2741,37256,93.1,249,67,26.9
6,All Students,2021-22,3,s,s,s,s,s,s
All Grades,All Students,2018-19,200292,11958,188334,94.0,1169,218,18.6
All Grades,All Students,2019-20,121439,8062,113377,93.4,1081,239,22.1
All Grades,All Students,2020-21,163247,8677,154570,94.7,964,143,14.8
All Grades,All Students,2021-22,150742,14211,136531,90.6,896,333,37.2
All Grades,All Students,2022-23,149539,14028,135511,90.6,897,344,38.4
PK in K-12 Schools,All Students,2018-19,9197,942,8255,89.8,56,26,46.4
PK in K-12 Schools,All Students,2019-20,6037,744,5293,87.7,54,29,53.7
PK in K-12 Schools,All Students,2020-21,7008,520,6488,92.6,43,11,25.6
PK in K-12 Schools,All Students,2021-22,9515,1597,7918,83.2,60,43,71.7
PK in K-12 Schools,All Students,2022-23,14590,2158,12432,85.2,91,60,65.9
0K,All Students,2018-19,23208,1752,21456,92.5,138,43,31.2
0K,All Students,2019-20,13974,1231,12743,91.2,124,47,37.9
0K,All Students,2020-21,18457,1392,17065,92.5,111,25,22.5
0K,All Students,2021-22,20620,2331,18289,88.7,125,60,48.0
0K,All Students,2022-23,18444,2275,16169,87.7,112,65,58.0
1,All Students,2018-19,24605,1670,22935,93.2,143,30,21.0
1,All Students,2019-20,15635,1049,14586,93.3,138,30,21.7
1,All Students,2020-21,21147,1106,20041,94.8,124,17,13.7
1,All Students,2021-22,16907,1503,15404,91.1,101,41,40.6
1,All Students,2022-23,21083,2154,18929,89.8,125,47,37.6
2,All Students,2018-19,32310,1861,30449,94.2,186,30,16.1
2,All Students,2019-20,16284,1143,15141,93.0,146,27,18.5
2,All Students,2020-21,23783,997,22786,95.8,141,16,11.3
2,All Students,2021-22,20565,1718,18847,91.6,122,38,31.1
2,All Students,2022-23,17298,1405,15893,91.9,102,37,36.3
3,All Students,2018-19,27891,1459,26432,94.8,160,21,13.1
3,All Students,2019-20,19330,978,18352,94.9,172,21,12.2
3,All Students,2020-21,22942,1270,21672,94.5,134,17,12.7
3,All Students,2021-22,23315,1792,21523,92.3,137,39,28.5
3,All Students,2022-23,22417,1575,20842,93.0,135,38,28.1
4,All Students,2018-19,31060,1549,29511,95.0,182,21,11.5
4,All Students,2019-20,18001,898,17103,95.0,158,21,13.3
4,All Students,2020-21,25790,1247,24543,95.2,152,18,11.8
4,All Students,2021-22,21754,1765,19989,91.9,131,40,30.5
4,All Students,2022-23,23500,1965,21535,91.6,144,46,31.9
5,All Students,2018-19,30275,1583,28692,94.8,179,33,18.4
5,All Students,2019-20,18669,1108,17561,94.1,169,32,18.9
5,All Students,2020-21,24729,1254,23475,94.9,147,24,16.3
5,All Students,2021-22,25022,2066,22956,91.7,145,43,29.7
5,All Students,2022-23,19675,1427,18248,92.7,115,25,21.7
6,All Students,2018-19,21746,1142,20604,94.7,125,14,11.2
6,All Students,2019-20,13509,911,12598,93.3,120,32,26.7
6,All Students,2020-21,19391,891,18500,95.4,112,15,13.4
6,All Students,2021-22,13044,1439,11605,89.0,75,29,38.7
6,All Students,2022-23,12532,1069,11463,91.5,73,26,35.6
All Grades,All Students,2018-19,144430,10440,133990,92.8,886,228,25.7
All Grades,All Students,2019-20,78997,6093,72904,92.3,734,197,26.8
All Grades,All Students,2020-21,106387,8875,97512,91.7,631,161,25.5
All Grades,All Students,2021-22,100269,10980,89289,89.0,615,294,47.8
All Grades,All Students,2022-23,97619,10087,87532,89.7,637,277,43.5
PK in K-12 Schools,All Students,2018-19,15085,2202,12883,85.4,99,59,59.6
PK in K-12 Schools,All Students,2019-20,5558,769,4789,86.2,53,28,52.8
PK in K-12 Schools,All Students,2020-21,8992,604,8388,93.3,56,13,23.2
PK in K-12 Schools,All Students,2021-22,10230,1744,8486,83.0,66,51,77.3
PK in K-12 Schools,All Students,2022-23,12094,1704,10390,85.9,74,46,62.2
0K,All Students,2018-19,20017,1847,18170,90.8,126,46,36.5
0K,All Students,2019-20,11965,1255,10710,89.5,116,47,40.5
0K,All Students,2020-21,12838,2251,10587,82.5,77,36,46.8
0K,All Students,2021-22,15840,2058,13782,87.0,99,57,57.6
0K,All Students,2022-23,11435,1775,9660,84.5,86,58,67.4
1,All Students,2018-19,17516,1292,16224,92.6,107,29,27.1
1,All Students,2019-20,12015,941,11074,92.2,111,32,28.8
1,All Students,2020-21,16733,1231,15502,92.6,99,18,18.2
1,All Students,2021-22,11739,1558,10181,86.7,74,44,59.5
1,All Students,2022-23,14524,1544,12980,89.4,94,40,42.6
2,All Students,2018-19,17832,1191,16641,93.3,112,26,23.2
2,All Students,2019-20,11776,845,10931,92.8,107,24,22.4
2,All Students,2020-21,15656,1452,14204,90.7,94,28,29.8
2,All Students,2021-22,15803,1505,14298,90.5,97,39,40.2
2,All Students,2022-23,11343,1239,10104,89.1,74,35,47.3
3,All Students,2018-19,20976,1197,19779,94.3,127,17,13.4
3,All Students,2019-20,11103,755,10348,93.2,105,23,21.9
3,All Students,2020-21,17033,1412,15621,91.7,101,29,28.7
3,All Students,2021-22,15407,1532,13875,90.1,93,37,39.8
3,All Students,2022-23,14823,1170,13653,92.1,98,28,28.6
4,All Students,2018-19,21260,1246,20014,94.1,128,26,20.3
4,All Students,2019-20,13532,827,12705,93.9,124,24,19.4
4,All Students,2020-21,15888,971,14917,93.9,92,20,21.7
4,All Students,2021-22,16451,1306,15145,92.1,99,30,30.3
4,All Students,2022-23,15732,1387,14345,91.2,102,36,35.3
5,All Students,2018-19,31744,1465,30279,95.4,187,25,13.4
5,All Students,2019-20,13048,701,12347,94.6,118,19,16.1
5,All Students,2020-21,19247,954,18293,95.0,112,17,15.2
5,All Students,2021-22,14799,1277,13522,91.4,87,36,41.4
5,All Students,2022-23,17668,1268,16400,92.8,109,34,31.2
All Grades,All Students,2018-19,92207,5894,86313,93.6,556,109,19.6
All Grades,All Students,2019-20,76476,4996,71480,93.5,698,140,20.1
All Grades,All Students,2020-21,132016,8463,123553,93.6,794,186,23.4
All Grades,All Students,2021-22,134822,12056,122766,91.1,825,290,35.2
All Grades,All Students,2022-23,147155,11942,135213,91.9,916,280,30.6
PK in K-12 Schools,All Students,2018-19,6320,534,5786,91.6,38,13,34.2
PK in K-12 Schools,All Students,2019-20,4059,460,3599,88.7,39,14,35.9
PK in K-12 Schools,All Students,2020-21,6177,232,5945,96.2,36,3,8.3
PK in K-12 Schools,All Students,2021-22,6330,629,5701,90.1,39,18,46.2
PK in K-12 Schools,All Students,2022-23,6329,828,5501,86.9,38,23,60.5
0K,All Students,2018-19,29991,2242,27749,92.5,178,42,23.6
0K,All Students,2019-20,21712,1689,20023,92.2,195,52,26.7
0K,All Students,2020-21,28700,2389,26311,91.7,174,63,36.2
0K,All Students,2021-22,23810,2214,21596,90.7,148,59,39.9
0K,All Students,2022-23,22909,2415,20494,89.5,142,65,45.8
1,All Students,2018-19,15287,1160,14127,92.4,92,24,26.1
1,All Students,2019-20,18829,1231,17598,93.5,171,35,20.5
1,All Students,2020-21,30519,2531,27988,91.7,185,54,29.2
1,All Students,2021-22,24184,2535,21649,89.5,145,61,42.1
1,All Students,2022-23,26654,2059,24595,92.3,166,48,28.9
2,All Students,2018-19,12172,708,11464,94.2,77,15,19.5
2,All Students,2019-20,10179,582,9597,94.3,95,13,13.7
2,All Students,2020-21,26964,1349,25615,95.0,162,28,17.3
2,All Students,2021-22,26555,2405,24150,90.9,162,59,36.4
2,All Students,2022-23,21506,1686,19820,92.2,136,36,26.5
3,All Students,2018-19,10987,577,10410,94.7,64,7,10.9
3,All Students,2019-20,8529,394,8135,95.4,78,12,15.4
3,All Students,2020-21,15682,928,14754,94.1,92,22,23.9
3,All Students,2021-22,24502,1762,22740,92.8,152,34,22.4
3,All Students,2022-23,27613,2033,25580,92.6,171,44,25.7
4,All Students,2018-19,9911,433,9478,95.6,61,6,9.8
4,All Students,2019-20,7471,395,7076,94.7,68,10,14.7
4,All Students,2020-21,12603,468,12135,96.3,75,4,5.3
4,All Students,2021-22,16919,1490,15429,91.2,100,37,37.0
4,All Students,2022-23,24991,1715,23276,93.1,154,37,24.0
5,All Students,2018-19,7539,240,7299,96.8,46,2,4.3
5,All Students,2019-20,5697,245,5452,95.7,52,4,7.7
5,All Students,2020-21,11371,566,10805,95.0,70,12,17.1
5,All Students,2021-22,12522,1021,11501,91.8,79,22,27.8
5,All Students,2022-23,17153,1206,15947,93.0,109,27,24.8
All Grades,All Students,2018-19,252943,12785,240158,94.9,1481,218,14.7
All Grades,All Students,2019-20,159875,7819,152056,95.1,1431,225,15.7
All Grades,All Students,2020-21,223886,12939,210947,94.2,1318,238,18.1
All Grades,All Students,2021-22,206269,17440,188829,91.5,1228,396,32.2
All Grades,All Students,2022-23,199782,14286,185496,92.8,1208,319,26.4
PK in K-12 Schools,All Students,2018-19,6329,447,5882,92.9,37,8,21.6
PK in K-12 Schools,All Students,2019-20,4049,260,3789,93.6,39,10,25.6
PK in K-12 Schools,All Students,2020-21,5453,440,5013,91.9,34,9,26.5
PK in K-12 Schools,All Students,2021-22,6157,675,5482,89.0,36,14,38.9
PK in K-12 Schools,All Students,2022-23,6187,s,s,s,s,s,s
0K,All Students,2018-19,34396,2482,31914,92.8,203,47,23.2
0K,All Students,2019-20,25969,1625,24344,93.7,236,45,19.1
0K,All Students,2020-21,34724,2315,32409,93.3,205,53,25.9
0K,All Students,2021-22,29066,3170,25896,89.1,175,84,48.0
0K,All Students,2022-23,27479,2824,24655,89.7,166,70,42.2
1,All Students,2018-19,40781,2046,38735,95.0,241,34,14.1
1,All Students,2019-20,21136,1259,19877,94.0,190,41,21.6
1,All Students,2020-21,36757,2858,33899,92.2,220,48,21.8
1,All Students,2021-22,32504,2815,29689,91.3,195,61,31.3
1,All Students,2022-23,30903,2427,28476,92.1,189,55,29.1
2,All Students,2018-19,42132,2163,39969,94.9,248,39,15.7
2,All Students,2019-20,25681,1185,24496,95.4,230,34,14.8
2,All Students,2020-21,30318,1618,28700,94.7,180,32,17.8
2,All Students,2021-22,33838,2491,31347,92.6,203,53,26.1
2,All Students,2022-23,34370,2237,32133,93.5,206,44,21.4
3,All Students,2018-19,43553,2032,41521,95.3,256,35,13.7
3,All Students,2019-20,27530,1282,26248,95.3,242,33,13.6
3,All Students,2020-21,37128,1950,35178,94.7,218,34,15.6
3,All Students,2021-22,30593,2536,28057,91.7,183,56,30.6
3,All Students,2022-23,33257,2012,31245,94.0,199,44,22.1
4,All Students,2018-19,44341,1606,42735,96.4,257,23,8.9
4,All Students,2019-20,27849,1128,26721,95.9,248,30,12.1
4,All Students,2020-21,40225,1855,38370,95.4,235,32,13.6
4,All Students,2021-22,35175,2402,32773,93.2,208,56,26.9
4,All Students,2022-23,32203,2010,30193,93.8,198,45,22.7
5,All Students,2018-19,41411,2009,39402,95.1,239,32,13.4
5,All Students,2019-20,27661,1080,26581,96.1,246,32,13.0
5,All Students,2020-21,39281,1903,37378,95.2,226,30,13.3
5,All Students,2021-22,38936,3351,35585,91.4,228,72,31.6
5,All Students,2022-23,35382,2078,33304,94.1,213,45,21.1
6,All Students,2022-23,1,s,s,s,s,s,s
All Grades,All Students,2018-19,45296,5824,39472,87.1,304,104,34.2
All Grades,All Students,2019-20,31587,3036,28551,90.4,295,79,26.8
All Grades,All Students,2020-21,44368,9913,34455,77.7,260,153,58.8
All Grades,All Students,2021-22,45319,8838,36481,80.5,261,170,65.1
All Grades,All Students,2022-23,43653,4654,38999,89.3,278,82,29.5
9,All Students,2018-19,9471,840,8631,91.1,75,18,24.0
9,All Students,2019-20,10363,851,9512,91.8,98,19,19.4
9,All Students,2020-21,6286,999,5287,84.1,40,20,50.0
9,All Students,2021-22,14316,1865,12451,87.0,84,41,48.8
9,All Students,2022-23,11047,1177,9870,89.3,77,20,26.0
10,All Students,2018-19,13480,1616,11864,88.0,90,23,25.6
10,All Students,2019-20,7631,766,6865,90.0,72,19,26.4
10,All Students,2020-21,15847,3428,12419,78.4,89,43,48.3
10,All Students,2021-22,8456,2275,6181,73.1,47,32,68.1
10,All Students,2022-23,14830,1651,13179,88.9,91,26,28.6
11,All Students,2018-19,9586,854,8732,91.1,63,20,31.7
11,All Students,2019-20,7507,550,6957,92.7,69,18,26.1
11,All Students,2020-21,10482,2700,7782,74.2,61,44,72.1
11,All Students,2021-22,12927,2334,10593,81.9,73,47,64.4
11,All Students,2022-23,6574,627,5947,90.5,42,10,23.8
12,All Students,2018-19,12759,2514,10245,80.3,76,43,56.6
12,All Students,2019-20,6086,869,5217,85.7,56,23,41.1
12,All Students,2020-21,11753,2786,8967,76.3,70,46,65.7
12,All Students,2021-22,9620,2364,7256,75.4,57,50,87.7
12,All Students,2022-23,11202,1199,10003,89.3,68,26,38.2
All Grades,All Students,2018-19,95952,6464,89488,93.3,568,127,22.4
All Grades,All Students,2019-20,58804,3659,55145,93.8,526,94,17.9
All Grades,All Students,2020-21,83956,6306,77650,92.5,514,137,26.7
All Grades,All Students,2021-22,81282,8087,73195,90.1,490,193,39.4
All Grades,All Students,2022-23,77909,6708,71201,91.4,475,157,33.1
PK in K-12 Schools,All Students,2018-19,9542,958,8584,90.0,55,21,38.2
PK in K-12 Schools,All Students,2019-20,6126,490,5636,92.0,57,17,29.8
PK in K-12 Schools,All Students,2020-21,8511,636,7875,92.5,54,15,27.8
9,All Students,2022-23,29639,1347,28292,95.5,182,10,5.5
PK in K-12 Schools,All Students,2021-22,10641,1407,9234,86.8,71,41,57.7
PK in K-12 Schools,All Students,2022-23,9639,1219,8420,87.4,59,31,52.5
0K,All Students,2018-19,12783,975,11808,92.4,76,21,27.6
0K,All Students,2019-20,7651,535,7116,93.0,70,14,20.0
0K,All Students,2020-21,13366,1395,11971,89.6,82,30,36.6
0K,All Students,2021-22,12375,1397,10978,88.7,76,35,46.1
0K,All Students,2022-23,11426,1273,10153,88.9,71,31,43.7
1,All Students,2018-19,13106,984,12122,92.5,78,22,28.2
1,All Students,2019-20,8219,512,7707,93.8,73,12,16.4
1,All Students,2020-21,9657,743,8914,92.3,60,16,26.7
1,All Students,2021-22,12932,1273,11659,90.2,76,28,36.8
1,All Students,2022-23,11553,961,10592,91.7,71,25,35.2
2,All Students,2018-19,13997,819,13178,94.1,82,14,17.1
2,All Students,2019-20,8270,522,7748,93.7,74,12,16.2
2,All Students,2020-21,12200,944,11256,92.3,75,19,25.3
2,All Students,2021-22,9928,919,9009,90.7,59,23,39.0
2,All Students,2022-23,11778,759,11019,93.6,72,13,18.1
3,All Students,2018-19,15819,961,14858,93.9,95,21,22.1
3,All Students,2019-20,8675,453,8222,94.8,76,12,15.8
3,All Students,2020-21,12643,844,11799,93.3,76,18,23.7
3,All Students,2021-22,12026,976,11050,91.9,72,25,34.7
3,All Students,2022-23,9734,754,8980,92.3,61,20,32.8
4,All Students,2018-19,15364,984,14380,93.6,93,15,16.1
4,All Students,2019-20,10015,644,9371,93.6,89,17,19.1
4,All Students,2020-21,13003,757,12246,94.2,78,18,23.1
4,All Students,2021-22,11648,1102,10546,90.5,68,21,30.9
4,All Students,2022-23,11312,706,10606,93.8,68,14,20.6
5,All Students,2018-19,15341,783,14558,94.9,89,13,14.6
5,All Students,2019-20,9848,503,9345,94.9,87,10,11.5
5,All Students,2020-21,14576,987,13589,93.2,89,21,23.6
5,All Students,2021-22,11732,1013,10719,91.4,68,20,29.4
5,All Students,2022-23,12467,1036,11431,91.7,73,23,31.5
All Grades,All Students,2018-19,107589,7227,100362,93.3,662,142,21.5
All Grades,All Students,2019-20,74652,4044,70608,94.6,690,120,17.4
All Grades,All Students,2020-21,127259,5131,122128,96.0,749,56,7.5
All Grades,All Students,2021-22,128668,13560,115108,89.5,778,281,36.1
All Grades,All Students,2022-23,146625,16996,129629,88.4,912,303,33.2
9,All Students,2018-19,26300,1187,25113,95.5,162,18,11.1
9,All Students,2019-20,17710,700,17010,96.0,165,18,10.9
9,All Students,2020-21,35875,1095,34780,96.9,212,8,3.8
9,All Students,2021-22,31413,3132,28281,90.0,199,74,37.2
9,All Students,2022-23,45646,4413,41233,90.3,286,84,29.4
10,All Students,2018-19,30699,1781,28918,94.2,192,29,15.1
10,All Students,2019-20,19282,1036,18246,94.6,180,29,16.1
10,All Students,2020-21,29850,1293,28557,95.7,176,18,10.2
10,All Students,2021-22,41119,3811,37308,90.7,246,74,30.1
10,All Students,2022-23,36846,4654,32192,87.4,232,76,32.8
11,All Students,2018-19,26320,1667,24653,93.7,162,31,19.1
11,All Students,2019-20,20532,900,19632,95.6,188,23,12.2
11,All Students,2020-21,28932,1067,27865,96.3,170,8,4.7
11,All Students,2021-22,28164,3064,25100,89.1,167,55,32.9
11,All Students,2022-23,36796,3328,33468,91.0,227,61,26.9
12,All Students,2018-19,24270,2592,21678,89.3,146,64,43.8
12,All Students,2019-20,17128,1408,15720,91.8,157,50,31.8
12,All Students,2020-21,32602,1676,30926,94.9,191,22,11.5
12,All Students,2021-22,27972,3553,24419,87.3,166,78,47.0
12,All Students,2022-23,27337,4601,22736,83.2,167,82,49.1
All Grades,All Students,2018-19,66815,6428,60387,90.4,424,134,31.6
All Grades,All Students,2019-20,44561,4726,39835,89.4,424,127,30.0
All Grades,All Students,2020-21,68055,9636,58419,85.8,397,128,32.2
All Grades,All Students,2021-22,65907,9491,56416,85.6,409,186,45.5
All Grades,All Students,2022-23,62789,9750,53039,84.5,420,179,42.6
9,All Students,2018-19,20148,2039,18109,89.9,132,36,27.3
9,All Students,2019-20,12927,1194,11733,90.8,128,39,30.5
9,All Students,2020-21,20586,2916,17670,85.8,121,41,33.9
9,All Students,2021-22,19976,2551,17425,87.2,124,49,39.5
9,All Students,2022-23,18234,3061,15173,83.2,137,69,50.4
10,All Students,2018-19,20347,1945,18402,90.4,128,39,30.5
10,All Students,2019-20,12461,1456,11005,88.3,118,35,29.7
10,All Students,2020-21,17771,3120,14651,82.4,102,41,40.2
10,All Students,2021-22,18156,2481,15675,86.3,116,48,41.4
10,All Students,2022-23,19357,3034,16323,84.3,126,50,39.7
11,All Students,2018-19,12982,971,12011,92.5,82,19,23.2
11,All Students,2019-20,10072,1108,8964,89.0,92,25,27.2
11,All Students,2020-21,15277,1942,13335,87.3,89,25,28.1
11,All Students,2021-22,13887,2124,11763,84.7,86,44,51.2
11,All Students,2022-23,12037,1483,10554,87.7,76,24,31.6
12,All Students,2018-19,13338,1473,11865,89.0,82,40,48.8
12,All Students,2019-20,9101,968,8133,89.4,86,28,32.6
12,All Students,2020-21,14421,1658,12763,88.5,85,21,24.7
12,All Students,2021-22,13888,2335,11553,83.2,83,45,54.2
12,All Students,2022-23,13161,2172,10989,83.5,81,36,44.4
All Grades,All Students,2018-19,103316,5055,98261,95.1,604,66,10.9
All Grades,All Students,2019-20,66753,3533,63220,94.7,595,83,13.9
All Grades,All Students,2020-21,96595,2415,94180,97.5,578,45,7.8
All Grades,All Students,2021-22,99879,7364,92515,92.6,590,150,25.4
All Grades,All Students,2022-23,99461,7311,92150,92.6,576,145,25.2
PK in K-12 Schools,All Students,2018-19,6159,496,5663,91.9,39,10,25.6
PK in K-12 Schools,All Students,2019-20,4120,391,3729,90.5,37,11,29.7
PK in K-12 Schools,All Students,2020-21,6165,324,5841,94.7,37,7,18.9
PK in K-12 Schools,All Students,2021-22,6224,614,5610,90.1,36,11,30.6
PK in K-12 Schools,All Students,2022-23,6344,716,5628,88.7,37,14,37.8
0K,All Students,2018-19,15732,959,14773,93.9,94,16,17.0
0K,All Students,2019-20,10248,675,9573,93.4,91,12,13.2
0K,All Students,2020-21,15910,436,15474,97.3,96,7,7.3
0K,All Students,2021-22,16836,1501,15335,91.1,99,41,41.4
0K,All Students,2022-23,16130,1514,14616,90.6,96,40,41.7
1,All Students,2018-19,15979,702,15277,95.6,96,6,6.3
1,All Students,2019-20,10901,597,10304,94.5,99,17,17.2
1,All Students,2020-21,15294,333,14961,97.8,93,8,8.6
1,All Students,2021-22,16220,1268,14952,92.2,97,26,26.8
1,All Students,2022-23,18094,1432,16662,92.1,105,27,25.7
2,All Students,2018-19,19874,1074,18800,94.6,114,13,11.4
2,All Students,2019-20,10093,521,9572,94.8,90,14,15.6
2,All Students,2020-21,15066,378,14688,97.5,92,7,7.6
2,All Students,2021-22,15565,968,14597,93.8,91,14,15.4
2,All Students,2022-23,17617,1299,16318,92.6,102,30,29.4
3,All Students,2018-19,17077,767,16310,95.5,97,8,8.2
3,All Students,2019-20,12386,604,11782,95.1,109,14,12.8
3,All Students,2020-21,14205,139,14066,99.0,83,1,1.2
3,All Students,2021-22,14047,961,13086,93.2,86,18,20.9
3,All Students,2022-23,16127,918,15209,94.3,93,15,16.1
4,All Students,2018-19,15063,562,14501,96.3,87,8,9.2
4,All Students,2019-20,9408,390,9018,95.9,83,8,9.6
4,All Students,2020-21,17775,477,17298,97.3,105,10,9.5
4,All Students,2021-22,13493,847,12646,93.7,79,17,21.5
4,All Students,2022-23,13379,860,12519,93.6,76,11,14.5
5,All Students,2018-19,13432,495,12937,96.3,77,5,6.5
5,All Students,2019-20,9597,355,9242,96.3,86,7,8.1
5,All Students,2020-21,12180,328,11852,97.3,72,5,6.9
5,All Students,2021-22,17494,1205,16289,93.1,102,23,22.5
5,All Students,2022-23,11770,572,11198,95.1,67,8,11.9
All Grades,All Students,2018-19,97824,8556,89268,91.3,602,163,27.1
All Grades,All Students,2019-20,70734,4952,65782,93.0,655,161,24.6
All Grades,All Students,2020-21,114415,8312,106103,92.7,659,147,22.3
All Grades,All Students,2021-22,106571,11421,95150,89.3,643,239,37.2
All Grades,All Students,2022-23,96258,11215,85043,88.3,613,231,37.7
8,All Students,2022-23,8,s,s,s,s,s,s
9,All Students,2018-19,32056,2169,29887,93.2,197,34,17.3
9,All Students,2019-20,19979,1180,18799,94.1,187,35,18.7
9,All Students,2020-21,27265,1907,25358,93.0,158,31,19.6
9,All Students,2021-22,25484,1614,23870,93.7,154,35,22.7
9,All Students,2022-23,24267,2684,21583,88.9,155,57,36.8
10,All Students,2018-19,25531,2336,23195,90.9,158,45,28.5
10,All Students,2019-20,21077,1306,19771,93.8,196,38,19.4
10,All Students,2020-21,31704,2442,29262,92.3,183,43,23.5
10,All Students,2021-22,24778,3252,21526,86.9,152,62,40.8
10,All Students,2022-23,26077,3169,22908,87.8,172,57,33.1
11,All Students,2018-19,21984,1863,20121,91.5,137,41,29.9
11,All Students,2019-20,15567,1219,14348,92.2,143,40,28.0
11,All Students,2020-21,30771,1899,28872,93.8,177,39,22.0
11,All Students,2021-22,26780,2825,23955,89.5,161,55,34.2
11,All Students,2022-23,20192,s,s,s,s,s,s
12,All Students,2018-19,18253,2188,16065,88.0,110,43,39.1
12,All Students,2019-20,14111,1247,12864,91.2,129,48,37.2
12,All Students,2020-21,24675,2064,22611,91.6,141,34,24.1
12,All Students,2021-22,29529,3730,25799,87.4,176,87,49.4
12,All Students,2022-23,25714,3220,22494,87.5,158,72,45.6
All Grades,All Students,2018-19,71223,4924,66299,93.1,491,94,19.1
All Grades,All Students,2019-20,47459,3884,43575,91.8,455,115,25.3
All Grades,All Students,2020-21,62999,3186,59813,94.9,406,63,15.5
All Grades,All Students,2021-22,66938,3244,63694,95.2,439,65,14.8
All Grades,All Students,2022-23,79647,3920,75727,95.1,506,74,14.6
8,All Students,2020-21,5,s,s,s,s,s,s
9,All Students,2018-19,18635,600,18035,96.8,156,15,9.6
9,All Students,2019-20,15240,878,14362,94.2,152,25,16.4
9,All Students,2020-21,12310,s,s,s,s,s,s
9,All Students,2021-22,23349,1118,22231,95.2,160,25,15.6
9,All Students,2022-23,25229,1532,23697,93.9,166,29,17.5
10,All Students,2018-19,10415,671,9744,93.6,69,15,21.7
10,All Students,2019-20,11697,907,10790,92.2,110,26,23.6
10,All Students,2020-21,21399,855,20544,96.0,128,12,9.4
10,All Students,2021-22,10295,665,9630,93.5,64,8,12.5
10,All Students,2022-23,26763,1181,25582,95.6,168,21,12.5
11,All Students,2018-19,19102,954,18148,95.0,121,17,14.0
11,All Students,2019-20,7485,660,6825,91.2,71,22,31.0
11,All Students,2020-21,14854,1023,13831,93.1,92,18,19.6
11,All Students,2021-22,17253,701,16552,95.9,107,12,11.2
11,All Students,2022-23,9237,451,8786,95.1,57,10,17.5
12,All Students,2018-19,23071,2699,20372,88.3,145,47,32.4
12,All Students,2019-20,13037,1439,11598,89.0,122,42,34.4
12,All Students,2020-21,14431,646,13785,95.5,86,16,18.6
12,All Students,2021-22,16041,760,15281,95.3,108,20,18.5
12,All Students,2022-23,18418,756,17662,95.9,115,14,12.2
All Grades,All Students,2018-19,107842,3783,104059,96.5,644,39,6.1
All Grades,All Students,2019-20,70004,2277,67727,96.7,641,40,6.2
All Grades,All Students,2020-21,113805,10452,103353,90.8,654,204,31.2
All Grades,All Students,2021-22,113727,9903,103824,91.3,675,226,33.5
All Grades,All Students,2022-23,109211,6812,102399,93.8,670,109,16.3
9,All Students,2018-19,30744,641,30103,97.9,183,2,1.1
9,All Students,2019-20,16291,404,15887,97.5,149,8,5.4
9,All Students,2020-21,30368,2202,28166,92.7,174,27,15.5
9,All Students,2021-22,31109,1953,29156,93.7,187,34,18.2
10,All Students,2018-19,27783,709,27074,97.4,166,1,0.6
10,All Students,2019-20,19360,424,18936,97.8,178,2,1.1
10,All Students,2020-21,25491,1847,23644,92.8,147,28,19.0
10,All Students,2021-22,29492,1799,27693,93.9,174,21,12.1
10,All Students,2022-23,29357,1647,27710,94.4,180,21,11.7
11,All Students,2018-19,25880,731,25149,97.2,155,5,3.2
11,All Students,2019-20,17490,523,16967,97.0,160,7,4.4
11,All Students,2020-21,30208,2604,27604,91.4,174,48,27.6
11,All Students,2021-22,24098,2285,21813,90.5,143,56,39.2
11,All Students,2022-23,27116,1259,25857,95.4,166,14,8.4
12,All Students,2018-19,23435,1702,21733,92.7,140,31,22.1
12,All Students,2019-20,16863,926,15937,94.5,154,23,14.9
12,All Students,2020-21,27738,3799,23939,86.3,159,101,63.5
12,All Students,2021-22,29028,3866,25162,86.7,171,115,67.3
12,All Students,2022-23,23099,2559,20540,88.9,142,64,45.1
All Grades,All Students,2018-19,104909,6702,98207,93.6,615,136,22.1
All Grades,All Students,2019-20,64881,4145,60736,93.6,580,129,22.2
All Grades,All Students,2020-21,91461,7952,83509,91.3,546,157,28.8
All Grades,All Students,2021-22,88859,9424,79435,89.4,543,228,42.0
All Grades,All Students,2022-23,81987,7032,74955,91.4,488,162,33.2
PK in K-12 Schools,All Students,2018-19,5661,593,5068,89.5,35,12,34.3
PK in K-12 Schools,All Students,2019-20,5649,620,5029,89.0,52,24,46.2
PK in K-12 Schools,All Students,2020-21,7749,1076,6673,86.1,49,24,49.0
PK in K-12 Schools,All Students,2021-22,10121,1386,8735,86.3,63,34,54.0
PK in K-12 Schools,All Students,2022-23,10909,1134,9775,89.6,67,29,43.3
0K,All Students,2018-19,16937,1249,15688,92.6,99,31,31.3
0K,All Students,2019-20,9211,669,8542,92.7,83,24,28.9
0K,All Students,2020-21,11606,1096,10510,90.6,71,27,38.0
0K,All Students,2021-22,14230,1784,12446,87.5,92,48,52.2
0K,All Students,2022-23,10986,1240,9746,88.7,64,29,45.3
1,All Students,2018-19,18656,1163,17493,93.8,109,23,21.1
1,All Students,2019-20,10899,759,10140,93.0,97,24,24.7
1,All Students,2020-21,11949,1479,10470,87.6,73,30,41.1
1,All Students,2021-22,10207,884,9323,91.3,63,23,36.5
1,All Students,2022-23,11627,1125,10502,90.3,71,28,39.4
2,All Students,2018-19,21424,1376,20048,93.6,126,30,23.8
2,All Students,2019-20,10960,591,10369,94.6,98,17,17.3
2,All Students,2020-21,15791,983,14808,93.8,93,20,21.5
2,All Students,2021-22,11587,1189,10398,89.7,68,26,38.2
2,All Students,2022-23,9643,694,8949,92.8,58,17,29.3
3,All Students,2018-19,12526,635,11891,94.9,74,8,10.8
3,All Students,2019-20,11298,683,10615,94.0,101,21,20.8
3,All Students,2020-21,16079,1246,14833,92.3,93,17,18.3
3,All Students,2021-22,14213,1519,12694,89.3,86,41,47.7
3,All Students,2022-23,10887,769,10118,92.9,65,19,29.2
4,All Students,2018-19,14374,868,13506,94.0,83,18,21.7
4,All Students,2019-20,8166,394,7772,95.2,71,9,12.7
4,All Students,2020-21,16438,1297,15141,92.1,96,26,27.1
4,All Students,2021-22,13974,1151,12823,91.8,83,23,27.7
4,All Students,2022-23,14373,1123,13250,92.2,83,25,30.1
5,All Students,2018-19,15331,818,14513,94.7,89,14,15.7
5,All Students,2019-20,8698,429,8269,95.1,78,10,12.8
5,All Students,2020-21,11849,775,11074,93.5,71,13,18.3
5,All Students,2021-22,14527,1511,13016,89.6,88,33,37.5
5,All Students,2022-23,13562,947,12615,93.0,80,15,18.8
All Grades,All Students,2018-19,161283,6443,154840,96.0,941,86,9.1
All Grades,All Students,2019-20,100105,4015,96090,96.0,894,87,9.7
All Grades,All Students,2020-21,144423,9363,135060,93.5,840,157,18.7
All Grades,All Students,2021-22,138390,9111,129279,93.4,824,188,22.8
All Grades,All Students,2022-23,133439,8365,125074,93.7,808,162,20.0
PK in K-12 Schools,All Students,2021-22,2519,278,2241,89.0,16,8,50.0
PK in K-12 Schools,All Students,2022-23,5709,471,5238,91.7,35,9,25.7
0K,All Students,2018-19,26643,1558,25085,94.2,161,26,16.1
0K,All Students,2019-20,15063,776,14287,94.8,135,17,12.6
0K,All Students,2020-21,22040,2123,19917,90.4,131,41,31.3
0K,All Students,2021-22,18936,1714,17222,90.9,117,40,34.2
0K,All Students,2022-23,18190,1456,16734,92.0,109,28,25.7
1,All Students,2018-19,29196,1266,27930,95.7,172,16,9.3
1,All Students,2019-20,17473,893,16580,94.9,157,26,16.6
1,All Students,2020-21,21822,1819,20003,91.7,129,38,29.5
1,All Students,2021-22,23385,1624,21761,93.1,140,38,27.1
1,All Students,2022-23,17869,1279,16590,92.8,110,32,29.1
2,All Students,2018-19,28025,1005,27020,96.4,161,12,7.5
2,All Students,2019-20,17864,662,17202,96.3,160,12,7.5
2,All Students,2020-21,25314,1473,23841,94.2,148,25,16.9
2,All Students,2021-22,22081,1472,20609,93.3,128,27,21.1
2,All Students,2022-23,23445,1348,22097,94.3,144,25,17.4
3,All Students,2018-19,25746,823,24923,96.8,150,10,6.7
3,All Students,2019-20,17320,569,16751,96.7,154,12,7.8
3,All Students,2020-21,25013,1180,23833,95.3,144,13,9.0
3,All Students,2021-22,24960,1365,23595,94.5,149,26,17.4
3,All Students,2022-23,21513,1254,20259,94.2,133,24,18.0
4,All Students,2018-19,26486,866,25620,96.7,152,10,6.6
4,All Students,2019-20,16974,483,16491,97.2,152,7,4.6
4,All Students,2020-21,25675,1075,24600,95.8,147,12,8.2
4,All Students,2021-22,22620,1229,21391,94.6,136,22,16.2
4,All Students,2022-23,24555,1424,23131,94.2,147,27,18.4
5,All Students,2018-19,25187,925,24262,96.3,145,12,8.3
5,All Students,2019-20,15411,632,14779,95.9,136,13,9.6
5,All Students,2020-21,24559,1693,22866,93.1,141,28,19.9
5,All Students,2021-22,23889,1429,22460,94.0,138,27,19.6
5,All Students,2022-23,22158,1133,21025,94.9,130,17,13.1
All Grades,All Students,2018-19,136189,5659,130530,95.8,781,85,10.9
All Grades,All Students,2019-20,87837,4260,83577,95.2,781,101,12.9
All Grades,All Students,2020-21,128674,13464,115210,89.5,762,238,31.2
All Grades,All Students,2021-22,132647,11205,121442,91.6,770,220,28.6
All Grades,All Students,2022-23,132903,10007,122896,92.5,783,195,24.9
6,All Students,2018-19,28916,1098,27818,96.2,164,15,9.1
6,All Students,2019-20,30305,1314,28991,95.7,269,28,10.4
6,All Students,2020-21,49781,4644,45137,90.7,293,75,25.6
6,All Students,2021-22,35167,s,s,s,s,s,s
6,All Students,2022-23,45927,2839,43088,93.8,274,51,18.6
7,All Students,2018-19,56206,2475,53731,95.6,324,41,12.7
7,All Students,2019-20,21466,1113,20353,94.8,193,25,13.0
7,All Students,2020-21,46463,5234,41229,88.7,274,97,35.4
7,All Students,2021-22,51604,4346,47258,91.6,298,89,29.9
7,All Students,2022-23,34870,2505,32365,92.8,204,47,23.0
8,All Students,2018-19,51067,2086,48981,95.9,293,29,9.9
8,All Students,2019-20,36066,1833,34233,94.9,319,48,15.0
8,All Students,2020-21,32430,3586,28844,88.9,195,66,33.8
8,All Students,2021-22,45871,4392,41479,90.4,268,81,30.2
8,All Students,2022-23,52106,4663,47443,91.1,305,97,31.8
9,All Students,2021-22,5,s,s,s,s,s,s
All Grades,All Students,2018-19,100310,5823,94487,94.2,592,107,18.1
All Grades,All Students,2019-20,57010,2781,54229,95.1,514,69,13.4
All Grades,All Students,2020-21,78035,8481,69554,89.1,462,171,37.0
All Grades,All Students,2021-22,80268,7854,72414,90.2,483,195,40.4
All Grades,All Students,2022-23,88126,7961,80165,91.0,548,194,35.4
0K,All Students,2018-19,14641,956,13685,93.5,86,17,19.8
0K,All Students,2019-20,9062,616,8446,93.2,84,14,16.7
0K,All Students,2020-21,12874,1724,11150,86.6,77,37,48.1
0K,All Students,2021-22,13342,1718,11624,87.1,80,39,48.8
0K,All Students,2022-23,14118,1363,12755,90.3,84,30,35.7
1,All Students,2018-19,14348,1096,13252,92.4,87,21,24.1
1,All Students,2019-20,9430,448,8982,95.2,87,14,16.1
1,All Students,2020-21,13889,2024,11865,85.4,83,37,44.6
1,All Students,2021-22,13580,1332,12248,90.2,81,35,43.2
1,All Students,2022-23,14067,1568,12499,88.9,88,43,48.9
2,All Students,2018-19,11455,668,10787,94.2,70,15,21.4
2,All Students,2019-20,9455,555,8900,94.1,85,16,18.8
2,All Students,2020-21,14651,1612,13039,89.0,86,30,34.9
2,All Students,2021-22,13726,1240,12486,91.0,84,32,38.1
2,All Students,2022-23,14267,1249,13018,91.2,90,30,33.3
3,All Students,2018-19,11981,678,11303,94.3,71,12,16.9
3,All Students,2019-20,7110,321,6789,95.5,63,9,14.3
3,All Students,2020-21,14597,1287,13310,91.2,87,31,35.6
3,All Students,2021-22,14078,1146,12932,91.9,84,28,33.3
3,All Students,2022-23,16080,1332,14748,91.7,104,38,36.5
4,All Students,2018-19,25055,1294,23761,94.8,146,21,14.4
4,All Students,2019-20,7922,315,7607,96.0,72,6,8.3
4,All Students,2020-21,10785,837,9948,92.2,64,15,23.4
4,All Students,2021-22,15195,1336,13859,91.2,92,33,35.9
4,All Students,2022-23,15554,1280,14274,91.8,97,28,28.9
5,All Students,2018-19,22830,1131,21699,95.0,132,21,15.9
5,All Students,2019-20,14031,526,13505,96.3,123,10,8.1
5,All Students,2020-21,11239,997,10242,91.1,65,21,32.3
5,All Students,2021-22,10347,1082,9265,89.5,62,28,45.2
5,All Students,2022-23,14040,1169,12871,91.7,85,25,29.4
All Grades,All Students,2022-23,184562,34805,149757,81.1,1181,878,74.3
PK in K-12 Schools,All Students,2022-23,184400,s,s,s,s,s,s
0K,All Students,2022-23,162,s,s,s,s,s,s
All Grades,All Students,2018-19,75530,5169,70361,93.2,447,107,23.9
All Grades,All Students,2019-20,55966,3395,52571,93.9,504,100,19.8
All Grades,All Students,2020-21,80230,4340,75890,94.6,476,73,15.3
All Grades,All Students,2021-22,79020,6778,72242,91.4,463,148,32.0
All Grades,All Students,2022-23,79035,6180,72855,92.2,479,126,26.3
PK in K-12 Schools,All Students,2018-19,3186,307,2879,90.4,18,8,44.4
0K,All Students,2018-19,13106,1026,12080,92.2,76,20,26.3
0K,All Students,2019-20,8870,711,8159,92.0,83,26,31.3
0K,All Students,2020-21,12074,998,11076,91.7,73,14,19.2
0K,All Students,2021-22,14069,1289,12780,90.8,82,30,36.6
0K,All Students,2022-23,13725,1302,12423,90.5,83,29,34.9
1,All Students,2018-19,13491,1014,12477,92.5,80,22,27.5
1,All Students,2019-20,9044,521,8523,94.2,80,13,16.3
1,All Students,2020-21,12851,616,12235,95.2,77,8,10.4
1,All Students,2021-22,12484,1174,11310,90.6,73,26,35.6
1,All Students,2022-23,14720,1249,13471,91.5,92,24,26.1
2,All Students,2018-19,16535,1119,15416,93.2,99,21,21.2
2,All Students,2019-20,9630,608,9022,93.7,86,21,24.4
2,All Students,2020-21,12970,638,12332,95.1,77,10,13.0
2,All Students,2021-22,12506,1099,11407,91.2,74,28,37.8
2,All Students,2022-23,12535,1048,11487,91.6,73,20,27.4
3,All Students,2018-19,15221,949,14272,93.8,92,22,23.9
3,All Students,2019-20,9926,581,9345,94.1,89,16,18.0
3,All Students,2020-21,14134,674,13460,95.2,84,13,15.5
3,All Students,2021-22,12368,916,11452,92.6,73,17,23.3
3,All Students,2022-23,12437,873,11564,93.0,76,17,22.4
4,All Students,2018-19,13991,754,13237,94.6,82,14,17.1
4,All Students,2019-20,9291,476,8815,94.9,84,12,14.3
4,All Students,2020-21,14944,707,14237,95.3,88,11,12.5
4,All Students,2021-22,13442,1040,12402,92.3,79,22,27.8
4,All Students,2022-23,12800,807,11993,93.7,79,15,19.0
5,All Students,2019-20,9205,498,8707,94.6,82,12,14.6
5,All Students,2020-21,13257,707,12550,94.7,77,17,22.1
5,All Students,2021-22,14151,1260,12891,91.1,82,25,30.5
5,All Students,2022-23,12818,901,11917,93.0,76,21,27.6
All Grades,All Students,2022-23,33523,2092,31431,93.8,200,40,20.0
6,All Students,2022-23,33523,2092,31431,93.8,200,40,20.0
All Grades,All Students,2018-19,289722,31490,258232,89.1,1920,533,27.8
All Grades,All Students,2019-20,181273,17425,163848,90.4,1801,493,27.4
All Grades,All Students,2020-21,282734,46697,236037,83.5,1697,692,40.8
All Grades,All Students,2021-22,284060,39796,244264,86.0,1769,632,35.7
All Grades,All Students,2022-23,289553,40268,249285,86.1,1946,698,35.9
8,All Students,2022-23,23,s,s,s,s,s,s
9,All Students,2018-19,77129,10091,67038,86.9,549,179,32.6
9,All Students,2019-20,52140,6084,46056,88.3,540,166,30.7
9,All Students,2020-21,78559,15238,63321,80.6,483,206,42.7
9,All Students,2021-22,90196,12528,77668,86.1,566,176,31.1
9,All Students,2022-23,76838,11042,65796,85.6,544,195,35.8
10,All Students,2018-19,79320,9957,69363,87.4,536,175,32.6
10,All Students,2019-20,49263,5463,43800,88.9,493,165,33.5
10,All Students,2020-21,72204,13879,58325,80.8,438,201,45.9
10,All Students,2021-22,69657,10191,59466,85.4,439,160,36.4
10,All Students,2022-23,87141,12230,74911,86.0,593,216,36.4
11,All Students,2018-19,56558,3252,53306,94.3,355,53,14.9
11,All Students,2019-20,38702,2825,35877,92.7,378,78,20.6
11,All Students,2020-21,61157,8364,52793,86.3,360,136,37.8
11,All Students,2021-22,56877,6656,50221,88.3,348,111,31.9
11,All Students,2022-23,61419,s,s,s,s,s,s
12,All Students,2018-19,76715,8190,68525,89.3,480,126,26.3
12,All Students,2019-20,41168,3053,38115,92.6,390,84,21.5
12,All Students,2020-21,70814,9216,61598,87.0,416,149,35.8
12,All Students,2021-22,67330,10421,56909,84.5,416,185,44.5
12,All Students,2022-23,64132,9659,54473,84.9,403,160,39.7
All Grades,All Students,2018-19,278052,45827,232225,83.5,1817,810,44.6
All Grades,All Students,2019-20,184097,30383,153714,83.5,1721,695,40.4
All Grades,All Students,2020-21,269374,48001,221373,82.2,1625,751,46.2
All Grades,All Students,2021-22,242363,46569,195794,80.8,1499,730,48.7
All Grades,All Students,2022-23,238436,40252,198184,83.1,1579,766,48.5
8,All Students,2021-22,6,s,s,s,s,s,s
8,All Students,2022-23,3,s,s,s,s,s,s
9,All Students,2018-19,74114,14326,59788,80.7,500,228,45.6
9,All Students,2019-20,49713,9807,39906,80.3,468,185,39.5
9,All Students,2020-21,62713,13915,48798,77.8,382,190,49.7
9,All Students,2021-22,63264,11432,51832,81.9,390,168,43.1
9,All Students,2022-23,68685,11627,57058,83.1,453,196,43.3
10,All Students,2018-19,76374,13410,62964,82.4,494,230,46.6
10,All Students,2019-20,52016,8873,43143,82.9,489,217,44.4
10,All Students,2020-21,82526,14783,67743,82.1,500,243,48.6
10,All Students,2021-22,60123,14948,45175,75.1,370,203,54.9
10,All Students,2022-23,69200,11555,57645,83.3,462,220,47.6
11,All Students,2018-19,62637,7595,55042,87.9,404,152,37.6
11,All Students,2019-20,39066,5040,34026,87.1,365,131,35.9
11,All Students,2020-21,62713,8134,54579,87.0,371,142,38.3
11,All Students,2021-22,60628,8883,51745,85.3,374,163,43.6
11,All Students,2022-23,40011,s,s,s,s,s,s
12,All Students,2018-19,64927,10496,54431,83.8,419,200,47.7
12,All Students,2019-20,43302,6663,36639,84.6,399,162,40.6
12,All Students,2020-21,61422,11169,50253,81.8,372,176,47.3
12,All Students,2021-22,58342,s,s,s,s,s,s
12,All Students,2022-23,60537,10796,49741,82.2,391,212,54.2
All Grades,All Students,2018-19,84786,5607,79179,93.4,518,95,18.3
All Grades,All Students,2019-20,55453,3848,51605,93.1,511,115,22.5
All Grades,All Students,2020-21,87611,9819,77792,88.8,519,191,36.8
All Grades,All Students,2021-22,82888,10854,72034,86.9,497,213,42.9
All Grades,All Students,2022-23,80217,7876,72341,90.2,498,160,32.1
9,All Students,2018-19,18893,1293,17600,93.2,113,12,10.6
9,All Students,2019-20,12486,790,11696,93.7,114,25,21.9
9,All Students,2020-21,19512,1409,18103,92.8,114,24,21.1
9,All Students,2021-22,15768,1602,14166,89.8,97,21,21.6
9,All Students,2022-23,18319,2100,16219,88.5,110,37,33.6
10,All Students,2018-19,20036,1568,18468,92.2,123,31,25.2
10,All Students,2019-20,13548,1217,12331,91.0,124,36,29.0
10,All Students,2020-21,21862,2652,19210,87.9,128,40,31.3
10,All Students,2021-22,20816,3241,17575,84.4,124,63,50.8
10,All Students,2022-23,16336,1559,14777,90.5,103,29,28.2
11,All Students,2018-19,18350,1505,16845,91.8,109,29,26.6
11,All Students,2019-20,12100,988,11112,91.8,111,29,26.1
11,All Students,2020-21,19904,2637,17267,86.8,116,53,45.7
11,All Students,2021-22,20252,3183,17069,84.3,120,62,51.7
11,All Students,2022-23,18587,1910,16677,89.7,114,37,32.5
12,All Students,2018-19,27507,1241,26266,95.5,173,23,13.3
12,All Students,2019-20,17319,853,16466,95.1,162,25,15.4
12,All Students,2020-21,26333,3121,23212,88.1,161,74,46.0
12,All Students,2021-22,26052,2828,23224,89.1,156,67,42.9
12,All Students,2022-23,26975,2307,24668,91.4,171,57,33.3
All Grades,All Students,2018-19,83446,6816,76630,91.8,535,130,24.3
All Grades,All Students,2019-20,56836,4447,52389,92.2,536,139,25.9
All Grades,All Students,2020-21,87713,8787,78926,90.0,537,151,28.1
All Grades,All Students,2021-22,84098,8790,75308,89.5,531,172,32.4
All Grades,All Students,2022-23,84473,7099,77374,91.6,536,138,25.7
9,All Students,2018-19,21272,1640,19632,92.3,141,32,22.7
9,All Students,2019-20,12849,800,12049,93.8,126,26,20.6
9,All Students,2020-21,19588,1767,17821,91.0,125,34,27.2
9,All Students,2021-22,22373,1746,20627,92.2,141,36,25.5
9,All Students,2022-23,19413,1484,17929,92.4,124,36,29.0
10,All Students,2018-19,17715,1131,16584,93.6,115,19,16.5
10,All Students,2019-20,12323,1096,11227,91.1,116,34,29.3
10,All Students,2020-21,22374,2505,19869,88.8,138,36,26.1
10,All Students,2021-22,17560,1376,16184,92.2,113,24,21.2
10,All Students,2022-23,19616,1604,18012,91.8,121,33,27.3
11,All Students,2018-19,18694,1840,16854,90.2,116,40,34.5
11,All Students,2019-20,12499,1063,11436,91.5,114,33,28.9
11,All Students,2020-21,18193,2063,16130,88.7,105,38,36.2
11,All Students,2021-22,19836,2394,17442,87.9,121,44,36.4
11,All Students,2022-23,17387,1672,15715,90.4,106,30,28.3
12,All Students,2018-19,25765,2205,23560,91.4,163,39,23.9
12,All Students,2019-20,19165,1488,17677,92.2,180,46,25.6
12,All Students,2020-21,27558,2452,25106,91.1,169,43,25.4
12,All Students,2021-22,24329,3274,21055,86.5,156,68,43.6
12,All Students,2022-23,28057,2339,25718,91.7,185,39,21.1
All Grades,All Students,2018-19,129624,11193,118431,91.4,805,208,25.8
All Grades,All Students,2019-20,85144,6235,78909,92.7,793,176,22.2
All Grades,All Students,2020-21,132399,8310,124089,93.7,773,127,16.4
All Grades,All Students,2021-22,129316,12871,116445,90.0,785,247,31.5
All Grades,All Students,2022-23,122557,12157,110400,90.1,773,228,29.5
9,All Students,2018-19,41231,4026,37205,90.2,254,68,26.8
9,All Students,2019-20,27526,2432,25094,91.2,261,68,26.1
9,All Students,2020-21,37104,3319,33785,91.1,219,48,21.9
9,All Students,2021-22,35833,3699,32134,89.7,222,63,28.4
9,All Students,2022-23,35094,4501,30593,87.2,226,80,35.4
10,All Students,2018-19,32122,2740,29382,91.5,207,46,22.2
10,All Students,2019-20,21793,1445,20348,93.4,203,48,23.6
10,All Students,2020-21,34271,1767,32504,94.8,199,30,15.1
10,All Students,2021-22,32779,3620,29159,89.0,201,67,33.3
10,All Students,2022-23,30572,2825,27747,90.8,197,58,29.4
11,All Students,2018-19,26459,1986,24473,92.5,161,34,21.1
11,All Students,2019-20,18524,1002,17522,94.6,171,21,12.3
11,All Students,2020-21,32118,1743,30375,94.6,188,24,12.8
11,All Students,2021-22,30545,2596,27949,91.5,183,53,29.0
11,All Students,2022-23,27092,2081,25011,92.3,167,37,22.2
12,All Students,2018-19,29812,2441,27371,91.8,183,60,32.8
12,All Students,2019-20,17301,1356,15945,92.2,158,39,24.7
12,All Students,2020-21,28906,1481,27425,94.9,167,25,15.0
12,All Students,2021-22,30159,2956,27203,90.2,179,64,35.8
12,All Students,2022-23,29799,2750,27049,90.8,183,53,29.0
All Grades,All Students,2018-19,109128,7063,102065,93.5,659,119,18.1
All Grades,All Students,2019-20,72334,4344,67990,94.0,656,122,18.6
All Grades,All Students,2020-21,112531,15178,97353,86.5,652,234,35.9
All Grades,All Students,2021-22,103796,11613,92183,88.8,621,208,33.5
All Grades,All Students,2022-23,102947,12405,90542,88.0,631,226,35.8
6,All Students,2018-19,8054,187,7867,97.7,46,2,4.3
6,All Students,2019-20,6579,133,6446,98.0,58,2,3.4
6,All Students,2020-21,14234,626,13608,95.6,82,7,8.5
6,All Students,2021-22,5475,339,5136,93.8,33,8,24.2
6,All Students,2022-23,9342,688,8654,92.6,57,10,17.5
7,All Students,2018-19,9268,262,9006,97.2,54,3,5.6
7,All Students,2019-20,5702,156,5546,97.3,50,1,2.0
7,All Students,2020-21,9476,626,8850,93.4,55,13,23.6
7,All Students,2021-22,12626,435,12191,96.6,73,4,5.5
7,All Students,2022-23,4326,203,4123,95.3,27,4,14.8
8,All Students,2018-19,10449,277,10172,97.3,60,3,5.0
8,All Students,2019-20,5928,236,5692,96.0,52,6,11.5
8,All Students,2020-21,8127,732,7395,91.0,47,10,21.3
8,All Students,2021-22,9616,448,9168,95.3,55,4,7.3
8,All Students,2022-23,12187,587,11600,95.2,71,11,15.5
9,All Students,2018-19,19646,970,18676,95.1,123,15,12.2
9,All Students,2019-20,14610,884,13726,93.9,134,25,18.7
9,All Students,2020-21,20221,2872,17349,85.8,117,49,41.9
9,All Students,2021-22,19792,2203,17589,88.9,126,48,38.1
9,All Students,2022-23,20498,2357,18141,88.5,130,49,37.7
10,All Students,2018-19,19972,1181,18791,94.1,122,17,13.9
10,All Students,2019-20,12667,793,11874,93.7,117,24,20.5
10,All Students,2020-21,21629,3586,18043,83.4,125,53,42.4
10,All Students,2021-22,18202,1878,16324,89.7,108,33,30.6
10,All Students,2022-23,19761,2717,17044,86.3,123,52,42.3
11,All Students,2018-19,21927,1499,20428,93.2,134,22,16.4
11,All Students,2019-20,12850,828,12022,93.6,117,22,18.8
11,All Students,2020-21,19005,2834,16171,85.1,111,43,38.7
11,All Students,2021-22,20032,2526,17506,87.4,119,42,35.3
11,All Students,2022-23,17884,2351,15533,86.9,108,38,35.2
12,All Students,2018-19,19812,2687,17125,86.4,120,57,47.5
12,All Students,2019-20,13998,1314,12684,90.6,128,42,32.8
12,All Students,2020-21,19839,3902,15937,80.3,115,59,51.3
12,All Students,2021-22,18053,3784,14269,79.0,107,69,64.5
12,All Students,2022-23,18949,3502,15447,81.5,115,62,53.9
All Grades,All Students,2018-19,199629,12824,186805,93.6,1221,251,20.6
All Grades,All Students,2019-20,135090,8370,126720,93.8,1244,242,19.5
All Grades,All Students,2020-21,210110,31050,179060,85.2,1220,534,43.8
All Grades,All Students,2021-22,182891,20665,162226,88.7,1109,442,39.9
All Grades,All Students,2022-23,173694,19460,154234,88.8,1080,432,40.0
9,All Students,2018-19,48018,2476,45542,94.8,294,48,16.3
9,All Students,2019-20,31962,1571,30391,95.1,294,49,16.7
9,All Students,2020-21,46234,3713,42521,92.0,270,71,26.3
9,All Students,2021-22,45231,4681,40550,89.7,277,90,32.5
9,All Students,2022-23,43775,3596,40179,91.8,273,67,24.5
10,All Students,2018-19,68826,3509,65317,94.9,416,56,13.5
10,All Students,2019-20,30520,1790,28730,94.1,283,53,18.7
10,All Students,2020-21,49060,4752,44308,90.3,286,83,29.0
10,All Students,2021-22,44297,4575,39722,89.7,273,103,37.7
10,All Students,2022-23,40693,4238,36455,89.6,256,85,33.2
11,All Students,2018-19,42532,2239,40293,94.7,260,41,15.8
11,All Students,2019-20,44736,2787,41949,93.8,410,72,17.6
11,All Students,2020-21,46883,6210,40673,86.8,271,99,36.5
11,All Students,2021-22,47812,5423,42389,88.7,287,118,41.1
11,All Students,2022-23,43772,5093,38679,88.4,272,120,44.1
12,All Students,2018-19,40253,4600,35653,88.6,251,106,42.2
12,All Students,2019-20,27872,2222,25650,92.0,257,68,26.5
12,All Students,2020-21,67933,16375,51558,75.9,393,281,71.5
12,All Students,2021-22,45551,5986,39565,86.9,272,131,48.2
12,All Students,2022-23,45454,6533,38921,85.6,279,160,57.3
All Grades,All Students,2018-19,248695,19395,229300,92.2,1509,269,17.8
All Grades,All Students,2019-20,159676,9947,149729,93.8,1465,226,15.4
All Grades,All Students,2020-21,257014,31038,225976,87.9,1484,425,28.6
All Grades,All Students,2021-22,240676,27142,213534,88.7,1453,463,31.9
All Grades,All Students,2022-23,220061,21224,198837,90.4,1376,386,28.1
9,All Students,2018-19,72479,6650,65829,90.8,437,79,18.1
9,All Students,2019-20,42756,2677,40079,93.7,396,62,15.7
9,All Students,2020-21,67958,10053,57905,85.2,392,127,32.4
9,All Students,2021-22,72265,10103,62162,86.0,439,157,35.8
9,All Students,2022-23,64554,7666,56888,88.1,407,133,32.7
10,All Students,2018-19,84432,6747,77685,92.0,517,92,17.8
10,All Students,2019-20,52408,3894,48514,92.6,483,90,18.6
10,All Students,2020-21,82414,12018,70396,85.4,478,170,35.6
10,All Students,2021-22,64173,7220,56953,88.7,393,132,33.6
10,All Students,2022-23,65655,6753,58902,89.7,413,129,31.2
11,All Students,2018-19,50848,3084,47764,93.9,304,47,15.5
11,All Students,2019-20,38922,2184,36738,94.4,354,47,13.3
11,All Students,2020-21,58599,5476,53123,90.7,340,78,22.9
11,All Students,2021-22,51280,4201,47079,91.8,305,72,23.6
11,All Students,2022-23,43759,3220,40539,92.6,269,52,19.3
12,All Students,2018-19,40936,2914,38022,92.9,251,51,20.3
12,All Students,2019-20,25590,1192,24398,95.3,233,28,12.0
12,All Students,2020-21,48043,3491,44552,92.7,274,50,18.2
12,All Students,2021-22,52958,5618,47340,89.4,316,102,32.3
12,All Students,2022-23,46093,3585,42508,92.2,287,72,25.1
All Grades,All Students,2018-19,345784,8987,336797,97.4,2103,124,5.9
All Grades,All Students,2019-20,226949,6459,220490,97.2,2078,158,7.6
All Grades,All Students,2020-21,348014,10057,337957,97.1,2041,135,6.6
All Grades,All Students,2021-22,324796,21931,302865,93.2,1934,354,18.3
All Grades,All Students,2022-23,326594,18234,308360,94.4,2021,312,15.4
9,All Students,2018-19,85191,1915,83276,97.8,521,24,4.6
9,All Students,2019-20,55587,1469,54118,97.4,513,37,7.2
9,All Students,2020-21,83278,1703,81575,98.0,501,33,6.6
9,All Students,2021-22,88632,5938,82694,93.3,528,89,16.9
9,All Students,2022-23,84261,4260,80001,94.9,525,74,14.1
10,All Students,2018-19,79333,1326,78007,98.3,483,13,2.7
10,All Students,2019-20,52304,1219,51085,97.7,481,27,5.6
10,All Students,2020-21,77733,2090,75643,97.3,449,22,4.9
10,All Students,2021-22,70326,3111,67215,95.6,418,40,9.6
10,All Students,2022-23,77271,4196,73075,94.6,477,73,15.3
11,All Students,2018-19,74401,1419,72982,98.1,451,18,4.0
11,All Students,2019-20,50808,872,49936,98.3,462,12,2.6
11,All Students,2020-21,82117,1412,80705,98.3,474,16,3.4
11,All Students,2021-22,73438,4538,68900,93.8,437,75,17.2
11,All Students,2022-23,64316,2476,61840,96.2,393,26,6.6
12,All Students,2018-19,106859,4327,102532,96.0,648,69,10.6
12,All Students,2019-20,68250,2899,65351,95.8,622,82,13.2
12,All Students,2020-21,104850,4827,100023,95.4,616,63,10.2
12,All Students,2021-22,92400,8344,84056,91.0,551,150,27.2
12,All Students,2022-23,100746,7302,93444,92.8,626,139,22.2
All Grades,All Students,2018-19,215052,10039,205013,95.3,1315,202,15.4
All Grades,All Students,2019-20,137137,7782,129355,94.3,1254,231,18.4
All Grades,All Students,2020-21,202643,8828,193815,95.6,1197,175,14.6
All Grades,All Students,2021-22,196985,14591,182394,92.6,1208,327,27.1
All Grades,All Students,2022-23,183158,11905,171253,93.5,1128,263,23.3
PK in K-12 Schools,All Students,2018-19,16102,1391,14711,91.4,116,36,31.0
PK in K-12 Schools,All Students,2019-20,11548,1148,10400,90.1,112,45,40.2
PK in K-12 Schools,All Students,2020-21,17034,1463,15571,91.4,108,29,26.9
PK in K-12 Schools,All Students,2021-22,20350,2847,17503,86.0,139,82,59.0
PK in K-12 Schools,All Students,2022-23,18358,2018,16340,89.0,124,62,50.0
0K,All Students,2018-19,29803,1887,27916,93.7,190,45,23.7
0K,All Students,2019-20,19715,1535,18180,92.2,186,53,28.5
0K,All Students,2020-21,29758,1542,28216,94.8,178,32,18.0
0K,All Students,2021-22,27934,2731,25203,90.2,174,58,33.3
0K,All Students,2022-23,27746,2290,25456,91.7,166,45,27.1
1,All Students,2018-19,36906,1778,35128,95.2,224,36,16.1
1,All Students,2019-20,18708,1176,17532,93.7,174,36,20.7
1,All Students,2020-21,27443,1244,26199,95.5,163,25,15.3
1,All Students,2021-22,26669,2107,24562,92.1,165,50,30.3
1,All Students,2022-23,25970,1939,24031,92.5,163,47,28.8
2,All Students,2018-19,37857,1581,36276,95.8,227,27,11.9
2,All Students,2019-20,24226,1287,22939,94.7,217,29,13.4
2,All Students,2020-21,26402,1334,25068,94.9,157,28,17.8
2,All Students,2021-22,26563,1688,24875,93.6,164,34,20.7
2,All Students,2022-23,26114,1625,24489,93.8,160,35,21.9
3,All Students,2018-19,28950,1250,27700,95.7,170,24,14.1
3,All Students,2019-20,23313,1079,22234,95.4,212,28,13.2
3,All Students,2020-21,35667,1283,34384,96.4,208,27,13.0
3,All Students,2021-22,24695,1685,23010,93.2,152,36,23.7
3,All Students,2022-23,26807,1316,25491,95.1,162,22,13.6
4,All Students,2018-19,32822,1110,31712,96.6,197,17,8.6
4,All Students,2019-20,19460,943,18517,95.2,175,29,16.6
4,All Students,2020-21,38405,826,37579,97.8,221,13,5.9
4,All Students,2021-22,34099,1749,32350,94.9,202,34,16.8
4,All Students,2022-23,25644,1207,24437,95.3,156,24,15.4
5,All Students,2018-19,32612,1042,31570,96.8,191,17,8.9
5,All Students,2019-20,20167,614,19553,97.0,178,11,6.2
5,All Students,2020-21,27934,1136,26798,95.9,162,21,13.0
5,All Students,2021-22,36675,1784,34891,95.1,212,33,15.6
5,All Students,2022-23,32519,1510,31009,95.4,197,28,14.2
All Grades,All Students,2018-19,238671,11086,227585,95.4,1405,195,13.9
All Grades,All Students,2019-20,153229,8146,145083,94.7,1374,209,15.2
All Grades,All Students,2020-21,212500,8289,204211,96.1,1256,149,11.9
All Grades,All Students,2021-22,199731,13493,186238,93.2,1183,282,23.8
All Grades,All Students,2022-23,193276,13962,179314,92.8,1159,309,26.7
PK in K-12 Schools,All Students,2018-19,15646,1325,14321,91.5,94,39,41.5
PK in K-12 Schools,All Students,2019-20,10152,881,9271,91.3,90,28,31.1
PK in K-12 Schools,All Students,2020-21,14261,833,13428,94.2,86,15,17.4
PK in K-12 Schools,All Students,2021-22,12017,1565,10452,87.0,71,38,53.5
PK in K-12 Schools,All Students,2022-23,10743,1521,9222,85.8,68,44,64.7
0K,All Students,2018-19,32604,2206,30398,93.2,195,48,24.6
0K,All Students,2019-20,22669,1556,21113,93.1,202,47,23.3
0K,All Students,2020-21,28195,1066,27129,96.2,171,21,12.3
0K,All Students,2021-22,29436,2400,27036,91.8,178,55,30.9
0K,All Students,2022-23,27114,2795,24319,89.7,166,70,42.2
1,All Students,2018-19,34824,1803,33021,94.8,209,27,12.9
1,All Students,2019-20,21776,1265,20511,94.2,196,33,16.8
1,All Students,2020-21,31741,1404,30337,95.6,192,28,14.6
1,All Students,2021-22,27376,1979,25397,92.8,166,44,26.5
1,All Students,2022-23,30754,2586,28168,91.6,188,55,29.3
2,All Students,2018-19,38854,1670,37184,95.7,228,29,12.7
2,All Students,2019-20,23217,1216,22001,94.8,208,24,11.5
2,All Students,2020-21,31287,972,30315,96.9,184,16,8.7
2,All Students,2021-22,30196,1910,28286,93.7,174,35,20.1
2,All Students,2022-23,30815,2117,28698,93.1,180,45,25.0
3,All Students,2018-19,34438,1311,33127,96.2,203,13,6.4
3,All Students,2019-20,24908,970,23938,96.1,224,21,9.4
3,All Students,2020-21,33431,1098,32333,96.7,194,20,10.3
3,All Students,2021-22,29502,1879,27623,93.6,175,39,22.3
3,All Students,2022-23,31368,1822,29546,94.2,185,41,22.2
4,All Students,2018-19,42070,1587,40483,96.2,244,24,9.8
4,All Students,2019-20,22880,989,21891,95.7,208,28,13.5
4,All Students,2020-21,40347,1473,38874,96.3,235,23,9.8
4,All Students,2021-22,32688,1657,31031,94.9,193,26,13.5
4,All Students,2022-23,29419,1569,27850,94.7,177,30,16.9
5,All Students,2018-19,40235,1184,39051,97.1,232,15,6.5
5,All Students,2019-20,27627,1269,26358,95.4,246,28,11.4
5,All Students,2020-21,33190,1437,31753,95.7,193,25,13.0
5,All Students,2021-22,38516,2103,36413,94.5,226,45,19.9
5,All Students,2022-23,33063,1552,31511,95.3,195,24,12.3
All Grades,All Students,2018-19,161288,6290,154998,96.1,966,92,9.5
All Grades,All Students,2019-20,99345,4788,94557,95.2,892,123,13.8
All Grades,All Students,2020-21,142864,5941,136923,95.8,846,108,12.8
All Grades,All Students,2021-22,132772,7647,125125,94.2,813,164,20.2
All Grades,All Students,2022-23,133206,7542,125664,94.3,814,151,18.6
PK in K-12 Schools,All Students,2018-19,6341,602,5739,90.5,39,15,38.5
PK in K-12 Schools,All Students,2019-20,2070,129,1941,93.8,19,2,10.5
PK in K-12 Schools,All Students,2020-21,3075,276,2799,91.0,18,7,38.9
PK in K-12 Schools,All Students,2021-22,3159,243,2916,92.3,18,5,27.8
PK in K-12 Schools,All Students,2022-23,3126,325,2801,89.6,19,10,52.6
0K,All Students,2018-19,25613,1487,24126,94.2,158,32,20.3
0K,All Students,2019-20,16034,1205,14829,92.5,147,36,24.5
0K,All Students,2020-21,20453,919,19534,95.5,124,16,12.9
0K,All Students,2021-22,19767,1545,18222,92.2,129,46,35.7
0K,All Students,2022-23,18696,1342,17354,92.8,114,29,25.4
1,All Students,2018-19,27428,1149,26279,95.8,166,14,8.4
1,All Students,2019-20,15818,889,14929,94.4,141,29,20.6
1,All Students,2020-21,23960,1299,22661,94.6,143,26,18.2
1,All Students,2021-22,20414,1453,18961,92.9,124,31,25.0
1,All Students,2022-23,23327,1512,21815,93.5,146,31,21.2
2,All Students,2018-19,26942,912,26030,96.6,162,12,7.4
2,All Students,2019-20,17618,810,16808,95.4,158,21,13.3
2,All Students,2020-21,22408,941,21467,95.8,132,16,12.1
2,All Students,2021-22,22327,1354,20973,93.9,136,31,22.8
2,All Students,2022-23,20594,1145,19449,94.4,125,23,18.4
3,All Students,2018-19,26185,853,25332,96.7,155,11,7.1
3,All Students,2019-20,15477,552,14925,96.4,138,4,2.9
3,All Students,2020-21,25412,868,24544,96.6,148,15,10.1
3,All Students,2021-22,20120,1018,19102,94.9,120,15,12.5
3,All Students,2022-23,21147,1049,20098,95.0,123,14,11.4
4,All Students,2018-19,25090,696,24394,97.2,150,5,3.3
4,All Students,2019-20,16530,597,15933,96.4,148,16,10.8
4,All Students,2020-21,22908,713,22195,96.9,135,12,8.9
4,All Students,2021-22,24571,1253,23318,94.9,152,25,16.4
4,All Students,2022-23,22511,1075,21436,95.2,144,27,18.8
5,All Students,2018-19,23689,591,23098,97.5,136,3,2.2
5,All Students,2019-20,15798,606,15192,96.2,141,15,10.6
5,All Students,2020-21,24648,925,23723,96.2,146,16,11.0
5,All Students,2021-22,22414,781,21633,96.5,134,11,8.2
5,All Students,2022-23,23805,1094,22711,95.4,143,17,11.9
All Grades,All Students,2018-19,187938,5915,182023,96.9,1144,92,8.0
All Grades,All Students,2019-20,125145,4657,120488,96.3,1143,97,8.5
All Grades,All Students,2020-21,187586,3786,183800,98.0,1115,51,4.6
All Grades,All Students,2021-22,189680,10068,179612,94.7,1148,185,16.1
All Grades,All Students,2022-23,197306,9604,187702,95.1,1208,169,14.0
PK in K-12 Schools,All Students,2018-19,6336,s,s,s,s,s,s
PK in K-12 Schools,All Students,2019-20,6135,346,5789,94.4,57,10,17.5
PK in K-12 Schools,All Students,2020-21,9352,255,9097,97.3,55,3,5.5
PK in K-12 Schools,All Students,2021-22,9401,857,8544,90.9,54,15,27.8
PK in K-12 Schools,All Students,2022-23,9370,833,8537,91.1,59,17,28.8
0K,All Students,2018-19,27367,1308,26059,95.2,167,24,14.4
0K,All Students,2019-20,17812,1080,16732,93.9,165,31,18.8
0K,All Students,2020-21,27381,707,26674,97.4,168,12,7.1
0K,All Students,2021-22,28828,1952,26876,93.2,178,41,23.0
0K,All Students,2022-23,30115,1915,28200,93.6,188,36,19.1
1,All Students,2018-19,27605,1085,26520,96.1,170,17,10.0
1,All Students,2019-20,19910,841,19069,95.8,184,16,8.7
1,All Students,2020-21,27574,609,26965,97.8,166,9,5.4
1,All Students,2021-22,28229,1526,26703,94.6,173,29,16.8
1,All Students,2022-23,28283,1608,26675,94.3,174,31,17.8
2,All Students,2018-19,27201,977,26224,96.4,167,16,9.6
2,All Students,2019-20,19030,747,18283,96.1,173,14,8.1
2,All Students,2020-21,30258,649,29609,97.9,179,10,5.6
2,All Students,2021-22,27521,1589,25932,94.2,166,28,16.9
2,All Students,2022-23,26525,1388,25137,94.8,166,25,15.1
3,All Students,2018-19,27764,722,27042,97.4,169,7,4.1
3,All Students,2019-20,18492,625,17867,96.6,171,12,7.0
3,All Students,2020-21,28966,417,28549,98.6,169,2,1.2
3,All Students,2021-22,29553,1601,27952,94.6,181,32,17.7
3,All Students,2022-23,32746,1393,31353,95.7,200,23,11.5
4,All Students,2018-19,35364,749,34615,97.9,217,11,5.1
4,All Students,2019-20,21501,558,20943,97.4,194,11,5.7
4,All Students,2020-21,32528,656,31872,98.0,195,11,5.6
4,All Students,2021-22,35323,1404,33919,96.0,213,23,10.8
4,All Students,2022-23,35078,1466,33612,95.8,215,24,11.2
5,All Students,2018-19,36300,799,35501,97.8,216,13,6.0
5,All Students,2019-20,22265,460,21805,97.9,199,3,1.5
5,All Students,2020-21,31527,493,31034,98.4,183,4,2.2
5,All Students,2021-22,30825,1139,29686,96.3,183,17,9.3
5,All Students,2022-23,35189,1001,34188,97.2,206,13,6.3
6,All Students,2018-19,1,s,s,s,s,s,s
All Grades,All Students,2018-19,187373,5916,181457,96.8,1086,80,7.4
All Grades,All Students,2019-20,122985,3744,119241,97.0,1100,85,7.7
All Grades,All Students,2020-21,181547,4843,176704,97.3,1052,89,8.5
All Grades,All Students,2021-22,177069,8163,168906,95.4,1039,148,14.2
All Grades,All Students,2022-23,179882,8495,171387,95.3,1054,151,14.3
6,All Students,2018-19,61772,1712,60060,97.2,361,25,6.9
6,All Students,2019-20,38850,998,37852,97.4,350,18,5.1
6,All Students,2020-21,58346,s,s,s,s,s,s
6,All Students,2021-22,55854,2415,53439,95.7,328,40,12.2
6,All Students,2022-23,58924,2370,56554,96.0,346,41,11.8
7,All Students,2018-19,64223,1931,62292,97.0,372,21,5.6
7,All Students,2019-20,41076,1212,39864,97.0,367,29,7.9
7,All Students,2020-21,59103,1273,57830,97.8,346,21,6.1
7,All Students,2021-22,61192,2902,58290,95.3,361,56,15.5
7,All Students,2022-23,58479,s,s,s,s,s,s
8,All Students,2018-19,61378,2273,59105,96.3,353,34,9.6
8,All Students,2019-20,43059,1534,41525,96.4,383,38,9.9
8,All Students,2020-21,64087,2134,61953,96.7,365,38,10.4
8,All Students,2021-22,60023,2846,57177,95.3,350,52,14.9
8,All Students,2022-23,62438,3180,59258,94.9,362,58,16.0
9,All Students,2020-21,11,s,s,s,s,s,s
9,All Students,2022-23,41,s,s,s,s,s,s
All Grades,All Students,2018-19,124279,7032,117247,94.3,752,129,17.2
All Grades,All Students,2019-20,82181,4880,77301,94.1,746,136,18.2
All Grades,All Students,2020-21,121691,6126,115565,95.0,738,110,14.9
All Grades,All Students,2021-22,127351,13302,114049,89.6,788,344,43.7
All Grades,All Students,2022-23,126582,10786,115796,91.5,790,275,34.8
PK in K-12 Schools,All Students,2018-19,6208,s,s,s,s,s,s
PK in K-12 Schools,All Students,2019-20,3973,348,3625,91.2,37,12,32.4
PK in K-12 Schools,All Students,2020-21,6048,361,5687,94.0,37,7,18.9
PK in K-12 Schools,All Students,2021-22,5910,831,5079,85.9,41,26,63.4
PK in K-12 Schools,All Students,2022-23,6066,690,5376,88.6,38,17,44.7
0K,All Students,2018-19,18581,1396,17185,92.5,112,28,25.0
0K,All Students,2019-20,13902,1109,12793,92.0,132,41,31.1
0K,All Students,2020-21,18666,1546,17120,91.7,117,32,27.4
0K,All Students,2021-22,18422,2423,15999,86.8,116,62,53.4
0K,All Students,2022-23,18258,1643,16615,91.0,115,46,40.0
1,All Students,2018-19,20355,1252,19103,93.8,127,27,21.3
1,All Students,2019-20,12775,858,11917,93.3,115,23,20.0
1,All Students,2020-21,19602,874,18728,95.5,119,15,12.6
1,All Students,2021-22,19851,2370,17481,88.1,121,62,51.2
1,All Students,2022-23,20562,2055,18507,90.0,131,60,45.8
2,All Students,2018-19,18323,1007,17316,94.5,112,19,17.0
2,All Students,2019-20,13899,752,13147,94.6,125,21,16.8
2,All Students,2020-21,19025,861,18164,95.5,114,17,14.9
2,All Students,2021-22,19595,1731,17864,91.2,121,39,32.2
2,All Students,2022-23,18083,1670,16413,90.8,114,41,36.0
3,All Students,2018-19,19858,935,18923,95.3,121,12,9.9
3,All Students,2019-20,12083,584,11499,95.2,109,10,9.2
3,All Students,2020-21,20563,944,19619,95.4,125,18,14.4
3,All Students,2021-22,21119,2100,19019,90.1,128,57,44.5
3,All Students,2022-23,19253,1399,17854,92.7,121,32,26.4
4,All Students,2018-19,20936,1027,19909,95.1,123,17,13.8
4,All Students,2019-20,11951,557,11394,95.3,108,13,12.0
4,All Students,2020-21,19496,748,18748,96.2,116,10,8.6
4,All Students,2021-22,21437,1821,19616,91.5,131,44,33.6
4,All Students,2022-23,21036,1681,19355,92.0,128,42,32.8
5,All Students,2018-19,20011,960,19051,95.2,119,18,15.1
5,All Students,2019-20,13598,672,12926,95.1,120,16,13.3
5,All Students,2020-21,18291,792,17499,95.7,110,11,10.0
5,All Students,2021-22,21017,2026,18991,90.4,130,54,41.5
5,All Students,2022-23,23324,1648,21676,92.9,143,37,25.9
6,All Students,2018-19,7,s,s,s,s,s,s
All Grades,All Students,2018-19,176259,7456,168803,95.8,1032,107,10.4
All Grades,All Students,2019-20,117934,4690,113244,96.0,1049,90,8.6
All Grades,All Students,2020-21,166089,3256,162833,98.0,966,53,5.5
All Grades,All Students,2021-22,155154,8374,146780,94.6,903,128,14.2
All Grades,All Students,2022-23,151987,8170,143817,94.6,895,143,16.0
PK in K-12 Schools,All Students,2018-19,6184,474,5710,92.3,39,15,38.5
PK in K-12 Schools,All Students,2019-20,4110,288,3822,93.0,37,10,27.0
0K,All Students,2018-19,30660,1589,29071,94.8,187,25,13.4
0K,All Students,2019-20,20238,1291,18947,93.6,182,30,16.5
0K,All Students,2020-21,26711,597,26114,97.8,157,10,6.4
0K,All Students,2021-22,22878,1639,21239,92.8,134,25,18.7
0K,All Students,2022-23,21470,1443,20027,93.3,129,31,24.0
1,All Students,2018-19,27805,1120,26685,96.0,164,12,7.3
1,All Students,2019-20,19600,780,18820,96.0,174,15,8.6
1,All Students,2020-21,29907,853,29054,97.1,176,17,9.7
1,All Students,2021-22,25106,1449,23657,94.2,146,22,15.1
1,All Students,2022-23,23147,1444,21703,93.8,134,23,17.2
2,All Students,2018-19,31179,1457,29722,95.3,179,18,10.1
2,All Students,2019-20,17512,614,16898,96.5,155,12,7.7
2,All Students,2020-21,28809,510,28299,98.2,167,8,4.8
2,All Students,2021-22,28700,1983,26717,93.1,164,33,20.1
2,All Students,2022-23,26012,1440,24572,94.5,153,27,17.6
3,All Students,2018-19,27015,998,26017,96.3,155,13,8.4
3,All Students,2019-20,19689,622,19067,96.8,177,8,4.5
3,All Students,2020-21,25880,350,25530,98.6,151,3,2.0
3,All Students,2021-22,26903,1365,25538,94.9,154,24,15.6
3,All Students,2022-23,29200,1678,27522,94.3,171,29,17.0
4,All Students,2018-19,29423,924,28499,96.9,169,11,6.5
4,All Students,2019-20,17534,533,17001,97.0,155,8,5.2
4,All Students,2020-21,28936,355,28581,98.8,166,2,1.2
4,All Students,2021-22,24800,858,23942,96.5,147,13,8.8
4,All Students,2022-23,26387,1156,25231,95.6,156,19,12.2
5,All Students,2018-19,23993,894,23099,96.3,139,13,9.4
5,All Students,2019-20,19251,562,18689,97.1,169,7,4.1
5,All Students,2020-21,25846,591,25255,97.7,149,13,8.7
5,All Students,2021-22,26767,1080,25687,96.0,158,11,7.0
5,All Students,2022-23,25771,1009,24762,96.1,152,14,9.2
All Grades,All Students,2018-19,193955,7686,186269,96.0,1138,103,9.1
All Grades,All Students,2019-20,125247,5142,120105,95.9,1122,118,10.5
All Grades,All Students,2020-21,187359,4576,182783,97.6,1115,85,7.6
All Grades,All Students,2021-22,186224,10342,175882,94.4,1103,189,17.1
All Grades,All Students,2022-23,187641,10731,176910,94.3,1096,185,16.9
PK in K-12 Schools,All Students,2018-19,6364,307,6057,95.2,37,3,8.1
PK in K-12 Schools,All Students,2019-20,4099,181,3918,95.6,37,2,5.4
PK in K-12 Schools,All Students,2020-21,6122,155,5967,97.5,38,3,7.9
PK in K-12 Schools,All Students,2021-22,6316,629,5687,90.0,36,13,36.1
PK in K-12 Schools,All Students,2022-23,9409,895,8514,90.5,54,20,37.0
0K,All Students,2018-19,26112,1547,24565,94.1,158,28,17.7
0K,All Students,2019-20,17446,984,16462,94.4,155,28,18.1
0K,All Students,2020-21,26247,858,25389,96.7,158,22,13.9
0K,All Students,2021-22,27987,1930,26057,93.1,170,41,24.1
0K,All Students,2022-23,24505,1996,22509,91.9,145,39,26.9
1,All Students,2018-19,30206,1266,28940,95.8,178,17,9.6
1,All Students,2019-20,19935,905,19030,95.5,183,24,13.1
1,All Students,2020-21,31421,843,30578,97.3,187,14,7.5
1,All Students,2021-22,29363,2005,27358,93.2,175,43,24.6
1,All Students,2022-23,30262,2013,28249,93.3,178,33,18.5
2,All Students,2018-19,31538,1219,30319,96.1,186,15,8.1
2,All Students,2019-20,20443,885,19558,95.7,181,17,9.4
2,All Students,2020-21,31058,634,30424,98.0,183,9,4.9
2,All Students,2021-22,31965,1619,30346,94.9,189,22,11.6
2,All Students,2022-23,30033,1665,28368,94.5,174,29,16.7
3,All Students,2018-19,32254,1084,31170,96.6,189,9,4.8
3,All Students,2019-20,20465,839,19626,95.9,181,19,10.5
3,All Students,2020-21,30906,676,30230,97.8,185,9,4.9
3,All Students,2021-22,28475,1224,27251,95.7,169,22,13.0
3,All Students,2022-23,30469,1450,29019,95.2,181,20,11.0
4,All Students,2018-19,33720,1220,32500,96.4,195,18,9.2
4,All Students,2019-20,21057,649,20408,96.9,189,16,8.5
4,All Students,2020-21,30827,610,30217,98.0,181,13,7.2
4,All Students,2021-22,31572,1573,29999,95.0,186,27,14.5
4,All Students,2022-23,30603,1158,29445,96.2,178,18,10.1
5,All Students,2018-19,33761,1043,32718,96.9,195,13,6.7
5,All Students,2019-20,21802,699,21103,96.8,196,12,6.1
5,All Students,2020-21,30778,800,29978,97.4,183,15,8.2
5,All Students,2021-22,30546,1362,29184,95.5,178,21,11.8
5,All Students,2022-23,32360,1554,30806,95.2,186,26,14.0
All Grades,All Students,2018-19,166472,8628,157844,94.8,984,148,15.0
All Grades,All Students,2019-20,107822,5953,101869,94.5,974,174,17.9
All Grades,All Students,2020-21,156313,7653,148660,95.1,923,129,14.0
All Grades,All Students,2021-22,156042,13296,142746,91.5,957,297,31.0
All Grades,All Students,2022-23,153123,10162,142961,93.4,926,206,22.2
PK in K-12 Schools,All Students,2018-19,11979,1042,10937,91.3,72,25,34.7
PK in K-12 Schools,All Students,2019-20,8248,732,7516,91.1,74,29,39.2
PK in K-12 Schools,All Students,2020-21,11261,932,10329,91.7,71,24,33.8
PK in K-12 Schools,All Students,2021-22,11684,1532,10152,86.9,72,42,58.3
PK in K-12 Schools,All Students,2022-23,8987,967,8020,89.2,57,26,45.6
0K,All Students,2018-19,27106,1875,25231,93.1,166,36,21.7
0K,All Students,2019-20,19152,1422,17730,92.6,176,46,26.1
0K,All Students,2020-21,23234,1351,21883,94.2,141,24,17.0
0K,All Students,2021-22,22039,1964,20075,91.1,142,52,36.6
0K,All Students,2022-23,22965,1873,21092,91.8,143,46,32.2
1,All Students,2018-19,26576,1375,25201,94.8,157,19,12.1
1,All Students,2019-20,16157,937,15220,94.2,148,28,18.9
1,All Students,2020-21,26571,1154,25417,95.7,157,17,10.8
1,All Students,2021-22,24275,2259,22016,90.7,148,53,35.8
1,All Students,2022-23,20984,1443,19541,93.1,130,30,23.1
2,All Students,2018-19,24319,1202,23117,95.1,143,16,11.2
2,All Students,2019-20,17474,905,16569,94.8,160,25,15.6
2,All Students,2020-21,24614,1051,23563,95.7,145,18,12.4
2,All Students,2021-22,26705,2096,24609,92.2,160,43,26.9
2,All Students,2022-23,23791,1679,22112,92.9,139,32,23.0
3,All Students,2018-19,23654,1048,22606,95.6,140,19,13.6
3,All Students,2019-20,15129,680,14449,95.5,135,15,11.1
3,All Students,2020-21,24819,995,23824,96.0,143,13,9.1
3,All Students,2021-22,23712,1794,21918,92.4,144,31,21.5
3,All Students,2022-23,25105,1406,23699,94.4,153,25,16.3
4,All Students,2018-19,24032,1015,23017,95.8,140,19,13.6
4,All Students,2019-20,16047,588,15459,96.3,142,12,8.5
4,All Students,2020-21,22806,1053,21753,95.4,133,17,12.8
4,All Students,2021-22,25598,1985,23613,92.2,156,38,24.4
4,All Students,2022-23,24983,1424,23559,94.3,148,27,18.2
5,All Students,2018-19,28806,1071,27735,96.3,166,14,8.4
5,All Students,2019-20,15615,689,14926,95.6,139,19,13.7
5,All Students,2020-21,23008,1117,21891,95.1,133,16,12.0
5,All Students,2021-22,22029,1666,20363,92.4,135,38,28.1
5,All Students,2022-23,26308,1370,24938,94.8,156,20,12.8
All Grades,All Students,2018-19,171639,5988,165651,96.5,1055,99,9.4
All Grades,All Students,2019-20,104677,4207,100470,96.0,952,97,10.2
All Grades,All Students,2020-21,144363,5330,139033,96.3,858,93,10.8
All Grades,All Students,2021-22,128412,9107,119305,92.9,802,207,25.8
All Grades,All Students,2022-23,127593,8835,118758,93.1,814,217,26.7
PK in K-12 Schools,All Students,2018-19,9536,492,9044,94.8,54,8,14.8
PK in K-12 Schools,All Students,2019-20,6150,494,5656,92.0,58,16,27.6
PK in K-12 Schools,All Students,2020-21,9164,675,8489,92.6,57,12,21.1
PK in K-12 Schools,All Students,2021-22,8991,1232,7759,86.3,55,31,56.4
PK in K-12 Schools,All Students,2022-23,9486,1407,8079,85.2,56,37,66.1
0K,All Students,2018-19,26631,1338,25293,95.0,167,25,15.0
0K,All Students,2019-20,14145,717,13428,94.9,133,19,14.3
0K,All Students,2020-21,17245,902,16343,94.8,106,17,16.0
0K,All Students,2021-22,19661,2001,17660,89.8,130,51,39.2
0K,All Students,2022-23,19527,1517,18010,92.2,131,38,29.0
1,All Students,2018-19,29045,1023,28022,96.5,180,14,7.8
1,All Students,2019-20,15873,697,15176,95.6,147,15,10.2
1,All Students,2020-21,19057,739,18318,96.1,113,11,9.7
1,All Students,2021-22,15487,1266,14221,91.8,100,29,29.0
1,All Students,2022-23,20214,1646,18568,91.9,127,41,32.3
2,All Students,2018-19,25267,929,24338,96.3,167,15,9.0
2,All Students,2019-20,16307,627,15680,96.2,148,15,10.1
2,All Students,2020-21,22661,657,22004,97.1,134,11,8.2
2,All Students,2021-22,16217,974,15243,94.0,101,23,22.8
2,All Students,2022-23,16305,1199,15106,92.6,104,30,28.8
3,All Students,2018-19,22888,802,22086,96.5,138,13,9.4
3,All Students,2019-20,15984,576,15408,96.4,143,11,7.7
3,All Students,2020-21,23331,752,22579,96.8,138,14,10.1
3,All Students,2021-22,19920,1081,18839,94.6,122,23,18.9
3,All Students,2022-23,16474,1001,15473,93.9,109,24,22.0
4,All Students,2018-19,29640,690,28950,97.7,181,13,7.2
4,All Students,2019-20,16456,576,15880,96.5,147,12,8.2
4,All Students,2020-21,27480,791,26689,97.1,160,11,6.9
4,All Students,2021-22,24421,1445,22976,94.1,151,29,19.2
4,All Students,2022-23,22490,987,21503,95.6,144,23,16.0
5,All Students,2018-19,28632,714,27918,97.5,168,11,6.5
5,All Students,2019-20,19762,520,19242,97.4,176,9,5.1
5,All Students,2020-21,25425,814,24611,96.8,150,17,11.3
5,All Students,2021-22,23715,1108,22607,95.3,143,21,14.7
5,All Students,2022-23,23097,1078,22019,95.3,143,24,16.8
All Grades,All Students,2018-19,194594,9864,184730,94.9,1157,182,15.7
All Grades,All Students,2019-20,127473,6821,120652,94.6,1151,164,14.2
All Grades,All Students,2020-21,186308,9573,176735,94.9,1099,177,16.1
All Grades,All Students,2021-22,203761,17622,186139,91.4,1261,448,35.5
All Grades,All Students,2022-23,209645,17137,192508,91.8,1267,402,31.7
PK in K-12 Schools,All Students,2020-21,3149,148,3001,95.3,19,3,15.8
PK in K-12 Schools,All Students,2021-22,12065,1232,10833,89.8,71,28,39.4
PK in K-12 Schools,All Students,2022-23,12167,1199,10968,90.1,70,30,42.9
0K,All Students,2018-19,31396,2136,29260,93.2,189,48,25.4
0K,All Students,2019-20,21239,1576,19663,92.6,193,45,23.3
0K,All Students,2020-21,30178,2215,27963,92.7,180,45,25.0
0K,All Students,2021-22,32235,3379,28856,89.5,208,105,50.5
0K,All Students,2022-23,31750,3492,28258,89.0,202,95,47.0
1,All Students,2018-19,34085,1701,32384,95.0,197,23,11.7
1,All Students,2019-20,20883,1204,19679,94.2,191,33,17.3
1,All Students,2020-21,30061,2069,27992,93.1,177,46,26.0
1,All Students,2021-22,31306,3028,28278,90.3,199,75,37.7
1,All Students,2022-23,32750,2641,30109,91.9,199,62,31.2
2,All Students,2018-19,30635,1600,29035,94.8,188,33,17.6
2,All Students,2019-20,21911,990,20921,95.5,197,21,10.7
2,All Students,2020-21,29999,1416,28583,95.3,178,27,15.2
2,All Students,2021-22,32122,2720,29402,91.5,200,67,33.5
2,All Students,2022-23,32654,2632,30022,91.9,200,65,32.5
3,All Students,2018-19,31398,1449,29949,95.4,187,24,12.8
3,All Students,2019-20,20728,1144,19584,94.5,186,24,12.9
3,All Students,2020-21,31615,1284,30331,95.9,184,17,9.2
3,All Students,2021-22,28904,2339,26565,91.9,173,53,30.6
3,All Students,2022-23,32414,2386,30028,92.6,192,55,28.6
4,All Students,2018-19,33498,1528,31970,95.4,201,30,14.9
4,All Students,2019-20,20221,s,s,s,s,s,s
4,All Students,2020-21,30895,1233,29662,96.0,182,19,10.4
4,All Students,2021-22,35481,2719,32762,92.3,219,65,29.7
4,All Students,2022-23,31632,2199,29433,93.0,190,45,23.7
5,All Students,2018-19,33582,1450,32132,95.7,195,24,12.3
5,All Students,2019-20,22482,1030,21452,95.4,199,21,10.6
5,All Students,2020-21,30411,1208,29203,96.0,179,20,11.2
5,All Students,2021-22,31648,2205,29443,93.0,191,55,28.8
5,All Students,2022-23,36278,2588,33690,92.9,214,50,23.4
6,All Students,2019-20,9,s,s,s,s,s,s
All Grades,All Students,2018-19,71719,3548,68171,95.1,410,49,12.0
All Grades,All Students,2019-20,46165,1736,44429,96.2,405,26,6.4
All Grades,All Students,2020-21,69971,1403,68568,98.0,406,16,3.9
All Grades,All Students,2021-22,69049,4430,64619,93.6,407,86,21.1
All Grades,All Students,2022-23,63717,3913,59804,93.9,375,74,19.7
PK in K-12 Schools,All Students,2018-19,3192,325,2867,89.8,18,9,50.0
PK in K-12 Schools,All Students,2019-20,4108,347,3761,91.6,37,11,29.7
PK in K-12 Schools,All Students,2020-21,6257,220,6037,96.5,36,4,11.1
PK in K-12 Schools,All Students,2021-22,6089,855,5234,86.0,36,21,58.3
PK in K-12 Schools,All Students,2022-23,5902,766,5136,87.0,35,20,57.1
0K,All Students,2018-19,8963,696,8267,92.2,52,15,28.8
0K,All Students,2019-20,5703,245,5458,95.7,50,4,8.0
0K,All Students,2020-21,12745,332,12413,97.4,75,5,6.7
0K,All Students,2021-22,12919,934,11985,92.8,78,20,25.6
0K,All Students,2022-23,8384,687,7697,91.8,50,13,26.0
1,All Students,2018-19,11884,576,11308,95.2,69,5,7.2
1,All Students,2019-20,5573,200,5373,96.4,49,3,6.1
1,All Students,2020-21,9066,93,8973,99.0,52,0,0.0
1,All Students,2021-22,11604,795,10809,93.1,72,18,25.0
1,All Students,2022-23,12926,724,12202,94.4,76,8,10.5
2,All Students,2018-19,13863,656,13207,95.3,79,8,10.1
2,All Students,2019-20,7233,230,7003,96.8,64,2,3.1
2,All Students,2020-21,8640,160,8480,98.1,51,2,3.9
2,All Students,2021-22,8945,513,8432,94.3,53,9,17.0
2,All Students,2022-23,11270,703,10567,93.8,66,20,30.3
3,All Students,2018-19,12537,533,12004,95.7,72,6,8.3
3,All Students,2019-20,8862,251,8611,97.2,77,1,1.3
3,All Students,2020-21,9943,151,9792,98.5,57,0,0.0
3,All Students,2021-22,7811,389,7422,95.0,45,5,11.1
3,All Students,2022-23,8773,366,8407,95.8,50,3,6.0
4,All Students,2018-19,11490,381,11109,96.7,65,1,1.5
4,All Students,2019-20,7559,253,7306,96.7,66,3,4.5
4,All Students,2020-21,12748,192,12556,98.5,73,1,1.4
4,All Students,2021-22,9993,477,9516,95.2,57,4,7.0
4,All Students,2022-23,7196,292,6904,95.9,43,5,11.6
5,All Students,2018-19,9790,381,9409,96.1,55,5,9.1
5,All Students,2019-20,7127,210,6917,97.1,62,2,3.2
5,All Students,2020-21,10572,255,10317,97.6,62,4,6.5
5,All Students,2021-22,11688,467,11221,96.0,66,9,13.6
5,All Students,2022-23,9266,375,8891,96.0,55,5,9.1
All Grades,All Students,2018-19,119051,6475,112576,94.6,712,137,19.2
All Grades,All Students,2019-20,73908,4134,69774,94.4,674,132,19.6
All Grades,All Students,2020-21,104003,5697,98306,94.5,624,110,17.6
All Grades,All Students,2021-22,100689,8167,92522,91.9,620,198,31.9
All Grades,All Students,2022-23,101702,8498,93204,91.6,628,211,33.6
PK in K-12 Schools,All Students,2018-19,5958,547,5411,90.8,37,15,40.5
PK in K-12 Schools,All Students,2019-20,4009,369,3640,90.8,36,14,38.9
PK in K-12 Schools,All Students,2020-21,4886,203,4683,95.8,30,4,13.3
PK in K-12 Schools,All Students,2021-22,6051,760,5291,87.4,39,20,51.3
PK in K-12 Schools,All Students,2022-23,6133,925,5208,84.9,40,28,70.0
0K,All Students,2018-19,18839,1168,17671,93.8,113,24,21.2
0K,All Students,2019-20,11346,841,10505,92.6,103,27,26.2
0K,All Students,2020-21,15612,999,14613,93.6,96,18,18.8
0K,All Students,2021-22,14526,1344,13182,90.7,92,30,32.6
0K,All Students,2022-23,15746,1615,14131,89.7,97,36,37.1
1,All Students,2018-19,17929,1006,16923,94.4,108,26,24.1
1,All Students,2019-20,11732,673,11059,94.3,108,22,20.4
1,All Students,2020-21,16387,898,15489,94.5,96,18,18.8
1,All Students,2021-22,17350,1609,15741,90.7,110,39,35.5
1,All Students,2022-23,15093,1198,13895,92.1,96,28,29.2
2,All Students,2018-19,16650,1069,15581,93.6,101,23,22.8
2,All Students,2019-20,11419,562,10857,95.1,103,16,15.5
2,All Students,2020-21,17217,981,16236,94.3,103,19,18.4
2,All Students,2021-22,14896,1025,13871,93.1,87,23,26.4
2,All Students,2022-23,16466,1478,14988,91.0,101,43,42.6
3,All Students,2018-19,20183,1091,19092,94.6,122,20,16.4
3,All Students,2019-20,10289,540,9749,94.8,95,19,20.0
3,All Students,2020-21,14663,494,14169,96.6,89,9,10.1
3,All Students,2021-22,18028,1186,16842,93.4,112,34,30.4
3,All Students,2022-23,15196,1100,14096,92.8,93,23,24.7
4,All Students,2018-19,20183,763,19420,96.2,117,12,10.3
4,All Students,2019-20,12902,643,12259,95.0,117,18,15.4
4,All Students,2020-21,15837,1106,14731,93.0,95,25,26.3
4,All Students,2021-22,14900,1255,13645,91.6,90,34,37.8
4,All Students,2022-23,17664,1202,16462,93.2,106,29,27.4
5,All Students,2018-19,19309,831,18478,95.7,114,17,14.9
5,All Students,2019-20,12211,506,11705,95.9,112,16,14.3
5,All Students,2020-21,19401,1016,18385,94.8,115,17,14.8
5,All Students,2021-22,14938,988,13950,93.4,90,18,20.0
5,All Students,2022-23,15404,980,14424,93.6,95,24,25.3
All Grades,All Students,2018-19,143483,5314,138169,96.3,857,90,10.5
All Grades,All Students,2019-20,93010,3884,89126,95.8,848,95,11.2
All Grades,All Students,2020-21,140879,3950,136929,97.2,834,70,8.4
All Grades,All Students,2021-22,141594,8732,132862,93.8,846,191,22.6
All Grades,All Students,2022-23,136284,7123,129161,94.8,829,149,18.0
PK in K-12 Schools,All Students,2018-19,12384,1020,11364,91.8,78,30,38.5
PK in K-12 Schools,All Students,2019-20,8101,773,7328,90.5,73,30,41.1
PK in K-12 Schools,All Students,2020-21,12526,688,11838,94.5,74,11,14.9
PK in K-12 Schools,All Students,2021-22,12353,1506,10847,87.8,76,45,59.2
PK in K-12 Schools,All Students,2022-23,10254,1151,9103,88.8,67,33,49.3
0K,All Students,2018-19,22100,1112,20988,95.0,132,20,15.2
0K,All Students,2019-20,13894,803,13091,94.2,133,22,16.5
0K,All Students,2020-21,22028,745,21283,96.6,131,17,13.0
0K,All Students,2021-22,21483,1793,19690,91.7,130,43,33.1
0K,All Students,2022-23,20864,1452,19412,93.0,125,33,26.4
1,All Students,2018-19,24756,925,23831,96.3,149,12,8.1
1,All Students,2019-20,14596,694,13902,95.2,133,16,12.0
1,All Students,2020-21,20210,752,19458,96.3,122,11,9.0
1,All Students,2021-22,22685,1409,21276,93.8,138,32,23.2
1,All Students,2022-23,21118,1201,19917,94.3,131,23,17.6
2,All Students,2018-19,22316,785,21531,96.5,132,11,8.3
2,All Students,2019-20,15284,429,14855,97.2,137,8,5.8
2,All Students,2020-21,21211,641,20570,97.0,126,16,12.7
2,All Students,2021-22,19299,1169,18130,93.9,115,27,23.5
2,All Students,2022-23,22095,1022,21073,95.4,132,20,15.2
3,All Students,2018-19,21673,579,21094,97.3,130,7,5.4
3,All Students,2019-20,14665,540,14125,96.3,132,8,6.1
3,All Students,2020-21,22437,524,21913,97.7,132,8,6.1
3,All Students,2021-22,22135,977,21158,95.6,129,15,11.6
3,All Students,2022-23,19737,894,18843,95.5,121,16,13.2
4,All Students,2018-19,19554,423,19131,97.8,116,4,3.4
4,All Students,2019-20,13765,333,13432,97.6,124,6,4.8
4,All Students,2020-21,21513,331,21182,98.5,124,1,0.8
4,All Students,2021-22,22593,939,21654,95.8,134,14,10.4
4,All Students,2022-23,21110,763,20347,96.4,127,12,9.4
5,All Students,2018-19,20700,470,20230,97.7,120,6,5.0
5,All Students,2019-20,12705,312,12393,97.5,116,5,4.3
5,All Students,2020-21,20954,269,20685,98.7,125,6,4.8
5,All Students,2021-22,21046,939,20107,95.5,124,15,12.1
5,All Students,2022-23,21106,640,20466,97.0,126,12,9.5
All Grades,All Students,2018-19,120096,6284,113812,94.8,713,103,14.4
All Grades,All Students,2019-20,76813,3724,73089,95.2,692,100,14.5
All Grades,All Students,2020-21,106540,6152,100388,94.2,630,130,20.6
All Grades,All Students,2021-22,100865,6371,94494,93.7,599,127,21.2
All Grades,All Students,2022-23,93677,6441,87236,93.1,558,135,24.2
PK in K-12 Schools,All Students,2018-19,6263,573,5690,90.9,37,10,27.0
PK in K-12 Schools,All Students,2019-20,3069,276,2793,91.0,27,8,29.6
PK in K-12 Schools,All Students,2020-21,3892,210,3682,94.6,24,7,29.2
PK in K-12 Schools,All Students,2021-22,5240,524,4716,90.0,34,13,38.2
PK in K-12 Schools,All Students,2022-23,3641,580,3061,84.1,26,19,73.1
0K,All Students,2018-19,12569,762,11807,93.9,75,15,20.0
0K,All Students,2019-20,7693,563,7130,92.7,70,19,27.1
0K,All Students,2020-21,9361,527,8834,94.4,58,14,24.1
0K,All Students,2021-22,7903,772,7131,90.2,47,18,38.3
0K,All Students,2022-23,8692,890,7802,89.8,54,25,46.3
1,All Students,2018-19,9935,559,9376,94.4,61,10,16.4
1,All Students,2019-20,6807,427,6380,93.7,62,10,16.1
1,All Students,2020-21,11182,691,10491,93.8,66,13,19.7
1,All Students,2021-22,9468,642,8826,93.2,56,16,28.6
1,All Students,2022-23,7434,655,6779,91.2,46,17,37.0
2,All Students,2018-19,10941,608,10333,94.4,67,13,19.4
2,All Students,2019-20,6387,350,6037,94.5,59,10,16.9
2,All Students,2020-21,8948,400,8548,95.5,52,7,13.5
2,All Students,2021-22,9729,676,9053,93.1,59,15,25.4
2,All Students,2022-23,8503,610,7893,92.8,50,9,18.0
3,All Students,2018-19,11816,597,11219,94.9,68,12,17.6
3,All Students,2019-20,6931,359,6572,94.8,63,11,17.5
3,All Students,2020-21,8095,447,7648,94.5,49,9,18.4
3,All Students,2021-22,8504,531,7973,93.8,50,8,16.0
3,All Students,2022-23,9155,593,8562,93.5,53,13,24.5
4,All Students,2018-19,11900,704,11196,94.1,69,11,15.9
4,All Students,2019-20,7626,321,7305,95.8,68,8,11.8
4,All Students,2020-21,10656,838,9818,92.1,63,23,36.5
4,All Students,2021-22,8134,429,7705,94.7,47,6,12.8
4,All Students,2022-23,8642,554,8088,93.6,51,8,15.7
5,All Students,2018-19,11899,597,11302,95.0,69,9,13.0
5,All Students,2019-20,7743,392,7351,94.9,72,13,18.1
5,All Students,2020-21,11019,749,10270,93.2,66,10,15.2
5,All Students,2021-22,9531,629,8902,93.4,58,13,22.4
5,All Students,2022-23,8690,535,8155,93.8,51,11,21.6
6,All Students,2018-19,15378,595,14783,96.1,96,7,7.3
6,All Students,2019-20,11034,383,10651,96.5,97,7,7.2
6,All Students,2020-21,14803,883,13920,94.0,86,20,23.3
6,All Students,2021-22,15684,876,14808,94.4,93,17,18.3
6,All Students,2022-23,13528,764,12764,94.4,80,13,16.3
7,All Students,2018-19,15587,672,14915,95.7,91,8,8.8
7,All Students,2019-20,9301,262,9039,97.2,84,6,7.1
7,All Students,2020-21,15203,750,14453,95.1,87,12,13.8
7,All Students,2021-22,12129,495,11634,95.9,70,6,8.6
7,All Students,2022-23,13826,670,13156,95.2,79,8,10.1
8,All Students,2018-19,13808,617,13191,95.5,80,8,10.0
8,All Students,2019-20,10222,391,9831,96.2,90,8,8.9
8,All Students,2020-21,13381,657,12724,95.1,79,15,19.0
8,All Students,2021-22,14543,797,13746,94.5,85,15,17.6
8,All Students,2022-23,11566,590,10976,94.9,68,12,17.6
All Grades,All Students,2018-19,129052,8530,120522,93.4,779,179,23.0
All Grades,All Students,2019-20,82148,5068,77080,93.8,750,152,20.3
All Grades,All Students,2020-21,123167,6815,116352,94.5,737,125,17.0
All Grades,All Students,2021-22,114754,8892,105862,92.3,693,192,27.7
All Grades,All Students,2022-23,113465,9618,103847,91.5,675,215,31.9
PK in K-12 Schools,All Students,2018-19,8592,1096,7496,87.2,54,32,59.3
PK in K-12 Schools,All Students,2019-20,5970,750,5220,87.4,55,27,49.1
PK in K-12 Schools,All Students,2020-21,7582,466,7116,93.9,46,13,28.3
PK in K-12 Schools,All Students,2021-22,8200,1267,6933,84.5,53,33,62.3
PK in K-12 Schools,All Students,2022-23,7489,1060,6429,85.8,45,26,57.8
0K,All Students,2018-19,21230,1759,19471,91.7,135,38,28.1
0K,All Students,2019-20,13122,959,12163,92.7,121,31,25.6
0K,All Students,2020-21,19447,1335,18112,93.1,121,23,19.0
0K,All Students,2021-22,19345,1976,17369,89.8,121,53,43.8
0K,All Students,2022-23,18801,1939,16862,89.7,114,48,42.1
1,All Students,2018-19,21274,1558,19716,92.7,127,33,26.0
1,All Students,2019-20,13643,852,12791,93.8,126,25,19.8
1,All Students,2020-21,18587,1113,17474,94.0,118,19,16.1
1,All Students,2021-22,15614,1009,14605,93.5,92,17,18.5
1,All Students,2022-23,19213,1772,17441,90.8,115,36,31.3
2,All Students,2018-19,20498,1338,19160,93.5,120,24,20.0
2,All Students,2019-20,13738,887,12851,93.5,127,28,22.0
2,All Students,2020-21,20231,853,19378,95.8,119,14,11.8
2,All Students,2021-22,15407,1195,14212,92.2,93,23,24.7
2,All Students,2022-23,17074,1257,15817,92.6,103,27,26.2
3,All Students,2018-19,19764,941,18823,95.2,120,18,15.0
3,All Students,2019-20,12084,572,11512,95.3,108,16,14.8
3,All Students,2020-21,20696,999,19697,95.2,121,20,16.5
3,All Students,2021-22,19056,1047,18009,94.5,113,20,17.7
3,All Students,2022-23,15499,980,14519,93.7,91,20,22.0
4,All Students,2018-19,18213,838,17375,95.4,108,14,13.0
4,All Students,2019-20,12804,584,12220,95.4,116,13,11.2
4,All Students,2020-21,18158,1231,16927,93.2,106,24,22.6
4,All Students,2021-22,19623,1242,18381,93.7,117,26,22.2
4,All Students,2022-23,17931,1287,16644,92.8,108,30,27.8
5,All Students,2018-19,19481,1000,18481,94.9,115,20,17.4
5,All Students,2019-20,10787,464,10323,95.7,97,12,12.4
5,All Students,2020-21,18466,818,17648,95.6,106,12,11.3
5,All Students,2021-22,17509,1156,16353,93.4,104,20,19.2
5,All Students,2022-23,17458,1323,16135,92.4,99,28,28.3
All Grades,All Students,2018-19,76674,3852,72822,95.0,448,59,13.2
All Grades,All Students,2019-20,44083,1963,42120,95.5,391,38,9.7
All Grades,All Students,2020-21,63197,1480,61717,97.7,372,17,4.6
All Grades,All Students,2021-22,63690,3834,59856,94.0,374,67,17.9
All Grades,All Students,2022-23,65346,4316,61030,93.4,385,82,21.3
PK in K-12 Schools,All Students,2018-19,6006,644,5362,89.3,36,16,44.4
0K,All Students,2018-19,14438,820,13618,94.3,83,12,14.5
0K,All Students,2019-20,7615,398,7217,94.8,68,12,17.6
0K,All Students,2020-21,12083,380,11703,96.9,70,4,5.7
0K,All Students,2021-22,9906,743,9163,92.5,59,12,20.3
0K,All Students,2022-23,9372,840,8532,91.0,55,20,36.4
1,All Students,2018-19,9997,469,9528,95.3,57,6,10.5
1,All Students,2019-20,9110,454,8656,95.0,81,8,9.9
1,All Students,2020-21,10749,331,10418,96.9,63,5,7.9
1,All Students,2021-22,12617,731,11886,94.2,75,15,20.0
1,All Students,2022-23,9778,774,9004,92.1,58,17,29.3
2,All Students,2018-19,9337,422,8915,95.5,57,8,14.0
2,All Students,2019-20,6655,337,6318,94.9,60,6,10.0
2,All Students,2020-21,12722,182,12540,98.6,74,1,1.4
2,All Students,2021-22,9960,664,9296,93.3,57,16,28.1
2,All Students,2022-23,13121,824,12297,93.7,76,13,17.1
3,All Students,2018-19,11697,427,11270,96.3,68,1,1.5
3,All Students,2019-20,5592,177,5415,96.8,50,2,4.0
3,All Students,2020-21,8885,155,8730,98.3,53,2,3.8
3,All Students,2021-22,13949,808,13141,94.2,82,12,14.6
3,All Students,2022-23,10401,645,9756,93.8,62,13,21.0
4,All Students,2018-19,11269,468,10801,95.8,65,6,9.2
4,All Students,2019-20,7714,316,7398,95.9,67,3,4.5
4,All Students,2020-21,7619,84,7535,98.9,45,0,0.0
4,All Students,2021-22,9072,504,8568,94.4,54,7,13.0
4,All Students,2022-23,14121,868,13253,93.9,84,16,19.0
5,All Students,2018-19,13930,602,13328,95.7,82,10,12.2
5,All Students,2019-20,7397,281,7116,96.2,65,7,10.8
5,All Students,2020-21,11139,348,10791,96.9,67,5,7.5
5,All Students,2021-22,8186,384,7802,95.3,47,5,10.6
5,All Students,2022-23,8553,365,8188,95.7,50,3,6.0
All Grades,All Students,2018-19,93018,3856,89162,95.9,538,53,9.9
All Grades,All Students,2019-20,60709,2363,58346,96.1,537,40,7.4
All Grades,All Students,2020-21,86179,2030,84149,97.6,513,32,6.2
All Grades,All Students,2021-22,87437,5086,82351,94.2,519,89,17.1
All Grades,All Students,2022-23,85768,4436,81332,94.8,502,72,14.3
PK in K-12 Schools,All Students,2018-19,6277,411,5866,93.5,38,6,15.8
PK in K-12 Schools,All Students,2019-20,4102,284,3818,93.1,36,7,19.4
PK in K-12 Schools,All Students,2020-21,5232,196,5036,96.3,34,5,14.7
PK in K-12 Schools,All Students,2021-22,5235,398,4837,92.4,35,10,28.6
PK in K-12 Schools,All Students,2022-23,5899,556,5343,90.6,34,14,41.2
0K,All Students,2018-19,13230,768,12462,94.2,79,14,17.7
0K,All Students,2019-20,8649,473,8176,94.5,78,11,14.1
0K,All Students,2020-21,12965,401,12564,96.9,74,7,9.5
0K,All Students,2021-22,13085,1100,11985,91.6,79,25,31.6
0K,All Students,2022-23,12808,923,11885,92.8,74,21,28.4
1,All Students,2018-19,14747,770,13977,94.8,85,13,15.3
1,All Students,2019-20,8447,375,8072,95.6,76,5,6.6
1,All Students,2020-21,12322,277,12045,97.8,74,3,4.1
1,All Students,2021-22,13912,800,13112,94.2,81,10,12.3
1,All Students,2022-23,13074,750,12324,94.3,78,14,17.9
2,All Students,2018-19,16149,554,15595,96.6,92,6,6.5
2,All Students,2019-20,9735,341,9394,96.5,86,4,4.7
2,All Students,2020-21,12825,329,12496,97.4,76,5,6.6
2,All Students,2021-22,12355,715,11640,94.2,72,11,15.3
2,All Students,2022-23,14274,671,13603,95.3,84,6,7.1
3,All Students,2018-19,13469,481,12988,96.4,77,9,11.7
3,All Students,2019-20,11038,374,10664,96.6,96,6,6.3
3,All Students,2020-21,14384,141,14243,99.0,87,3,3.4
3,All Students,2021-22,12572,663,11909,94.7,73,9,12.3
3,All Students,2022-23,12633,511,12122,96.0,74,5,6.8
4,All Students,2018-19,14214,500,13714,96.5,81,3,3.7
4,All Students,2019-20,8967,268,8699,97.0,80,6,7.5
4,All Students,2020-21,16127,517,15610,96.8,95,7,7.4
4,All Students,2021-22,13705,658,13047,95.2,84,14,16.7
4,All Students,2022-23,13081,531,12550,95.9,78,8,10.3
5,All Students,2018-19,14932,372,14560,97.5,86,2,2.3
5,All Students,2019-20,9771,248,9523,97.5,85,1,1.2
5,All Students,2020-21,12324,169,12155,98.6,73,2,2.7
5,All Students,2021-22,16573,752,15821,95.5,95,10,10.5
5,All Students,2022-23,13999,494,13505,96.5,80,4,5.0
All Grades,All Students,2018-19,268755,9649,259106,96.4,1562,169,10.8
All Grades,All Students,2019-20,168611,6566,162045,96.1,1496,158,10.6
All Grades,All Students,2020-21,244053,9942,234111,95.9,1424,158,11.1
All Grades,All Students,2021-22,234271,15280,218991,93.5,1385,308,22.2
All Grades,All Students,2022-23,247161,13547,233614,94.5,1465,282,19.2
6,All Students,2018-19,91620,2868,88752,96.9,536,47,8.8
6,All Students,2019-20,51944,1827,50117,96.5,464,46,9.9
6,All Students,2020-21,80431,3494,76937,95.7,472,60,12.7
6,All Students,2021-22,79307,5324,73983,93.3,465,103,22.2
6,All Students,2022-23,84785,4020,80765,95.3,508,80,15.7
7,All Students,2018-19,88769,3218,85551,96.4,514,61,11.9
7,All Students,2019-20,59555,2291,57264,96.2,527,57,10.8
7,All Students,2020-21,76501,2241,74260,97.1,447,35,7.8
7,All Students,2021-22,79711,5338,74373,93.3,477,110,23.1
7,All Students,2022-23,79944,s,s,s,s,s,s
8,All Students,2018-19,88366,3563,84803,96.0,512,61,11.9
8,All Students,2019-20,57112,2448,54664,95.7,505,55,10.9
8,All Students,2020-21,87121,4207,82914,95.2,505,63,12.5
8,All Students,2021-22,75253,4618,70635,93.9,443,95,21.4
8,All Students,2022-23,82351,5408,76943,93.4,479,107,22.3
9,All Students,2022-23,81,s,s,s,s,s,s
All Grades,All Students,2018-19,137162,4178,132984,97.0,799,50,6.3
All Grades,All Students,2019-20,84525,2750,81775,96.7,764,63,8.2
All Grades,All Students,2020-21,125052,6959,118093,94.4,734,127,17.3
All Grades,All Students,2021-22,114166,6027,108139,94.7,687,121,17.6
All Grades,All Students,2022-23,110938,5173,105765,95.3,670,80,11.9
6,All Students,2018-19,45530,1368,44162,97.0,271,14,5.2
6,All Students,2019-20,26952,s,s,s,s,s,s
6,All Students,2020-21,43577,2221,41356,94.9,259,44,17.0
6,All Students,2021-22,32010,2096,29914,93.5,195,43,22.1
6,All Students,2022-23,37392,1980,35412,94.7,229,24,10.5
7,All Students,2018-19,46585,1316,45269,97.2,269,17,6.3
7,All Students,2019-20,27548,803,26745,97.1,247,16,6.5
7,All Students,2020-21,40324,2371,37953,94.1,234,37,15.8
7,All Students,2021-22,42280,1884,40396,95.5,251,35,13.9
7,All Students,2022-23,31933,s,s,s,s,s,s
8,All Students,2018-19,45047,1494,43553,96.7,259,19,7.3
8,All Students,2019-20,30021,1103,28918,96.3,268,26,9.7
8,All Students,2020-21,41151,2367,38784,94.2,241,46,19.1
8,All Students,2021-22,39876,2047,37829,94.9,241,43,17.8
8,All Students,2022-23,41610,1576,40034,96.2,248,25,10.1
9,All Students,2019-20,4,s,s,s,s,s,s
9,All Students,2022-23,3,s,s,s,s,s,s
All Grades,All Students,2018-19,99919,5279,94640,94.7,578,73,12.6
All Grades,All Students,2019-20,66042,3493,62549,94.7,589,82,13.9
All Grades,All Students,2020-21,101675,4327,97348,95.7,597,77,12.9
All Grades,All Students,2021-22,100154,6967,93187,93.0,592,142,24.0
All Grades,All Students,2022-23,98134,6741,91393,93.1,569,120,21.1
PK in K-12 Schools,All Students,2018-19,9064,991,8073,89.1,55,21,38.2
PK in K-12 Schools,All Students,2019-20,6945,591,6354,91.5,62,17,27.4
PK in K-12 Schools,All Students,2020-21,9141,597,8544,93.5,54,13,24.1
PK in K-12 Schools,All Students,2021-22,8896,1073,7823,87.9,54,28,51.9
PK in K-12 Schools,All Students,2022-23,5730,692,5038,87.9,34,15,44.1
0K,All Students,2018-19,13721,962,12759,93.0,79,17,21.5
0K,All Students,2019-20,10932,740,10192,93.2,99,21,21.2
0K,All Students,2020-21,16410,818,15592,95.0,97,15,15.5
0K,All Students,2021-22,14693,1269,13424,91.4,87,30,34.5
0K,All Students,2022-23,15355,1261,14094,91.8,89,27,30.3
1,All Students,2018-19,19016,898,18118,95.3,109,7,6.4
1,All Students,2019-20,8959,478,8481,94.7,81,11,13.6
1,All Students,2020-21,16332,812,15520,95.0,96,13,13.5
1,All Students,2021-22,16244,1198,15046,92.6,97,29,29.9
1,All Students,2022-23,14866,1076,13790,92.8,87,21,24.1
2,All Students,2018-19,15812,612,15200,96.1,90,5,5.6
2,All Students,2019-20,12251,588,11663,95.2,108,13,12.0
2,All Students,2020-21,14696,572,14124,96.1,87,13,14.9
2,All Students,2021-22,14865,925,13940,93.8,89,17,19.1
2,All Students,2022-23,16075,1017,15058,93.7,92,17,18.5
3,All Students,2018-19,12633,606,12027,95.2,74,9,12.2
3,All Students,2019-20,10465,427,10038,95.9,91,8,8.8
3,All Students,2020-21,17245,490,16755,97.2,100,7,7.0
3,All Students,2021-22,13481,832,12649,93.8,81,13,16.0
3,All Students,2022-23,14040,852,13188,93.9,82,15,18.3
4,All Students,2018-19,12830,526,12304,95.9,73,4,5.5
4,All Students,2019-20,8066,356,7710,95.6,73,9,12.3
4,All Students,2020-21,15011,494,14517,96.7,88,6,6.8
4,All Students,2021-22,16543,866,15677,94.8,95,13,13.7
4,All Students,2022-23,15575,916,14659,94.1,90,14,15.6
5,All Students,2018-19,16843,684,16159,95.9,98,10,10.2
5,All Students,2019-20,8424,313,8111,96.3,75,3,4.0
5,All Students,2020-21,12840,544,12296,95.8,75,10,13.3
5,All Students,2021-22,15432,804,14628,94.8,89,12,13.5
5,All Students,2022-23,16493,927,15566,94.4,95,11,11.6
All Grades,All Students,2018-19,228172,10458,217714,95.4,1322,179,13.5
All Grades,All Students,2019-20,148261,5727,142534,96.1,1316,136,10.3
All Grades,All Students,2020-21,207161,8478,198683,95.9,1209,141,11.7
All Grades,All Students,2021-22,178690,12120,166570,93.2,1055,243,23.0
All Grades,All Students,2022-23,171447,10565,160882,93.8,1006,203,20.2
6,All Students,2018-19,78557,3242,75315,95.9,454,58,12.8
6,All Students,2019-20,49778,1764,48014,96.5,441,40,9.1
6,All Students,2020-21,61196,2706,58490,95.6,360,54,15.0
6,All Students,2021-22,48888,2869,46019,94.1,294,57,19.4
6,All Students,2022-23,61640,3645,57995,94.1,363,76,20.9
7,All Students,2018-19,75627,2769,72858,96.3,441,39,8.8
7,All Students,2019-20,49547,1997,47550,96.0,437,51,11.7
7,All Students,2020-21,72377,2747,69630,96.2,423,42,9.9
7,All Students,2021-22,56252,3696,52556,93.4,333,76,22.8
7,All Students,2022-23,52418,2959,49459,94.4,308,54,17.5
8,All Students,2018-19,73988,4447,69541,94.0,427,82,19.2
8,All Students,2019-20,48936,1966,46970,96.0,438,45,10.3
8,All Students,2020-21,73588,3025,70563,95.9,426,45,10.6
8,All Students,2021-22,73550,5555,67995,92.4,428,110,25.7
8,All Students,2022-23,57389,3961,53428,93.1,335,73,21.8
All Grades,All Students,2018-19,95132,6249,88883,93.4,559,133,23.8
All Grades,All Students,2019-20,62973,3736,59237,94.1,565,106,18.8
All Grades,All Students,2020-21,90416,6984,83432,92.3,536,131,24.4
All Grades,All Students,2021-22,90807,8685,82122,90.4,535,196,36.6
All Grades,All Students,2022-23,89971,7475,82496,91.7,532,175,32.9
PK in K-12 Schools,All Students,2018-19,8644,999,7645,88.4,56,29,51.8
PK in K-12 Schools,All Students,2019-20,5531,502,5029,90.9,51,19,37.3
PK in K-12 Schools,All Students,2020-21,6988,379,6609,94.6,42,5,11.9
PK in K-12 Schools,All Students,2021-22,7908,886,7022,88.8,46,22,47.8
PK in K-12 Schools,All Students,2022-23,6159,754,5405,87.8,38,20,52.6
0K,All Students,2018-19,9055,731,8324,91.9,52,14,26.9
0K,All Students,2019-20,5571,423,5148,92.4,50,14,28.0
0K,All Students,2020-21,8459,848,7611,90.0,51,23,45.1
0K,All Students,2021-22,8391,1008,7383,88.0,49,23,46.9
0K,All Students,2022-23,8782,710,8072,91.9,53,20,37.7
1,All Students,2018-19,8493,621,7872,92.7,50,17,34.0
1,All Students,2019-20,5821,370,5451,93.6,52,11,21.2
1,All Students,2020-21,8732,951,7781,89.1,54,20,37.0
1,All Students,2021-22,9446,875,8571,90.7,58,23,39.7
1,All Students,2022-23,9165,842,8323,90.8,54,18,33.3
2,All Students,2018-19,9039,565,8474,93.7,54,10,18.5
2,All Students,2019-20,5962,280,5682,95.3,55,6,10.9
2,All Students,2020-21,7872,386,7486,95.1,47,7,14.9
2,All Students,2021-22,8463,800,7663,90.5,50,21,42.0
2,All Students,2022-23,9210,851,8359,90.8,55,23,41.8
3,All Students,2018-19,8532,455,8077,94.7,51,6,11.8
3,All Students,2019-20,6377,442,5935,93.1,58,15,25.9
3,All Students,2020-21,9455,560,8895,94.1,57,10,17.5
3,All Students,2021-22,7891,632,7259,92.0,46,14,30.4
3,All Students,2022-23,8545,763,7782,91.1,51,18,35.3
4,All Students,2018-19,10509,645,9864,93.9,63,13,20.6
4,All Students,2019-20,5908,285,5623,95.2,52,7,13.5
4,All Students,2020-21,10267,851,9416,91.7,60,20,33.3
4,All Students,2021-22,9166,789,8377,91.4,54,16,29.6
4,All Students,2022-23,8041,561,7480,93.0,49,13,26.5
5,All Students,2018-19,8260,488,7772,94.1,48,9,18.8
5,All Students,2019-20,7176,351,6825,95.1,63,7,11.1
5,All Students,2020-21,8884,413,8471,95.4,52,4,7.7
5,All Students,2021-22,9429,698,8731,92.6,56,12,21.4
5,All Students,2022-23,9839,721,9118,92.7,58,12,20.7
6,All Students,2018-19,10632,620,10012,94.2,61,10,16.4
6,All Students,2019-20,6755,323,6432,95.2,62,9,14.5
6,All Students,2020-21,9975,674,9301,93.2,59,12,20.3
6,All Students,2021-22,11190,1043,10147,90.7,66,20,30.3
6,All Students,2022-23,10427,772,9655,92.6,59,19,32.2
7,All Students,2018-19,10613,434,10179,95.9,60,9,15.0
7,All Students,2019-20,6814,391,6423,94.3,60,8,13.3
7,All Students,2020-21,10092,940,9152,90.7,58,13,22.4
7,All Students,2021-22,9408,955,8453,89.8,55,23,41.8
7,All Students,2022-23,10692,775,9917,92.8,61,14,23.0
8,All Students,2018-19,11355,691,10664,93.9,64,16,25.0
8,All Students,2019-20,7058,369,6689,94.8,62,10,16.1
8,All Students,2020-21,9692,982,8710,89.9,56,17,30.4
8,All Students,2021-22,9515,999,8516,89.5,55,22,40.0
8,All Students,2022-23,9111,726,8385,92.0,54,18,33.3
All Grades,All Students,2018-19,86267,6824,79443,92.1,524,153,29.2
All Grades,All Students,2019-20,52971,4759,48212,91.0,500,172,34.4
All Grades,All Students,2020-21,76747,6087,70660,92.1,457,119,26.0
All Grades,All Students,2021-22,72758,8548,64210,88.3,450,223,49.6
All Grades,All Students,2022-23,69203,7282,61921,89.5,434,187,43.1
PK in K-12 Schools,All Students,2018-19,7177,649,6528,91.0,44,16,36.4
PK in K-12 Schools,All Students,2019-20,5179,636,4543,87.7,55,26,47.3
PK in K-12 Schools,All Students,2020-21,6520,232,6288,96.4,40,3,7.5
PK in K-12 Schools,All Students,2021-22,9472,1515,7957,84.0,66,47,71.2
PK in K-12 Schools,All Students,2022-23,10322,1427,8895,86.2,70,38,54.3
0K,All Students,2018-19,13382,1310,12072,90.2,84,30,35.7
0K,All Students,2019-20,6319,585,5734,90.7,64,20,31.3
0K,All Students,2020-21,10143,1467,8676,85.5,64,27,42.2
0K,All Students,2021-22,10896,1245,9651,88.6,70,38,54.3
0K,All Students,2022-23,9545,1029,8516,89.2,60,29,48.3
1,All Students,2018-19,12458,1175,11283,90.6,75,29,38.7
1,All Students,2019-20,9064,868,8196,90.4,84,34,40.5
1,All Students,2020-21,9951,741,9210,92.6,59,15,25.4
1,All Students,2021-22,9641,1340,8301,86.1,58,33,56.9
1,All Students,2022-23,10917,1045,9872,90.4,66,28,42.4
2,All Students,2018-19,13365,865,12500,93.5,79,17,21.5
2,All Students,2019-20,7661,944,6717,87.7,70,32,45.7
2,All Students,2020-21,12993,1186,11807,90.9,76,27,35.5
2,All Students,2021-22,8848,1005,7843,88.6,52,24,46.2
2,All Students,2022-23,8979,1102,7877,87.7,55,27,49.1
3,All Students,2018-19,15064,1049,14015,93.0,90,19,21.1
3,All Students,2019-20,7988,557,7431,93.0,74,21,28.4
3,All Students,2020-21,11269,771,10498,93.2,67,17,25.4
3,All Students,2021-22,12825,1334,11491,89.6,77,31,40.3
3,All Students,2022-23,8382,736,7646,91.2,55,20,36.4
4,All Students,2018-19,12568,979,11589,92.2,77,21,27.3
4,All Students,2019-20,9276,645,8631,93.0,83,18,21.7
4,All Students,2020-21,12434,612,11822,95.1,72,9,12.5
4,All Students,2021-22,9528,1061,8467,88.9,57,26,45.6
4,All Students,2022-23,11630,1105,10525,90.5,70,26,37.1
5,All Students,2018-19,12253,797,11456,93.5,75,21,28.0
5,All Students,2019-20,7484,524,6960,93.0,70,21,30.0
5,All Students,2020-21,13437,1078,12359,92.0,79,21,26.6
5,All Students,2021-22,11548,1048,10500,90.9,70,24,34.3
5,All Students,2022-23,9428,838,8590,91.1,58,19,32.8
All Grades,All Students,2018-19,98484,3746,94738,96.2,573,42,7.3
All Grades,All Students,2019-20,63776,2736,61040,95.7,570,52,9.1
All Grades,All Students,2020-21,95839,2704,93135,97.2,558,30,5.4
All Grades,All Students,2021-22,91365,4523,86842,95.0,530,64,12.1
All Grades,All Students,2022-23,88668,4656,84012,94.7,511,79,15.5
PK in K-12 Schools,All Students,2018-19,3196,206,2990,93.6,19,3,15.8
PK in K-12 Schools,All Students,2019-20,2038,137,1901,93.3,19,4,21.1
PK in K-12 Schools,All Students,2020-21,3112,160,2952,94.9,18,2,11.1
PK in K-12 Schools,All Students,2021-22,3117,252,2865,91.9,18,6,33.3
PK in K-12 Schools,All Students,2022-23,3127,325,2802,89.6,18,6,33.3
0K,All Students,2018-19,15825,813,15012,94.9,92,13,14.1
0K,All Students,2019-20,10009,579,9430,94.2,91,12,13.2
0K,All Students,2020-21,14105,364,13741,97.4,83,4,4.8
0K,All Students,2021-22,14744,886,13858,94.0,87,15,17.2
0K,All Students,2022-23,12387,872,11515,93.0,71,15,21.1
1,All Students,2018-19,18784,764,18020,95.9,111,7,6.3
1,All Students,2019-20,10263,549,9714,94.7,92,13,14.1
1,All Students,2020-21,15514,404,15110,97.4,90,4,4.4
1,All Students,2021-22,13061,635,12426,95.1,76,4,5.3
1,All Students,2022-23,15452,967,14485,93.7,91,19,20.9
2,All Students,2018-19,18581,730,17851,96.1,109,10,9.2
2,All Students,2019-20,12257,423,11834,96.5,108,6,5.6
2,All Students,2020-21,15182,415,14767,97.3,88,4,4.5
2,All Students,2021-22,13676,723,12953,94.7,80,12,15.0
2,All Students,2022-23,13826,571,13255,95.9,80,6,7.5
3,All Students,2018-19,13026,363,12663,97.2,76,2,2.6
3,All Students,2019-20,11873,493,11380,95.8,105,10,9.5
3,All Students,2020-21,18710,441,18269,97.6,109,6,5.5
3,All Students,2021-22,13541,655,12886,95.2,78,12,15.4
3,All Students,2022-23,14253,670,13583,95.3,82,10,12.2
4,All Students,2018-19,14120,390,13730,97.2,82,5,6.1
4,All Students,2019-20,8510,300,8210,96.5,77,3,3.9
4,All Students,2020-21,16873,543,16330,96.8,99,6,6.1
4,All Students,2021-22,18078,766,17312,95.8,104,7,6.7
4,All Students,2022-23,12215,627,11588,94.9,70,13,18.6
5,All Students,2018-19,14952,480,14472,96.8,84,2,2.4
5,All Students,2019-20,8826,255,8571,97.1,78,4,5.1
5,All Students,2020-21,12343,377,11966,96.9,71,4,5.6
5,All Students,2021-22,15148,606,14542,96.0,87,8,9.2
5,All Students,2022-23,17408,624,16784,96.4,99,10,10.1
All Grades,All Students,2018-19,80287,3396,76891,95.8,472,58,12.3
All Grades,All Students,2019-20,47595,1959,45636,95.9,439,47,10.7
All Grades,All Students,2020-21,65298,3343,61955,94.9,383,52,13.6
All Grades,All Students,2021-22,63331,4430,58901,93.0,402,100,24.9
All Grades,All Students,2022-23,61445,3756,57689,93.9,380,76,20.0
PK in K-12 Schools,All Students,2018-19,6243,545,5698,91.3,37,13,35.1
PK in K-12 Schools,All Students,2019-20,3864,253,3611,93.5,41,11,26.8
PK in K-12 Schools,All Students,2020-21,5620,269,5351,95.2,36,3,8.3
PK in K-12 Schools,All Students,2021-22,3892,438,3454,88.7,27,12,44.4
PK in K-12 Schools,All Students,2022-23,3641,290,3351,92.0,23,5,21.7
0K,All Students,2018-19,8770,550,8220,93.7,54,8,14.8
0K,All Students,2019-20,5008,376,4632,92.5,48,11,22.9
0K,All Students,2020-21,8631,403,8228,95.3,52,5,9.6
0K,All Students,2021-22,7681,628,7053,91.8,49,16,32.7
0K,All Students,2022-23,5942,724,5218,87.8,39,21,53.8
1,All Students,2018-19,9520,391,9129,95.9,57,7,12.3
1,All Students,2019-20,5333,230,5103,95.7,50,6,12.0
1,All Students,2020-21,6817,663,6154,90.3,39,9,23.1
1,All Students,2021-22,8330,694,7636,91.7,55,17,30.9
1,All Students,2022-23,8144,480,7664,94.1,55,10,18.2
2,All Students,2018-19,8380,318,8062,96.2,49,4,8.2
2,All Students,2019-20,6977,311,6666,95.5,65,7,10.8
2,All Students,2020-21,7058,466,6592,93.4,41,7,17.1
2,All Students,2021-22,8827,962,7865,89.1,58,20,34.5
2,All Students,2022-23,8078,460,7618,94.3,50,9,18.0
3,All Students,2018-19,10522,475,10047,95.5,60,11,18.3
3,All Students,2019-20,5886,205,5681,96.5,52,1,1.9
3,All Students,2020-21,9951,343,9608,96.6,58,7,12.1
3,All Students,2021-22,6440,344,6096,94.7,43,10,23.3
3,All Students,2022-23,9486,761,8725,92.0,56,13,23.2
4,All Students,2018-19,16941,481,16460,97.2,99,8,8.1
4,All Students,2019-20,9673,323,9350,96.7,87,8,9.2
4,All Students,2020-21,13738,492,13246,96.4,80,8,10.0
4,All Students,2021-22,14638,712,13926,95.1,90,12,13.3
4,All Students,2022-23,11498,447,11051,96.1,70,7,10.0
5,All Students,2018-19,19911,636,19275,96.8,116,7,6.0
5,All Students,2019-20,10854,261,10593,97.6,96,3,3.1
5,All Students,2020-21,13483,707,12776,94.8,77,13,16.9
5,All Students,2021-22,13523,652,12871,95.2,80,13,16.3
5,All Students,2022-23,14656,594,14062,95.9,87,11,12.6
All Grades,All Students,2018-19,112074,5684,106390,94.9,666,112,16.8
All Grades,All Students,2019-20,73372,3633,69739,95.0,655,101,15.4
All Grades,All Students,2020-21,110343,3848,106495,96.5,645,68,10.5
All Grades,All Students,2021-22,103982,6855,97127,93.4,629,152,24.2
All Grades,All Students,2022-23,106984,6721,100263,93.7,643,145,22.6
PK in K-12 Schools,All Students,2018-19,7236,821,6415,88.7,45,15,33.3
PK in K-12 Schools,All Students,2019-20,4600,447,4153,90.3,43,17,39.5
PK in K-12 Schools,All Students,2020-21,7173,412,6761,94.3,43,8,18.6
PK in K-12 Schools,All Students,2021-22,6823,905,5918,86.7,48,31,64.6
PK in K-12 Schools,All Students,2022-23,6788,668,6120,90.2,42,17,40.5
0K,All Students,2018-19,9301,764,8537,91.8,58,17,29.3
0K,All Students,2019-20,6415,528,5887,91.8,58,22,37.9
0K,All Students,2020-21,10207,623,9584,93.9,62,9,14.5
0K,All Students,2021-22,9810,798,9012,91.9,59,17,28.8
0K,All Students,2022-23,9306,874,8432,90.6,57,23,40.4
1,All Students,2018-19,8562,474,8088,94.5,54,8,14.8
1,All Students,2019-20,6658,432,6226,93.5,60,13,21.7
1,All Students,2020-21,9790,284,9506,97.1,57,5,8.8
1,All Students,2021-22,9950,621,9329,93.8,63,14,22.2
1,All Students,2022-23,9827,724,9103,92.6,61,15,24.6
2,All Students,2018-19,10860,526,10334,95.2,66,13,19.7
2,All Students,2019-20,6432,397,6035,93.8,57,10,17.5
2,All Students,2020-21,9950,329,9621,96.7,59,6,10.2
2,All Students,2021-22,8814,596,8218,93.2,51,13,25.5
2,All Students,2022-23,9714,759,8955,92.2,62,16,25.8
3,All Students,2018-19,10760,533,10227,95.0,64,11,17.2
3,All Students,2019-20,7057,308,6749,95.6,62,8,12.9
3,All Students,2020-21,9842,365,9477,96.3,58,9,15.5
3,All Students,2021-22,10035,617,9418,93.9,61,14,23.0
3,All Students,2022-23,9459,571,8888,94.0,60,13,21.7
4,All Students,2018-19,10565,488,10077,95.4,62,9,14.5
4,All Students,2019-20,7425,345,7080,95.4,66,9,13.6
4,All Students,2020-21,10846,328,10518,97.0,62,6,9.7
4,All Students,2021-22,9720,530,9190,94.5,60,9,15.0
4,All Students,2022-23,11137,747,10390,93.3,63,17,27.0
5,All Students,2018-19,10749,507,10242,95.3,65,13,20.0
5,All Students,2019-20,6749,214,6535,96.8,59,2,3.4
5,All Students,2020-21,11045,243,10802,97.8,64,2,3.1
5,All Students,2021-22,10394,529,9865,94.9,62,12,19.4
5,All Students,2022-23,11637,566,11071,95.1,71,10,14.1
6,All Students,2018-19,13290,417,12873,96.9,77,5,6.5
6,All Students,2019-20,8419,395,8024,95.3,78,11,14.1
6,All Students,2020-21,14762,456,14306,96.9,86,8,9.3
6,All Students,2021-22,12690,812,11878,93.6,76,14,18.4
6,All Students,2022-23,12618,598,12020,95.3,76,12,15.8
7,All Students,2018-19,16577,519,16058,96.9,95,7,7.4
7,All Students,2019-20,8813,272,8541,96.9,78,5,6.4
7,All Students,2020-21,13648,523,13125,96.2,78,11,14.1
7,All Students,2021-22,13486,685,12801,94.9,79,14,17.7
7,All Students,2022-23,12695,575,12120,95.5,73,13,17.8
8,All Students,2018-19,14174,635,13539,95.5,80,14,17.5
8,All Students,2019-20,10804,295,10509,97.3,94,4,4.3
8,All Students,2020-21,13080,285,12795,97.8,76,4,5.3
8,All Students,2021-22,12260,762,11498,93.8,70,14,20.0
8,All Students,2022-23,13803,639,13164,95.4,78,9,11.5
All Grades,All Students,2018-19,245147,9247,235900,96.2,1451,171,11.8
All Grades,All Students,2019-20,155859,5854,150005,96.2,1391,139,10.0
All Grades,All Students,2020-21,230040,7881,222159,96.6,1333,126,9.5
All Grades,All Students,2021-22,213994,11901,202093,94.4,1277,233,18.2
All Grades,All Students,2022-23,212330,10225,202105,95.2,1284,208,16.2
6,All Students,2018-19,76982,2157,74825,97.2,457,38,8.3
6,All Students,2019-20,51305,s,s,s,s,s,s
6,All Students,2020-21,74023,2613,71410,96.5,429,41,9.6
6,All Students,2021-22,69234,3863,65371,94.4,413,72,17.4
6,All Students,2022-23,73078,3151,69927,95.7,442,58,13.1
7,All Students,2018-19,78170,2699,75471,96.5,466,53,11.4
7,All Students,2019-20,51950,1718,50232,96.7,463,37,8.0
7,All Students,2020-21,77821,2807,75014,96.4,450,46,10.2
7,All Students,2021-22,69881,3492,66389,95.0,420,74,17.6
7,All Students,2022-23,69639,3527,66112,94.9,424,71,16.7
8,All Students,2018-19,89995,4391,85604,95.1,528,80,15.2
8,All Students,2019-20,52546,2284,50262,95.7,467,57,12.2
8,All Students,2020-21,78196,2461,75735,96.9,454,39,8.6
8,All Students,2021-22,74879,4546,70333,93.9,444,87,19.6
8,All Students,2022-23,69613,3547,66066,94.9,418,79,18.9
9,All Students,2019-20,58,s,s,s,s,s,s
All Grades,All Students,2018-19,94852,10562,84290,88.9,595,217,36.5
All Grades,All Students,2019-20,66450,7386,59064,88.9,625,202,32.3
All Grades,All Students,2020-21,106157,11665,94492,89.0,641,192,30.0
All Grades,All Students,2021-22,101693,14709,86984,85.5,635,329,51.8
All Grades,All Students,2022-23,101507,14458,87049,85.8,659,294,44.6
9,All Students,2018-19,25667,3127,22540,87.8,164,55,33.5
9,All Students,2019-20,18623,2230,16393,88.0,174,52,29.9
9,All Students,2020-21,27922,3289,24633,88.2,168,49,29.2
9,All Students,2021-22,26449,2679,23770,89.9,166,60,36.1
9,All Students,2022-23,26970,3623,23347,86.6,180,66,36.7
10,All Students,2018-19,27131,3087,24044,88.6,173,66,38.2
10,All Students,2019-20,21632,2874,18758,86.7,206,79,38.3
10,All Students,2020-21,32325,5083,27242,84.3,202,78,38.6
10,All Students,2021-22,26969,4570,22399,83.1,169,88,52.1
10,All Students,2022-23,27968,4445,23523,84.1,186,80,43.0
11,All Students,2018-19,19537,1443,18094,92.6,121,28,23.1
11,All Students,2019-20,12159,878,11281,92.8,112,30,26.8
11,All Students,2020-21,22768,1250,21518,94.5,135,26,19.3
11,All Students,2021-22,27728,4026,23702,85.5,173,92,53.2
11,All Students,2022-23,22990,2709,20281,88.2,147,63,42.9
12,All Students,2018-19,22517,2905,19612,87.1,137,68,49.6
12,All Students,2019-20,14036,1404,12632,90.0,133,41,30.8
12,All Students,2020-21,23142,2043,21099,91.2,136,39,28.7
12,All Students,2021-22,20547,3434,17113,83.3,127,89,70.1
12,All Students,2022-23,23579,3681,19898,84.4,146,85,58.2
All Grades,All Students,2018-19,70165,4535,65630,93.5,442,82,18.6
All Grades,All Students,2019-20,48961,3484,45477,92.9,454,101,22.2
All Grades,All Students,2020-21,74612,9770,64842,86.9,446,159,35.7
All Grades,All Students,2021-22,76306,7848,68458,89.7,461,134,29.1
All Grades,All Students,2022-23,72009,6614,65395,90.8,457,117,25.6
9,All Students,2018-19,19394,772,18622,96.0,128,11,8.6
9,All Students,2019-20,12383,401,11982,96.8,117,13,11.1
9,All Students,2020-21,19410,2573,16837,86.7,118,41,34.7
9,All Students,2021-22,20633,1320,19313,93.6,126,19,15.1
9,All Students,2022-23,20049,1659,18390,91.7,133,30,22.6
10,All Students,2018-19,17897,1104,16793,93.8,114,20,17.5
10,All Students,2019-20,13118,765,12353,94.2,120,17,14.2
10,All Students,2020-21,18960,2029,16931,89.3,112,32,28.6
10,All Students,2021-22,19438,2298,17140,88.2,119,41,34.5
10,All Students,2022-23,19354,1262,18092,93.5,122,21,17.2
11,All Students,2018-19,17391,1442,15949,91.7,106,28,26.4
11,All Students,2019-20,12068,824,11244,93.2,111,21,18.9
11,All Students,2020-21,19305,2054,17251,89.4,115,38,33.0
11,All Students,2021-22,18096,1751,16345,90.3,108,30,27.8
11,All Students,2022-23,15816,1712,14104,89.2,98,28,28.6
12,All Students,2018-19,15483,1217,14266,92.1,94,23,24.5
12,All Students,2019-20,11392,1494,9898,86.9,106,50,47.2
12,All Students,2020-21,16937,3114,13823,81.6,101,48,47.5
12,All Students,2021-22,18139,2479,15660,86.3,108,44,40.7
12,All Students,2022-23,16790,1981,14809,88.2,104,38,36.5
All Grades,All Students,2018-19,70029,2997,67032,95.7,412,41,10.0
All Grades,All Students,2019-20,46132,2594,43538,94.4,413,69,16.7
All Grades,All Students,2020-21,68904,1672,67232,97.6,407,29,7.1
All Grades,All Students,2021-22,61104,4764,56340,92.2,359,101,28.1
All Grades,All Students,2022-23,52963,3564,49399,93.3,318,68,21.4
PK in K-12 Schools,All Students,2018-19,6181,403,5778,93.5,39,8,20.5
PK in K-12 Schools,All Students,2019-20,4099,411,3688,90.0,37,18,48.6
PK in K-12 Schools,All Students,2020-21,6164,172,5992,97.2,36,1,2.8
PK in K-12 Schools,All Students,2021-22,5646,890,4756,84.2,33,24,72.7
PK in K-12 Schools,All Students,2022-23,6101,590,5511,90.3,37,13,35.1
0K,All Students,2018-19,20462,1065,19397,94.8,121,21,17.4
0K,All Students,2019-20,13420,899,12521,93.3,123,22,17.9
0K,All Students,2020-21,16198,547,15651,96.6,101,15,14.9
0K,All Students,2021-22,18133,1618,16515,91.1,107,42,39.3
0K,All Students,2022-23,12405,1089,11316,91.2,76,24,31.6
1,All Students,2018-19,17158,689,16469,96.0,99,6,6.1
1,All Students,2019-20,11106,675,10431,93.9,98,20,20.4
1,All Students,2020-21,17170,399,16771,97.7,100,6,6.0
1,All Students,2021-22,11183,820,10363,92.7,67,13,19.4
1,All Students,2022-23,14840,929,13911,93.7,88,16,18.2
2,All Students,2018-19,14551,487,14064,96.7,84,2,2.4
2,All Students,2019-20,8997,336,8661,96.3,81,6,7.4
2,All Students,2020-21,15837,309,15528,98.0,92,4,4.3
2,All Students,2021-22,13571,811,12760,94.0,79,11,13.9
2,All Students,2022-23,8933,523,8410,94.1,54,8,14.8
3,All Students,2018-19,11677,353,11324,97.0,69,4,5.8
3,All Students,2019-20,8510,273,8237,96.8,74,3,4.1
3,All Students,2020-21,13535,245,13290,98.2,78,3,3.8
3,All Students,2021-22,12571,625,11946,95.0,73,11,15.1
3,All Students,2022-23,10684,433,10251,95.9,63,7,11.1
All Grades,All Students,2018-19,80049,2902,77147,96.4,476,39,8.2
All Grades,All Students,2019-20,53966,2656,51310,95.1,479,67,14.0
All Grades,All Students,2020-21,84615,1905,82710,97.7,492,31,6.3
All Grades,All Students,2021-22,79193,4594,74599,94.2,472,82,17.4
All Grades,All Students,2022-23,76523,4361,72162,94.3,460,79,17.2
PK in K-12 Schools,All Students,2018-19,6209,357,5852,94.3,38,7,18.4
PK in K-12 Schools,All Students,2019-20,4090,281,3809,93.1,37,9,24.3
PK in K-12 Schools,All Students,2020-21,6172,275,5897,95.5,36,3,8.3
PK in K-12 Schools,All Students,2021-22,6308,609,5699,90.3,39,14,35.9
PK in K-12 Schools,All Students,2022-23,6340,322,6018,94.9,38,6,15.8
0K,All Students,2018-19,22172,936,21236,95.8,134,8,6.0
0K,All Students,2019-20,14562,1022,13540,93.0,130,28,21.5
0K,All Students,2020-21,22535,714,21821,96.8,133,18,13.5
0K,All Students,2021-22,22845,1525,21320,93.3,139,29,20.9
0K,All Students,2022-23,22355,1643,20712,92.7,134,34,25.4
1,All Students,2018-19,21358,711,20647,96.7,124,11,8.9
1,All Students,2019-20,12942,596,12346,95.4,115,14,12.2
1,All Students,2020-21,20801,314,20487,98.5,121,2,1.7
1,All Students,2021-22,18525,1056,17469,94.3,109,20,18.3
1,All Students,2022-23,20699,1150,19549,94.4,125,18,14.4
2,All Students,2018-19,16650,503,16147,97.0,102,7,6.9
2,All Students,2019-20,12480,481,11999,96.1,111,9,8.1
2,All Students,2020-21,17486,256,17230,98.5,101,2,2.0
2,All Students,2021-22,17257,894,16363,94.8,103,15,14.6
2,All Students,2022-23,15992,719,15273,95.5,95,11,11.6
3,All Students,2018-19,13660,395,13265,97.1,78,6,7.7
3,All Students,2019-20,9892,276,9616,97.2,86,7,8.1
3,All Students,2020-21,17621,346,17275,98.0,101,6,5.9
3,All Students,2021-22,14258,510,13748,96.4,82,4,4.9
3,All Students,2022-23,11137,527,10610,95.3,68,10,14.7
All Grades,All Students,2018-19,66064,4878,61186,92.6,397,108,27.2
All Grades,All Students,2019-20,41229,2500,38729,93.9,381,71,18.6
All Grades,All Students,2020-21,57948,5638,52310,90.3,348,112,32.2
All Grades,All Students,2021-22,58126,6854,51272,88.2,353,166,47.0
All Grades,All Students,2022-23,50187,5180,45007,89.7,308,121,39.3
6,All Students,2018-19,19650,1580,18070,92.0,120,39,32.5
6,All Students,2019-20,12979,855,12124,93.4,122,31,25.4
6,All Students,2020-21,15380,s,s,s,s,s,s
6,All Students,2021-22,17781,1971,15810,88.9,110,52,47.3
6,All Students,2022-23,14388,1437,12951,90.0,89,35,39.3
7,All Students,2018-19,22795,1510,21285,93.4,135,30,22.2
7,All Students,2019-20,13249,778,12471,94.1,123,21,17.1
7,All Students,2020-21,21316,2282,19034,89.3,127,45,35.4
7,All Students,2021-22,17369,2057,15312,88.2,106,51,48.1
7,All Students,2022-23,18498,1754,16744,90.5,113,36,31.9
8,All Students,2018-19,23619,1788,21831,92.4,142,39,27.5
8,All Students,2019-20,15001,867,14134,94.2,136,19,14.0
8,All Students,2020-21,21244,2291,18953,89.2,128,48,37.5
8,All Students,2021-22,22976,2826,20150,87.7,137,63,46.0
8,All Students,2022-23,17301,1989,15312,88.5,106,50,47.2
9,All Students,2020-21,8,s,s,s,s,s,s
All Grades,All Students,2018-19,101891,5402,96489,94.7,603,94,15.6
All Grades,All Students,2019-20,66349,3095,63254,95.3,601,78,13.0
All Grades,All Students,2020-21,105544,6993,98551,93.4,610,115,18.9
All Grades,All Students,2021-22,99170,6061,93109,93.9,587,107,18.2
All Grades,All Students,2022-23,96919,7566,89353,92.2,591,152,25.7
6,All Students,2018-19,14962,562,14400,96.2,86,11,12.8
6,All Students,2019-20,10202,406,9796,96.0,91,7,7.7
6,All Students,2020-21,15820,703,15117,95.6,94,13,13.8
6,All Students,2021-22,13523,1002,12521,92.6,83,21,25.3
6,All Students,2022-23,13211,958,12253,92.7,78,20,25.6
7,All Students,2018-19,14585,715,13870,95.1,83,13,15.7
7,All Students,2019-20,9257,366,8891,96.0,82,9,11.0
7,All Students,2020-21,14995,387,14608,97.4,87,7,8.0
7,All Students,2021-22,14126,870,13256,93.8,82,19,23.2
7,All Students,2022-23,12167,871,11296,92.8,70,16,22.9
8,All Students,2018-19,15834,823,15011,94.8,91,17,18.7
8,All Students,2019-20,8831,436,8395,95.1,78,10,12.8
8,All Students,2020-21,13821,792,13029,94.3,79,9,11.4
8,All Students,2021-22,13260,861,12399,93.5,77,12,15.6
8,All Students,2022-23,12849,823,12026,93.6,80,14,17.5
9,All Students,2018-19,15156,1000,14156,93.4,94,15,16.0
9,All Students,2019-20,10977,451,10526,95.9,101,14,13.9
9,All Students,2020-21,16662,967,15695,94.2,96,17,17.7
9,All Students,2021-22,15824,650,15174,95.9,94,11,11.7
9,All Students,2022-23,16147,1610,14537,90.0,103,45,43.7
10,All Students,2018-19,14125,1012,13113,92.8,86,15,17.4
10,All Students,2019-20,9129,526,8603,94.2,85,14,16.5
10,All Students,2020-21,15824,1324,14500,91.6,91,24,26.4
10,All Students,2021-22,14640,1184,13456,91.9,87,20,23.0
10,All Students,2022-23,14760,953,13807,93.5,90,15,16.7
11,All Students,2018-19,13957,612,13345,95.6,84,10,11.9
11,All Students,2019-20,8823,567,8256,93.6,81,12,14.8
11,All Students,2020-21,15122,1558,13564,89.7,87,21,24.1
11,All Students,2021-22,14458,934,13524,93.5,85,17,20.0
11,All Students,2022-23,14192,1187,13005,91.6,87,22,25.3
12,All Students,2018-19,13272,678,12594,94.9,79,13,16.5
12,All Students,2019-20,9130,343,8787,96.2,83,12,14.5
12,All Students,2020-21,13300,1262,12038,90.5,76,24,31.6
12,All Students,2021-22,13339,560,12779,95.8,79,7,8.9
12,All Students,2022-23,13593,1164,12429,91.4,83,20,24.1
All Grades,All Students,2018-19,68859,7794,61065,88.7,449,152,33.9
All Grades,All Students,2019-20,48806,6671,42135,86.3,454,187,41.2
All Grades,All Students,2020-21,72061,8417,63644,88.3,438,149,34.0
All Grades,All Students,2021-22,66987,10486,56501,84.3,430,224,52.1
All Grades,All Students,2022-23,66861,8051,58810,88.0,448,186,41.5
9,All Students,2018-19,20284,1897,18387,90.6,142,51,35.9
9,All Students,2019-20,15040,1607,13433,89.3,146,57,39.0
9,All Students,2020-21,15432,1176,14256,92.4,107,25,23.4
9,All Students,2021-22,19555,2210,17345,88.7,138,62,44.9
9,All Students,2022-23,21177,1949,19228,90.8,152,51,33.6
10,All Students,2018-19,17322,1320,16002,92.4,112,26,23.2
10,All Students,2019-20,12223,1945,10278,84.1,112,52,46.4
10,All Students,2020-21,21456,2555,18901,88.1,126,42,33.3
10,All Students,2021-22,13414,1675,11739,87.5,82,45,54.9
10,All Students,2022-23,13489,1420,12069,89.5,89,26,29.2
11,All Students,2018-19,16093,2135,13958,86.7,101,35,34.7
11,All Students,2019-20,11343,1272,10071,88.8,103,33,32.0
11,All Students,2020-21,17567,2638,14929,85.0,101,38,37.6
11,All Students,2021-22,18706,3366,15340,82.0,117,65,55.6
11,All Students,2022-23,16599,2253,14346,86.4,110,56,50.9
12,All Students,2018-19,15160,2442,12718,83.9,94,40,42.6
12,All Students,2019-20,10200,1847,8353,81.9,93,45,48.4
12,All Students,2020-21,17606,2048,15558,88.4,104,44,42.3
12,All Students,2021-22,15312,3235,12077,78.9,93,52,55.9
12,All Students,2022-23,15596,2429,13167,84.4,97,53,54.6
All Grades,All Students,2018-19,110848,4975,105873,95.5,662,87,13.1
All Grades,All Students,2019-20,74302,3137,71165,95.8,679,83,12.2
All Grades,All Students,2020-21,117746,3538,114208,97.0,684,50,7.3
All Grades,All Students,2021-22,113189,7655,105534,93.2,673,134,19.9
All Grades,All Students,2022-23,114561,6584,107977,94.3,697,108,15.5
6,All Students,2018-19,18817,263,18554,98.6,109,3,2.8
6,All Students,2019-20,11474,240,11234,97.9,103,3,2.9
6,All Students,2020-21,16183,370,15813,97.7,94,5,5.3
6,All Students,2021-22,16906,1118,15788,93.4,99,19,19.2
6,All Students,2022-23,19190,600,18590,96.9,111,6,5.4
7,All Students,2018-19,16050,301,15749,98.1,94,3,3.2
7,All Students,2019-20,12200,288,11912,97.6,108,5,4.6
7,All Students,2020-21,16709,244,16465,98.5,97,3,3.1
7,All Students,2021-22,15131,639,14492,95.8,90,10,11.1
7,All Students,2022-23,15547,646,14901,95.8,94,13,13.8
8,All Students,2018-19,17455,544,16911,96.9,100,7,7.0
8,All Students,2019-20,10628,240,10388,97.7,94,5,5.3
8,All Students,2020-21,18598,366,18232,98.0,109,4,3.7
8,All Students,2021-22,15699,464,15235,97.0,93,7,7.5
8,All Students,2022-23,14393,501,13892,96.5,86,9,10.5
9,All Students,2018-19,15550,809,14741,94.8,96,16,16.7
9,All Students,2019-20,10473,619,9854,94.1,98,19,19.4
9,All Students,2020-21,19918,871,19047,95.6,117,13,11.1
9,All Students,2021-22,17772,1441,16331,91.9,106,22,20.8
9,All Students,2022-23,16519,1223,15296,92.6,104,18,17.3
10,All Students,2018-19,16065,946,15119,94.1,98,14,14.3
10,All Students,2019-20,9762,669,9093,93.1,94,16,17.0
10,All Students,2020-21,16427,498,15929,97.0,95,9,9.5
10,All Students,2021-22,17826,1184,16642,93.4,106,21,19.8
10,All Students,2022-23,16980,1194,15786,93.0,105,19,18.1
11,All Students,2018-19,14818,652,14166,95.6,92,13,14.1
11,All Students,2019-20,9138,381,8757,95.8,85,12,14.1
11,All Students,2020-21,14875,493,14382,96.7,85,6,7.1
11,All Students,2021-22,15405,996,14409,93.5,91,17,18.7
11,All Students,2022-23,17160,1064,16096,93.8,106,20,18.9
12,All Students,2018-19,12093,1460,10633,87.9,73,31,42.5
12,All Students,2019-20,10627,700,9927,93.4,97,23,23.7
12,All Students,2020-21,14977,637,14340,95.7,87,10,11.5
12,All Students,2021-22,14450,1813,12637,87.5,88,38,43.2
12,All Students,2022-23,14772,1356,13416,90.8,91,23,25.3
All Grades,All Students,2018-19,98913,6765,92148,93.2,594,129,21.7
All Grades,All Students,2019-20,67485,4500,62985,93.3,612,116,19.0
All Grades,All Students,2020-21,108326,5694,102632,94.7,627,85,13.6
All Grades,All Students,2021-22,108664,10012,98652,90.8,646,214,33.1
All Grades,All Students,2022-23,103193,8836,94357,91.4,630,176,27.9
5,All Students,2022-23,1,s,s,s,s,s,s
6,All Students,2018-19,15513,711,14802,95.4,92,11,12.0
6,All Students,2019-20,11186,500,10686,95.5,99,6,6.1
6,All Students,2020-21,17226,363,16863,97.9,99,4,4.0
6,All Students,2021-22,16555,898,15657,94.6,95,15,15.8
6,All Students,2022-23,15224,890,14334,94.2,88,15,17.0
7,All Students,2018-19,16030,935,15095,94.2,92,21,22.8
7,All Students,2019-20,9628,457,9171,95.3,85,9,10.6
7,All Students,2020-21,16182,369,15813,97.7,93,2,2.2
7,All Students,2021-22,15456,742,14714,95.2,89,9,10.1
7,All Students,2022-23,15784,959,14825,93.9,92,15,16.3
8,All Students,2018-19,13549,559,12990,95.9,78,7,9.0
8,All Students,2019-20,9539,542,8997,94.3,85,16,18.8
8,All Students,2020-21,14268,652,13616,95.4,82,13,15.9
8,All Students,2021-22,15354,1181,14173,92.3,89,21,23.6
8,All Students,2022-23,13908,s,s,s,s,s,s
9,All Students,2018-19,15775,1687,14088,89.3,98,29,29.6
9,All Students,2019-20,9999,747,9252,92.5,93,23,24.7
9,All Students,2020-21,16903,559,16344,96.7,100,7,7.0
9,All Students,2021-22,16066,1529,14537,90.5,100,36,36.0
9,All Students,2022-23,15052,1535,13517,89.8,98,29,29.6
10,All Students,2018-19,14007,871,13136,93.8,87,17,19.5
10,All Students,2019-20,9349,948,8401,89.9,87,25,28.7
10,All Students,2020-21,15053,944,14109,93.7,88,18,20.5
10,All Students,2021-22,15596,1523,14073,90.2,95,37,38.9
10,All Students,2022-23,14400,1295,13105,91.0,93,30,32.3
11,All Students,2018-19,12280,873,11407,92.9,75,16,21.3
11,All Students,2019-20,9119,544,8575,94.0,83,13,15.7
11,All Students,2020-21,14411,960,13451,93.3,82,9,11.0
11,All Students,2021-22,15065,1728,13337,88.5,91,42,46.2
11,All Students,2022-23,14553,1644,12909,88.7,91,36,39.6
12,All Students,2018-19,11759,1129,10630,90.4,72,28,38.9
12,All Students,2019-20,8665,762,7903,91.2,80,24,30.0
12,All Students,2020-21,14283,1847,12436,87.1,83,32,38.6
12,All Students,2021-22,14572,2411,12161,83.5,87,54,62.1
12,All Students,2022-23,14271,1793,12478,87.4,87,40,46.0
All Grades,All Students,2018-19,64065,2596,61469,95.9,369,39,10.6
All Grades,All Students,2019-20,41229,1413,39816,96.6,363,30,8.3
All Grades,All Students,2020-21,61697,1518,60179,97.5,354,16,4.5
All Grades,All Students,2021-22,62319,3291,59028,94.7,360,50,13.9
All Grades,All Students,2022-23,61664,2651,59013,95.7,356,32,9.0
6,All Students,2018-19,23622,851,22771,96.4,136,10,7.4
6,All Students,2019-20,11580,374,11206,96.8,102,8,7.8
6,All Students,2020-21,24160,541,23619,97.8,139,6,4.3
6,All Students,2021-22,23525,1120,22405,95.2,137,14,10.2
6,All Students,2022-23,18166,669,17497,96.3,105,6,5.7
7,All Students,2018-19,23712,922,22790,96.1,136,15,11.0
7,All Students,2019-20,14725,469,14256,96.8,130,10,7.7
7,All Students,2020-21,16783,394,16389,97.7,96,5,5.2
7,All Students,2021-22,22227,1118,21109,95.0,128,19,14.8
7,All Students,2022-23,22138,968,21170,95.6,129,12,9.3
8,All Students,2018-19,16731,823,15908,95.1,97,14,14.4
8,All Students,2019-20,14924,570,14354,96.2,131,12,9.2
8,All Students,2020-21,20754,583,20171,97.2,119,5,4.2
8,All Students,2021-22,16567,1053,15514,93.6,95,17,17.9
8,All Students,2022-23,21360,1014,20346,95.3,122,14,11.5
All Grades,All Students,2018-19,27783,1341,26442,95.2,161,22,13.7
All Grades,All Students,2019-20,38971,1734,37237,95.6,352,43,12.2
All Grades,All Students,2020-21,83629,4840,78789,94.2,487,76,15.6
All Grades,All Students,2021-22,83108,7526,75582,90.9,500,181,36.2
All Grades,All Students,2022-23,81288,6340,74948,92.2,489,135,27.6
6,All Students,2018-19,27783,1341,26442,95.2,161,22,13.7
6,All Students,2019-20,20958,889,20069,95.8,188,22,11.7
6,All Students,2020-21,27587,1767,25820,93.6,160,31,19.4
6,All Students,2021-22,27730,2649,25081,90.4,167,60,35.9
6,All Students,2022-23,27659,2145,25514,92.2,170,49,28.8
7,All Students,2019-20,18013,845,17168,95.3,164,21,12.8
7,All Students,2020-21,29670,1514,28156,94.9,174,23,13.2
7,All Students,2021-22,28113,2381,25732,91.5,172,57,33.1
7,All Students,2022-23,26800,1935,24865,92.8,160,39,24.4
8,All Students,2020-21,26372,1559,24813,94.1,153,22,14.4
8,All Students,2021-22,27265,2496,24769,90.8,161,64,39.8
8,All Students,2022-23,26829,2260,24569,91.6,159,47,29.6
All Grades,All Students,2022-23,46784,7516,39268,83.9,311,200,64.3
PK in K-12 Schools,All Students,2022-23,46769,s,s,s,s,s,s
0K,All Students,2022-23,15,s,s,s,s,s,s
All Grades,All Students,2018-19,576341,86513,489828,85.0,3689,1448,39.3
All Grades,All Students,2019-20,377106,53772,323334,85.7,3539,1232,34.8
All Grades,All Students,2020-21,570075,114067,456008,80.0,3280,1295,39.5
All Grades,All Students,2021-22,510078,113643,396435,77.7,3070,1698,55.3
All Grades,All Students,2022-23,480935,71833,409102,85.1,3151,1150,36.5
9,All Students,2018-19,185136,34150,150986,81.6,1218,527,43.3
9,All Students,2019-20,118976,21606,97370,81.8,1123,430,38.3
9,All Students,2020-21,143166,25060,118106,82.5,838,314,37.5
9,All Students,2021-22,147405,33073,114332,77.6,908,451,49.7
9,All Students,2022-23,154173,22645,131528,85.3,1039,350,33.7
10,All Students,2018-19,143873,18403,125470,87.2,916,313,34.2
10,All Students,2019-20,92902,11493,81409,87.6,893,303,33.9
10,All Students,2020-21,161110,38896,122214,75.9,917,395,43.1
10,All Students,2021-22,126224,29150,97074,76.9,760,408,53.7
10,All Students,2022-23,124966,20073,104893,83.9,823,303,36.8
11,All Students,2018-19,129305,15219,114086,88.2,817,275,33.7
11,All Students,2019-20,92766,11684,81082,87.4,866,285,32.9
11,All Students,2020-21,137382,23647,113735,82.8,787,272,34.6
11,All Students,2021-22,119016,23199,95817,80.5,708,391,55.2
11,All Students,2022-23,103337,13839,89498,86.6,659,226,34.3
12,All Students,2018-19,118027,18741,99286,84.1,738,333,45.1
12,All Students,2019-20,72462,8989,63473,87.6,660,217,32.9
12,All Students,2020-21,128417,26464,101953,79.4,738,314,42.5
12,All Students,2021-22,117433,28221,89212,76.0,694,448,64.6
12,All Students,2022-23,98459,15276,83183,84.5,630,271,43.0
All Grades,All Students,2018-19,261921,41057,220864,84.3,1690,748,44.3
All Grades,All Students,2019-20,163535,22747,140788,86.1,1577,638,40.5
All Grades,All Students,2020-21,242152,47467,194685,80.4,1456,746,51.2
All Grades,All Students,2021-22,243231,42918,200313,82.4,1493,821,55.0
All Grades,All Students,2022-23,240437,39181,201256,83.7,1626,842,51.8
8,All Students,2018-19,13,s,s,s,s,s,s
8,All Students,2021-22,15,s,s,s,s,s,s
9,All Students,2018-19,93255,15756,77499,83.1,616,271,44.0
9,All Students,2019-20,48361,6765,41596,86.0,486,176,36.2
9,All Students,2020-21,69901,14128,55773,79.8,421,216,51.3
9,All Students,2021-22,73956,12742,61214,82.8,453,228,50.3
9,All Students,2022-23,76550,14553,61997,81.0,545,294,53.9
10,All Students,2018-19,61267,9981,51286,83.7,403,169,41.9
10,All Students,2019-20,54809,7607,47202,86.1,530,220,41.5
10,All Students,2020-21,63728,13619,50109,78.6,389,201,51.7
10,All Students,2021-22,59963,10781,49182,82.0,371,192,51.8
10,All Students,2022-23,66004,10235,55769,84.5,454,229,50.4
11,All Students,2018-19,61277,8751,52526,85.7,387,182,47.0
11,All Students,2019-20,26360,3119,23241,88.2,250,89,35.6
11,All Students,2020-21,64168,9767,54401,84.8,386,184,47.7
11,All Students,2021-22,49226,s,s,s,s,s,s
11,All Students,2022-23,51797,6536,45261,87.4,336,136,40.5
12,All Students,2018-19,46109,s,s,s,s,s,s
12,All Students,2019-20,34005,5256,28749,84.5,312,153,49.0
12,All Students,2020-21,44355,9953,34402,77.6,260,145,55.8
12,All Students,2021-22,60071,12017,48054,80.0,362,247,68.2
12,All Students,2022-23,46086,7857,38229,83.0,291,183,62.9
All Grades,All Students,2018-19,93886,2746,91140,97.1,536,28,5.2
All Grades,All Students,2019-20,59663,1761,57902,97.0,526,24,4.6
All Grades,All Students,2020-21,89148,2287,86861,97.4,518,28,5.4
All Grades,All Students,2021-22,89131,5420,83711,93.9,519,95,18.3
All Grades,All Students,2022-23,87914,4540,83374,94.8,521,81,15.5
PK in K-12 Schools,All Students,2018-19,3064,224,2840,92.7,18,5,27.8
PK in K-12 Schools,All Students,2019-20,2002,199,1803,90.1,19,7,36.8
PK in K-12 Schools,All Students,2020-21,2973,209,2764,93.0,17,4,23.5
PK in K-12 Schools,All Students,2021-22,3015,396,2619,86.9,18,13,72.2
PK in K-12 Schools,All Students,2022-23,3065,235,2830,92.3,19,4,21.1
0K,All Students,2018-19,8133,395,7738,95.1,48,6,12.5
0K,All Students,2019-20,5390,296,5094,94.5,48,7,14.6
0K,All Students,2020-21,7754,289,7465,96.3,46,5,10.9
0K,All Students,2021-22,7206,690,6516,90.4,42,16,38.1
0K,All Students,2022-23,8400,547,7853,93.5,51,11,21.6
1,All Students,2018-19,9410,347,9063,96.3,53,6,11.3
1,All Students,2019-20,5850,220,5630,96.2,53,1,1.9
1,All Students,2020-21,8375,475,7900,94.3,49,7,14.3
1,All Students,2021-22,8398,600,7798,92.9,50,13,26.0
1,All Students,2022-23,7106,493,6613,93.1,42,11,26.2
2,All Students,2018-19,10093,265,9828,97.4,58,1,1.7
2,All Students,2019-20,5872,169,5703,97.1,52,3,5.8
2,All Students,2020-21,8895,369,8526,95.9,52,5,9.6
2,All Students,2021-22,8548,560,7988,93.4,50,11,22.0
2,All Students,2022-23,7518,428,7090,94.3,43,6,14.0
3,All Students,2018-19,10791,299,10492,97.2,61,2,3.3
3,All Students,2019-20,6996,168,6828,97.6,61,1,1.6
3,All Students,2020-21,9819,117,9702,98.8,58,0,0.0
3,All Students,2021-22,9792,665,9127,93.2,57,10,17.5
3,All Students,2022-23,9037,443,8594,95.1,53,7,13.2
4,All Students,2018-19,10826,319,10507,97.1,62,4,6.5
4,All Students,2019-20,6830,137,6693,98.0,60,1,1.7
4,All Students,2020-21,10647,95,10552,99.1,62,0,0.0
4,All Students,2021-22,10198,482,9716,95.3,60,7,11.7
4,All Students,2022-23,9989,516,9473,94.8,61,10,16.4
5,All Students,2018-19,10995,254,10741,97.7,62,1,1.6
5,All Students,2019-20,6817,198,6619,97.1,60,4,6.7
5,All Students,2020-21,10235,182,10053,98.2,60,1,1.7
5,All Students,2021-22,10234,415,9819,95.9,61,6,9.8
5,All Students,2022-23,9215,383,8832,95.8,54,10,18.5
6,All Students,2018-19,11139,308,10831,97.2,64,1,1.6
6,All Students,2019-20,6911,132,6779,98.1,60,0,0.0
6,All Students,2020-21,10675,377,10298,96.5,61,6,9.8
6,All Students,2021-22,11738,665,11073,94.3,68,8,11.8
6,All Students,2022-23,11465,466,10999,95.9,66,5,7.6
7,All Students,2018-19,10179,153,10026,98.5,58,0,0.0
7,All Students,2019-20,6555,116,6439,98.2,57,0,0.0
7,All Students,2020-21,9800,64,9736,99.3,56,0,0.0
7,All Students,2021-22,10267,619,9648,94.0,58,8,13.8
7,All Students,2022-23,11870,569,11301,95.2,72,9,12.5
8,All Students,2018-19,9256,182,9074,98.0,52,2,3.8
8,All Students,2019-20,6440,126,6314,98.0,56,0,0.0
8,All Students,2020-21,9975,110,9865,98.9,57,0,0.0
8,All Students,2021-22,9735,328,9407,96.6,55,3,5.5
8,All Students,2022-23,10249,460,9789,95.5,60,8,13.3
All Grades,All Students,2018-19,197265,5358,191907,97.3,1184,60,5.1
All Grades,All Students,2019-20,134172,3308,130864,97.5,1222,65,5.3
All Grades,All Students,2020-21,222405,3822,218583,98.3,1271,44,3.5
All Grades,All Students,2021-22,228760,9412,219348,95.9,1352,144,10.7
All Grades,All Students,2022-23,217248,9688,207560,95.5,1332,143,10.7
9,All Students,2018-19,51256,749,50507,98.5,307,5,1.6
9,All Students,2019-20,34670,538,34132,98.4,316,8,2.5
9,All Students,2020-21,60547,571,59976,99.1,346,4,1.2
9,All Students,2021-22,63087,1881,61206,97.0,373,24,6.4
9,All Students,2022-23,49425,1888,47537,96.2,306,25,8.2
10,All Students,2018-19,48907,1199,47708,97.5,294,12,4.1
10,All Students,2019-20,35032,485,34547,98.6,319,4,1.3
10,All Students,2020-21,55120,693,54427,98.7,315,5,1.6
10,All Students,2021-22,58848,1701,57147,97.1,350,24,6.9
10,All Students,2022-23,60979,2267,58712,96.3,373,32,8.6
11,All Students,2018-19,49284,1288,47996,97.4,296,14,4.7
11,All Students,2019-20,32240,810,31430,97.5,294,17,5.8
11,All Students,2020-21,55638,763,54875,98.6,318,6,1.9
11,All Students,2021-22,52255,2012,50243,96.1,308,22,7.1
11,All Students,2022-23,56553,2061,54492,96.4,346,26,7.5
12,All Students,2018-19,47818,2122,45696,95.6,287,29,10.1
12,All Students,2019-20,32230,1475,30755,95.4,293,36,12.3
12,All Students,2020-21,51100,1795,49305,96.5,292,29,9.9
12,All Students,2021-22,54570,3818,50752,93.0,321,74,23.1
12,All Students,2022-23,50291,3472,46819,93.1,307,60,19.5
All Grades,All Students,2018-19,117005,11751,105254,90.0,730,225,30.8
All Grades,All Students,2019-20,73885,6924,66961,90.6,683,186,27.2
All Grades,All Students,2020-21,112863,16371,96492,85.5,651,211,32.4
All Grades,All Students,2021-22,97032,12729,84303,86.9,588,252,42.9
All Grades,All Students,2022-23,92939,10387,82552,88.8,590,213,36.1
9,All Students,2018-19,30657,3766,26891,87.7,189,56,29.6
9,All Students,2019-20,21759,2094,19665,90.4,201,52,25.9
9,All Students,2020-21,30829,4079,26750,86.8,180,54,30.0
9,All Students,2021-22,26380,3416,22964,87.1,159,66,41.5
9,All Students,2022-23,26530,2610,23920,90.2,171,51,29.8
10,All Students,2018-19,28738,2897,25841,89.9,184,55,29.9
10,All Students,2019-20,17888,1728,16160,90.3,165,39,23.6
10,All Students,2020-21,31002,4690,26312,84.9,175,58,33.1
10,All Students,2021-22,24409,3257,21152,86.7,146,61,41.8
10,All Students,2022-23,23676,2873,20803,87.9,148,62,41.9
11,All Students,2018-19,28218,2289,25929,91.9,177,45,25.4
11,All Students,2019-20,15976,1353,14623,91.5,149,40,26.8
11,All Students,2020-21,24018,2898,21120,87.9,138,40,29.0
11,All Students,2021-22,23802,2624,21178,89.0,145,56,38.6
11,All Students,2022-23,20510,2350,18160,88.5,133,51,38.3
12,All Students,2018-19,29392,2799,26593,90.5,180,69,38.3
12,All Students,2019-20,18262,1749,16513,90.4,168,55,32.7
12,All Students,2020-21,27014,4704,22310,82.6,158,59,37.3
12,All Students,2021-22,22441,3432,19009,84.7,138,69,50.0
12,All Students,2022-23,22223,2554,19669,88.5,138,49,35.5
All Grades,All Students,2018-19,105857,4399,101458,95.8,612,54,8.8
All Grades,All Students,2019-20,58384,3045,55339,94.8,525,77,14.7
All Grades,All Students,2020-21,77647,3933,73714,94.9,462,74,16.0
All Grades,All Students,2021-22,73297,5996,67301,91.8,451,147,32.6
All Grades,All Students,2022-23,78168,6806,71362,91.3,468,145,31.0
PK in K-12 Schools,All Students,2018-19,6364,524,5840,91.8,36,12,33.3
PK in K-12 Schools,All Students,2019-20,4070,398,3672,90.2,38,14,36.8
PK in K-12 Schools,All Students,2020-21,5933,491,5442,91.7,37,11,29.7
PK in K-12 Schools,All Students,2021-22,8173,1309,6864,84.0,55,43,78.2
PK in K-12 Schools,All Students,2022-23,11228,1910,9318,83.0,69,43,62.3
0K,All Students,2018-19,13618,753,12865,94.5,80,11,13.8
0K,All Students,2019-20,8276,576,7700,93.0,78,21,26.9
0K,All Students,2020-21,11713,807,10906,93.1,70,18,25.7
0K,All Students,2021-22,11461,1099,10362,90.4,72,29,40.3
0K,All Students,2022-23,12246,1251,10995,89.8,76,34,44.7
1,All Students,2018-19,14134,677,13457,95.2,81,7,8.6
1,All Students,2019-20,8908,452,8456,94.9,79,8,10.1
1,All Students,2020-21,11342,540,10802,95.2,68,9,13.2
1,All Students,2021-22,10126,857,9269,91.5,61,19,31.1
1,All Students,2022-23,11113,877,10236,92.1,69,17,24.6
2,All Students,2018-19,11520,426,11094,96.3,66,3,4.5
2,All Students,2019-20,9192,510,8682,94.5,81,16,19.8
2,All Students,2020-21,12500,740,11760,94.1,72,16,22.2
2,All Students,2021-22,10492,715,9777,93.2,64,14,21.9
2,All Students,2022-23,10504,883,9621,91.6,62,23,37.1
3,All Students,2018-19,16184,609,15575,96.2,95,7,7.4
3,All Students,2019-20,7120,283,6837,96.0,64,3,4.7
3,All Students,2020-21,13029,511,12518,96.1,76,7,9.2
3,All Students,2021-22,11559,730,10829,93.7,68,13,19.1
3,All Students,2022-23,9634,604,9030,93.7,57,10,17.5
4,All Students,2018-19,18043,599,17444,96.7,105,6,5.7
4,All Students,2019-20,9549,385,9164,96.0,85,8,9.4
4,All Students,2020-21,9983,463,9520,95.4,61,7,11.5
4,All Students,2021-22,12157,830,11327,93.2,75,23,30.7
4,All Students,2022-23,11519,588,10931,94.9,67,7,10.4
5,All Students,2018-19,25994,811,25183,96.9,149,8,5.4
5,All Students,2019-20,11269,441,10828,96.1,100,7,7.0
5,All Students,2020-21,13147,381,12766,97.1,78,6,7.7
5,All Students,2021-22,9329,456,8873,95.1,56,6,10.7
5,All Students,2022-23,11924,693,11231,94.2,68,11,16.2
All Grades,All Students,2018-19,126648,7227,119421,94.3,750,125,16.7
All Grades,All Students,2019-20,80445,4809,75636,94.0,730,145,19.9
All Grades,All Students,2020-21,115059,5993,109066,94.8,715,135,18.9
All Grades,All Students,2021-22,110354,9380,100974,91.5,668,203,30.4
All Grades,All Students,2022-23,105257,7973,97284,92.4,619,178,28.8
PK in K-12 Schools,All Students,2018-19,5225,531,4694,89.8,33,11,33.3
PK in K-12 Schools,All Students,2019-20,3431,343,3088,90.0,30,14,46.7
PK in K-12 Schools,All Students,2020-21,4612,281,4331,93.9,31,7,22.6
PK in K-12 Schools,All Students,2021-22,5130,469,4661,90.9,30,10,33.3
PK in K-12 Schools,All Students,2022-23,7648,1003,6645,86.9,46,29,63.0
0K,All Students,2018-19,20139,1525,18614,92.4,122,31,25.4
0K,All Students,2019-20,13409,1097,12312,91.8,122,44,36.1
0K,All Students,2020-21,18983,1229,17754,93.5,122,28,23.0
0K,All Students,2021-22,16850,1779,15071,89.4,103,39,37.9
0K,All Students,2022-23,13161,1210,11951,90.8,80,29,36.3
1,All Students,2018-19,22352,1503,20849,93.3,134,30,22.4
1,All Students,2019-20,12400,813,11587,93.4,115,21,18.3
1,All Students,2020-21,17596,1471,16125,91.6,110,35,31.8
1,All Students,2021-22,18707,1652,17055,91.2,117,37,31.6
1,All Students,2022-23,17062,1291,15771,92.4,101,27,26.7
2,All Students,2018-19,20354,1111,19243,94.5,117,16,13.7
2,All Students,2019-20,13733,868,12865,93.7,124,23,18.5
2,All Students,2020-21,19159,921,18238,95.2,117,19,16.2
2,All Students,2021-22,15881,1503,14378,90.5,102,33,32.4
2,All Students,2022-23,16690,1203,15487,92.8,99,23,23.2
3,All Students,2018-19,18934,910,18024,95.2,111,13,11.7
3,All Students,2019-20,13067,635,12432,95.1,121,19,15.7
3,All Students,2020-21,19122,872,18250,95.4,120,24,20.0
3,All Students,2021-22,19310,1504,17806,92.2,112,35,31.3
3,All Students,2022-23,15380,1097,14283,92.9,90,26,28.9
4,All Students,2018-19,19307,807,18500,95.8,113,9,8.0
4,All Students,2019-20,11366,461,10905,95.9,102,12,11.8
4,All Students,2020-21,18583,696,17887,96.3,112,12,10.7
4,All Students,2021-22,16524,1090,15434,93.4,99,20,20.2
4,All Students,2022-23,17628,1098,16530,93.8,102,26,25.5
5,All Students,2018-19,20337,840,19497,95.9,120,15,12.5
5,All Students,2019-20,13039,592,12447,95.5,116,12,10.3
5,All Students,2020-21,17004,523,16481,96.9,103,10,9.7
5,All Students,2021-22,17952,1383,16569,92.3,105,29,27.6
5,All Students,2022-23,17688,1071,16617,93.9,101,18,17.8
All Grades,All Students,2018-19,96702,4327,92375,95.5,574,73,12.7
All Grades,All Students,2019-20,58148,2610,55538,95.5,524,65,12.4
All Grades,All Students,2020-21,79001,3097,75904,96.1,458,51,11.1
All Grades,All Students,2021-22,75787,5785,70002,92.4,452,123,27.2
All Grades,All Students,2022-23,65681,4313,61368,93.4,426,113,26.5
PK in K-12 Schools,All Students,2018-19,6135,608,5527,90.1,39,12,30.8
PK in K-12 Schools,All Students,2019-20,4032,456,3576,88.7,39,17,43.6
PK in K-12 Schools,All Students,2020-21,5020,253,4767,95.0,29,6,20.7
PK in K-12 Schools,All Students,2021-22,5383,809,4574,85.0,32,18,56.3
PK in K-12 Schools,All Students,2022-23,3571,396,3175,88.9,28,13,46.4
0K,All Students,2018-19,12963,889,12074,93.1,76,21,27.6
0K,All Students,2019-20,6588,325,6263,95.1,60,6,10.0
0K,All Students,2020-21,9922,477,9445,95.2,59,7,11.9
0K,All Students,2021-22,9040,968,8072,89.3,58,25,43.1
0K,All Students,2022-23,8586,822,7764,90.4,60,27,45.0
1,All Students,2018-19,13178,551,12627,95.8,78,9,11.5
1,All Students,2019-20,7878,446,7432,94.3,69,11,15.9
1,All Students,2020-21,9270,168,9102,98.2,53,2,3.8
1,All Students,2021-22,8604,596,8008,93.1,51,11,21.6
1,All Students,2022-23,8639,578,8061,93.3,61,17,27.9
2,All Students,2018-19,17990,643,17347,96.4,106,7,6.6
2,All Students,2019-20,7533,274,7259,96.4,67,3,4.5
2,All Students,2020-21,10425,468,9957,95.5,62,8,12.9
2,All Students,2021-22,8615,541,8074,93.7,53,9,17.0
2,All Students,2022-23,9966,562,9404,94.4,65,10,15.4
3,All Students,2018-19,14944,596,14348,96.0,89,8,9.0
3,All Students,2019-20,11931,359,11572,97.0,110,9,8.2
3,All Students,2020-21,11025,383,10642,96.5,63,7,11.1
3,All Students,2021-22,11836,977,10859,91.7,69,22,31.9
3,All Students,2022-23,7920,378,7542,95.2,51,7,13.7
4,All Students,2018-19,17236,592,16644,96.6,101,9,8.9
4,All Students,2019-20,9563,334,9229,96.5,84,8,9.5
4,All Students,2020-21,18882,589,18293,96.9,109,10,9.2
4,All Students,2021-22,13822,858,12964,93.8,81,19,23.5
4,All Students,2022-23,12403,838,11565,93.2,75,20,26.7
5,All Students,2018-19,14256,448,13808,96.9,85,7,8.2
5,All Students,2019-20,10623,416,10207,96.1,95,11,11.6
5,All Students,2020-21,14457,759,13698,94.7,83,11,13.3
5,All Students,2021-22,18487,1036,17451,94.4,108,19,17.6
5,All Students,2022-23,14596,739,13857,94.9,86,19,22.1
All Grades,All Students,2018-19,83105,3168,79937,96.2,483,37,7.7
All Grades,All Students,2019-20,53918,2247,51671,95.8,478,46,9.6
All Grades,All Students,2020-21,77068,2107,74961,97.3,453,29,6.4
All Grades,All Students,2021-22,70826,3858,66968,94.6,420,69,16.4
All Grades,All Students,2022-23,72480,4006,68474,94.5,425,72,16.9
0K,All Students,2018-19,13714,633,13081,95.4,79,9,11.4
0K,All Students,2019-20,8335,465,7870,94.4,73,11,15.1
0K,All Students,2020-21,11889,462,11427,96.1,72,9,12.5
0K,All Students,2021-22,10604,758,9846,92.9,63,15,23.8
0K,All Students,2022-23,12228,1009,11219,91.7,74,20,27.0
1,All Students,2018-19,16225,586,15639,96.4,95,7,7.4
1,All Students,2019-20,8883,394,8489,95.6,79,10,12.7
1,All Students,2020-21,10580,255,10325,97.6,63,3,4.8
1,All Students,2021-22,11909,775,11134,93.5,70,15,21.4
1,All Students,2022-23,10710,691,10019,93.5,63,12,19.0
2,All Students,2018-19,11970,413,11557,96.5,71,3,4.2
2,All Students,2019-20,11550,405,11145,96.5,102,6,5.9
2,All Students,2020-21,12841,428,12413,96.7,75,7,9.3
2,All Students,2021-22,9283,592,8691,93.6,56,10,17.9
2,All Students,2022-23,11535,588,10947,94.9,68,10,14.7
3,All Students,2018-19,13668,536,13132,96.1,80,8,10.0
3,All Students,2019-20,7806,292,7514,96.3,68,3,4.4
3,All Students,2020-21,17114,309,16805,98.2,101,3,3.0
3,All Students,2021-22,11525,574,10951,95.0,69,11,15.9
3,All Students,2022-23,9780,501,9279,94.9,57,9,15.8
4,All Students,2018-19,14198,590,13608,95.8,81,6,7.4
4,All Students,2019-20,8570,302,8268,96.5,78,5,6.4
4,All Students,2020-21,11925,335,11590,97.2,68,2,2.9
4,All Students,2021-22,15726,651,15075,95.9,94,9,9.6
4,All Students,2022-23,12919,523,12396,96.0,74,11,14.9
5,All Students,2018-19,13330,410,12920,96.9,77,4,5.2
5,All Students,2019-20,8774,389,8385,95.6,78,11,14.1
5,All Students,2020-21,12719,318,12401,97.5,74,5,6.8
5,All Students,2021-22,11779,508,11271,95.7,68,9,13.2
5,All Students,2022-23,15308,694,14614,95.5,89,10,11.2
All Grades,All Students,2018-19,100000,3996,96004,96.0,580,62,10.7
All Grades,All Students,2019-20,62264,2769,59495,95.6,564,66,11.7
All Grades,All Students,2020-21,85060,2423,82637,97.2,508,33,6.5
All Grades,All Students,2021-22,84949,4587,80362,94.6,502,86,17.1
All Grades,All Students,2022-23,81142,4680,76462,94.2,484,86,17.8
PK in K-12 Schools,All Students,2018-19,6359,480,5879,92.5,36,10,27.8
PK in K-12 Schools,All Students,2019-20,4013,409,3604,89.8,38,12,31.6
PK in K-12 Schools,All Students,2020-21,4392,237,4155,94.6,30,7,23.3
PK in K-12 Schools,All Students,2021-22,6334,586,5748,90.7,37,9,24.3
PK in K-12 Schools,All Students,2022-23,6325,683,5642,89.2,38,14,36.8
0K,All Students,2018-19,14055,804,13251,94.3,82,16,19.5
0K,All Students,2019-20,9179,554,8625,94.0,85,13,15.3
0K,All Students,2020-21,11758,435,11323,96.3,72,4,5.6
0K,All Students,2021-22,12236,878,11358,92.8,75,21,28.0
0K,All Students,2022-23,11253,915,10338,91.9,67,20,29.9
1,All Students,2018-19,16431,637,15794,96.1,98,7,7.1
1,All Students,2019-20,8770,392,8378,95.5,78,8,10.3
1,All Students,2020-21,12230,403,11827,96.7,72,5,6.9
1,All Students,2021-22,13462,720,12742,94.7,82,13,15.9
1,All Students,2022-23,10774,608,10166,94.4,64,8,12.5
2,All Students,2018-19,12413,446,11967,96.4,71,7,9.9
2,All Students,2019-20,10477,451,10026,95.7,96,9,9.4
2,All Students,2020-21,12843,383,12460,97.0,77,3,3.9
2,All Students,2021-22,12694,632,12062,95.0,74,11,14.9
2,All Students,2022-23,13080,760,12320,94.2,78,18,23.1
3,All Students,2018-19,15572,492,15080,96.8,89,8,9.0
3,All Students,2019-20,8134,315,7819,96.1,72,9,12.5
3,All Students,2020-21,15657,397,15260,97.5,93,7,7.5
3,All Students,2021-22,12398,494,11904,96.0,72,9,12.5
3,All Students,2022-23,12871,558,12313,95.7,76,7,9.2
4,All Students,2018-19,17551,574,16977,96.7,103,6,5.8
4,All Students,2019-20,10315,285,10030,97.2,94,7,7.4
4,All Students,2020-21,12420,246,12174,98.0,72,2,2.8
4,All Students,2021-22,14337,774,13563,94.6,84,16,19.0
4,All Students,2022-23,13193,557,12636,95.8,78,10,12.8
5,All Students,2018-19,17619,563,17056,96.8,101,8,7.9
5,All Students,2019-20,11376,363,11013,96.8,101,8,7.9
5,All Students,2020-21,15760,322,15438,98.0,92,5,5.4
5,All Students,2021-22,13488,503,12985,96.3,78,7,9.0
5,All Students,2022-23,13646,599,13047,95.6,83,9,10.8
All Grades,All Students,2018-19,169702,4450,165252,97.4,964,53,5.5
All Grades,All Students,2019-20,120121,3244,116877,97.3,1061,62,5.8
All Grades,All Students,2020-21,181765,4681,177084,97.4,1050,67,6.4
All Grades,All Students,2021-22,175874,6384,169490,96.4,1013,96,9.5
All Grades,All Students,2022-23,164252,6636,157616,96.0,944,88,9.3
6,All Students,2018-19,64748,1913,62835,97.0,369,22,6.0
6,All Students,2019-20,43557,1123,42434,97.4,385,22,5.7
6,All Students,2020-21,59429,1143,58286,98.1,345,12,3.5
6,All Students,2021-22,58872,1862,57010,96.8,342,28,8.2
6,All Students,2022-23,53232,2075,51157,96.1,307,29,9.4
7,All Students,2018-19,55842,1251,54591,97.8,318,16,5.0
7,All Students,2019-20,40794,1188,39606,97.1,362,23,6.4
7,All Students,2020-21,61522,1623,59899,97.4,354,22,6.2
7,All Students,2021-22,54828,1817,53011,96.7,317,27,8.5
7,All Students,2022-23,56951,2116,54835,96.3,326,25,7.7
8,All Students,2018-19,49112,1286,47826,97.4,277,15,5.4
8,All Students,2019-20,35770,933,34837,97.4,314,17,5.4
8,All Students,2020-21,60814,1915,58899,96.9,351,33,9.4
8,All Students,2021-22,62174,2705,59469,95.6,354,41,11.6
8,All Students,2022-23,54069,2445,51624,95.5,311,34,10.9
All Grades,All Students,2018-19,206323,5603,200720,97.3,1182,66,5.6
All Grades,All Students,2019-20,133201,3518,129683,97.4,1171,64,5.5
All Grades,All Students,2020-21,193911,3674,190237,98.1,1131,31,2.7
All Grades,All Students,2021-22,179507,6486,173021,96.4,1045,98,9.4
All Grades,All Students,2022-23,180960,7348,173612,95.9,1056,115,10.9
6,All Students,2018-19,73952,1889,72063,97.4,429,19,4.4
6,All Students,2019-20,42254,1000,41254,97.6,374,16,4.3
6,All Students,2020-21,60148,1143,59005,98.1,357,10,2.8
6,All Students,2021-22,60193,1943,58250,96.8,349,27,7.7
6,All Students,2022-23,63930,2349,61581,96.3,371,31,8.4
7,All Students,2018-19,65536,1537,63999,97.7,371,14,3.8
7,All Students,2019-20,47696,1225,46471,97.4,418,25,6.0
7,All Students,2020-21,61211,915,60296,98.5,356,6,1.7
7,All Students,2021-22,57971,2015,55956,96.5,340,31,9.1
7,All Students,2022-23,59485,2437,57048,95.9,350,45,12.9
8,All Students,2018-19,66835,2177,64658,96.7,382,33,8.6
8,All Students,2019-20,43251,1293,41958,97.0,379,23,6.1
8,All Students,2020-21,72552,1616,70936,97.8,418,15,3.6
8,All Students,2021-22,61343,2528,58815,95.9,356,40,11.2
8,All Students,2022-23,57545,2562,54983,95.5,335,39,11.6
All Grades,All Students,2018-19,56120,1831,54289,96.7,327,16,4.9
All Grades,All Students,2019-20,39304,1293,38011,96.7,358,21,5.9
All Grades,All Students,2020-21,54035,1134,52901,97.9,315,15,4.8
All Grades,All Students,2021-22,55297,2137,53160,96.1,326,27,8.3
All Grades,All Students,2022-23,58320,2528,55792,95.7,341,30,8.8
PK in K-12 Schools,All Students,2019-20,1752,105,1647,94.0,19,3,15.8
PK in K-12 Schools,All Students,2020-21,3248,70,3178,97.8,19,0,0.0
PK in K-12 Schools,All Students,2021-22,2993,340,2653,88.6,19,11,57.9
PK in K-12 Schools,All Students,2022-23,3078,217,2861,92.9,18,3,16.7
0K,All Students,2018-19,8853,363,8490,95.9,51,5,9.8
0K,All Students,2019-20,5761,282,5479,95.1,53,6,11.3
0K,All Students,2020-21,6517,160,6357,97.5,38,3,7.9
0K,All Students,2021-22,10086,489,9597,95.2,60,7,11.7
0K,All Students,2022-23,8853,591,8262,93.3,51,9,17.6
1,All Students,2018-19,7992,350,7642,95.6,45,3,6.7
1,All Students,2019-20,6110,252,5858,95.9,54,3,5.6
1,All Students,2020-21,8052,162,7890,98.0,47,3,6.4
1,All Students,2021-22,7647,260,7387,96.6,45,1,2.2
1,All Students,2022-23,10987,559,10428,94.9,65,8,12.3
2,All Students,2018-19,8205,259,7946,96.8,48,0,0.0
2,All Students,2019-20,5529,218,5311,96.1,52,6,11.5
2,All Students,2020-21,8550,148,8402,98.3,49,2,4.1
2,All Students,2021-22,8944,257,8687,97.1,53,0,0.0
2,All Students,2022-23,9063,307,8756,96.6,52,2,3.8
3,All Students,2018-19,10956,309,10647,97.2,64,3,4.7
3,All Students,2019-20,5630,88,5542,98.4,51,1,2.0
3,All Students,2020-21,8716,190,8526,97.8,50,2,4.0
3,All Students,2021-22,8138,251,7887,96.9,48,2,4.2
3,All Students,2022-23,8673,306,8367,96.5,49,0,0.0
4,All Students,2018-19,10324,232,10092,97.8,61,1,1.6
4,All Students,2019-20,7241,185,7056,97.4,65,2,3.1
4,All Students,2020-21,8239,136,8103,98.3,48,0,0.0
4,All Students,2021-22,9488,304,9184,96.8,55,4,7.3
4,All Students,2022-23,8454,236,8218,97.2,50,2,4.0
5,All Students,2018-19,9790,318,9472,96.8,58,4,6.9
5,All Students,2019-20,7281,163,7118,97.8,64,0,0.0
5,All Students,2020-21,10713,268,10445,97.5,64,5,7.8
5,All Students,2021-22,8001,236,7765,97.1,46,2,4.3
5,All Students,2022-23,9212,312,8900,96.6,56,6,10.7
All Grades,All Students,2018-19,50051,2086,47965,95.8,288,25,8.7
All Grades,All Students,2019-20,32213,1529,30684,95.3,293,36,12.3
All Grades,All Students,2020-21,44946,688,44258,98.5,269,3,1.1
All Grades,All Students,2021-22,40881,2155,38726,94.7,244,32,13.1
All Grades,All Students,2022-23,42628,2706,39922,93.7,247,45,18.2
PK in K-12 Schools,All Students,2018-19,3175,226,2949,92.9,19,5,26.3
PK in K-12 Schools,All Students,2019-20,2070,119,1951,94.3,18,4,22.2
PK in K-12 Schools,All Students,2020-21,2664,99,2565,96.3,18,2,11.1
PK in K-12 Schools,All Students,2021-22,2862,262,2600,90.8,17,4,23.5
PK in K-12 Schools,All Students,2022-23,3184,348,2836,89.1,18,9,50.0
0K,All Students,2018-19,8517,509,8008,94.0,51,11,21.6
0K,All Students,2019-20,5375,359,5016,93.3,50,12,24.0
0K,All Students,2020-21,6907,108,6799,98.4,41,0,0.0
0K,All Students,2021-22,7241,476,6765,93.4,44,8,18.2
0K,All Students,2022-23,6968,478,6490,93.1,42,10,23.8
1,All Students,2018-19,8774,383,8391,95.6,50,2,4.0
1,All Students,2019-20,4908,247,4661,95.0,45,5,11.1
1,All Students,2020-21,6856,84,6772,98.8,42,0,0.0
1,All Students,2021-22,6833,353,6480,94.8,40,6,15.0
1,All Students,2022-23,6261,425,5836,93.2,36,8,22.2
2,All Students,2018-19,7313,294,7019,96.0,42,5,11.9
2,All Students,2019-20,5579,278,5301,95.0,52,8,15.4
2,All Students,2020-21,6847,122,6725,98.2,43,1,2.3
2,All Students,2021-22,5706,217,5489,96.2,35,2,5.7
2,All Students,2022-23,6378,429,5949,93.3,36,8,22.2
3,All Students,2018-19,8367,264,8103,96.8,47,1,2.1
3,All Students,2019-20,4239,173,4066,95.9,38,1,2.6
3,All Students,2020-21,7596,104,7492,98.6,44,0,0.0
3,All Students,2021-22,6460,282,6178,95.6,37,2,5.4
3,All Students,2022-23,6371,369,6002,94.2,37,4,10.8
4,All Students,2018-19,6942,199,6743,97.1,39,1,2.6
4,All Students,2019-20,5472,221,5251,96.0,48,5,10.4
4,All Students,2020-21,5775,84,5691,98.5,33,0,0.0
4,All Students,2021-22,6204,351,5853,94.3,37,7,18.9
4,All Students,2022-23,7439,322,7117,95.7,43,1,2.3
5,All Students,2018-19,6963,211,6752,97.0,40,0,0.0
5,All Students,2019-20,4570,132,4438,97.1,42,1,2.4
5,All Students,2020-21,8301,87,8214,99.0,48,0,0.0
5,All Students,2021-22,5575,214,5361,96.2,34,3,8.8
5,All Students,2022-23,6027,335,5692,94.4,35,5,14.3
All Grades,All Students,2018-19,138507,6108,132399,95.6,797,104,13.0
All Grades,All Students,2019-20,88847,3824,85023,95.7,784,65,8.3
All Grades,All Students,2020-21,131073,3960,127113,97.0,781,71,9.1
All Grades,All Students,2021-22,116053,7394,108659,93.6,683,146,21.4
All Grades,All Students,2022-23,116411,7728,108683,93.4,680,141,20.7
PK in K-12 Schools,All Students,2018-19,9348,968,8380,89.6,57,29,50.9
PK in K-12 Schools,All Students,2019-20,6196,575,5621,90.7,55,14,25.5
PK in K-12 Schools,All Students,2020-21,8632,624,8008,92.8,53,14,26.4
PK in K-12 Schools,All Students,2021-22,9261,1121,8140,87.9,56,28,50.0
PK in K-12 Schools,All Students,2022-23,8400,957,7443,88.6,50,19,38.0
0K,All Students,2018-19,19615,1390,18225,92.9,113,27,23.9
0K,All Students,2019-20,11799,664,11135,94.4,106,17,16.0
0K,All Students,2020-21,18084,420,17664,97.7,106,8,7.5
0K,All Students,2021-22,15709,1231,14478,92.2,94,29,30.9
0K,All Students,2022-23,17831,1697,16134,90.5,105,39,37.1
1,All Students,2018-19,22820,960,21860,95.8,130,12,9.2
1,All Students,2019-20,14445,656,13789,95.5,129,8,6.2
1,All Students,2020-21,20032,583,19449,97.1,120,12,10.0
1,All Students,2021-22,16166,1124,15042,93.0,97,24,24.7
1,All Students,2022-23,15920,1031,14889,93.5,93,15,16.1
2,All Students,2018-19,22494,755,21739,96.6,129,9,7.0
2,All Students,2019-20,14951,555,14396,96.3,131,5,3.8
2,All Students,2020-21,21591,562,21029,97.4,130,9,6.9
2,All Students,2021-22,16859,1149,15710,93.2,98,21,21.4
2,All Students,2022-23,16547,977,15570,94.1,95,15,15.8
3,All Students,2018-19,22327,788,21539,96.5,126,9,7.1
3,All Students,2019-20,14137,450,13687,96.8,125,2,1.6
3,All Students,2020-21,21918,516,21402,97.6,130,6,4.6
3,All Students,2021-22,19738,1086,18652,94.5,115,20,17.4
3,All Students,2022-23,19250,1143,18107,94.1,113,22,19.5
4,All Students,2018-19,20732,658,20074,96.8,119,12,10.1
4,All Students,2019-20,14237,402,13835,97.2,124,7,5.6
4,All Students,2020-21,20688,602,20086,97.1,121,11,9.1
4,All Students,2021-22,19841,869,18972,95.6,117,13,11.1
4,All Students,2022-23,19452,1063,18389,94.5,114,21,18.4
5,All Students,2018-19,21171,589,20582,97.2,123,6,4.9
5,All Students,2019-20,13082,522,12560,96.0,114,12,10.5
5,All Students,2020-21,20128,653,19475,96.8,121,11,9.1
5,All Students,2021-22,18479,814,17665,95.6,106,11,10.4
5,All Students,2022-23,19011,860,18151,95.5,110,10,9.1
All Grades,All Students,2018-19,104001,4760,99241,95.4,609,67,11.0
All Grades,All Students,2019-20,69373,3417,65956,95.1,619,82,13.2
All Grades,All Students,2020-21,104596,3965,100631,96.2,609,45,7.4
All Grades,All Students,2021-22,104165,8428,95737,91.9,630,203,32.2
All Grades,All Students,2022-23,102857,8171,94686,92.1,614,185,30.1
PK in K-12 Schools,All Students,2018-19,8620,794,7826,90.8,51,13,25.5
PK in K-12 Schools,All Students,2019-20,5517,529,4988,90.4,52,17,32.7
PK in K-12 Schools,All Students,2020-21,7501,457,7044,93.9,46,10,21.7
PK in K-12 Schools,All Students,2021-22,11185,1482,9703,86.8,72,43,59.7
PK in K-12 Schools,All Students,2022-23,11727,1758,9969,85.0,71,42,59.2
0K,All Students,2018-19,14933,794,14139,94.7,90,13,14.4
0K,All Students,2019-20,9589,581,9008,93.9,86,19,22.1
0K,All Students,2020-21,16124,673,15451,95.8,95,6,6.3
0K,All Students,2021-22,12850,1301,11549,89.9,77,34,44.2
0K,All Students,2022-23,12623,1126,11497,91.1,79,31,39.2
1,All Students,2018-19,17284,740,16544,95.7,103,10,9.7
1,All Students,2019-20,10347,500,9847,95.2,92,7,7.6
1,All Students,2020-21,16037,618,15419,96.1,93,9,9.7
1,All Students,2021-22,16272,1425,14847,91.2,103,35,34.0
1,All Students,2022-23,14665,1279,13386,91.3,87,34,39.1
2,All Students,2018-19,16936,625,16311,96.3,98,6,6.1
2,All Students,2019-20,10971,527,10444,95.2,98,17,17.3
2,All Students,2020-21,16097,511,15586,96.8,93,3,3.2
2,All Students,2021-22,14809,937,13872,93.7,89,19,21.3
2,All Students,2022-23,16478,1360,15118,91.7,96,33,34.4
3,All Students,2018-19,17123,688,16435,96.0,98,8,8.2
3,All Students,2019-20,11357,528,10829,95.4,102,11,10.8
3,All Students,2020-21,15934,451,15483,97.2,91,3,3.3
3,All Students,2021-22,15757,1149,14608,92.7,95,27,28.4
3,All Students,2022-23,15253,898,14355,94.1,93,16,17.2
4,All Students,2018-19,16856,685,16171,95.9,100,15,15.0
4,All Students,2019-20,11104,399,10705,96.4,97,5,5.2
4,All Students,2020-21,16963,790,16173,95.3,99,8,8.1
4,All Students,2021-22,16426,980,15446,94.0,96,21,21.9
4,All Students,2022-23,15046,828,14218,94.5,89,15,16.9
5,All Students,2018-19,12249,434,11815,96.5,69,2,2.9
5,All Students,2019-20,10488,353,10135,96.6,92,6,6.5
5,All Students,2020-21,15940,465,15475,97.1,92,6,6.5
5,All Students,2021-22,16866,1154,15712,93.2,98,24,24.5
5,All Students,2022-23,17065,922,16143,94.6,99,14,14.1
All Grades,All Students,2018-19,191755,6217,185538,96.8,1100,93,8.5
All Grades,All Students,2019-20,122560,3581,118979,97.1,1102,83,7.5
All Grades,All Students,2020-21,168908,4852,164056,97.1,1004,71,7.1
All Grades,All Students,2021-22,143777,6433,137344,95.5,865,123,14.2
All Grades,All Students,2022-23,135180,6517,128663,95.2,803,121,15.1
5,All Students,2020-21,6,s,s,s,s,s,s
6,All Students,2018-19,64478,1982,62496,96.9,365,26,7.1
6,All Students,2019-20,36578,1057,35521,97.1,325,17,5.2
6,All Students,2020-21,49319,1639,47680,96.7,298,30,10.1
6,All Students,2021-22,42172,1915,40257,95.5,262,38,14.5
6,All Students,2022-23,44185,2096,42089,95.3,265,36,13.6
7,All Students,2018-19,62391,1888,60503,97.0,366,30,8.2
7,All Students,2019-20,44001,1140,42861,97.4,397,29,7.3
7,All Students,2020-21,52658,1236,51422,97.7,312,16,5.1
7,All Students,2021-22,46431,2034,44397,95.6,282,45,16.0
7,All Students,2022-23,43615,1960,41655,95.5,258,35,13.6
8,All Students,2018-19,64886,2347,62539,96.4,369,37,10.0
8,All Students,2019-20,41981,1384,40597,96.7,380,37,9.7
8,All Students,2020-21,66921,1977,64944,97.0,394,25,6.3
8,All Students,2021-22,55174,2484,52690,95.5,321,40,12.5
8,All Students,2022-23,47380,2461,44919,94.8,280,50,17.9
9,All Students,2020-21,4,s,s,s,s,s,s
All Grades,All Students,2018-19,118035,3956,114079,96.6,698,42,6.0
All Grades,All Students,2019-20,76445,3052,73393,96.0,698,71,10.2
All Grades,All Students,2020-21,110868,2299,108569,97.9,664,35,5.3
All Grades,All Students,2021-22,106366,5919,100447,94.4,624,100,16.0
All Grades,All Students,2022-23,101003,5389,95614,94.7,599,92,15.4
PK in K-12 Schools,All Students,2018-19,7772,502,7270,93.5,44,9,20.5
PK in K-12 Schools,All Students,2019-20,4990,406,4584,91.9,44,11,25.0
PK in K-12 Schools,All Students,2020-21,7469,156,7313,97.9,45,2,4.4
PK in K-12 Schools,All Students,2021-22,7470,589,6881,92.1,43,13,30.2
PK in K-12 Schools,All Students,2022-23,6360,663,5697,89.6,38,16,42.1
0K,All Students,2018-19,17059,845,16214,95.0,105,10,9.5
0K,All Students,2019-20,11306,697,10609,93.8,103,16,15.5
0K,All Students,2020-21,15182,349,14833,97.7,93,4,4.3
0K,All Students,2021-22,15249,1177,14072,92.3,92,29,31.5
0K,All Students,2022-23,12875,924,11951,92.8,79,20,25.3
1,All Students,2018-19,17732,549,17183,96.9,104,3,2.9
1,All Students,2019-20,11855,538,11317,95.5,107,17,15.9
1,All Students,2020-21,15680,296,15384,98.1,93,6,6.5
1,All Students,2021-22,15388,986,14402,93.6,90,14,15.6
1,All Students,2022-23,14542,892,13650,93.9,86,16,18.6
2,All Students,2018-19,17674,581,17093,96.7,108,6,5.6
2,All Students,2019-20,11418,439,10979,96.2,105,9,8.6
2,All Students,2020-21,18143,533,17610,97.1,109,9,8.3
2,All Students,2021-22,16309,796,15513,95.1,95,12,12.6
2,All Students,2022-23,15652,781,14871,95.0,93,12,12.9
3,All Students,2018-19,19721,600,19121,97.0,117,6,5.1
3,All Students,2019-20,10992,324,10668,97.1,103,8,7.8
3,All Students,2020-21,16300,289,16011,98.2,97,4,4.1
3,All Students,2021-22,17632,1123,16509,93.6,102,18,17.6
3,All Students,2022-23,14617,538,14079,96.3,84,5,6.0
4,All Students,2018-19,18035,366,17669,98.0,106,3,2.8
4,All Students,2019-20,13636,370,13266,97.3,126,6,4.8
4,All Students,2020-21,16956,203,16753,98.8,102,3,2.9
4,All Students,2021-22,18039,666,17373,96.3,107,8,7.5
4,All Students,2022-23,17906,878,17028,95.1,105,14,13.3
5,All Students,2018-19,20042,513,19529,97.4,114,5,4.4
5,All Students,2019-20,12248,278,11970,97.7,110,4,3.6
5,All Students,2020-21,21138,473,20665,97.8,125,7,5.6
5,All Students,2021-22,16279,582,15697,96.4,95,6,6.3
5,All Students,2022-23,19051,713,18338,96.3,114,9,7.9
All Grades,All Students,2018-19,118918,4098,114820,96.6,686,50,7.3
All Grades,All Students,2019-20,74671,2787,71884,96.3,672,63,9.4
All Grades,All Students,2020-21,100156,2342,97814,97.7,588,40,6.8
All Grades,All Students,2021-22,98900,5576,93324,94.4,581,97,16.7
All Grades,All Students,2022-23,91184,4798,86386,94.7,538,83,15.4
PK in K-12 Schools,All Students,2018-19,3124,176,2948,94.4,18,2,11.1
PK in K-12 Schools,All Students,2019-20,2067,126,1941,93.9,18,3,16.7
PK in K-12 Schools,All Students,2020-21,3114,38,3076,98.8,19,2,10.5
PK in K-12 Schools,All Students,2021-22,3174,225,2949,92.9,18,4,22.2
PK in K-12 Schools,All Students,2022-23,3165,269,2896,91.5,18,6,33.3
0K,All Students,2018-19,16451,919,15532,94.4,96,16,16.7
0K,All Students,2019-20,11321,587,10734,94.8,104,16,15.4
0K,All Students,2020-21,11544,288,11256,97.5,68,5,7.4
0K,All Students,2021-22,13106,1089,12017,91.7,77,26,33.8
0K,All Students,2022-23,11129,785,10344,92.9,66,14,21.2
1,All Students,2018-19,17783,815,16968,95.4,103,12,11.7
1,All Students,2019-20,11182,557,10625,95.0,100,15,15.0
1,All Students,2020-21,16030,326,15704,98.0,95,6,6.3
1,All Students,2021-22,13332,703,12629,94.7,78,9,11.5
1,All Students,2022-23,13743,916,12827,93.3,83,18,21.7
2,All Students,2018-19,19934,610,19324,96.9,115,4,3.5
2,All Students,2019-20,11325,402,10923,96.5,103,11,10.7
2,All Students,2020-21,15899,459,15440,97.1,94,8,8.5
2,All Students,2021-22,15176,793,14383,94.8,90,14,15.6
2,All Students,2022-23,13769,703,13066,94.9,81,11,13.6
3,All Students,2018-19,17285,488,16797,97.2,99,4,4.0
3,All Students,2019-20,12755,390,12365,96.9,114,5,4.4
3,All Students,2020-21,16614,290,16324,98.3,97,3,3.1
3,All Students,2021-22,16432,1009,15423,93.9,97,14,14.4
3,All Students,2022-23,15468,755,14713,95.1,92,12,13.0
4,All Students,2018-19,22868,588,22280,97.4,131,6,4.6
4,All Students,2019-20,11482,287,11195,97.5,103,5,4.9
4,All Students,2020-21,19541,619,18922,96.8,113,12,10.6
4,All Students,2021-22,16728,758,15970,95.5,99,12,12.1
4,All Students,2022-23,17460,781,16679,95.5,101,12,11.9
5,All Students,2018-19,21473,502,20971,97.7,124,6,4.8
5,All Students,2019-20,14539,438,14101,97.0,130,8,6.2
5,All Students,2020-21,17414,322,17092,98.2,102,4,3.9
5,All Students,2021-22,20952,999,19953,95.2,122,18,14.8
5,All Students,2022-23,16450,589,15861,96.4,97,10,10.3
All Grades,All Students,2018-19,175066,6483,168583,96.3,1008,75,7.4
All Grades,All Students,2019-20,115932,4003,111929,96.5,1028,84,8.2
All Grades,All Students,2020-21,169445,10153,159292,94.0,990,191,19.3
All Grades,All Students,2021-22,156203,8976,147227,94.3,924,183,19.8
All Grades,All Students,2022-23,140914,8586,132328,93.9,839,160,19.1
6,All Students,2018-19,59106,2020,57086,96.6,345,21,6.1
6,All Students,2019-20,38739,1240,37499,96.8,345,24,7.0
6,All Students,2020-21,53046,3016,50030,94.3,311,57,18.3
6,All Students,2021-22,49405,2757,46648,94.4,299,56,18.7
6,All Students,2022-23,43566,2676,40890,93.9,265,51,19.2
7,All Students,2018-19,56791,2043,54748,96.4,324,28,8.6
7,All Students,2019-20,39065,1207,37858,96.9,348,22,6.3
7,All Students,2020-21,57710,3024,54686,94.8,337,53,15.7
7,All Students,2021-22,50444,2739,47705,94.6,297,59,19.9
7,All Students,2022-23,50459,2654,47805,94.7,298,48,16.1
8,All Students,2018-19,59169,2420,56749,95.9,339,26,7.7
8,All Students,2019-20,38128,1556,36572,95.9,335,38,11.3
8,All Students,2020-21,58689,4113,54576,93.0,342,81,23.7
8,All Students,2021-22,56354,3480,52874,93.8,328,68,20.7
8,All Students,2022-23,46889,3256,43633,93.1,276,61,22.1
All Grades,All Students,2018-19,172766,6736,166030,96.1,1012,100,9.9
All Grades,All Students,2019-20,109870,4463,105407,95.9,985,93,9.4
All Grades,All Students,2020-21,154636,5897,148739,96.2,910,94,10.3
All Grades,All Students,2021-22,160550,9379,151171,94.2,956,188,19.7
All Grades,All Students,2022-23,167281,9166,158115,94.5,989,175,17.7
PK in K-12 Schools,All Students,2018-19,6346,371,5975,94.2,39,9,23.1
PK in K-12 Schools,All Students,2019-20,4126,313,3813,92.4,37,9,24.3
PK in K-12 Schools,All Students,2020-21,6154,271,5883,95.6,36,6,16.7
PK in K-12 Schools,All Students,2021-22,6127,847,5280,86.2,38,22,57.9
PK in K-12 Schools,All Students,2022-23,6360,680,5680,89.3,36,17,47.2
0K,All Students,2018-19,27773,1571,26202,94.3,162,25,15.4
0K,All Students,2019-20,17441,1021,16420,94.1,159,21,13.2
0K,All Students,2020-21,22872,991,21881,95.7,137,15,10.9
0K,All Students,2021-22,24199,2088,22111,91.4,146,49,33.6
0K,All Students,2022-23,24278,1813,22465,92.5,147,33,22.4
1,All Students,2018-19,25843,1005,24838,96.1,154,19,12.3
1,All Students,2019-20,17120,699,16421,95.9,152,14,9.2
1,All Students,2020-21,24544,820,23724,96.7,146,11,7.5
1,All Students,2021-22,25767,1589,24178,93.8,151,31,20.5
1,All Students,2022-23,24955,1473,23482,94.1,147,25,17.0
2,All Students,2018-19,26878,999,25879,96.3,154,10,6.5
2,All Students,2019-20,16212,553,15659,96.6,147,8,5.4
2,All Students,2020-21,25679,820,24859,96.8,150,12,8.0
2,All Students,2021-22,25030,1314,23716,94.8,154,24,15.6
2,All Students,2022-23,26322,1457,24865,94.5,155,31,20.0
3,All Students,2018-19,30540,1096,29444,96.4,182,17,9.3
3,All Students,2019-20,16662,630,16032,96.2,150,14,9.3
3,All Students,2020-21,23422,693,22729,97.0,137,11,8.0
3,All Students,2021-22,26604,1325,25279,95.0,157,22,14.0
3,All Students,2022-23,27365,1531,25834,94.4,162,31,19.1
4,All Students,2018-19,27680,923,26757,96.7,163,15,9.2
4,All Students,2019-20,19401,593,18808,96.9,170,12,7.1
4,All Students,2020-21,24079,835,23244,96.5,141,12,8.5
4,All Students,2021-22,26404,1016,25388,96.2,155,13,8.4
4,All Students,2022-23,29004,1200,27804,95.9,169,22,13.0
5,All Students,2018-19,27706,771,26935,97.2,158,5,3.2
5,All Students,2019-20,18908,654,18254,96.5,170,15,8.8
5,All Students,2020-21,27886,1467,26419,94.7,163,27,16.6
5,All Students,2021-22,26419,1200,25219,95.5,155,27,17.4
5,All Students,2022-23,28997,1012,27985,96.5,173,16,9.2
All Grades,All Students,2018-19,99619,4589,95030,95.4,590,67,11.4
All Grades,All Students,2019-20,65584,3360,62224,94.9,580,73,12.6
All Grades,All Students,2020-21,89120,4529,84591,94.9,533,76,14.3
All Grades,All Students,2021-22,89044,7519,81525,91.6,524,150,28.6
All Grades,All Students,2022-23,91104,7310,83794,92.0,543,146,26.9
PK in K-12 Schools,All Students,2018-19,6076,435,5641,92.8,35,10,28.6
PK in K-12 Schools,All Students,2019-20,4118,379,3739,90.8,36,12,33.3
PK in K-12 Schools,All Students,2020-21,3903,279,3624,92.9,23,4,17.4
PK in K-12 Schools,All Students,2021-22,7964,1171,6793,85.3,49,29,59.2
PK in K-12 Schools,All Students,2022-23,7076,s,s,s,s,s,s
0K,All Students,2018-19,8889,548,8341,93.8,53,7,13.2
0K,All Students,2019-20,5686,411,5275,92.8,51,9,17.6
0K,All Students,2020-21,8076,487,7589,94.0,49,10,20.4
0K,All Students,2021-22,8920,715,8205,92.0,52,14,26.9
0K,All Students,2022-23,8714,752,7962,91.4,50,17,34.0
1,All Students,2018-19,11747,606,11141,94.8,68,8,11.8
1,All Students,2019-20,6297,342,5955,94.6,56,7,12.5
1,All Students,2020-21,8487,508,7979,94.0,54,12,22.2
1,All Students,2021-22,8157,819,7338,90.0,48,20,41.7
1,All Students,2022-23,8890,650,8240,92.7,56,14,25.0
2,All Students,2018-19,10868,387,10481,96.4,63,4,6.3
2,All Students,2019-20,7657,400,7257,94.8,67,9,13.4
2,All Students,2020-21,8231,477,7754,94.2,48,7,14.6
2,All Students,2021-22,7363,588,6775,92.0,43,13,30.2
2,All Students,2022-23,8367,701,7666,91.6,49,15,30.6
3,All Students,2018-19,9098,355,8743,96.1,54,2,3.7
3,All Students,2019-20,7255,208,7047,97.1,64,2,3.1
3,All Students,2020-21,10950,444,10506,95.9,65,5,7.7
3,All Students,2021-22,7208,551,6657,92.4,42,12,28.6
3,All Students,2022-23,8218,539,7679,93.4,49,7,14.3
4,All Students,2018-19,11035,398,10637,96.4,65,4,6.2
4,All Students,2019-20,5549,273,5276,95.1,49,8,16.3
4,All Students,2020-21,10389,469,9920,95.5,61,9,14.8
4,All Students,2021-22,10352,768,9584,92.6,60,16,26.7
4,All Students,2022-23,9217,697,8520,92.4,56,15,26.8
5,All Students,2018-19,10568,533,10035,95.0,63,10,15.9
5,All Students,2019-20,7113,251,6862,96.5,62,2,3.2
5,All Students,2020-21,8456,281,8175,96.7,49,1,2.0
5,All Students,2021-22,10507,629,9878,94.0,62,6,9.7
5,All Students,2022-23,11051,900,10151,91.9,65,19,29.2
6,All Students,2018-19,11189,390,10799,96.5,66,4,6.1
6,All Students,2019-20,7077,469,6608,93.4,62,14,22.6
6,All Students,2020-21,11166,512,10654,95.4,67,11,16.4
6,All Students,2021-22,8414,709,7705,91.6,50,14,28.0
6,All Students,2022-23,10831,703,10128,93.5,63,8,12.7
7,All Students,2018-19,10350,436,9914,95.8,61,8,13.1
7,All Students,2019-20,7338,228,7110,96.9,66,3,4.5
7,All Students,2020-21,9688,642,9046,93.4,59,11,18.6
7,All Students,2021-22,10733,664,10069,93.8,64,11,17.2
7,All Students,2022-23,8019,655,7364,91.8,47,14,29.8
8,All Students,2018-19,9799,501,9298,94.9,62,10,16.1
8,All Students,2019-20,7494,399,7095,94.7,67,7,10.4
8,All Students,2020-21,9774,430,9344,95.6,58,6,10.3
8,All Students,2021-22,9426,905,8521,90.4,54,15,27.8
8,All Students,2022-23,10707,774,9933,92.8,64,13,20.3
9,All Students,2022-23,14,s,s,s,s,s,s
All Grades,All Students,2018-19,66453,3408,63045,94.9,395,62,15.7
All Grades,All Students,2019-20,42767,2245,40522,94.8,385,52,13.5
All Grades,All Students,2020-21,64997,1760,63237,97.3,386,18,4.7
All Grades,All Students,2021-22,65612,4807,60805,92.7,377,99,26.3
All Grades,All Students,2022-23,59353,4398,54955,92.6,353,98,27.8
PK in K-12 Schools,All Students,2018-19,5237,404,4833,92.3,31,10,32.3
PK in K-12 Schools,All Students,2019-20,3237,433,2804,86.6,29,10,34.5
PK in K-12 Schools,All Students,2020-21,4987,252,4735,94.9,30,3,10.0
PK in K-12 Schools,All Students,2021-22,5088,445,4643,91.3,29,13,44.8
PK in K-12 Schools,All Students,2022-23,3735,558,3177,85.1,23,14,60.9
0K,All Students,2018-19,10940,674,10266,93.8,66,11,16.7
0K,All Students,2019-20,7737,391,7346,94.9,72,9,12.5
0K,All Students,2020-21,11356,391,10965,96.6,67,5,7.5
0K,All Students,2021-22,10974,1000,9974,90.9,63,21,33.3
0K,All Students,2022-23,8780,757,8023,91.4,54,22,40.7
1,All Students,2018-19,9781,583,9198,94.0,62,16,25.8
1,All Students,2019-20,7002,408,6594,94.2,63,13,20.6
1,All Students,2020-21,11435,276,11159,97.6,69,2,2.9
1,All Students,2021-22,11775,880,10895,92.5,68,17,25.0
1,All Students,2022-23,9079,636,8443,93.0,53,10,18.9
2,All Students,2018-19,9738,518,9220,94.7,57,8,14.0
2,All Students,2019-20,6567,245,6322,96.3,58,5,8.6
2,All Students,2020-21,10123,214,9909,97.9,60,2,3.3
2,All Students,2021-22,10191,576,9615,94.3,59,10,16.9
2,All Students,2022-23,9964,661,9303,93.4,59,16,27.1
3,All Students,2018-19,9641,384,9257,96.0,55,4,7.3
3,All Students,2019-20,5854,286,5568,95.1,52,4,7.7
3,All Students,2020-21,9414,273,9141,97.1,58,4,6.9
3,All Students,2021-22,9099,652,8447,92.8,52,12,23.1
3,All Students,2022-23,9113,613,8500,93.3,56,13,23.2
4,All Students,2018-19,9414,446,8968,95.3,54,9,16.7
4,All Students,2019-20,6151,221,5930,96.4,55,5,9.1
4,All Students,2020-21,8932,190,8742,97.9,52,1,1.9
4,All Students,2021-22,9419,614,8805,93.5,54,12,22.2
4,All Students,2022-23,8907,542,8365,93.9,51,7,13.7
5,All Students,2018-19,11702,399,11303,96.6,70,4,5.7
5,All Students,2019-20,6219,261,5958,95.8,56,6,10.7
5,All Students,2020-21,8750,164,8586,98.1,50,1,2.0
5,All Students,2021-22,9066,640,8426,92.9,52,14,26.9
5,All Students,2022-23,9775,631,9144,93.5,57,16,28.1
All Grades,All Students,2018-19,127462,3939,123523,96.9,727,31,4.3
All Grades,All Students,2019-20,82048,2876,79172,96.5,721,47,6.5
All Grades,All Students,2020-21,125148,1986,123162,98.4,737,22,3.0
All Grades,All Students,2021-22,117930,5057,112873,95.7,680,60,8.8
All Grades,All Students,2022-23,119658,5547,114111,95.4,686,62,9.0
PK in K-12 Schools,All Students,2018-19,6369,384,5985,94.0,36,4,11.1
PK in K-12 Schools,All Students,2019-20,4140,317,3823,92.3,36,8,22.2
PK in K-12 Schools,All Students,2020-21,5627,140,5487,97.5,35,3,8.6
PK in K-12 Schools,All Students,2021-22,6264,606,5658,90.3,38,14,36.8
PK in K-12 Schools,All Students,2022-23,6302,648,5654,89.7,38,14,36.8
0K,All Students,2018-19,20430,826,19604,96.0,118,10,8.5
0K,All Students,2019-20,14242,700,13542,95.1,125,13,10.4
0K,All Students,2020-21,19964,449,19515,97.8,119,5,4.2
0K,All Students,2021-22,17285,1049,16236,93.9,99,15,15.2
0K,All Students,2022-23,17106,1091,16015,93.6,98,18,18.4
1,All Students,2018-19,22285,838,21447,96.2,126,5,4.0
1,All Students,2019-20,13938,544,13394,96.1,123,8,6.5
1,All Students,2020-21,21734,337,21397,98.4,127,3,2.4
1,All Students,2021-22,20036,796,19240,96.0,114,7,6.1
1,All Students,2022-23,18761,905,17856,95.2,109,8,7.3
2,All Students,2018-19,20102,620,19482,96.9,115,5,4.3
2,All Students,2019-20,13946,453,13493,96.8,123,5,4.1
2,All Students,2020-21,20714,305,20409,98.5,122,5,4.1
2,All Students,2021-22,19748,785,18963,96.0,115,6,5.2
2,All Students,2022-23,21756,933,20823,95.7,124,7,5.6
3,All Students,2018-19,20060,477,19583,97.6,113,1,0.9
3,All Students,2019-20,12632,378,12254,97.0,112,6,5.4
3,All Students,2020-21,19862,247,19615,98.8,118,3,2.5
3,All Students,2021-22,18368,814,17554,95.6,105,9,8.6
3,All Students,2022-23,19724,751,18973,96.2,113,6,5.3
4,All Students,2018-19,18585,362,18223,98.1,108,3,2.8
4,All Students,2019-20,12183,287,11896,97.6,106,6,5.7
4,All Students,2020-21,19207,254,18953,98.7,111,1,0.9
4,All Students,2021-22,18664,511,18153,97.3,108,3,2.8
4,All Students,2022-23,17324,690,16634,96.0,98,7,7.1
5,All Students,2018-19,19631,432,19199,97.8,111,3,2.7
5,All Students,2019-20,10967,197,10770,98.2,96,1,1.0
5,All Students,2020-21,18040,254,17786,98.6,105,2,1.9
5,All Students,2021-22,17565,496,17069,97.2,101,6,5.9
5,All Students,2022-23,18685,529,18156,97.2,106,2,1.9
All Grades,All Students,2018-19,68701,3428,65273,95.0,400,53,13.3
All Grades,All Students,2019-20,44078,2222,41856,95.0,396,58,14.6
All Grades,All Students,2020-21,69175,3019,66156,95.6,404,55,13.6
All Grades,All Students,2021-22,64274,5035,59239,92.2,386,112,29.0
All Grades,All Students,2022-23,59693,4869,54824,91.8,372,121,32.5
PK in K-12 Schools,All Students,2018-19,6346,577,5769,90.9,38,15,39.5
PK in K-12 Schools,All Students,2019-20,4063,445,3618,89.0,39,16,41.0
PK in K-12 Schools,All Students,2020-21,6294,344,5950,94.5,36,7,19.4
PK in K-12 Schools,All Students,2021-22,6339,872,5467,86.2,40,20,50.0
PK in K-12 Schools,All Students,2022-23,6334,842,5492,86.7,39,25,64.1
0K,All Students,2018-19,11258,845,10413,92.5,65,17,26.2
0K,All Students,2019-20,7297,447,6850,93.9,66,13,19.7
0K,All Students,2020-21,10963,689,10274,93.7,64,14,21.9
0K,All Students,2021-22,9374,770,8604,91.8,59,21,35.6
0K,All Students,2022-23,9455,1193,8262,87.4,58,31,53.4
1,All Students,2018-19,11079,593,10486,94.6,65,9,13.8
1,All Students,2019-20,6359,351,6008,94.5,56,9,16.1
1,All Students,2020-21,11002,465,10537,95.8,64,8,12.5
1,All Students,2021-22,9744,683,9061,93.0,58,14,24.1
1,All Students,2022-23,8089,577,7512,92.9,54,15,27.8
2,All Students,2018-19,9281,410,8871,95.6,53,4,7.5
2,All Students,2019-20,6763,297,6466,95.6,60,9,15.0
2,All Students,2020-21,10315,360,9955,96.5,62,7,11.3
2,All Students,2021-22,10306,775,9531,92.5,61,18,29.5
2,All Students,2022-23,9351,613,8738,93.4,59,14,23.7
3,All Students,2018-19,10458,351,10107,96.6,59,3,5.1
3,All Students,2019-20,6534,310,6224,95.3,59,9,15.3
3,All Students,2020-21,9716,518,9198,94.7,57,8,14.0
3,All Students,2021-22,9954,740,9214,92.6,58,10,17.2
3,All Students,2022-23,9019,705,8314,92.2,55,16,29.1
4,All Students,2018-19,9046,319,8727,96.5,56,2,3.6
4,All Students,2019-20,6853,199,6654,97.1,61,1,1.6
4,All Students,2020-21,9575,252,9323,97.4,56,4,7.1
4,All Students,2021-22,9166,639,8527,93.0,55,17,30.9
4,All Students,2022-23,8723,430,8293,95.1,51,7,13.7
5,All Students,2018-19,11233,333,10900,97.0,64,3,4.7
5,All Students,2019-20,6209,173,6036,97.2,55,1,1.8
5,All Students,2020-21,11310,391,10919,96.5,65,7,10.8
5,All Students,2021-22,9391,556,8835,94.1,55,12,21.8
5,All Students,2022-23,8722,509,8213,94.2,56,13,23.2
All Grades,All Students,2018-19,161533,5357,156176,96.7,937,72,7.7
All Grades,All Students,2019-20,98467,3632,94835,96.3,874,73,8.4
All Grades,All Students,2020-21,139096,3484,135612,97.5,816,49,6.0
All Grades,All Students,2021-22,136116,5766,130350,95.8,795,90,11.3
All Grades,All Students,2022-23,137578,6211,131367,95.5,796,90,11.3
PK in K-12 Schools,All Students,2018-19,9581,696,8885,92.7,56,17,30.4
PK in K-12 Schools,All Students,2019-20,6176,481,5695,92.2,54,13,24.1
PK in K-12 Schools,All Students,2020-21,8478,377,8101,95.6,52,10,19.2
PK in K-12 Schools,All Students,2021-22,9423,685,8738,92.7,54,11,20.4
PK in K-12 Schools,All Students,2022-23,9524,860,8664,91.0,55,17,30.9
0K,All Students,2018-19,25855,1271,24584,95.1,154,18,11.7
0K,All Students,2019-20,14415,869,13546,94.0,130,20,15.4
0K,All Students,2020-21,20551,500,20051,97.6,120,8,6.7
0K,All Students,2021-22,19665,1197,18468,93.9,114,21,18.4
0K,All Students,2022-23,23451,1354,22097,94.2,136,23,16.9
1,All Students,2018-19,22237,740,21497,96.7,128,8,6.3
1,All Students,2019-20,15796,612,15184,96.1,142,10,7.0
1,All Students,2020-21,20026,539,19487,97.3,118,5,4.2
1,All Students,2021-22,20828,872,19956,95.8,123,10,8.1
1,All Students,2022-23,21897,1154,20743,94.7,124,18,14.5
2,All Students,2018-19,26676,848,25828,96.8,156,11,7.1
2,All Students,2019-20,14299,430,13869,97.0,128,7,5.5
2,All Students,2020-21,23204,629,22575,97.3,138,8,5.8
2,All Students,2021-22,20324,789,19535,96.1,118,12,10.2
2,All Students,2022-23,21263,855,20408,96.0,124,14,11.3
3,All Students,2018-19,23716,638,23078,97.3,136,6,4.4
3,All Students,2019-20,16037,522,15515,96.7,140,11,7.9
3,All Students,2020-21,21758,469,21289,97.8,125,6,4.8
3,All Students,2021-22,22936,838,22098,96.3,135,13,9.6
3,All Students,2022-23,19327,699,18628,96.4,113,8,7.1
4,All Students,2018-19,27677,554,27123,98.0,160,4,2.5
4,All Students,2019-20,14675,356,14319,97.6,130,7,5.4
4,All Students,2020-21,23543,582,22961,97.5,138,8,5.8
4,All Students,2021-22,20629,588,20041,97.1,121,9,7.4
4,All Students,2022-23,21779,746,21033,96.6,127,9,7.1
5,All Students,2018-19,25791,610,25181,97.6,147,8,5.4
5,All Students,2019-20,17069,362,16707,97.9,150,5,3.3
5,All Students,2020-21,21536,388,21148,98.2,125,4,3.2
5,All Students,2021-22,22311,797,21514,96.4,130,14,10.8
5,All Students,2022-23,20337,543,19794,97.3,117,1,0.9
All Grades,All Students,2018-19,55914,2121,53793,96.2,324,28,8.6
All Grades,All Students,2019-20,34910,1631,33279,95.3,317,34,10.7
All Grades,All Students,2020-21,49318,1565,47753,96.8,285,23,8.1
All Grades,All Students,2021-22,46594,2416,44178,94.8,276,43,15.6
All Grades,All Students,2022-23,41030,2328,38702,94.3,241,42,17.4
PK in K-12 Schools,All Students,2018-19,6264,398,5866,93.6,36,9,25.0
PK in K-12 Schools,All Students,2019-20,4054,330,3724,91.9,39,10,25.6
PK in K-12 Schools,All Students,2020-21,5047,550,4497,89.1,30,9,30.0
PK in K-12 Schools,All Students,2021-22,5951,627,5324,89.5,34,16,47.1
PK in K-12 Schools,All Students,2022-23,4290,467,3823,89.1,26,13,50.0
0K,All Students,2018-19,7784,459,7325,94.1,45,11,24.4
0K,All Students,2019-20,5136,306,4830,94.0,49,8,16.3
0K,All Students,2020-21,7489,291,7198,96.1,43,6,14.0
0K,All Students,2021-22,8121,510,7611,93.7,50,10,20.0
0K,All Students,2022-23,5269,421,4848,92.0,31,10,32.3
1,All Students,2018-19,9029,298,8731,96.7,53,2,3.8
1,All Students,2019-20,4979,258,4721,94.8,44,5,11.4
1,All Students,2020-21,7269,152,7117,97.9,42,1,2.4
1,All Students,2021-22,6447,320,6127,95.0,38,6,15.8
1,All Students,2022-23,5853,347,5506,94.1,34,5,14.7
2,All Students,2018-19,6564,215,6349,96.7,38,2,5.3
2,All Students,2019-20,5415,232,5183,95.7,49,4,8.2
2,All Students,2020-21,6774,42,6732,99.4,39,0,0.0
2,All Students,2021-22,6271,262,6009,95.8,39,2,5.1
2,All Students,2022-23,6795,362,6433,94.7,39,5,12.8
3,All Students,2018-19,9468,316,9152,96.7,54,3,5.6
3,All Students,2019-20,3750,103,3647,97.3,33,0,0.0
3,All Students,2020-21,7875,227,7648,97.1,45,3,6.7
3,All Students,2021-22,7264,298,6966,95.9,42,4,9.5
3,All Students,2022-23,5407,216,5191,96.0,33,3,9.1
4,All Students,2018-19,8746,270,8476,96.9,52,1,1.9
4,All Students,2019-20,6299,200,6099,96.8,55,3,5.5
4,All Students,2020-21,5764,148,5616,97.4,34,3,8.8
4,All Students,2021-22,6865,258,6607,96.2,40,4,10.0
4,All Students,2022-23,7219,287,6932,96.0,41,1,2.4
5,All Students,2018-19,8059,165,7894,98.0,46,0,0.0
5,All Students,2019-20,5277,202,5075,96.2,48,4,8.3
5,All Students,2020-21,9100,155,8945,98.3,52,1,1.9
5,All Students,2021-22,5675,141,5534,97.5,33,1,3.0
5,All Students,2022-23,6197,228,5969,96.3,37,5,13.5
All Grades,All Students,2018-19,80483,4904,75579,93.9,482,95,19.7
All Grades,All Students,2019-20,52619,3435,49184,93.5,474,95,20.0
All Grades,All Students,2020-21,74484,2975,71509,96.0,448,57,12.7
All Grades,All Students,2021-22,69718,5602,64116,92.0,428,119,27.8
All Grades,All Students,2022-23,63919,4697,59222,92.7,377,91,24.1
PK in K-12 Schools,All Students,2018-19,12464,1188,11276,90.5,75,24,32.0
PK in K-12 Schools,All Students,2019-20,7192,615,6577,91.4,66,19,28.8
PK in K-12 Schools,All Students,2020-21,8528,652,7876,92.4,54,15,27.8
PK in K-12 Schools,All Students,2021-22,6705,868,5837,87.1,41,26,63.4
PK in K-12 Schools,All Students,2022-23,7448,952,6496,87.2,45,25,55.6
0K,All Students,2018-19,13383,971,12412,92.7,80,18,22.5
0K,All Students,2019-20,8237,636,7601,92.3,73,15,20.5
0K,All Students,2020-21,11335,374,10961,96.7,68,5,7.4
0K,All Students,2021-22,10755,928,9827,91.4,67,19,28.4
0K,All Students,2022-23,8565,693,7872,91.9,50,14,28.0
1,All Students,2018-19,12410,824,11586,93.4,75,18,24.0
1,All Students,2019-20,9017,611,8406,93.2,82,18,22.0
1,All Students,2020-21,11120,414,10706,96.3,67,10,14.9
1,All Students,2021-22,10972,755,10217,93.1,65,13,20.0
1,All Students,2022-23,10519,745,9774,92.9,62,15,24.2
2,All Students,2018-19,11056,568,10488,94.9,65,12,18.5
2,All Students,2019-20,7867,480,7387,93.9,69,16,23.2
2,All Students,2020-21,12908,602,12306,95.3,76,11,14.5
2,All Students,2021-22,9622,751,8871,92.2,61,20,32.8
2,All Students,2022-23,10639,759,9880,92.9,63,11,17.5
3,All Students,2018-19,11253,571,10682,94.9,69,9,13.0
3,All Students,2019-20,7289,471,6818,93.5,66,13,19.7
3,All Students,2020-21,10305,212,10093,97.9,62,4,6.5
3,All Students,2021-22,10921,931,9990,91.5,65,12,18.5
3,All Students,2022-23,7979,425,7554,94.7,47,6,12.8
4,All Students,2018-19,9800,415,9385,95.8,59,9,15.3
4,All Students,2019-20,6548,309,6239,95.3,59,7,11.9
4,All Students,2020-21,10938,476,10462,95.6,64,6,9.4
4,All Students,2021-22,10165,641,9524,93.7,63,12,19.0
4,All Students,2022-23,9085,614,8471,93.2,53,12,22.6
5,All Students,2018-19,10117,367,9750,96.4,59,5,8.5
5,All Students,2019-20,6469,313,6156,95.2,59,7,11.9
5,All Students,2020-21,9350,245,9105,97.4,57,6,10.5
5,All Students,2021-22,10578,728,9850,93.1,66,17,25.8
5,All Students,2022-23,9684,509,9175,94.7,57,8,14.0
All Grades,All Students,2018-19,271902,8945,262957,96.7,1568,117,7.5
All Grades,All Students,2019-20,181594,5785,175809,96.8,1613,107,6.6
All Grades,All Students,2020-21,276015,12102,263913,95.6,1617,186,11.5
All Grades,All Students,2021-22,252068,13551,238517,94.6,1495,253,16.9
All Grades,All Students,2022-23,262861,14230,248631,94.6,1531,259,16.9
6,All Students,2018-19,97115,3277,93838,96.6,569,43,7.6
6,All Students,2019-20,59913,1822,58091,97.0,534,37,6.9
6,All Students,2020-21,89347,4615,84732,94.8,531,78,14.7
6,All Students,2021-22,80113,4150,75963,94.8,481,76,15.8
6,All Students,2022-23,90406,4749,85657,94.7,533,84,15.8
7,All Students,2018-19,90831,3162,87669,96.5,522,48,9.2
7,All Students,2019-20,63283,2013,61270,96.8,559,36,6.4
7,All Students,2020-21,90965,3595,87370,96.0,535,58,10.8
7,All Students,2021-22,86138,4960,81178,94.2,516,98,19.0
7,All Students,2022-23,83216,3793,79423,95.4,486,66,13.6
8,All Students,2018-19,83956,2506,81450,97.0,477,26,5.5
8,All Students,2019-20,58398,1950,56448,96.7,520,34,6.5
8,All Students,2020-21,95703,3892,91811,95.9,551,50,9.1
8,All Students,2021-22,85817,4441,81376,94.8,498,79,15.9
8,All Students,2022-23,89239,5688,83551,93.6,512,109,21.3
All Grades,All Students,2018-19,112911,4118,108793,96.4,654,54,8.3
All Grades,All Students,2019-20,73484,2962,70522,96.0,656,68,10.4
All Grades,All Students,2020-21,102924,2878,100046,97.2,608,43,7.1
All Grades,All Students,2021-22,100225,6157,94068,93.9,592,111,18.8
All Grades,All Students,2022-23,96149,6102,90047,93.7,564,118,20.9
PK in K-12 Schools,All Students,2018-19,3186,192,2994,94.0,18,4,22.2
PK in K-12 Schools,All Students,2019-20,2065,124,1941,94.0,19,3,15.8
PK in K-12 Schools,All Students,2020-21,3193,220,2973,93.1,21,5,23.8
PK in K-12 Schools,All Students,2021-22,5654,797,4857,85.9,35,23,65.7
PK in K-12 Schools,All Students,2022-23,5835,763,5072,86.9,34,19,55.9
0K,All Students,2018-19,16314,777,15537,95.2,95,11,11.6
0K,All Students,2019-20,11369,665,10704,94.2,103,21,20.4
0K,All Students,2020-21,16428,574,15854,96.5,97,9,9.3
0K,All Students,2021-22,16740,1362,15378,91.9,97,28,28.9
0K,All Students,2022-23,13014,1078,11936,91.7,78,24,30.8
1,All Students,2018-19,21326,940,20386,95.6,124,13,10.5
1,All Students,2019-20,10067,500,9567,95.0,91,12,13.2
1,All Students,2020-21,14356,431,13925,97.0,84,5,6.0
1,All Students,2021-22,15734,986,14748,93.7,96,16,16.7
1,All Students,2022-23,17009,1334,15675,92.2,101,28,27.7
2,All Students,2018-19,16361,548,15813,96.7,95,7,7.4
2,All Students,2019-20,13292,516,12776,96.1,118,12,10.2
2,All Students,2020-21,13440,240,13200,98.2,80,2,2.5
2,All Students,2021-22,14568,756,13812,94.8,85,9,10.6
2,All Students,2022-23,13980,733,13247,94.8,80,11,13.8
3,All Students,2018-19,18524,543,17981,97.1,107,6,5.6
3,All Students,2019-20,10622,345,10277,96.8,95,6,6.3
3,All Students,2020-21,20083,411,19672,98.0,120,6,5.0
3,All Students,2021-22,13442,691,12751,94.9,79,13,16.5
3,All Students,2022-23,14400,839,13561,94.2,85,15,17.6
4,All Students,2018-19,20007,620,19387,96.9,116,7,6.0
4,All Students,2019-20,12832,360,12472,97.2,114,5,4.4
4,All Students,2020-21,15543,483,15060,96.9,91,6,6.6
4,All Students,2021-22,19501,843,18658,95.7,114,12,10.5
4,All Students,2022-23,12565,577,11988,95.4,74,9,12.2
5,All Students,2018-19,17193,498,16695,97.1,99,6,6.1
5,All Students,2019-20,13237,452,12785,96.6,116,9,7.8
5,All Students,2020-21,19881,519,19362,97.4,115,10,8.7
5,All Students,2021-22,14586,722,13864,95.1,86,10,11.6
5,All Students,2022-23,19346,778,18568,96.0,112,12,10.7
All Grades,All Students,2018-19,115312,5735,109577,95.0,660,82,12.4
All Grades,All Students,2019-20,71523,3482,68041,95.1,624,63,10.1
All Grades,All Students,2020-21,101688,1902,99786,98.1,591,13,2.2
All Grades,All Students,2021-22,94635,7085,87550,92.5,550,142,25.8
All Grades,All Students,2022-23,86591,5775,80816,93.3,502,120,23.9
PK in K-12 Schools,All Students,2018-19,3186,s,s,s,s,s,s
PK in K-12 Schools,All Students,2019-20,2066,146,1920,92.9,18,2,11.1
PK in K-12 Schools,All Students,2020-21,3142,83,3059,97.4,18,0,0.0
PK in K-12 Schools,All Students,2021-22,2748,308,2440,88.8,18,12,66.7
PK in K-12 Schools,All Students,2022-23,2822,368,2454,87.0,16,9,56.3
0K,All Students,2018-19,7820,560,7260,92.8,47,11,23.4
0K,All Students,2019-20,4869,341,4528,93.0,43,11,25.6
0K,All Students,2020-21,7465,175,7290,97.7,44,3,6.8
0K,All Students,2021-22,7855,785,7070,90.0,48,17,35.4
0K,All Students,2022-23,5995,569,5426,90.5,36,14,38.9
1,All Students,2018-19,9400,401,8999,95.7,53,4,7.5
1,All Students,2019-20,4944,274,4670,94.5,43,5,11.6
1,All Students,2020-21,7816,163,7653,97.9,46,1,2.2
1,All Students,2021-22,6843,548,6295,92.0,42,13,31.0
1,All Students,2022-23,7504,484,7020,93.6,44,9,20.5
2,All Students,2018-19,13805,919,12886,93.3,79,16,20.3
2,All Students,2019-20,7386,302,7084,95.9,65,5,7.7
2,All Students,2020-21,7312,75,7237,99.0,43,0,0.0
2,All Students,2021-22,8313,743,7570,91.1,48,12,25.0
2,All Students,2022-23,6897,523,6374,92.4,39,7,17.9
3,All Students,2018-19,11041,526,10515,95.2,62,4,6.5
3,All Students,2019-20,8494,508,7986,94.0,74,9,12.2
3,All Students,2020-21,11184,152,11032,98.6,64,1,1.6
3,All Students,2021-22,7507,568,6939,92.4,43,13,30.2
3,All Students,2022-23,8352,535,7817,93.6,49,12,24.5
4,All Students,2018-19,13197,567,12630,95.7,75,9,12.0
4,All Students,2019-20,7592,322,7270,95.8,66,3,4.5
4,All Students,2020-21,12273,217,12056,98.2,71,1,1.4
4,All Students,2021-22,9748,579,9169,94.1,55,7,12.7
4,All Students,2022-23,8106,541,7565,93.3,47,11,23.4
5,All Students,2018-19,14890,556,14334,96.3,85,7,8.2
5,All Students,2019-20,8632,350,8282,95.9,75,4,5.3
5,All Students,2020-21,11218,146,11072,98.7,65,1,1.5
5,All Students,2021-22,12052,939,11113,92.2,70,23,32.9
5,All Students,2022-23,9573,484,9089,94.9,55,9,16.4
6,All Students,2018-19,16098,781,15317,95.1,95,14,14.7
6,All Students,2019-20,9787,558,9229,94.3,85,12,14.1
6,All Students,2020-21,13877,287,13590,97.9,83,2,2.4
6,All Students,2021-22,12773,791,11982,93.8,73,13,17.8
6,All Students,2022-23,12856,898,11958,93.0,77,22,28.6
7,All Students,2018-19,14472,703,13769,95.1,82,10,12.2
7,All Students,2019-20,8947,354,8593,96.0,78,6,7.7
7,All Students,2020-21,14264,343,13921,97.6,82,3,3.7
7,All Students,2021-22,12865,794,12071,93.8,74,15,20.3
7,All Students,2022-23,11838,553,11285,95.3,67,10,14.9
8,All Students,2018-19,11402,473,10929,95.9,64,2,3.1
8,All Students,2019-20,8806,327,8479,96.3,77,6,7.8
8,All Students,2020-21,13137,261,12876,98.0,75,1,1.3
8,All Students,2021-22,13931,1030,12901,92.6,79,17,21.5
8,All Students,2022-23,12648,820,11828,93.5,72,17,23.6
9,All Students,2018-19,1,s,s,s,s,s,s
All Grades,All Students,2018-19,85520,11344,74176,86.7,553,230,41.6
All Grades,All Students,2019-20,54253,4033,50220,92.6,549,142,25.9
All Grades,All Students,2020-21,95022,10874,84148,88.6,555,197,35.5
All Grades,All Students,2021-22,89493,11378,78115,87.3,557,259,46.5
All Grades,All Students,2022-23,83669,10321,73348,87.7,536,235,43.8
9,All Students,2018-19,21548,1374,20174,93.6,141,34,24.1
9,All Students,2019-20,14964,905,14059,94.0,142,31,21.8
9,All Students,2020-21,23058,2077,20981,91.0,133,41,30.8
9,All Students,2021-22,22772,2496,20276,89.0,143,54,37.8
9,All Students,2022-23,20270,2110,18160,89.6,132,51,38.6
10,All Students,2018-19,20748,2057,18691,90.1,135,43,31.9
10,All Students,2019-20,14169,693,13476,95.1,131,24,18.3
10,All Students,2020-21,22473,1334,21139,94.1,130,28,21.5
10,All Students,2021-22,20970,2238,18732,89.3,133,48,36.1
10,All Students,2022-23,23286,2800,20486,88.0,148,58,39.2
11,All Students,2018-19,16908,2213,14695,86.9,105,40,38.1
11,All Students,2019-20,14004,1108,12896,92.1,133,43,32.3
11,All Students,2020-21,22449,1596,20853,92.9,129,35,27.1
11,All Students,2021-22,20753,2342,18411,88.7,127,58,45.7
11,All Students,2022-23,19928,2220,17708,88.9,123,40,32.5
12,All Students,2018-19,26316,5700,20616,78.3,172,113,65.7
12,All Students,2019-20,11116,1327,9789,88.1,143,44,30.8
12,All Students,2020-21,27042,5867,21175,78.3,163,93,57.1
12,All Students,2021-22,24998,4302,20696,82.8,154,99,64.3
12,All Students,2022-23,20185,3191,16994,84.2,133,86,64.7
All Grades,All Students,2018-19,30198,1861,28337,93.8,179,27,15.1
All Grades,All Students,2019-20,27918,1493,26425,94.7,255,43,16.9
All Grades,All Students,2020-21,52210,1348,50862,97.4,306,18,5.9
All Grades,All Students,2021-22,66524,4725,61799,92.9,404,101,25.0
All Grades,All Students,2022-23,85093,4434,80659,94.8,501,72,14.4
PK in K-12 Schools,All Students,2018-19,9376,795,8581,91.5,55,13,23.6
PK in K-12 Schools,All Students,2019-20,6064,369,5695,93.9,57,12,21.1
PK in K-12 Schools,All Students,2020-21,9085,289,8796,96.8,54,6,11.1
PK in K-12 Schools,All Students,2021-22,12063,1344,10719,88.9,72,33,45.8
PK in K-12 Schools,All Students,2022-23,11528,861,10667,92.5,68,16,23.5
0K,All Students,2018-19,11196,657,10539,94.1,66,11,16.7
0K,All Students,2019-20,8081,572,7509,92.9,75,23,30.7
0K,All Students,2020-21,11094,366,10728,96.7,65,5,7.7
0K,All Students,2021-22,11987,915,11072,92.4,75,23,30.7
0K,All Students,2022-23,11886,780,11106,93.4,69,12,17.4
1,All Students,2018-19,9626,409,9217,95.8,58,3,5.2
1,All Students,2019-20,6811,283,6528,95.8,60,5,8.3
1,All Students,2020-21,12313,305,12008,97.5,72,6,8.3
1,All Students,2021-22,9699,668,9031,93.1,57,12,21.1
1,All Students,2022-23,13446,700,12746,94.8,80,10,12.5
2,All Students,2019-20,6962,269,6693,96.1,63,3,4.8
2,All Students,2020-21,9884,200,9684,98.0,57,0,0.0
2,All Students,2021-22,12698,762,11936,94.0,79,17,21.5
2,All Students,2022-23,9661,442,9219,95.4,56,4,7.1
3,All Students,2020-21,9834,188,9646,98.1,58,1,1.7
3,All Students,2021-22,10252,549,9703,94.6,62,12,19.4
3,All Students,2022-23,17279,818,16461,95.3,103,16,15.5
4,All Students,2021-22,9825,487,9338,95.0,59,4,6.8
4,All Students,2022-23,10697,425,10272,96.0,63,9,14.3
5,All Students,2022-23,10596,408,10188,96.1,62,5,8.1
All Grades,All Students,2020-21,7184,246,6938,96.6,45,4,8.9
All Grades,All Students,2021-22,13631,1166,12465,91.4,82,26,31.7
All Grades,All Students,2022-23,18227,1756,16471,90.4,107,40,37.4
PK in K-12 Schools,All Students,2020-21,3088,s,s,s,s,s,s
PK in K-12 Schools,All Students,2021-22,5806,595,5211,89.8,33,15,45.5
PK in K-12 Schools,All Students,2022-23,5668,631,5037,88.9,32,15,46.9
0K,All Students,2020-21,3936,93,3843,97.6,25,2,8.0
0K,All Students,2021-22,4945,371,4574,92.5,31,8,25.8
0K,All Students,2022-23,6698,666,6032,90.1,41,18,43.9
1,All Students,2020-21,160,s,s,s,s,s,s
1,All Students,2021-22,2880,200,2680,93.1,18,3,16.7
1,All Students,2022-23,3897,281,3616,92.8,22,4,18.2
2,All Students,2022-23,1964,178,1786,90.9,12,3,25.0
All Grades,All Students,2018-19,593413,46881,546532,92.1,3691,819,22.2
All Grades,All Students,2019-20,375602,24585,351017,93.5,3489,617,17.7
All Grades,All Students,2020-21,588879,54695,534184,90.7,3412,1031,30.2
All Grades,All Students,2021-22,552073,50834,501239,90.8,3357,928,27.6
All Grades,All Students,2022-23,501808,56685,445123,88.7,3155,1051,33.3
9,All Students,2018-19,161514,12225,149289,92.4,1019,204,20.0
9,All Students,2019-20,104148,7088,97060,93.2,985,186,18.9
9,All Students,2020-21,167230,17624,149606,89.5,970,354,36.5
9,All Students,2021-22,139406,11244,128162,91.9,881,234,26.6
9,All Students,2022-23,125218,13432,111786,89.3,812,237,29.2
10,All Students,2018-19,148715,12001,136714,91.9,929,191,20.6
10,All Students,2019-20,98251,6689,91562,93.2,918,165,18.0
10,All Students,2020-21,146154,12956,133198,91.1,850,255,30.0
10,All Students,2021-22,146532,13482,133050,90.8,890,241,27.1
10,All Students,2022-23,123728,12900,110828,89.6,789,237,30.0
11,All Students,2018-19,140670,10429,130241,92.6,872,169,19.4
11,All Students,2019-20,87480,5636,81844,93.6,805,127,15.8
11,All Students,2020-21,150755,13514,137241,91.0,871,221,25.4
11,All Students,2021-22,136307,14430,121877,89.4,815,235,28.8
11,All Students,2022-23,137405,16828,120577,87.8,847,283,33.4
12,All Students,2018-19,142514,12226,130288,91.4,871,255,29.3
12,All Students,2019-20,85723,5172,80551,94.0,782,140,17.9
12,All Students,2020-21,124740,10601,114139,91.5,721,201,27.9
12,All Students,2021-22,129828,11678,118150,91.0,771,218,28.3
12,All Students,2022-23,115457,13525,101932,88.3,707,294,41.6
All Grades,All Students,2018-19,734893,57098,677795,92.2,4523,922,20.4
All Grades,All Students,2019-20,490696,30682,460014,93.7,4522,715,15.8
All Grades,All Students,2020-21,765700,58889,706811,92.3,4464,904,20.3
All Grades,All Students,2021-22,714462,73725,640737,89.7,4267,1178,27.6
All Grades,All Students,2022-23,700758,53685,647073,92.3,4403,921,20.9
9,All Students,2018-19,193074,16756,176318,91.3,1201,236,19.7
9,All Students,2019-20,133651,9677,123974,92.8,1242,207,16.7
9,All Students,2020-21,197601,16467,181134,91.7,1157,211,18.2
9,All Students,2021-22,178919,16331,162588,90.9,1084,241,22.2
9,All Students,2022-23,186046,13698,172348,92.6,1184,238,20.1
10,All Students,2018-19,185679,11818,173861,93.6,1151,166,14.4
10,All Students,2019-20,120143,6414,113729,94.7,1112,133,12.0
10,All Students,2020-21,204589,14627,189962,92.9,1194,205,17.2
10,All Students,2021-22,180851,15421,165430,91.5,1091,226,20.7
10,All Students,2022-23,181903,13792,168111,92.4,1154,232,20.1
11,All Students,2018-19,180204,10801,169403,94.0,1106,182,16.5
11,All Students,2019-20,118339,5219,113120,95.6,1093,119,10.9
11,All Students,2020-21,179080,11718,167362,93.5,1044,178,17.0
11,All Students,2021-22,174064,14665,159399,91.6,1031,229,22.2
11,All Students,2022-23,165054,11055,153999,93.3,1024,174,17.0
12,All Students,2018-19,175936,17723,158213,89.9,1065,338,31.7
12,All Students,2019-20,118563,9372,109191,92.1,1075,256,23.8
12,All Students,2020-21,184430,16077,168353,91.3,1069,310,29.0
12,All Students,2021-22,180628,27308,153320,84.9,1061,482,45.4
12,All Students,2022-23,167755,15140,152615,91.0,1041,277,26.6
All Grades,All Students,2018-19,190698,23118,167580,87.9,1225,447,36.5
All Grades,All Students,2019-20,126213,13949,112264,88.9,1216,394,32.4
All Grades,All Students,2020-21,197522,34749,162773,82.4,1174,540,46.0
All Grades,All Students,2021-22,184642,33718,150924,81.7,1196,666,55.7
All Grades,All Students,2022-23,173154,26633,146521,84.6,1148,522,45.5
9,All Students,2018-19,56609,6879,49730,87.8,374,140,37.4
9,All Students,2019-20,36384,4810,31574,86.8,364,134,36.8
9,All Students,2020-21,54878,11039,43839,79.9,331,169,51.1
9,All Students,2021-22,50597,7635,42962,84.9,335,167,49.9
9,All Students,2022-23,43748,6977,36771,84.1,308,143,46.4
10,All Students,2018-19,52256,5668,46588,89.2,343,105,30.6
10,All Students,2019-20,35986,4082,31904,88.7,346,133,38.4
10,All Students,2020-21,56089,11801,44288,79.0,334,172,51.5
10,All Students,2021-22,52842,11095,41747,79.0,346,202,58.4
10,All Students,2022-23,46088,6141,39947,86.7,308,117,38.0
11,All Students,2018-19,40068,4232,35836,89.4,252,78,31.0
11,All Students,2019-20,28162,2036,26126,92.8,268,54,20.1
11,All Students,2020-21,39500,4690,34810,88.1,232,82,35.3
11,All Students,2021-22,40470,6975,33495,82.8,259,137,52.9
11,All Students,2022-23,45796,7782,38014,83.0,294,140,47.6
12,All Students,2018-19,41765,6339,35426,84.8,256,124,48.4
12,All Students,2019-20,25681,3021,22660,88.2,239,74,31.0
12,All Students,2020-21,47055,7219,39836,84.7,277,117,42.2
12,All Students,2021-22,40733,8013,32720,80.3,256,160,62.5
12,All Students,2022-23,37522,5733,31789,84.7,238,122,51.3
All Grades,All Students,2018-19,466622,32618,434004,93.0,2915,625,21.4
All Grades,All Students,2019-20,321354,21612,299742,93.3,2926,634,21.7
All Grades,All Students,2020-21,497981,32563,465418,93.5,2983,548,18.4
All Grades,All Students,2021-22,493200,43628,449572,91.2,3031,844,27.8
All Grades,All Students,2022-23,495323,38617,456706,92.2,3081,728,23.6
8,All Students,2022-23,2,s,s,s,s,s,s
9,All Students,2018-19,175806,12975,162831,92.6,1078,231,21.4
9,All Students,2019-20,113036,7381,105655,93.5,1029,203,19.7
9,All Students,2020-21,174469,10185,164284,94.2,1013,146,14.4
9,All Students,2021-22,167874,13614,154260,91.9,1010,249,24.7
9,All Students,2022-23,147656,13114,134542,91.1,930,243,26.1
10,All Students,2018-19,99222,6182,93040,93.8,602,124,20.6
10,All Students,2019-20,67808,3967,63841,94.1,609,112,18.4
10,All Students,2020-21,103389,5520,97869,94.7,601,90,15.0
10,All Students,2021-22,125653,9771,115882,92.2,752,175,23.3
10,All Students,2022-23,135344,9014,126330,93.3,831,170,20.5
11,All Students,2018-19,107912,8072,99840,92.5,646,134,20.7
11,All Students,2019-20,71600,5696,65904,92.0,643,171,26.6
11,All Students,2020-21,119226,8766,110460,92.6,696,136,19.5
11,All Students,2021-22,109190,11396,97794,89.6,657,203,30.9
11,All Students,2022-23,127066,9948,117118,92.2,778,174,22.4
12,All Students,2018-19,83682,5389,78293,93.6,589,136,23.1
12,All Students,2019-20,68910,4568,64342,93.4,645,148,22.9
12,All Students,2020-21,100897,8092,92805,92.0,673,176,26.2
12,All Students,2021-22,90483,8847,81636,90.2,612,217,35.5
12,All Students,2022-23,85255,s,s,s,s,s,s
All Grades,All Students,2018-19,177223,17157,160066,90.3,1072,315,29.4
All Grades,All Students,2019-20,110881,8496,102385,92.3,1034,244,23.6
All Grades,All Students,2020-21,166967,25248,141719,84.9,967,386,39.9
All Grades,All Students,2021-22,153882,24021,129861,84.4,947,528,55.8
All Grades,All Students,2022-23,140589,19639,120950,86.0,902,460,51.0
9,All Students,2018-19,53256,4773,48483,91.0,323,80,24.8
9,All Students,2019-20,31889,2345,29544,92.6,302,71,23.5
9,All Students,2020-21,47233,8786,38447,81.4,274,131,47.8
9,All Students,2021-22,39061,5119,33942,86.9,252,126,50.0
9,All Students,2022-23,38682,4777,33905,87.7,261,115,44.1
10,All Students,2018-19,41514,4113,37401,90.1,251,58,23.1
10,All Students,2019-20,29628,2132,27496,92.8,274,55,20.1
10,All Students,2020-21,45227,6375,38852,85.9,262,93,35.5
10,All Students,2021-22,39922,5734,34188,85.6,241,111,46.1
10,All Students,2022-23,34730,4425,30305,87.3,225,101,44.9
11,All Students,2018-19,38441,1898,36543,95.1,233,26,11.2
11,All Students,2019-20,22107,1633,20474,92.6,206,42,20.4
11,All Students,2020-21,37429,3586,33843,90.4,216,58,26.9
11,All Students,2021-22,33845,4147,29698,87.7,210,88,41.9
11,All Students,2022-23,33238,4987,28251,85.0,208,107,51.4
12,All Students,2018-19,44012,6373,37639,85.5,265,151,57.0
12,All Students,2019-20,27257,2386,24871,91.2,252,76,30.2
12,All Students,2020-21,37078,6501,30577,82.5,215,104,48.4
12,All Students,2021-22,41054,9021,32033,78.0,244,203,83.2
12,All Students,2022-23,33939,5450,28489,83.9,208,137,65.9
All Grades,All Students,2018-19,114489,14877,99612,87.0,723,389,53.8
All Grades,All Students,2019-20,73073,8994,64079,87.7,681,346,50.8
All Grades,All Students,2020-21,107580,21590,85990,79.9,642,407,63.4
All Grades,All Students,2021-22,104045,18295,85750,82.4,636,448,70.4
All Grades,All Students,2022-23,110688,19590,91098,82.3,700,462,66.0
PK in K-12 Schools,All Students,2018-19,9582,1575,8007,83.6,63,40,63.5
PK in K-12 Schools,All Students,2019-20,7279,1212,6067,83.3,71,50,70.4
PK in K-12 Schools,All Students,2020-21,10019,2264,7755,77.4,60,46,76.7
PK in K-12 Schools,All Students,2021-22,11400,2333,9067,79.5,70,55,78.6
PK in K-12 Schools,All Students,2022-23,11188,2304,8884,79.4,71,50,70.4
0K,All Students,2018-19,11376,1871,9505,83.6,80,59,73.8
0K,All Students,2019-20,7355,966,6389,86.9,65,33,50.8
0K,All Students,2020-21,9998,1894,8104,81.1,60,34,56.7
0K,All Students,2021-22,9922,1688,8234,83.0,61,46,75.4
0K,All Students,2022-23,12469,2089,10380,83.2,77,43,55.8
1,All Students,2018-19,12856,1394,11462,89.2,80,37,46.3
1,All Students,2019-20,9104,1176,7928,87.1,88,48,54.5
1,All Students,2020-21,10671,2537,8134,76.2,63,42,66.7
1,All Students,2021-22,9992,1348,8644,86.5,61,36,59.0
1,All Students,2022-23,11840,2082,9758,82.4,78,57,73.1
2,All Students,2018-19,13324,2192,11132,83.5,82,56,68.3
2,All Students,2019-20,8120,861,7259,89.4,73,31,42.5
2,All Students,2020-21,12488,3027,9461,75.8,75,58,77.3
2,All Students,2021-22,10292,1849,8443,82.0,63,48,76.2
2,All Students,2022-23,10987,1714,9273,84.4,69,48,69.6
3,All Students,2018-19,11637,1345,10292,88.4,74,37,50.0
3,All Students,2019-20,7334,989,6345,86.5,67,38,56.7
3,All Students,2020-21,11836,2003,9833,83.1,71,45,63.4
3,All Students,2021-22,12699,2196,10503,82.7,78,54,69.2
3,All Students,2022-23,9923,1516,8407,84.7,62,37,59.7
4,All Students,2018-19,13174,1634,11540,87.6,80,42,52.5
4,All Students,2019-20,6544,791,5753,87.9,64,36,56.3
4,All Students,2020-21,11068,2130,8938,80.8,66,34,51.5
4,All Students,2021-22,11186,1803,9383,83.9,68,46,67.6
4,All Students,2022-23,12859,2165,10694,83.2,83,52,62.7
5,All Students,2018-19,10022,948,9074,90.5,65,27,41.5
5,All Students,2019-20,8608,867,7741,89.9,77,30,39.0
5,All Students,2020-21,9733,2026,7707,79.2,56,36,64.3
5,All Students,2021-22,10772,1937,8835,82.0,64,43,67.2
5,All Students,2022-23,12029,1929,10100,84.0,77,52,67.5
6,All Students,2018-19,12539,1317,11222,89.5,75,30,40.0
6,All Students,2019-20,5587,564,5023,89.9,53,18,34.0
6,All Students,2020-21,11821,1880,9941,84.1,72,38,52.8
6,All Students,2021-22,7446,1521,5925,79.6,47,36,76.6
6,All Students,2022-23,10249,1921,8328,81.3,63,38,60.3
7,All Students,2018-19,9012,1287,7725,85.7,55,31,56.4
7,All Students,2019-20,7420,711,6709,90.4,70,26,37.1
7,All Students,2020-21,9340,1950,7390,79.1,55,38,69.1
7,All Students,2021-22,11213,1977,9236,82.4,71,50,70.4
7,All Students,2022-23,7711,1697,6014,78.0,48,30,62.5
8,All Students,2018-19,10967,1314,9653,88.0,69,30,43.5
8,All Students,2019-20,5722,857,4865,85.0,53,36,67.9
8,All Students,2020-21,10606,1879,8727,82.3,64,36,56.3
8,All Students,2021-22,9123,1643,7480,82.0,53,34,64.2
8,All Students,2022-23,11433,2173,9260,81.0,72,55,76.4
All Grades,All Students,2018-19,155901,16693,139208,89.3,1000,442,44.2
All Grades,All Students,2019-20,97431,11811,85620,87.9,912,407,44.6
All Grades,All Students,2020-21,136515,28404,108111,79.2,830,488,58.8
All Grades,All Students,2021-22,130956,28598,102358,78.2,844,632,74.9
All Grades,All Students,2022-23,117155,23338,93817,80.1,752,536,71.3
PK in K-12 Schools,All Students,2018-19,14945,2376,12569,84.1,96,61,63.5
PK in K-12 Schools,All Students,2019-20,9231,1450,7781,84.3,87,52,59.8
PK in K-12 Schools,All Students,2020-21,11935,2711,9224,77.3,78,48,61.5
PK in K-12 Schools,All Students,2021-22,12666,3367,9299,73.4,85,76,89.4
PK in K-12 Schools,All Students,2022-23,12300,3302,8998,73.2,78,64,82.1
0K,All Students,2018-19,14839,1895,12944,87.2,103,58,56.3
0K,All Students,2019-20,10488,1469,9019,86.0,103,52,50.5
0K,All Students,2020-21,12512,3934,8578,68.6,82,65,79.3
0K,All Students,2021-22,12600,2980,9620,76.3,92,66,71.7
0K,All Students,2022-23,12279,2354,9925,80.8,86,64,74.4
1,All Students,2018-19,14870,1586,13284,89.3,99,44,44.4
1,All Students,2019-20,8835,935,7900,89.4,84,39,46.4
1,All Students,2020-21,15066,3247,11819,78.4,91,55,60.4
1,All Students,2021-22,11833,2984,8849,74.8,78,64,82.1
1,All Students,2022-23,11697,2676,9021,77.1,74,53,71.6
2,All Students,2018-19,16584,1873,14711,88.7,113,56,49.6
2,All Students,2019-20,8590,837,7753,90.3,79,26,32.9
2,All Students,2020-21,12120,2338,9782,80.7,74,40,54.1
2,All Students,2021-22,15099,2993,12106,80.2,97,66,68.0
2,All Students,2022-23,11014,2082,8932,81.1,71,55,77.5
3,All Students,2018-19,16128,1772,14356,89.0,109,56,51.4
3,All Students,2019-20,10381,1253,9128,87.9,101,47,46.5
3,All Students,2020-21,12398,1909,10489,84.6,77,39,50.6
3,All Students,2021-22,12570,2300,10270,81.7,79,53,67.1
3,All Students,2022-23,13181,2067,11114,84.3,87,61,70.1
4,All Students,2018-19,17356,1403,15953,91.9,112,38,33.9
4,All Students,2019-20,10804,1510,9294,86.0,103,53,51.5
4,All Students,2020-21,16331,3566,12765,78.2,97,55,56.7
4,All Students,2021-22,13327,3143,10184,76.4,85,71,83.5
4,All Students,2022-23,12329,2128,10201,82.7,79,53,67.1
5,All Students,2018-19,20601,2026,18575,90.2,129,43,33.3
5,All Students,2019-20,11242,1133,10109,89.9,106,46,43.4
5,All Students,2020-21,14878,2425,12453,83.7,88,52,59.1
5,All Students,2021-22,14833,3007,11826,79.7,92,63,68.5
5,All Students,2022-23,13269,2548,10721,80.8,85,59,69.4
6,All Students,2018-19,15546,1376,14170,91.1,90,33,36.7
6,All Students,2019-20,10290,1384,8906,86.6,93,37,39.8
6,All Students,2020-21,15214,2157,13057,85.8,92,38,41.3
6,All Students,2021-22,12960,2694,10266,79.2,79,64,81.0
6,All Students,2022-23,10991,2108,8883,80.8,68,45,66.2
7,All Students,2018-19,14070,1382,12688,90.2,84,31,36.9
7,All Students,2019-20,9078,948,8130,89.6,80,27,33.8
7,All Students,2020-21,14212,3881,10331,72.7,82,57,69.5
7,All Students,2021-22,12566,2659,9907,78.8,81,58,71.6
7,All Students,2022-23,9662,s,s,s,s,s,s
8,All Students,2018-19,10962,1004,9958,90.8,65,22,33.8
8,All Students,2019-20,8492,892,7600,89.5,76,28,36.8
8,All Students,2020-21,11792,2202,9590,81.3,68,38,55.9
8,All Students,2021-22,12502,2471,10031,80.2,76,51,67.1
8,All Students,2022-23,10426,2126,8300,79.6,63,38,60.3
9,All Students,2022-23,7,s,s,s,s,s,s
All Grades,All Students,2018-19,55259,4625,50634,91.6,362,129,35.6
All Grades,All Students,2019-20,37453,3299,34154,91.2,362,129,35.6
All Grades,All Students,2020-21,52617,5776,46841,89.0,329,135,41.0
All Grades,All Students,2021-22,48298,6848,41450,85.8,308,182,59.1
All Grades,All Students,2022-23,52085,7322,44763,85.9,370,220,59.5
PK in K-12 Schools,All Students,2018-19,10004,1334,8670,86.7,64,36,56.3
PK in K-12 Schools,All Students,2019-20,8382,1074,7308,87.2,86,49,57.0
PK in K-12 Schools,All Students,2020-21,9704,881,8823,90.9,65,20,30.8
PK in K-12 Schools,All Students,2021-22,9217,2024,7193,78.0,59,47,79.7
PK in K-12 Schools,All Students,2022-23,9778,1898,7880,80.6,71,56,78.9
0K,All Students,2018-19,6920,664,6256,90.4,47,16,34.0
0K,All Students,2019-20,5378,609,4769,88.7,51,24,47.1
0K,All Students,2020-21,7513,780,6733,89.6,49,19,38.8
0K,All Students,2021-22,8275,1280,6995,84.5,51,36,70.6
0K,All Students,2022-23,7364,1275,6089,82.7,57,40,70.2
1,All Students,2018-19,7411,689,6722,90.7,49,20,40.8
1,All Students,2019-20,4170,334,3836,92.0,41,11,26.8
1,All Students,2020-21,7573,942,6631,87.6,45,20,44.4
1,All Students,2021-22,6685,738,5947,89.0,43,21,48.8
1,All Students,2022-23,7865,996,6869,87.3,52,29,55.8
2,All Students,2018-19,7039,420,6619,94.0,45,11,24.4
2,All Students,2019-20,4546,360,4186,92.1,44,13,29.5
2,All Students,2020-21,5780,801,4979,86.1,35,21,60.0
2,All Students,2021-22,6187,845,5342,86.3,40,22,55.0
2,All Students,2022-23,6829,821,6008,88.0,44,23,52.3
3,All Students,2018-19,8624,574,8050,93.3,57,17,29.8
3,All Students,2019-20,4540,329,4211,92.8,43,12,27.9
3,All Students,2020-21,7187,832,6355,88.4,45,17,37.8
3,All Students,2021-22,4465,512,3953,88.5,30,14,46.7
3,All Students,2022-23,6688,849,5839,87.3,50,22,44.0
4,All Students,2018-19,7030,388,6642,94.5,45,11,24.4
4,All Students,2019-20,5700,360,5340,93.7,54,14,25.9
4,All Students,2020-21,6324,665,5659,89.5,38,14,36.8
4,All Students,2021-22,6471,705,5766,89.1,39,19,48.7
4,All Students,2022-23,5738,593,5145,89.7,42,19,45.2
5,All Students,2018-19,8231,556,7675,93.2,55,18,32.7
5,All Students,2019-20,4737,233,4504,95.1,43,6,14.0
5,All Students,2020-21,8536,875,7661,89.7,52,24,46.2
5,All Students,2021-22,6998,744,6254,89.4,46,23,50.0
5,All Students,2022-23,7823,890,6933,88.6,54,31,57.4
All Grades,All Students,2018-19,43733,2809,40924,93.6,253,51,20.2
All Grades,All Students,2019-20,29509,1961,27548,93.4,261,52,19.9
All Grades,All Students,2020-21,43249,3019,40230,93.0,251,54,21.5
All Grades,All Students,2021-22,44790,5233,39557,88.3,264,122,46.2
All Grades,All Students,2022-23,45742,5422,40320,88.1,274,136,49.6
PK in K-12 Schools,All Students,2018-19,5776,531,5245,90.8,33,14,42.4
PK in K-12 Schools,All Students,2019-20,3791,404,3387,89.3,33,11,33.3
PK in K-12 Schools,All Students,2020-21,5581,480,5101,91.4,32,10,31.3
PK in K-12 Schools,All Students,2021-22,5390,1006,4384,81.3,32,24,75.0
PK in K-12 Schools,All Students,2022-23,5427,965,4462,82.2,32,24,75.0
0K,All Students,2018-19,3560,303,3257,91.5,20,7,35.0
0K,All Students,2019-20,2709,160,2549,94.1,25,6,24.0
0K,All Students,2020-21,4221,293,3928,93.1,24,6,25.0
0K,All Students,2021-22,4390,525,3865,88.0,26,13,50.0
0K,All Students,2022-23,4526,767,3759,83.1,26,18,69.2
1,All Students,2018-19,5198,302,4896,94.2,30,4,13.3
1,All Students,2019-20,2300,114,2186,95.0,20,1,5.0
1,All Students,2020-21,3566,203,3363,94.3,21,2,9.5
1,All Students,2021-22,4817,435,4382,91.0,29,12,41.4
1,All Students,2022-23,4644,492,4152,89.4,28,17,60.7
2,All Students,2018-19,4886,288,4598,94.1,28,4,14.3
2,All Students,2019-20,3565,163,3402,95.4,31,3,9.7
2,All Students,2020-21,3500,143,3357,95.9,20,3,15.0
2,All Students,2021-22,4046,394,3652,90.3,24,9,37.5
2,All Students,2022-23,5030,393,4637,92.2,30,11,36.7
3,All Students,2018-19,3512,204,3308,94.2,21,3,14.3
3,All Students,2019-20,3137,185,2952,94.1,28,3,10.7
3,All Students,2020-21,5095,175,4920,96.6,29,2,6.9
3,All Students,2021-22,4423,368,4055,91.7,25,7,28.0
3,All Students,2022-23,4887,496,4391,89.9,29,9,31.0
4,All Students,2018-19,6391,344,6047,94.6,38,7,18.4
4,All Students,2019-20,2530,133,2397,94.7,22,5,22.7
4,All Students,2020-21,4325,199,4126,95.4,26,3,11.5
4,All Students,2021-22,5229,478,4751,90.9,30,12,40.0
4,All Students,2022-23,4405,374,4031,91.5,26,11,42.3
5,All Students,2018-19,5042,310,4732,93.9,29,5,17.2
5,All Students,2019-20,4255,322,3933,92.4,37,11,29.7
5,All Students,2020-21,3241,172,3069,94.7,20,5,25.0
5,All Students,2021-22,5229,435,4794,91.7,30,8,26.7
5,All Students,2022-23,5538,513,5025,90.7,34,14,41.2
6,All Students,2018-19,4611,309,4302,93.3,26,6,23.1
6,All Students,2019-20,2224,171,2053,92.3,20,6,30.0
6,All Students,2020-21,5244,407,4837,92.2,30,7,23.3
6,All Students,2021-22,2583,313,2270,87.9,17,7,41.2
6,All Students,2022-23,4533,404,4129,91.1,27,9,33.3
7,All Students,2018-19,2799,113,2686,96.0,17,0,0.0
7,All Students,2019-20,3105,195,2910,93.7,28,5,17.9
7,All Students,2020-21,3500,384,3116,89.0,20,5,25.0
7,All Students,2021-22,5047,643,4404,87.3,30,15,50.0
7,All Students,2022-23,2244,242,2002,89.2,15,7,46.7
8,All Students,2018-19,1958,105,1853,94.6,11,1,9.1
8,All Students,2019-20,1893,114,1779,94.0,17,1,5.9
8,All Students,2020-21,4976,563,4413,88.7,29,11,37.9
8,All Students,2021-22,3636,636,3000,82.5,21,15,71.4
8,All Students,2022-23,4508,776,3732,82.8,27,16,59.3
All Grades,All Students,2018-19,43739,4169,39570,90.5,262,115,43.9
All Grades,All Students,2019-20,25020,2356,22664,90.6,231,84,36.4
All Grades,All Students,2020-21,36637,3044,33593,91.7,225,67,29.8
All Grades,All Students,2021-22,33518,4346,29172,87.0,211,106,50.2
All Grades,All Students,2022-23,35862,4976,30886,86.1,233,125,53.6
PK in K-12 Schools,All Students,2018-19,6314,656,5658,89.6,37,19,51.4
PK in K-12 Schools,All Students,2019-20,4011,412,3599,89.7,39,15,38.5
PK in K-12 Schools,All Students,2020-21,5521,500,5021,90.9,38,16,42.1
PK in K-12 Schools,All Students,2021-22,6222,809,5413,87.0,38,20,52.6
PK in K-12 Schools,All Students,2022-23,6155,783,5372,87.3,40,20,50.0
0K,All Students,2018-19,17423,1807,15616,89.6,109,51,46.8
0K,All Students,2019-20,11202,1174,10028,89.5,103,47,45.6
0K,All Students,2020-21,15797,1689,14108,89.3,97,34,35.1
0K,All Students,2021-22,12594,1690,10904,86.6,84,46,54.8
0K,All Students,2022-23,17385,2640,14745,84.8,116,68,58.6
1,All Students,2018-19,20002,1706,18296,91.5,116,45,38.8
1,All Students,2019-20,9807,770,9037,92.1,89,22,24.7
1,All Students,2020-21,15319,855,14464,94.4,90,17,18.9
1,All Students,2021-22,14702,1847,12855,87.4,89,40,44.9
1,All Students,2022-23,12322,1553,10769,87.4,77,37,48.1
All Grades,All Students,2018-19,41984,4355,37629,89.6,276,111,40.2
All Grades,All Students,2019-20,19789,1846,17943,90.7,194,75,38.7
All Grades,All Students,2020-21,28094,4620,23474,83.6,175,89,50.9
All Grades,All Students,2021-22,37208,5752,31456,84.5,243,146,60.1
All Grades,All Students,2022-23,37209,4325,32884,88.4,250,127,50.8
6,All Students,2018-19,9328,s,s,s,s,s,s
6,All Students,2019-20,4756,s,s,s,s,s,s
6,All Students,2020-21,9786,1725,8061,82.4,62,30,48.4
6,All Students,2021-22,12357,1752,10605,85.8,82,49,59.8
6,All Students,2022-23,8018,905,7113,88.7,58,28,48.3
7,All Students,2018-19,14475,1521,12954,89.5,93,36,38.7
7,All Students,2019-20,6428,614,5814,90.4,64,28,43.8
7,All Students,2020-21,7790,1336,6454,82.8,48,23,47.9
7,All Students,2021-22,13760,2178,11582,84.2,88,51,58.0
7,All Students,2022-23,14678,1776,12902,87.9,95,46,48.4
8,All Students,2018-19,18177,1819,16358,90.0,118,44,37.3
8,All Students,2019-20,8603,764,7839,91.1,83,29,34.9
8,All Students,2020-21,10518,1559,8959,85.2,65,36,55.4
8,All Students,2021-22,11091,1822,9269,83.6,73,46,63.0
8,All Students,2022-23,14513,1644,12869,88.7,97,53,54.6
9,All Students,2018-19,4,s,s,s,s,s,s
9,All Students,2019-20,2,s,s,s,s,s,s
All Grades,All Students,2018-19,63992,3546,60446,94.5,383,68,17.8
All Grades,All Students,2019-20,42752,2609,40143,93.9,385,82,21.3
All Grades,All Students,2020-21,57793,3766,54027,93.5,339,77,22.7
All Grades,All Students,2021-22,55332,4980,50352,91.0,332,120,36.1
All Grades,All Students,2022-23,57241,5101,52140,91.1,341,111,32.6
2,All Students,2018-19,15583,927,14656,94.1,93,21,22.6
2,All Students,2019-20,12631,868,11763,93.1,115,34,29.6
2,All Students,2020-21,14217,1355,12862,90.5,84,32,38.1
2,All Students,2021-22,13774,1380,12394,90.0,84,34,40.5
2,All Students,2022-23,13983,1560,12423,88.8,85,38,44.7
3,All Students,2018-19,16200,867,15333,94.6,95,14,14.7
3,All Students,2019-20,9132,595,8537,93.5,81,18,22.2
3,All Students,2020-21,16986,1181,15805,93.0,100,23,23.0
3,All Students,2021-22,14276,1170,13106,91.8,86,26,30.2
3,All Students,2022-23,15382,1318,14064,91.4,92,32,34.8
4,All Students,2018-19,16171,848,15323,94.8,99,18,18.2
4,All Students,2019-20,10724,539,10185,95.0,94,12,12.8
4,All Students,2020-21,12542,509,12033,95.9,74,9,12.2
4,All Students,2021-22,16224,1488,14736,90.8,96,38,39.6
4,All Students,2022-23,12771,944,11827,92.6,75,16,21.3
5,All Students,2018-19,16038,904,15134,94.4,96,15,15.6
5,All Students,2019-20,10265,607,9658,94.1,95,18,18.9
5,All Students,2020-21,14048,721,13327,94.9,81,13,16.0
5,All Students,2021-22,11058,942,10116,91.5,66,22,33.3
5,All Students,2022-23,15105,1279,13826,91.5,89,25,28.1
All Grades,All Students,2018-19,209293,14798,194495,92.9,1244,318,25.6
All Grades,All Students,2019-20,131590,10011,121579,92.4,1191,332,27.9
All Grades,All Students,2020-21,184504,14798,169706,92.0,1091,277,25.4
All Grades,All Students,2021-22,179777,20010,159767,88.9,1084,479,44.2
All Grades,All Students,2022-23,178236,18324,159912,89.7,1090,445,40.8
PK in K-12 Schools,All Students,2018-19,23156,2697,20459,88.4,138,68,49.3
PK in K-12 Schools,All Students,2019-20,18490,2353,16137,87.3,170,89,52.4
PK in K-12 Schools,All Students,2020-21,22499,2579,19920,88.5,133,62,46.6
PK in K-12 Schools,All Students,2021-22,24231,3769,20462,84.4,150,98,65.3
PK in K-12 Schools,All Students,2022-23,27615,4484,23131,83.8,171,125,73.1
0K,All Students,2018-19,29658,2485,27173,91.6,181,58,32.0
0K,All Students,2019-20,17499,1407,16092,92.0,158,49,31.0
0K,All Students,2020-21,26037,3209,22828,87.7,157,56,35.7
0K,All Students,2021-22,24822,3001,21821,87.9,150,82,54.7
0K,All Students,2022-23,22664,2895,19769,87.2,143,77,53.8
1,All Students,2018-19,26966,1863,25103,93.1,165,43,26.1
1,All Students,2019-20,17744,1315,16429,92.6,162,42,25.9
1,All Students,2020-21,25166,1757,23409,93.0,148,34,23.0
1,All Students,2021-22,24200,3034,21166,87.5,148,73,49.3
1,All Students,2022-23,24877,2442,22435,90.2,149,57,38.3
2,All Students,2018-19,32528,2123,30405,93.5,190,40,21.1
2,All Students,2019-20,17778,1271,16507,92.9,161,39,24.2
2,All Students,2020-21,24482,2402,22080,90.2,147,46,31.3
2,All Students,2021-22,26640,2698,23942,89.9,161,70,43.5
2,All Students,2022-23,24035,2488,21547,89.6,147,53,36.1
3,All Students,2018-19,33035,1994,31041,94.0,194,39,20.1
3,All Students,2019-20,19716,1159,18557,94.1,181,36,19.9
3,All Students,2020-21,26972,1857,25115,93.1,157,30,19.1
3,All Students,2021-22,25452,2691,22761,89.4,150,61,40.7
3,All Students,2022-23,25811,1892,23919,92.7,161,48,29.8
4,All Students,2018-19,28306,1634,26672,94.2,168,31,18.5
4,All Students,2019-20,20565,1250,19315,93.9,182,39,21.4
4,All Students,2020-21,28462,1611,26851,94.3,168,25,14.9
4,All Students,2021-22,26927,2384,24543,91.1,160,47,29.4
4,All Students,2022-23,25599,2179,23420,91.5,156,46,29.5
5,All Students,2018-19,35644,2002,33642,94.4,208,39,18.8
5,All Students,2019-20,19798,1256,18542,93.7,177,38,21.5
5,All Students,2020-21,30886,1383,29503,95.5,181,24,13.3
5,All Students,2021-22,27505,2433,25072,91.2,165,48,29.1
5,All Students,2022-23,27635,1944,25691,93.0,163,39,23.9
All Grades,All Students,2018-19,161754,9928,151826,93.9,956,191,20.0
All Grades,All Students,2019-20,106575,6434,100141,94.0,963,183,19.0
All Grades,All Students,2020-21,155236,10562,144674,93.2,913,183,20.0
All Grades,All Students,2021-22,146892,15151,131741,89.7,893,342,38.3
All Grades,All Students,2022-23,144454,14322,130132,90.1,891,342,38.4
PK in K-12 Schools,All Students,2018-19,6388,486,5902,92.4,37,10,27.0
PK in K-12 Schools,All Students,2019-20,6191,466,5725,92.5,55,14,25.5
PK in K-12 Schools,All Students,2020-21,9321,1140,8181,87.8,55,24,43.6
PK in K-12 Schools,All Students,2021-22,9450,1357,8093,85.6,58,35,60.3
PK in K-12 Schools,All Students,2022-23,9204,1290,7914,86.0,55,33,60.0
0K,All Students,2018-19,27198,2312,24886,91.5,164,52,31.7
0K,All Students,2019-20,16276,1369,14907,91.6,150,55,36.7
0K,All Students,2020-21,22426,2477,19949,89.0,136,40,29.4
0K,All Students,2021-22,21945,2940,19005,86.6,140,83,59.3
0K,All Students,2022-23,23588,2722,20866,88.5,150,74,49.3
1,All Students,2018-19,28336,1844,26492,93.5,167,36,21.6
1,All Students,2019-20,16442,1039,15403,93.7,150,29,19.3
1,All Students,2020-21,22128,1350,20778,93.9,132,18,13.6
1,All Students,2021-22,21576,2127,19449,90.1,131,47,35.9
1,All Students,2022-23,22631,2328,20303,89.7,139,54,38.8
2,All Students,2018-19,25204,1415,23789,94.4,149,23,15.4
2,All Students,2019-20,18217,1171,17046,93.6,167,32,19.2
2,All Students,2020-21,25202,1651,23551,93.4,146,32,21.9
2,All Students,2021-22,21330,2122,19208,90.1,129,46,35.7
2,All Students,2022-23,22319,2131,20188,90.5,141,53,37.6
3,All Students,2018-19,26584,1418,25166,94.7,156,23,14.7
3,All Students,2019-20,16821,882,15939,94.8,150,22,14.7
3,All Students,2020-21,25410,1482,23928,94.2,149,27,18.1
3,All Students,2021-22,24257,2222,22035,90.8,146,43,29.5
3,All Students,2022-23,18890,1704,17186,91.0,119,40,33.6
4,All Students,2018-19,24153,1166,22987,95.2,143,23,16.1
4,All Students,2019-20,17289,920,16369,94.7,157,25,15.9
4,All Students,2020-21,25494,983,24511,96.1,149,15,10.1
4,All Students,2021-22,23472,2383,21089,89.8,143,52,36.4
4,All Students,2022-23,24518,1958,22560,92.0,146,43,29.5
5,All Students,2018-19,23891,1287,22604,94.6,140,24,17.1
5,All Students,2019-20,15339,587,14752,96.2,134,6,4.5
5,All Students,2020-21,25255,1479,23776,94.1,146,27,18.5
5,All Students,2021-22,24862,2000,22862,92.0,146,36,24.7
5,All Students,2022-23,23304,2189,21115,90.6,141,45,31.9
All Grades,All Students,2018-19,214431,16351,198080,92.4,1289,362,28.1
All Grades,All Students,2019-20,135441,10252,125189,92.4,1237,330,26.7
All Grades,All Students,2020-21,191825,14336,177489,92.5,1135,263,23.2
All Grades,All Students,2021-22,184066,20168,163898,89.0,1116,474,42.5
All Grades,All Students,2022-23,180880,19401,161479,89.3,1115,470,42.2
PK in K-12 Schools,All Students,2018-19,16974,2330,14644,86.3,104,61,58.7
PK in K-12 Schools,All Students,2019-20,14254,1700,12554,88.1,134,64,47.8
PK in K-12 Schools,All Students,2020-21,20616,3083,17533,85.0,123,58,47.2
PK in K-12 Schools,All Students,2021-22,21602,4073,17529,81.1,138,94,68.1
PK in K-12 Schools,All Students,2022-23,22521,4224,18297,81.2,137,98,71.5
0K,All Students,2018-19,28943,2853,26090,90.1,177,75,42.4
0K,All Students,2019-20,19254,1864,17390,90.3,178,65,36.5
0K,All Students,2020-21,24995,3191,21804,87.2,153,59,38.6
0K,All Students,2021-22,25956,3180,22776,87.7,159,79,49.7
0K,All Students,2022-23,26151,3546,22605,86.4,167,96,57.5
1,All Students,2018-19,27947,2084,25863,92.5,177,47,26.6
1,All Students,2019-20,18860,1488,17372,92.1,171,52,30.4
1,All Students,2020-21,29556,2305,27251,92.2,174,47,27.0
1,All Students,2021-22,25847,3269,22578,87.4,156,83,53.2
1,All Students,2022-23,28036,2742,25294,90.2,170,66,38.8
2,All Students,2018-19,33455,2369,31086,92.9,203,52,25.6
2,All Students,2019-20,18559,1317,17242,92.9,169,38,22.5
2,All Students,2020-21,27690,1563,26127,94.4,164,26,15.9
2,All Students,2021-22,26294,2459,23835,90.6,158,56,35.4
2,All Students,2022-23,25360,2430,22930,90.4,159,64,40.3
3,All Students,2018-19,31479,2339,29140,92.6,188,51,27.1
3,All Students,2019-20,21638,1386,20252,93.6,197,41,20.8
3,All Students,2020-21,27245,1502,25743,94.5,161,23,14.3
3,All Students,2021-22,26515,2327,24188,91.2,159,51,32.1
3,All Students,2022-23,26380,2244,24136,91.5,159,51,32.1
4,All Students,2018-19,35749,1997,33752,94.4,211,33,15.6
4,All Students,2019-20,19332,1249,18083,93.5,178,43,24.2
4,All Students,2020-21,32526,1176,31350,96.4,190,20,10.5
4,All Students,2021-22,26419,2338,24081,91.2,159,50,31.4
4,All Students,2022-23,26915,2162,24753,92.0,167,47,28.1
5,All Students,2018-19,39884,2379,37505,94.0,229,43,18.8
5,All Students,2019-20,23544,1248,22296,94.7,210,27,12.9
5,All Students,2020-21,29197,1516,27681,94.8,170,30,17.6
5,All Students,2021-22,31433,2522,28911,92.0,187,61,32.6
5,All Students,2022-23,25517,2053,23464,92.0,156,48,30.8
All Grades,All Students,2018-19,98099,6188,91911,93.7,578,131,22.7
All Grades,All Students,2019-20,59954,4146,55808,93.1,545,116,21.3
All Grades,All Students,2020-21,83315,6307,77008,92.4,488,128,26.2
All Grades,All Students,2021-22,83066,10921,72145,86.9,502,259,51.6
All Grades,All Students,2022-23,81936,9667,72269,88.2,506,222,43.9
PK in K-12 Schools,All Students,2019-20,3576,509,3067,85.8,34,21,61.8
PK in K-12 Schools,All Students,2020-21,5711,s,s,s,s,s,s
PK in K-12 Schools,All Students,2021-22,5494,1433,4061,73.9,34,29,85.3
PK in K-12 Schools,All Students,2022-23,5394,1382,4012,74.4,33,29,87.9
0K,All Students,2018-19,12510,1040,11470,91.7,77,25,32.5
0K,All Students,2019-20,8757,759,7998,91.3,81,22,27.2
0K,All Students,2020-21,9292,1229,8063,86.8,56,26,46.4
0K,All Students,2021-22,15944,2470,13474,84.5,97,67,69.1
0K,All Students,2022-23,14009,2339,11670,83.3,88,59,67.0
1,All Students,2018-19,13547,958,12589,92.9,81,25,30.9
1,All Students,2019-20,7274,545,6729,92.5,68,18,26.5
1,All Students,2020-21,14363,1263,13100,91.2,85,29,34.1
1,All Students,2021-22,10144,1801,8343,82.2,62,40,64.5
1,All Students,2022-23,15802,2140,13662,86.5,97,49,50.5
2,All Students,2018-19,17227,1308,15919,92.4,99,23,23.2
2,All Students,2019-20,7985,452,7533,94.3,72,11,15.3
2,All Students,2020-21,11055,636,10419,94.2,64,11,17.2
2,All Students,2021-22,14234,1955,12279,86.3,86,54,62.8
2,All Students,2022-23,9555,1254,8301,86.9,57,28,49.1
3,All Students,2018-19,18754,1047,17707,94.4,111,25,22.5
3,All Students,2019-20,10272,743,9529,92.8,91,14,15.4
3,All Students,2020-21,12141,712,11429,94.1,73,12,16.4
3,All Students,2021-22,11169,985,10184,91.2,68,21,30.9
3,All Students,2022-23,14387,1221,13166,91.5,93,30,32.3
4,All Students,2018-19,16407,964,15443,94.1,97,18,18.6
4,All Students,2019-20,11802,616,11186,94.8,105,14,13.3
4,All Students,2020-21,15076,927,14149,93.9,87,17,19.5
4,All Students,2021-22,11410,1228,10182,89.2,69,27,39.1
4,All Students,2022-23,11045,680,10365,93.8,68,14,20.6
5,All Students,2018-19,19654,871,18783,95.6,113,15,13.3
5,All Students,2019-20,10288,522,9766,94.9,94,16,17.0
5,All Students,2020-21,15510,891,14619,94.3,89,14,15.7
5,All Students,2021-22,14671,1049,13622,92.8,86,21,24.4
5,All Students,2022-23,11744,651,11093,94.5,70,13,18.6
6,All Students,2020-21,167,s,s,s,s,s,s
All Grades,All Students,2018-19,81991,7005,74986,91.5,504,174,34.5
All Grades,All Students,2019-20,53737,4461,49276,91.7,493,154,31.2
All Grades,All Students,2020-21,73996,6602,67394,91.1,440,138,31.4
All Grades,All Students,2021-22,69169,8872,60297,87.2,414,212,51.2
All Grades,All Students,2022-23,67139,7599,59540,88.7,421,193,45.8
PK in K-12 Schools,All Students,2018-19,5675,920,4755,83.8,34,23,67.6
PK in K-12 Schools,All Students,2019-20,5243,906,4337,82.7,48,34,70.8
PK in K-12 Schools,All Students,2020-21,7010,991,6019,85.9,41,23,56.1
PK in K-12 Schools,All Students,2021-22,8436,2030,6406,75.9,50,41,82.0
PK in K-12 Schools,All Students,2022-23,7087,1396,5691,80.3,47,36,76.6
0K,All Students,2018-19,10556,1172,9384,88.9,71,36,50.7
0K,All Students,2019-20,8493,836,7657,90.2,82,36,43.9
0K,All Students,2020-21,10172,1288,8884,87.3,65,31,47.7
0K,All Students,2021-22,11844,1672,10172,85.9,73,48,65.8
0K,All Students,2022-23,9008,1309,7699,85.5,56,36,64.3
1,All Students,2018-19,14475,1416,13059,90.2,92,40,43.5
1,All Students,2019-20,6748,587,6161,91.3,63,21,33.3
1,All Students,2020-21,11695,1242,10453,89.4,68,25,36.8
1,All Students,2021-22,9717,1162,8555,88.0,60,26,43.3
1,All Students,2022-23,11341,1280,10061,88.7,69,36,52.2
2,All Students,2018-19,11318,937,10381,91.7,69,21,30.4
2,All Students,2019-20,7842,525,7317,93.3,71,15,21.1
2,All Students,2020-21,10140,949,9191,90.6,62,21,33.9
2,All Students,2021-22,9980,911,9069,90.9,58,24,41.4
2,All Students,2022-23,10066,943,9123,90.6,62,21,33.9
3,All Students,2018-19,14541,949,13592,93.5,86,21,24.4
3,All Students,2019-20,7001,468,6533,93.3,65,17,26.2
3,All Students,2020-21,11435,622,10813,94.6,66,10,15.2
3,All Students,2021-22,9058,944,8114,89.6,54,26,48.1
3,All Students,2022-23,10430,1015,9415,90.3,66,25,37.9
4,All Students,2018-19,12984,890,12094,93.1,79,22,27.8
4,All Students,2019-20,9368,555,8813,94.1,83,15,18.1
4,All Students,2020-21,9744,740,9004,92.4,58,13,22.4
4,All Students,2021-22,10905,1176,9729,89.2,65,28,43.1
4,All Students,2022-23,8978,819,8159,90.9,58,21,36.2
5,All Students,2018-19,12442,721,11721,94.2,73,11,15.1
5,All Students,2019-20,9042,584,8458,93.5,81,16,19.8
5,All Students,2020-21,13800,770,13030,94.4,80,15,18.8
5,All Students,2021-22,9229,977,8252,89.4,54,19,35.2
5,All Students,2022-23,10229,837,9392,91.8,63,18,28.6
All Grades,All Students,2018-19,86446,5832,80614,93.3,511,123,24.1
All Grades,All Students,2019-20,54744,3597,51147,93.4,501,99,19.8
All Grades,All Students,2020-21,85891,5342,80549,93.8,513,106,20.7
All Grades,All Students,2021-22,82150,7182,74968,91.3,492,168,34.1
All Grades,All Students,2022-23,90146,7775,82371,91.4,541,168,31.1
PK in K-12 Schools,All Students,2018-19,6345,556,5789,91.2,38,13,34.2
PK in K-12 Schools,All Students,2019-20,4114,339,3775,91.8,38,8,21.1
PK in K-12 Schools,All Students,2020-21,8606,744,7862,91.4,54,19,35.2
PK in K-12 Schools,All Students,2021-22,8950,1211,7739,86.5,51,33,64.7
PK in K-12 Schools,All Students,2022-23,8943,1123,7820,87.4,53,29,54.7
0K,All Students,2018-19,14549,1149,13400,92.1,86,28,32.6
0K,All Students,2019-20,9682,907,8775,90.6,94,31,33.0
0K,All Students,2020-21,15770,1066,14704,93.2,93,22,23.7
0K,All Students,2021-22,14099,1328,12771,90.6,86,33,38.4
0K,All Students,2022-23,16258,1643,14615,89.9,101,40,39.6
1,All Students,2018-19,11622,796,10826,93.2,67,16,23.9
1,All Students,2019-20,8412,542,7870,93.6,76,13,17.1
1,All Students,2020-21,15005,1018,13987,93.2,92,21,22.8
1,All Students,2021-22,14676,1256,13420,91.4,89,32,36.0
1,All Students,2022-23,14182,1146,13036,91.9,85,23,27.1
2,All Students,2018-19,11619,807,10812,93.1,73,19,26.0
2,All Students,2019-20,7152,413,6739,94.2,63,11,17.5
2,All Students,2020-21,11957,775,11182,93.5,69,11,15.9
2,All Students,2021-22,13432,1136,12296,91.5,79,25,31.6
2,All Students,2022-23,14781,1206,13575,91.8,89,27,30.3
3,All Students,2018-19,13505,679,12826,95.0,78,9,11.5
3,All Students,2019-20,7016,442,6574,93.7,64,10,15.6
3,All Students,2020-21,10636,632,10004,94.1,64,11,17.2
3,All Students,2021-22,12300,954,11346,92.2,74,19,25.7
3,All Students,2022-23,12929,808,12121,93.8,76,13,17.1
4,All Students,2018-19,14577,883,13694,93.9,86,19,22.1
4,All Students,2019-20,8531,490,8041,94.3,78,13,16.7
4,All Students,2020-21,10883,333,10550,96.9,64,4,6.3
4,All Students,2021-22,10177,703,9474,93.1,62,11,17.7
4,All Students,2022-23,12553,1067,11486,91.5,74,22,29.7
5,All Students,2018-19,14229,962,13267,93.2,83,19,22.9
5,All Students,2019-20,9837,464,9373,95.3,88,13,14.8
5,All Students,2020-21,13034,774,12260,94.1,77,18,23.4
5,All Students,2021-22,8514,s,s,s,s,s,s
5,All Students,2022-23,10500,782,9718,92.6,63,14,22.2
6,All Students,2021-22,2,s,s,s,s,s,s
All Grades,All Students,2018-19,142181,8977,133204,93.7,847,179,21.1
All Grades,All Students,2019-20,86274,5632,80642,93.5,787,168,21.3
All Grades,All Students,2020-21,116160,8652,107508,92.6,697,177,25.4
All Grades,All Students,2021-22,109191,10605,98586,90.3,665,253,38.0
All Grades,All Students,2022-23,108716,9348,99368,91.4,673,225,33.4
PK in K-12 Schools,All Students,2018-19,9418,910,8508,90.3,60,24,40.0
PK in K-12 Schools,All Students,2019-20,6165,571,5594,90.7,55,20,36.4
PK in K-12 Schools,All Students,2020-21,11359,1063,10296,90.6,68,22,32.4
PK in K-12 Schools,All Students,2021-22,11863,1746,10117,85.3,78,46,59.0
PK in K-12 Schools,All Students,2022-23,11735,1427,10308,87.8,77,40,51.9
0K,All Students,2018-19,20932,1616,19316,92.3,125,43,34.4
0K,All Students,2019-20,11546,933,10613,91.9,107,32,29.9
0K,All Students,2020-21,13281,875,12406,93.4,82,20,24.4
0K,All Students,2021-22,13329,1326,12003,90.1,79,30,38.0
0K,All Students,2022-23,15275,1644,13631,89.2,96,42,43.8
1,All Students,2018-19,24004,1542,22462,93.6,142,27,19.0
1,All Students,2019-20,13392,993,12399,92.6,120,31,25.8
1,All Students,2020-21,17018,1738,15280,89.8,105,36,34.3
1,All Students,2021-22,14074,1363,12711,90.3,85,33,38.8
1,All Students,2022-23,13016,1074,11942,91.7,83,26,31.3
2,All Students,2018-19,19610,1190,18420,93.9,117,20,17.1
2,All Students,2019-20,14347,811,13536,94.3,133,26,19.5
2,All Students,2020-21,18746,1314,17432,93.0,111,24,21.6
2,All Students,2021-22,15853,1455,14398,90.8,95,35,36.8
2,All Students,2022-23,15125,1286,13839,91.5,93,26,28.0
3,All Students,2018-19,19401,1017,18384,94.8,116,17,14.7
3,All Students,2019-20,13325,867,12458,93.5,120,22,18.3
3,All Students,2020-21,20108,1335,18773,93.4,119,30,25.2
3,All Students,2021-22,17743,1636,16107,90.8,107,38,35.5
3,All Students,2022-23,16200,1091,15109,93.3,100,25,25.0
4,All Students,2018-19,25424,1450,23974,94.3,148,27,18.2
4,All Students,2019-20,12059,550,11509,95.4,113,13,11.5
4,All Students,2020-21,18677,1411,17266,92.4,112,27,24.1
4,All Students,2021-22,19422,1514,17908,92.2,117,36,30.8
4,All Students,2022-23,18416,1649,16767,91.0,113,40,35.4
5,All Students,2018-19,23392,1252,22140,94.6,139,21,15.1
5,All Students,2019-20,15440,907,14533,94.1,139,24,17.3
5,All Students,2020-21,16971,916,16055,94.6,100,18,18.0
5,All Students,2021-22,16907,1565,15342,90.7,104,35,33.7
5,All Students,2022-23,18949,1177,17772,93.8,111,26,23.4
All Grades,All Students,2018-19,55069,3325,51744,94.0,320,61,19.1
All Grades,All Students,2019-20,35414,2310,33104,93.5,321,77,24.0
All Grades,All Students,2020-21,52180,4859,47321,90.7,309,87,28.2
All Grades,All Students,2021-22,53063,5865,47198,88.9,323,135,41.8
All Grades,All Students,2022-23,52103,5283,46820,89.9,324,120,37.0
PK in K-12 Schools,All Students,2018-19,6308,568,5740,91.0,36,14,38.9
PK in K-12 Schools,All Students,2019-20,4118,s,s,s,s,s,s
PK in K-12 Schools,All Students,2020-21,5002,602,4400,88.0,31,12,38.7
PK in K-12 Schools,All Students,2021-22,6287,841,5446,86.6,38,20,52.6
PK in K-12 Schools,All Students,2022-23,6268,779,5489,87.6,37,20,54.1
0K,All Students,2018-19,8942,667,8275,92.5,53,15,28.3
0K,All Students,2019-20,5795,516,5279,91.1,52,17,32.7
0K,All Students,2020-21,7353,975,6378,86.7,45,21,46.7
0K,All Students,2021-22,8563,1310,7253,84.7,50,30,60.0
0K,All Students,2022-23,8241,993,7248,88.0,53,25,47.2
1,All Students,2018-19,5951,239,5712,96.0,36,3,8.3
1,All Students,2019-20,5578,355,5223,93.6,50,11,22.0
1,All Students,2020-21,8580,973,7607,88.7,49,13,26.5
1,All Students,2021-22,7294,745,6549,89.8,49,23,46.9
1,All Students,2022-23,8808,1039,7769,88.2,53,22,41.5
2,All Students,2018-19,8195,459,7736,94.4,47,6,12.8
2,All Students,2019-20,4336,213,4123,95.1,39,4,10.3
2,All Students,2020-21,8237,920,7317,88.8,50,16,32.0
2,All Students,2021-22,8220,1071,7149,87.0,48,19,39.6
2,All Students,2022-23,7447,856,6591,88.5,45,20,44.4
3,All Students,2018-19,8605,415,8190,95.2,49,5,10.2
3,All Students,2019-20,5193,251,4942,95.2,48,9,18.8
3,All Students,2020-21,6827,328,6499,95.2,40,5,12.5
3,All Students,2021-22,8091,658,7433,91.9,49,15,30.6
3,All Students,2022-23,7161,629,6532,91.2,47,12,25.5
4,All Students,2018-19,7909,482,7427,93.9,47,10,21.3
4,All Students,2019-20,5781,282,5499,95.1,53,12,22.6
4,All Students,2020-21,7598,435,7163,94.3,44,9,20.5
4,All Students,2021-22,7368,523,6845,92.9,45,10,22.2
4,All Students,2022-23,7666,512,7154,93.3,47,9,19.1
5,All Students,2018-19,9159,495,8664,94.6,52,8,15.4
5,All Students,2019-20,4611,339,4272,92.6,42,12,28.6
5,All Students,2020-21,8583,626,7957,92.7,50,11,22.0
5,All Students,2021-22,7240,717,6523,90.1,44,18,40.9
5,All Students,2022-23,6512,475,6037,92.7,42,12,28.6
6,All Students,2019-20,2,s,s,s,s,s,s
All Grades,All Students,2018-19,126780,8177,118603,93.6,751,165,22.0
All Grades,All Students,2019-20,77575,5114,72461,93.4,700,154,22.0
All Grades,All Students,2020-21,109132,8132,101000,92.5,648,146,22.5
All Grades,All Students,2021-22,105294,11869,93425,88.7,634,276,43.5
All Grades,All Students,2022-23,105497,10245,95252,90.3,634,237,37.4
PK in K-12 Schools,All Students,2018-19,6355,593,5762,90.7,36,14,38.9
PK in K-12 Schools,All Students,2019-20,4064,391,3673,90.4,38,16,42.1
PK in K-12 Schools,All Students,2020-21,6244,1000,5244,84.0,37,21,56.8
PK in K-12 Schools,All Students,2021-22,6360,933,5427,85.3,36,22,61.1
PK in K-12 Schools,All Students,2022-23,6179,814,5365,86.8,37,20,54.1
0K,All Students,2018-19,21462,1698,19764,92.1,129,36,27.9
0K,All Students,2019-20,11598,871,10727,92.5,105,27,25.7
0K,All Students,2020-21,15641,1948,13693,87.5,95,35,36.8
0K,All Students,2021-22,15486,2229,13257,85.6,98,56,57.1
0K,All Students,2022-23,16530,2038,14492,87.7,100,50,50.0
1,All Students,2018-19,18358,1380,16978,92.5,111,30,27.0
1,All Students,2019-20,13429,1019,12410,92.4,118,32,27.1
1,All Students,2020-21,16535,1307,15228,92.1,101,26,25.7
1,All Students,2021-22,15363,2079,13284,86.5,95,47,49.5
1,All Students,2022-23,15892,1696,14196,89.3,95,40,42.1
2,All Students,2018-19,20619,1066,19553,94.8,123,21,17.1
2,All Students,2019-20,11335,796,10539,93.0,103,22,21.4
2,All Students,2020-21,19966,1229,18737,93.8,118,22,18.6
2,All Students,2021-22,16196,1713,14483,89.4,96,40,41.7
2,All Students,2022-23,15542,1455,14087,90.6,95,32,33.7
3,All Students,2018-19,19284,1095,18189,94.3,114,20,17.5
3,All Students,2019-20,12540,614,11926,95.1,115,20,17.4
3,All Students,2020-21,16320,1051,15269,93.6,97,17,17.5
3,All Students,2021-22,18291,1967,16324,89.2,108,40,37.0
3,All Students,2022-23,17344,1508,15836,91.3,100,35,35.0
4,All Students,2018-19,19434,1270,18164,93.5,115,29,25.2
4,All Students,2019-20,11565,585,10980,94.9,106,15,14.2
4,All Students,2020-21,17641,884,16757,95.0,103,13,12.6
4,All Students,2021-22,16812,1640,15172,90.2,100,40,40.0
4,All Students,2022-23,18243,1519,16724,91.7,112,34,30.4
5,All Students,2018-19,21268,1075,20193,94.9,123,15,12.2
5,All Students,2019-20,13044,838,12206,93.6,115,22,19.1
5,All Students,2020-21,16785,713,16072,95.8,97,12,12.4
5,All Students,2021-22,16786,1308,15478,92.2,101,31,30.7
5,All Students,2022-23,15767,1215,14552,92.3,95,26,27.4
All Grades,All Students,2018-19,170555,11887,158668,93.0,1006,253,25.1
All Grades,All Students,2019-20,102679,7106,95573,93.1,920,227,24.7
All Grades,All Students,2020-21,149162,11552,137610,92.3,880,189,21.5
All Grades,All Students,2021-22,131343,15352,115991,88.3,793,377,47.5
All Grades,All Students,2022-23,125690,12798,112892,89.8,768,315,41.0
PK in K-12 Schools,All Students,2018-19,14961,1680,13281,88.8,88,46,52.3
PK in K-12 Schools,All Students,2019-20,9802,1049,8753,89.3,90,45,50.0
PK in K-12 Schools,All Students,2020-21,14540,1678,12862,88.5,90,31,34.4
PK in K-12 Schools,All Students,2021-22,12494,1952,10542,84.4,83,58,69.9
PK in K-12 Schools,All Students,2022-23,13861,2227,11634,83.9,86,59,68.6
0K,All Students,2018-19,27235,2483,24752,90.9,168,63,37.5
0K,All Students,2019-20,14317,1155,13162,91.9,130,38,29.2
0K,All Students,2020-21,18064,2099,15965,88.4,107,34,31.8
0K,All Students,2021-22,17432,2552,14880,85.4,108,61,56.5
0K,All Students,2022-23,15571,2040,13531,86.9,99,53,53.5
1,All Students,2018-19,26097,1753,24344,93.3,155,29,18.7
1,All Students,2019-20,16797,1292,15505,92.3,150,42,28.0
1,All Students,2020-21,20176,1736,18440,91.4,122,29,23.8
1,All Students,2021-22,16750,1888,14862,88.7,105,55,52.4
1,All Students,2022-23,19335,2130,17205,89.0,115,44,38.3
2,All Students,2018-19,27884,1963,25921,93.0,167,42,25.1
2,All Students,2019-20,16573,965,15608,94.2,146,24,16.4
2,All Students,2020-21,24686,1742,22944,92.9,144,28,19.4
2,All Students,2021-22,16918,1889,15029,88.8,98,46,46.9
2,All Students,2022-23,16019,1470,14549,90.8,99,38,38.4
3,All Students,2018-19,23969,1287,22682,94.6,139,21,15.1
3,All Students,2019-20,16517,1145,15372,93.1,147,36,24.5
3,All Students,2020-21,24924,1823,23101,92.7,145,26,17.9
3,All Students,2021-22,22770,2781,19989,87.8,138,71,51.4
3,All Students,2022-23,15937,1319,14618,91.7,95,35,36.8
4,All Students,2018-19,22502,1272,21230,94.3,128,27,21.1
4,All Students,2019-20,14670,769,13901,94.8,132,22,16.7
4,All Students,2020-21,24448,1287,23161,94.7,142,20,14.1
4,All Students,2021-22,22638,1916,20722,91.5,133,39,29.3
4,All Students,2022-23,22824,2015,20809,91.2,138,52,37.7
5,All Students,2018-19,27907,1449,26458,94.8,161,25,15.5
5,All Students,2019-20,14003,731,13272,94.8,125,20,16.0
5,All Students,2020-21,22324,1187,21137,94.7,130,21,16.2
5,All Students,2021-22,22341,2374,19967,89.4,128,47,36.7
5,All Students,2022-23,22143,1597,20546,92.8,136,34,25.0
All Grades,All Students,2018-19,113615,9163,104452,91.9,683,202,29.6
All Grades,All Students,2019-20,71644,5810,65834,91.9,676,213,31.5
All Grades,All Students,2020-21,105104,12303,92801,88.3,644,244,37.9
All Grades,All Students,2021-22,100456,12817,87639,87.2,622,322,51.8
All Grades,All Students,2022-23,92803,11080,81723,88.1,568,295,51.9
PK in K-12 Schools,All Students,2018-19,7747,569,7178,92.7,47,12,25.5
PK in K-12 Schools,All Students,2019-20,5699,543,5156,90.5,53,22,41.5
PK in K-12 Schools,All Students,2020-21,6741,357,6384,94.7,43,9,20.9
PK in K-12 Schools,All Students,2021-22,8673,1320,7353,84.8,56,32,57.1
PK in K-12 Schools,All Students,2022-23,9257,s,s,s,s,s,s
0K,All Students,2018-19,13939,1585,12354,88.6,91,44,48.4
0K,All Students,2019-20,8918,793,8125,91.1,84,26,31.0
0K,All Students,2020-21,13968,2526,11442,81.9,92,58,63.0
0K,All Students,2021-22,13317,2015,11302,84.9,82,48,58.5
0K,All Students,2022-23,11484,1567,9917,86.4,73,40,54.8
1,All Students,2018-19,16736,1415,15321,91.5,101,34,33.7
1,All Students,2019-20,9577,877,8700,90.8,93,36,38.7
1,All Students,2020-21,15441,2734,12707,82.3,97,52,53.6
1,All Students,2021-22,15057,2043,13014,86.4,95,53,55.8
1,All Students,2022-23,12992,1581,11411,87.8,81,49,60.5
2,All Students,2018-19,18906,1587,17319,91.6,112,31,27.7
2,All Students,2019-20,11461,790,10671,93.1,110,27,24.5
2,All Students,2020-21,15109,1987,13122,86.8,89,37,41.6
2,All Students,2021-22,14664,1966,12698,86.6,94,53,56.4
2,All Students,2022-23,13929,1497,12432,89.3,87,41,47.1
3,All Students,2018-19,19160,1500,17660,92.2,115,30,26.1
3,All Students,2019-20,12111,927,11184,92.3,112,34,30.4
3,All Students,2020-21,17679,1292,16387,92.7,106,26,24.5
3,All Students,2021-22,14035,1550,12485,89.0,84,36,42.9
3,All Students,2022-23,15183,1611,13572,89.4,91,42,46.2
4,All Students,2018-19,18468,1209,17259,93.5,109,24,22.0
4,All Students,2019-20,11714,984,10730,91.6,111,35,31.5
4,All Students,2020-21,18571,1396,17175,92.5,111,24,21.6
4,All Students,2021-22,17430,1933,15497,88.9,107,53,49.5
4,All Students,2022-23,13475,1634,11841,87.9,81,43,53.1
5,All Students,2018-19,18659,1298,17361,93.0,108,27,25.0
5,All Students,2019-20,12164,896,11268,92.6,113,33,29.2
5,All Students,2020-21,17595,2011,15584,88.6,106,38,35.8
5,All Students,2021-22,17280,1990,15290,88.5,104,47,45.2
5,All Students,2022-23,16479,1667,14812,89.9,100,45,45.0
6,All Students,2022-23,4,s,s,s,s,s,s
All Grades,All Students,2018-19,149459,16655,132804,88.9,927,445,48.0
All Grades,All Students,2019-20,95091,9675,85416,89.8,877,364,41.5
All Grades,All Students,2020-21,136187,25751,110436,81.1,807,475,58.9
All Grades,All Students,2021-22,122380,20715,101665,83.1,759,533,70.2
All Grades,All Students,2022-23,117842,18365,99477,84.4,744,485,65.2
PK in K-12 Schools,All Students,2018-19,5932,927,5005,84.4,39,27,69.2
PK in K-12 Schools,All Students,2019-20,5647,758,4889,86.6,55,31,56.4
PK in K-12 Schools,All Students,2020-21,7126,2074,5052,70.9,46,36,78.3
PK in K-12 Schools,All Students,2021-22,8150,s,s,s,s,s,s
PK in K-12 Schools,All Students,2022-23,7756,1818,5938,76.6,55,45,81.8
0K,All Students,2018-19,16400,2444,13956,85.1,106,73,68.9
0K,All Students,2019-20,9022,1131,7891,87.5,88,47,53.4
0K,All Students,2020-21,12490,2797,9693,77.6,76,52,68.4
0K,All Students,2021-22,11103,2180,8923,80.4,72,54,75.0
0K,All Students,2022-23,9574,1912,7662,80.0,62,53,85.5
1,All Students,2018-19,14969,2006,12963,86.6,98,60,61.2
1,All Students,2019-20,9934,1057,8877,89.4,91,41,45.1
1,All Students,2020-21,12119,3140,8979,74.1,70,50,71.4
1,All Students,2021-22,11488,1906,9582,83.4,74,57,77.0
1,All Students,2022-23,10108,1478,8630,85.4,63,43,68.3
2,All Students,2018-19,13100,1630,11470,87.6,84,43,51.2
2,All Students,2019-20,8288,916,7372,88.9,79,40,50.6
2,All Students,2020-21,13813,2692,11121,80.5,81,51,63.0
2,All Students,2021-22,10280,1788,8492,82.6,64,50,78.1
2,All Students,2022-23,10588,1433,9155,86.5,71,45,63.4
3,All Students,2018-19,14796,1379,13417,90.7,88,35,39.8
3,All Students,2019-20,8869,845,8024,90.5,80,27,33.8
3,All Students,2020-21,11945,1996,9949,83.3,72,41,56.9
3,All Students,2021-22,12519,1888,10631,84.9,76,52,68.4
3,All Students,2022-23,10007,1366,8641,86.3,61,34,55.7
4,All Students,2018-19,20096,1964,18132,90.2,125,51,40.8
4,All Students,2019-20,9688,797,8891,91.8,86,25,29.1
4,All Students,2020-21,13264,2725,10539,79.5,77,47,61.0
4,All Students,2021-22,11811,1924,9887,83.7,72,48,66.7
4,All Students,2022-23,13088,1856,11232,85.8,85,49,57.6
5,All Students,2018-19,17079,1624,15455,90.5,102,35,34.3
5,All Students,2019-20,14797,1405,13392,90.5,134,51,38.1
5,All Students,2020-21,14674,1524,13150,89.6,84,33,39.3
5,All Students,2021-22,13453,2142,11311,84.1,83,50,60.2
5,All Students,2022-23,12215,1685,10530,86.2,75,47,62.7
6,All Students,2018-19,17501,1623,15878,90.7,106,41,38.7
6,All Students,2019-20,8388,766,7622,90.9,76,30,39.5
6,All Students,2020-21,21581,3576,18005,83.4,128,69,53.9
6,All Students,2021-22,13607,1862,11745,86.3,83,52,62.7
6,All Students,2022-23,12926,2154,10772,83.3,83,54,65.1
7,All Students,2018-19,14727,1565,13162,89.4,88,42,47.7
7,All Students,2019-20,11171,1102,10069,90.1,104,37,35.6
7,All Students,2020-21,12347,2484,9863,79.9,72,43,59.7
7,All Students,2021-22,18852,2947,15905,84.4,113,72,63.7
7,All Students,2022-23,13328,1812,11516,86.4,80,45,56.3
8,All Students,2018-19,14859,1493,13366,90.0,91,38,41.8
8,All Students,2019-20,9287,898,8389,90.3,84,35,41.7
8,All Students,2020-21,16828,2743,14085,83.7,101,53,52.5
8,All Students,2021-22,11113,2042,9071,81.6,69,49,71.0
8,All Students,2022-23,18252,2851,15401,84.4,109,70,64.2
9,All Students,2021-22,4,s,s,s,s,s,s
All Grades,All Students,2018-19,37021,4283,32738,88.4,236,126,53.4
All Grades,All Students,2019-20,21695,2411,19284,88.9,212,98,46.2
All Grades,All Students,2020-21,28352,5650,22702,80.1,170,113,66.5
All Grades,All Students,2021-22,26022,5112,20910,80.4,169,124,73.4
All Grades,All Students,2022-23,27717,4869,22848,82.4,183,113,61.7
PK in K-12 Schools,All Students,2018-19,3056,415,2641,86.4,22,16,72.7
PK in K-12 Schools,All Students,2019-20,1958,272,1686,86.1,20,13,65.0
PK in K-12 Schools,All Students,2020-21,1001,243,758,75.7,7,5,71.4
PK in K-12 Schools,All Students,2021-22,2220,455,1765,79.5,16,15,93.8
PK in K-12 Schools,All Students,2022-23,2992,602,2390,79.9,25,17,68.0
0K,All Students,2018-19,4716,690,4026,85.4,31,20,64.5
0K,All Students,2019-20,3193,501,2692,84.3,34,24,70.6
0K,All Students,2020-21,4849,1444,3405,70.2,30,25,83.3
0K,All Students,2021-22,3737,833,2904,77.7,26,20,76.9
0K,All Students,2022-23,4481,1036,3445,76.9,30,21,70.0
1,All Students,2018-19,5753,795,4958,86.2,35,26,74.3
1,All Students,2019-20,2664,325,2339,87.8,26,13,50.0
1,All Students,2020-21,5829,1301,4528,77.7,35,25,71.4
1,All Students,2021-22,4467,1170,3297,73.8,31,28,90.3
1,All Students,2022-23,4661,798,3863,82.9,31,17,54.8
2,All Students,2018-19,6870,667,6203,90.3,43,17,39.5
2,All Students,2019-20,3822,414,3408,89.2,36,17,47.2
2,All Students,2020-21,4814,757,4057,84.3,28,19,67.9
2,All Students,2021-22,4906,792,4114,83.9,30,19,63.3
2,All Students,2022-23,4108,793,3315,80.7,28,20,71.4
3,All Students,2018-19,3700,396,3304,89.3,22,10,45.5
3,All Students,2019-20,3720,387,3333,89.6,36,16,44.4
3,All Students,2020-21,3617,540,3077,85.1,22,14,63.6
3,All Students,2021-22,3844,796,3048,79.3,25,19,76.0
3,All Students,2022-23,4108,535,3573,87.0,24,13,54.2
4,All Students,2018-19,7360,724,6636,90.2,50,23,46.0
4,All Students,2019-20,2399,190,2209,92.1,22,5,22.7
4,All Students,2020-21,4534,819,3715,81.9,26,15,57.7
4,All Students,2021-22,2990,439,2551,85.3,19,12,63.2
4,All Students,2022-23,4073,714,3359,82.5,24,15,62.5
5,All Students,2018-19,5566,596,4970,89.3,33,14,42.4
5,All Students,2019-20,3939,322,3617,91.8,38,10,26.3
5,All Students,2020-21,3708,546,3162,85.3,22,10,45.5
5,All Students,2021-22,3858,627,3231,83.7,22,11,50.0
5,All Students,2022-23,3294,391,2903,88.1,21,10,47.6
All Grades,All Students,2018-19,251487,14963,236524,94.1,1488,295,19.8
All Grades,All Students,2019-20,157622,9176,148446,94.2,1409,261,18.5
All Grades,All Students,2020-21,226630,9668,216962,95.7,1330,181,13.6
All Grades,All Students,2021-22,208433,20639,187794,90.1,1260,527,41.8
All Grades,All Students,2022-23,197085,17215,179870,91.3,1177,413,35.1
PK in K-12 Schools,All Students,2018-19,6346,476,5870,92.5,39,12,30.8
PK in K-12 Schools,All Students,2019-20,7849,757,7092,90.4,71,24,33.8
PK in K-12 Schools,All Students,2020-21,11905,938,10967,92.1,70,17,24.3
PK in K-12 Schools,All Students,2021-22,11873,1691,10182,85.8,76,54,71.1
PK in K-12 Schools,All Students,2022-23,12070,1667,10403,86.2,71,38,53.5
0K,All Students,2018-19,34468,2719,31749,92.1,203,65,32.0
0K,All Students,2019-20,19926,1542,18384,92.3,181,59,32.6
0K,All Students,2020-21,31012,1885,29127,93.9,185,39,21.1
0K,All Students,2021-22,30473,4215,26258,86.2,187,115,61.5
0K,All Students,2022-23,27751,2714,25037,90.2,167,76,45.5
1,All Students,2018-19,36724,2489,34235,93.2,216,48,22.2
1,All Students,2019-20,23829,1511,22318,93.7,213,44,20.7
1,All Students,2020-21,32877,1828,31049,94.4,192,37,19.3
1,All Students,2021-22,29980,3261,26719,89.1,187,87,46.5
1,All Students,2022-23,31930,3014,28916,90.6,191,69,36.1
2,All Students,2018-19,41229,2334,38895,94.3,248,47,19.0
2,All Students,2019-20,23210,1411,21799,93.9,207,42,20.3
2,All Students,2020-21,35978,1159,34819,96.8,210,23,11.0
2,All Students,2021-22,32318,2924,29394,91.0,193,78,40.4
2,All Students,2022-23,30211,2444,27767,91.9,184,57,31.0
3,All Students,2018-19,39606,2134,37472,94.6,235,40,17.0
3,All Students,2019-20,26507,1322,25185,95.0,236,35,14.8
3,All Students,2020-21,34992,1190,33802,96.6,207,19,9.2
3,All Students,2021-22,31887,2434,29453,92.4,188,53,28.2
3,All Students,2022-23,29723,2309,27414,92.2,177,55,31.1
4,All Students,2018-19,46857,2472,44385,94.7,273,39,14.3
4,All Students,2019-20,25984,1310,24674,95.0,232,26,11.2
4,All Students,2020-21,40158,1234,38924,96.9,234,16,6.8
4,All Students,2021-22,33751,2999,30752,91.1,204,69,33.8
4,All Students,2022-23,32995,2408,30587,92.7,196,57,29.1
5,All Students,2018-19,46257,2339,43918,94.9,274,44,16.1
5,All Students,2019-20,30317,1323,28994,95.6,269,31,11.5
5,All Students,2020-21,39708,1434,38274,96.4,232,30,12.9
5,All Students,2021-22,38151,3115,35036,91.8,225,71,31.6
5,All Students,2022-23,32405,2659,29746,91.8,191,61,31.9
All Grades,All Students,2018-19,121498,6617,114881,94.6,690,76,11.0
All Grades,All Students,2019-20,81387,4407,76980,94.6,717,85,11.9
All Grades,All Students,2020-21,111683,4580,107103,95.9,653,59,9.0
All Grades,All Students,2021-22,103927,7703,96224,92.6,608,134,22.0
All Grades,All Students,2022-23,105256,8716,96540,91.7,607,168,27.7
PK in K-12 Schools,All Students,2018-19,6372,448,5924,93.0,36,9,25.0
PK in K-12 Schools,All Students,2019-20,4104,268,3836,93.5,36,5,13.9
PK in K-12 Schools,All Students,2020-21,5807,652,5155,88.8,35,13,37.1
PK in K-12 Schools,All Students,2021-22,6358,680,5678,89.3,36,18,50.0
PK in K-12 Schools,All Students,2022-23,5850,696,5154,88.1,34,18,52.9
0K,All Students,2018-19,16820,1160,15660,93.1,96,21,21.9
0K,All Students,2019-20,12185,850,11335,93.0,106,25,23.6
0K,All Students,2020-21,14241,494,13747,96.5,84,6,7.1
0K,All Students,2021-22,13309,980,12329,92.6,79,18,22.8
0K,All Students,2022-23,15219,1493,13726,90.2,88,35,39.8
1,All Students,2018-19,14133,750,13383,94.7,81,7,8.6
1,All Students,2019-20,10268,544,9724,94.7,90,7,7.8
1,All Students,2020-21,16527,438,16089,97.3,96,3,3.1
1,All Students,2021-22,13159,954,12205,92.8,77,12,15.6
1,All Students,2022-23,13720,1048,12672,92.4,78,17,21.8
2,All Students,2018-19,15857,871,14986,94.5,90,10,11.1
2,All Students,2019-20,9436,495,8941,94.8,83,7,8.4
2,All Students,2020-21,12687,496,12191,96.1,75,6,8.0
2,All Students,2021-22,14561,979,13582,93.3,83,11,13.3
2,All Students,2022-23,12480,997,11483,92.0,72,19,26.4
3,All Students,2018-19,15177,700,14477,95.4,86,3,3.5
3,All Students,2019-20,10325,551,9774,94.7,91,7,7.7
3,All Students,2020-21,13644,299,13345,97.8,78,2,2.6
3,All Students,2021-22,11358,721,10637,93.7,70,11,15.7
3,All Students,2022-23,14517,897,13620,93.8,82,12,14.6
4,All Students,2018-19,18562,883,17679,95.2,105,7,6.7
4,All Students,2019-20,9890,354,9536,96.4,86,2,2.3
4,All Students,2020-21,13293,622,12671,95.3,78,7,9.0
4,All Students,2021-22,12514,868,11646,93.1,72,12,16.7
4,All Students,2022-23,11324,842,10482,92.6,66,13,19.7
5,All Students,2018-19,13668,576,13092,95.8,77,3,3.9
5,All Students,2019-20,12425,634,11791,94.9,111,17,15.3
5,All Students,2020-21,14017,469,13548,96.7,81,5,6.2
5,All Students,2021-22,13819,1092,12727,92.1,79,24,30.4
5,All Students,2022-23,12031,818,11213,93.2,68,13,19.1
6,All Students,2018-19,8667,457,8210,94.7,49,5,10.2
6,All Students,2019-20,3946,194,3752,95.1,35,3,8.6
6,All Students,2020-21,7854,300,7554,96.2,46,4,8.7
6,All Students,2021-22,6341,422,5919,93.3,38,7,18.4
6,All Students,2022-23,7606,782,6824,89.7,46,15,32.6
7,All Students,2018-19,4988,321,4667,93.6,28,4,14.3
7,All Students,2019-20,5550,269,5281,95.2,50,5,10.0
7,All Students,2020-21,5792,233,5559,96.0,35,4,11.4
7,All Students,2021-22,7204,559,6645,92.2,43,13,30.2
7,All Students,2022-23,5388,431,4957,92.0,32,10,31.3
8,All Students,2018-19,7254,451,6803,93.8,42,7,16.7
8,All Students,2019-20,3258,248,3010,92.4,29,7,24.1
8,All Students,2020-21,7821,577,7244,92.6,45,9,20.0
8,All Students,2021-22,5177,s,s,s,s,s,s
8,All Students,2022-23,7121,712,6409,90.0,41,16,39.0
9,All Students,2021-22,127,s,s,s,s,s,s
All Grades,All Students,2018-19,119622,8042,111580,93.3,730,164,22.5
All Grades,All Students,2019-20,74770,4821,69949,93.6,696,144,20.7
All Grades,All Students,2020-21,104224,6375,97849,93.9,626,109,17.4
All Grades,All Students,2021-22,97970,10747,87223,89.0,596,255,42.8
All Grades,All Students,2022-23,93419,9791,83628,89.5,581,219,37.7
PK in K-12 Schools,All Students,2018-19,9142,791,8351,91.3,58,18,31.0
PK in K-12 Schools,All Students,2019-20,7211,822,6389,88.6,70,28,40.0
PK in K-12 Schools,All Students,2020-21,9839,1021,8818,89.6,59,18,30.5
PK in K-12 Schools,All Students,2021-22,11268,1454,9814,87.1,70,38,54.3
PK in K-12 Schools,All Students,2022-23,11390,1754,9636,84.6,71,42,59.2
0K,All Students,2018-19,17839,1450,16389,91.9,113,32,28.3
0K,All Students,2019-20,9631,725,8906,92.5,92,22,23.9
0K,All Students,2020-21,14321,1129,13192,92.1,89,24,27.0
0K,All Students,2021-22,13035,1751,11284,86.6,80,43,53.8
0K,All Students,2022-23,13632,1550,12082,88.6,82,32,39.0
1,All Students,2018-19,14536,1029,13507,92.9,92,28,30.4
1,All Students,2019-20,10491,617,9874,94.1,98,17,17.3
1,All Students,2020-21,13780,895,12885,93.5,83,17,20.5
1,All Students,2021-22,15072,1608,13464,89.3,94,37,39.4
1,All Students,2022-23,13876,1395,12481,89.9,88,31,35.2
2,All Students,2018-19,18600,1178,17422,93.7,114,21,18.4
2,All Students,2019-20,9605,588,9017,93.9,93,23,24.7
2,All Students,2020-21,16138,847,15291,94.8,99,16,16.2
2,All Students,2021-22,13457,1473,11984,89.1,80,30,37.5
2,All Students,2022-23,14431,1644,12787,88.6,89,40,44.9
3,All Students,2018-19,19237,1212,18025,93.7,119,28,23.5
3,All Students,2019-20,11729,604,11125,94.9,107,14,13.1
3,All Students,2020-21,14911,952,13959,93.6,88,12,13.6
3,All Students,2021-22,13350,1214,12136,90.9,82,33,40.2
3,All Students,2022-23,13359,1222,12137,90.9,85,24,28.2
4,All Students,2018-19,21727,1169,20558,94.6,127,16,12.6
4,All Students,2019-20,12122,754,11368,93.8,110,21,19.1
4,All Students,2020-21,17393,759,16634,95.6,101,11,10.9
4,All Students,2021-22,14286,1587,12699,88.9,87,40,46.0
4,All Students,2022-23,13050,1093,11957,91.6,80,24,30.0
5,All Students,2018-19,18541,1213,17328,93.5,107,21,19.6
5,All Students,2019-20,13981,711,13270,94.9,126,19,15.1
5,All Students,2020-21,17842,772,17070,95.7,107,11,10.3
5,All Students,2021-22,17502,1660,15842,90.5,103,34,33.0
5,All Students,2022-23,13681,1133,12548,91.7,86,26,30.2
All Grades,All Students,2018-19,200838,11612,189226,94.2,1184,216,18.2
All Grades,All Students,2019-20,128807,7476,121331,94.2,1172,219,18.7
All Grades,All Students,2020-21,189409,9685,179724,94.9,1106,184,16.6
All Grades,All Students,2021-22,175698,16536,159162,90.6,1034,386,37.3
All Grades,All Students,2022-23,170686,14372,156314,91.6,1054,358,34.0
0K,All Students,2018-19,13294,1260,12034,90.5,85,32,37.6
0K,All Students,2019-20,10555,1010,9545,90.4,103,37,35.9
0K,All Students,2020-21,15101,1360,13741,91.0,92,28,30.4
0K,All Students,2021-22,16040,2291,13749,85.7,97,63,64.9
0K,All Students,2022-23,13280,1689,11591,87.3,82,45,54.9
1,All Students,2018-19,16035,1383,14652,91.4,98,38,38.8
1,All Students,2019-20,10314,788,9526,92.4,96,26,27.1
1,All Students,2020-21,17066,1172,15894,93.1,100,21,21.0
1,All Students,2021-22,14893,1689,13204,88.7,92,43,46.7
1,All Students,2022-23,16461,1866,14595,88.7,106,53,50.0
2,All Students,2018-19,21938,1416,20522,93.5,132,26,19.7
2,All Students,2019-20,11037,885,10152,92.0,104,36,34.6
2,All Students,2020-21,16341,1107,15234,93.2,94,27,28.7
2,All Students,2021-22,15644,1698,13946,89.1,92,41,44.6
2,All Students,2022-23,15006,1357,13649,91.0,98,34,34.7
3,All Students,2018-19,21972,1099,20873,95.0,130,13,10.0
3,All Students,2019-20,15329,906,14423,94.1,142,25,17.6
3,All Students,2020-21,18189,804,17385,95.6,106,13,12.3
3,All Students,2021-22,14761,1256,13505,91.5,88,31,35.2
3,All Students,2022-23,16167,1331,14836,91.8,102,36,35.3
4,All Students,2018-19,21847,1325,20522,93.9,131,28,21.4
4,All Students,2019-20,14177,719,13458,94.9,127,14,11.0
4,All Students,2020-21,23366,857,22509,96.3,138,19,13.8
4,All Students,2021-22,17982,1825,16157,89.9,109,47,43.1
4,All Students,2022-23,15719,1269,14450,91.9,104,31,29.8
5,All Students,2018-19,25583,1417,24166,94.5,150,24,16.0
5,All Students,2019-20,14313,792,13521,94.5,128,24,18.8
5,All Students,2020-21,23122,913,22209,96.1,136,13,9.6
5,All Students,2021-22,25229,1953,23276,92.3,148,40,27.0
5,All Students,2022-23,20043,1605,18438,92.0,124,43,34.7
6,All Students,2018-19,27900,1366,26534,95.1,160,26,16.3
6,All Students,2019-20,17790,874,16916,95.1,160,20,12.5
6,All Students,2020-21,23159,1003,22156,95.7,136,15,11.0
6,All Students,2021-22,25225,2052,23173,91.9,144,46,31.9
6,All Students,2022-23,27170,1799,25371,93.4,163,37,22.7
7,All Students,2018-19,28555,1089,27466,96.2,163,9,5.5
7,All Students,2019-20,17551,812,16739,95.4,156,22,14.1
7,All Students,2020-21,27578,847,26731,96.9,158,15,9.5
7,All Students,2021-22,20887,1809,19078,91.3,121,35,28.9
7,All Students,2022-23,25682,1603,24079,93.8,151,31,20.5
8,All Students,2018-19,23714,1257,22457,94.7,135,20,14.8
8,All Students,2019-20,17741,690,17051,96.1,156,15,9.6
8,All Students,2020-21,25487,1622,23865,93.6,146,33,22.6
8,All Students,2021-22,25037,1963,23074,92.2,143,40,28.0
8,All Students,2022-23,21158,1853,19305,91.2,124,48,38.7
All Grades,All Students,2018-19,339481,22051,317430,93.5,1957,424,21.7
All Grades,All Students,2019-20,224307,13905,210402,93.8,1992,414,20.8
All Grades,All Students,2020-21,336229,24989,311240,92.6,1948,442,22.7
All Grades,All Students,2021-22,313934,30768,283166,90.2,1866,669,35.9
All Grades,All Students,2022-23,297572,27153,270419,90.9,1771,579,32.7
5,All Students,2018-19,2,s,s,s,s,s,s
6,All Students,2018-19,118334,6594,111740,94.4,682,109,16.0
6,All Students,2019-20,76459,4448,72011,94.2,680,122,17.9
6,All Students,2020-21,106112,s,s,s,s,s,s
6,All Students,2021-22,98951,9525,89426,90.4,589,208,35.3
6,All Students,2022-23,94483,s,s,s,s,s,s
7,All Students,2018-19,110995,7209,103786,93.5,642,150,23.4
7,All Students,2019-20,76356,4628,71728,93.9,678,142,20.9
7,All Students,2020-21,114713,7219,107494,93.7,663,130,19.6
7,All Students,2021-22,105278,9594,95684,90.9,628,202,32.2
7,All Students,2022-23,99834,9410,90424,90.6,593,207,34.9
8,All Students,2018-19,110149,8245,101904,92.5,633,165,26.1
8,All Students,2019-20,71492,4829,66663,93.2,634,150,23.7
8,All Students,2020-21,115376,12141,103235,89.5,668,224,33.5
8,All Students,2021-22,109705,11649,98056,89.4,649,259,39.9
8,All Students,2022-23,103242,10363,92879,90.0,611,223,36.5
9,All Students,2018-19,1,s,s,s,s,s,s
9,All Students,2020-21,28,s,s,s,s,s,s
9,All Students,2022-23,13,s,s,s,s,s,s
All Grades,All Students,2018-19,110909,6896,104013,93.8,638,113,17.7
All Grades,All Students,2019-20,66934,4557,62377,93.2,597,131,21.9
All Grades,All Students,2020-21,94413,5315,89098,94.4,552,88,15.9
All Grades,All Students,2021-22,90850,9194,81656,89.9,531,209,39.4
All Grades,All Students,2022-23,92593,8150,84443,91.2,538,183,34.0
PK in K-12 Schools,All Students,2018-19,5777,391,5386,93.2,34,5,14.7
PK in K-12 Schools,All Students,2019-20,3747,335,3412,91.1,33,13,39.4
PK in K-12 Schools,All Students,2020-21,5461,221,5240,96.0,33,4,12.1
PK in K-12 Schools,All Students,2021-22,5563,719,4844,87.1,32,18,56.3
PK in K-12 Schools,All Students,2022-23,5753,525,5228,90.9,33,13,39.4
0K,All Students,2018-19,8952,553,8399,93.8,51,8,15.7
0K,All Students,2019-20,5325,406,4919,92.4,48,14,29.2
0K,All Students,2020-21,8416,667,7749,92.1,49,11,22.4
0K,All Students,2021-22,8482,1006,7476,88.1,51,22,43.1
0K,All Students,2022-23,8823,1065,7758,87.9,53,29,54.7
1,All Students,2018-19,8945,463,8482,94.8,51,6,11.8
1,All Students,2019-20,5801,406,5395,93.0,52,9,17.3
1,All Students,2020-21,8144,417,7727,94.9,48,4,8.3
1,All Students,2021-22,9211,1117,8094,87.9,54,30,55.6
1,All Students,2022-23,10533,970,9563,90.8,64,29,45.3
2,All Students,2018-19,10039,629,9410,93.7,61,12,19.7
2,All Students,2019-20,5673,335,5338,94.1,50,8,16.0
2,All Students,2020-21,8531,228,8303,97.3,50,1,2.0
2,All Students,2021-22,7771,625,7146,92.0,46,16,34.8
2,All Students,2022-23,9814,1026,8788,89.5,58,25,43.1
3,All Students,2018-19,13414,966,12448,92.8,78,11,14.1
3,All Students,2019-20,6715,496,6219,92.6,62,17,27.4
3,All Students,2020-21,8458,290,8168,96.6,49,3,6.1
3,All Students,2021-22,9406,789,8617,91.6,54,15,27.8
3,All Students,2022-23,9029,611,8418,93.2,52,12,23.1
4,All Students,2018-19,14116,906,13210,93.6,81,16,19.8
4,All Students,2019-20,8585,565,8020,93.4,77,14,18.2
4,All Students,2020-21,10385,521,9864,95.0,60,10,16.7
4,All Students,2021-22,8628,868,7760,89.9,50,17,34.0
4,All Students,2022-23,10281,720,9561,93.0,58,14,24.1
5,All Students,2018-19,15587,800,14787,94.9,88,12,13.6
5,All Students,2019-20,8688,627,8061,92.8,77,20,26.0
5,All Students,2020-21,12491,613,11878,95.1,75,10,13.3
5,All Students,2021-22,10819,1186,9633,89.0,64,26,40.6
5,All Students,2022-23,9098,670,8428,92.6,52,15,28.8
6,All Students,2018-19,11533,622,10911,94.6,66,9,13.6
6,All Students,2019-20,7399,471,6928,93.6,66,14,21.2
6,All Students,2020-21,11385,729,10656,93.6,65,12,18.5
6,All Students,2021-22,10563,1174,9389,88.9,62,27,43.5
6,All Students,2022-23,9543,843,8700,91.2,56,17,30.4
7,All Students,2018-19,12760,775,11985,93.9,73,17,23.3
7,All Students,2019-20,7541,463,7078,93.9,67,11,16.4
7,All Students,2020-21,10642,736,9906,93.1,63,15,23.8
7,All Students,2021-22,10848,973,9875,91.0,64,20,31.3
7,All Students,2022-23,9641,901,8740,90.7,55,15,27.3
8,All Students,2018-19,9786,791,8995,91.9,55,17,30.9
8,All Students,2019-20,7460,453,7007,93.9,65,11,16.9
8,All Students,2020-21,10500,893,9607,91.5,60,18,30.0
8,All Students,2021-22,9559,737,8822,92.3,54,18,33.3
8,All Students,2022-23,10078,819,9259,91.9,57,14,24.6
All Grades,All Students,2018-19,95735,5603,90132,94.1,576,114,19.8
All Grades,All Students,2019-20,62655,3753,58902,94.0,574,103,17.9
All Grades,All Students,2020-21,94873,5394,89479,94.3,568,116,20.4
All Grades,All Students,2021-22,90337,8333,82004,90.8,534,175,32.8
All Grades,All Students,2022-23,91745,8176,83569,91.1,575,196,34.1
PK in K-12 Schools,All Students,2018-19,9479,691,8788,92.7,57,16,28.1
PK in K-12 Schools,All Students,2019-20,7665,666,6999,91.3,71,23,32.4
PK in K-12 Schools,All Students,2020-21,10357,501,9856,95.2,71,12,16.9
PK in K-12 Schools,All Students,2021-22,11696,1379,10317,88.2,70,33,47.1
PK in K-12 Schools,All Students,2022-23,11925,1412,10513,88.2,74,37,50.0
0K,All Students,2018-19,14199,1018,13181,92.8,81,18,22.2
0K,All Students,2019-20,8910,551,8359,93.8,84,14,16.7
0K,All Students,2020-21,13184,882,12302,93.3,79,18,22.8
0K,All Students,2021-22,13054,1482,11572,88.6,77,36,46.8
0K,All Students,2022-23,11828,1340,10488,88.7,83,37,44.6
1,All Students,2018-19,14688,950,13738,93.5,92,24,26.1
1,All Students,2019-20,10293,653,9640,93.7,93,18,19.4
1,All Students,2020-21,13000,616,12384,95.3,76,13,17.1
1,All Students,2021-22,12591,1207,11384,90.4,75,19,25.3
1,All Students,2022-23,13347,1309,12038,90.2,81,31,38.3
2,All Students,2018-19,12462,861,11601,93.1,74,16,21.6
2,All Students,2019-20,9286,571,8715,93.9,85,14,16.5
2,All Students,2020-21,16401,1039,15362,93.7,95,21,22.1
2,All Students,2021-22,12341,1131,11210,90.8,73,21,28.8
2,All Students,2022-23,12214,1163,11051,90.5,78,27,34.6
3,All Students,2018-19,15086,827,14259,94.5,91,15,16.5
3,All Students,2019-20,7686,384,7302,95.0,71,11,15.5
3,All Students,2020-21,14439,1185,13254,91.8,86,28,32.6
3,All Students,2021-22,15754,1153,14601,92.7,92,26,28.3
3,All Students,2022-23,11220,865,10355,92.3,72,22,30.6
4,All Students,2018-19,14490,624,13866,95.7,90,13,14.4
4,All Students,2019-20,9555,543,9012,94.3,87,15,17.2
4,All Students,2020-21,12834,499,12335,96.1,75,10,13.3
4,All Students,2021-22,14137,1054,13083,92.5,82,21,25.6
4,All Students,2022-23,15962,1076,14886,93.3,97,21,21.6
5,All Students,2018-19,15331,632,14699,95.9,91,12,13.2
5,All Students,2019-20,9260,385,8875,95.8,83,8,9.6
5,All Students,2020-21,14658,672,13986,95.4,86,14,16.3
5,All Students,2021-22,10764,927,9837,91.4,65,19,29.2
5,All Students,2022-23,15249,1011,14238,93.4,90,21,23.3
All Grades,All Students,2018-19,85983,10313,75670,88.0,538,288,53.5
All Grades,All Students,2019-20,53489,6482,47007,87.9,502,242,48.2
All Grades,All Students,2020-21,79861,15389,64472,80.7,496,326,65.7
All Grades,All Students,2021-22,82110,16391,65719,80.0,515,375,72.8
All Grades,All Students,2022-23,79991,14195,65796,82.3,497,336,67.6
PK in K-12 Schools,All Students,2018-19,7463,1227,6236,83.6,51,36,70.6
PK in K-12 Schools,All Students,2019-20,6098,1169,4929,80.8,57,38,66.7
PK in K-12 Schools,All Students,2020-21,7105,1534,5571,78.4,56,45,80.4
PK in K-12 Schools,All Students,2021-22,10610,2484,8126,76.6,68,53,77.9
PK in K-12 Schools,All Students,2022-23,8650,1850,6800,78.6,58,43,74.1
0K,All Students,2018-19,7479,1161,6318,84.5,49,35,71.4
0K,All Students,2019-20,4946,684,4262,86.2,48,24,50.0
0K,All Students,2020-21,7484,1435,6049,80.8,45,28,62.2
0K,All Students,2021-22,8880,1991,6889,77.6,59,50,84.7
0K,All Students,2022-23,6993,1189,5804,83.0,44,33,75.0
1,All Students,2018-19,11480,1582,9898,86.2,70,41,58.6
1,All Students,2019-20,4598,611,3987,86.7,44,23,52.3
1,All Students,2020-21,8138,1301,6837,84.0,51,27,52.9
1,All Students,2021-22,7595,1486,6109,80.4,45,34,75.6
1,All Students,2022-23,7913,1503,6410,81.0,50,35,70.0
2,All Students,2018-19,8093,842,7251,89.6,53,24,45.3
2,All Students,2019-20,6714,855,5859,87.3,64,36,56.3
2,All Students,2020-21,6387,1344,5043,79.0,39,27,69.2
2,All Students,2021-22,8282,1617,6665,80.5,51,35,68.6
2,All Students,2022-23,7943,1270,6673,84.0,48,31,64.6
3,All Students,2018-19,7578,838,6740,88.9,48,24,50.0
3,All Students,2019-20,5596,566,5030,89.9,50,20,40.0
3,All Students,2020-21,9893,2121,7772,78.6,60,42,70.0
3,All Students,2021-22,7910,1308,6602,83.5,51,30,58.8
3,All Students,2022-23,9570,1430,8140,85.1,58,35,60.3
4,All Students,2018-19,8548,818,7730,90.4,51,23,45.1
4,All Students,2019-20,5095,525,4570,89.7,49,18,36.7
4,All Students,2020-21,8683,1299,7384,85.0,52,36,69.2
4,All Students,2021-22,10094,2014,8080,80.0,62,45,72.6
4,All Students,2022-23,7812,1311,6501,83.2,46,32,69.6
5,All Students,2018-19,9563,880,8683,90.8,57,22,38.6
5,All Students,2019-20,5312,533,4779,90.0,47,17,36.2
5,All Students,2020-21,7318,1520,5798,79.2,44,28,63.6
5,All Students,2021-22,8433,1445,6988,82.9,52,39,75.0
5,All Students,2022-23,10807,2117,8690,80.4,67,46,68.7
6,All Students,2018-19,9431,992,8439,89.5,60,31,51.7
6,All Students,2019-20,4690,448,4242,90.4,45,23,51.1
6,All Students,2020-21,8399,1168,7231,86.1,52,25,48.1
6,All Students,2021-22,5367,1102,4265,79.5,36,27,75.0
6,All Students,2022-23,8011,1428,6583,82.2,51,39,76.5
7,All Students,2018-19,8207,905,7302,89.0,49,23,46.9
7,All Students,2019-20,5852,560,5292,90.4,55,24,43.6
7,All Students,2020-21,7002,1466,5536,79.1,40,26,65.0
7,All Students,2021-22,7945,1417,6528,82.2,48,27,56.3
7,All Students,2022-23,4764,725,4039,84.8,30,17,56.7
8,All Students,2018-19,8141,1068,7073,86.9,50,29,58.0
8,All Students,2019-20,4588,531,4057,88.4,43,19,44.2
8,All Students,2020-21,9452,2201,7251,76.7,57,42,73.7
8,All Students,2021-22,6994,1527,5467,78.2,43,35,81.4
8,All Students,2022-23,7528,1372,6156,81.8,45,25,55.6
All Grades,All Students,2018-19,94385,7576,86809,92.0,600,188,31.3
All Grades,All Students,2019-20,59795,5333,54462,91.1,552,182,33.0
All Grades,All Students,2020-21,77103,7539,69564,90.2,460,159,34.6
All Grades,All Students,2021-22,73751,10988,62763,85.1,453,280,61.8
All Grades,All Students,2022-23,72745,8483,64262,88.3,439,217,49.4
PK in K-12 Schools,All Students,2018-19,14558,1489,13069,89.8,96,40,41.7
PK in K-12 Schools,All Students,2019-20,10269,1279,8990,87.5,96,54,56.3
PK in K-12 Schools,All Students,2020-21,12997,1306,11691,90.0,77,28,36.4
PK in K-12 Schools,All Students,2021-22,13613,2892,10721,78.8,85,66,77.6
PK in K-12 Schools,All Students,2022-23,13157,2073,11084,84.2,81,52,64.2
0K,All Students,2018-19,13247,1338,11909,89.9,93,38,40.9
0K,All Students,2019-20,7569,799,6770,89.4,71,27,38.0
0K,All Students,2020-21,8799,s,s,s,s,s,s
0K,All Students,2021-22,9441,1381,8060,85.4,59,39,66.1
0K,All Students,2022-23,8683,1267,7416,85.4,53,34,64.2
1,All Students,2018-19,12339,1093,11246,91.1,79,31,39.2
1,All Students,2019-20,8922,784,8138,91.2,84,28,33.3
1,All Students,2020-21,10663,1455,9208,86.4,62,30,48.4
1,All Students,2021-22,10618,1533,9085,85.6,64,40,62.5
1,All Students,2022-23,10321,1113,9208,89.2,62,29,46.8
2,All Students,2018-19,11529,750,10779,93.5,68,16,23.5
2,All Students,2019-20,7892,676,7216,91.4,72,23,31.9
2,All Students,2020-21,12904,1180,11724,90.9,75,27,36.0
2,All Students,2021-22,9926,1172,8754,88.2,61,29,47.5
2,All Students,2022-23,11183,1100,10083,90.2,68,26,38.2
3,All Students,2018-19,11895,854,11041,92.8,76,23,30.3
3,All Students,2019-20,7658,497,7161,93.5,69,11,15.9
3,All Students,2020-21,11053,815,10238,92.6,66,14,21.2
3,All Students,2021-22,9780,1453,8327,85.1,59,38,64.4
3,All Students,2022-23,8081,760,7321,90.6,48,20,41.7
4,All Students,2018-19,17943,1203,16740,93.3,110,25,22.7
4,All Students,2019-20,6571,465,6106,92.9,62,14,22.6
4,All Students,2020-21,11114,682,10432,93.9,67,14,20.9
4,All Students,2021-22,10693,1425,9268,86.7,68,38,55.9
4,All Students,2022-23,10944,1173,9771,89.3,65,30,46.2
5,All Students,2018-19,12874,849,12025,93.4,78,15,19.2
5,All Students,2019-20,10914,833,10081,92.4,98,25,25.5
5,All Students,2020-21,9406,835,8571,91.1,56,17,30.4
5,All Students,2021-22,9680,1132,8548,88.3,57,30,52.6
5,All Students,2022-23,10376,997,9379,90.4,62,26,41.9
6,All Students,2020-21,167,s,s,s,s,s,s
All Grades,All Students,2018-19,198503,10927,187576,94.5,1149,192,16.7
All Grades,All Students,2019-20,125926,6511,119415,94.8,1130,163,14.4
All Grades,All Students,2020-21,179888,22520,157368,87.5,1049,440,41.9
All Grades,All Students,2021-22,155587,14313,141274,90.8,921,316,34.3
All Grades,All Students,2022-23,160294,14791,145503,90.8,966,354,36.6
5,All Students,2022-23,18,s,s,s,s,s,s
6,All Students,2018-19,64513,s,s,s,s,s,s
6,All Students,2019-20,38199,1783,36416,95.3,347,40,11.5
6,All Students,2020-21,56361,6253,50108,88.9,330,130,39.4
6,All Students,2021-22,43051,3503,39548,91.9,260,78,30.0
6,All Students,2022-23,51863,4426,47437,91.5,310,107,34.5
7,All Students,2018-19,68632,3798,64834,94.5,393,57,14.5
7,All Students,2019-20,43601,2635,40966,94.0,391,74,18.9
7,All Students,2020-21,58004,7718,50286,86.7,338,151,44.7
7,All Students,2021-22,55574,5373,50201,90.3,328,120,36.6
7,All Students,2022-23,47395,s,s,s,s,s,s
8,All Students,2018-19,65240,3724,61516,94.3,379,79,20.8
8,All Students,2019-20,44126,2093,42033,95.3,392,49,12.5
8,All Students,2020-21,65523,8549,56974,87.0,381,159,41.7
8,All Students,2021-22,56962,5437,51525,90.5,333,118,35.4
8,All Students,2022-23,61018,5791,55227,90.5,363,136,37.5
9,All Students,2018-19,118,s,s,s,s,s,s
All Grades,All Students,2018-19,122787,6825,115962,94.4,701,101,14.4
All Grades,All Students,2019-20,79242,4710,74532,94.1,702,121,17.2
All Grades,All Students,2020-21,114776,4584,110192,96.0,668,57,8.5
All Grades,All Students,2021-22,112764,10123,102641,91.0,648,210,32.4
All Grades,All Students,2022-23,114311,9800,104511,91.4,662,211,31.9
PK in K-12 Schools,All Students,2018-19,13924,1407,12517,89.9,81,34,42.0
PK in K-12 Schools,All Students,2019-20,11320,928,10392,91.8,101,33,32.7
PK in K-12 Schools,All Students,2020-21,14157,507,13650,96.4,84,9,10.7
PK in K-12 Schools,All Students,2021-22,15098,2131,12967,85.9,88,55,62.5
PK in K-12 Schools,All Students,2022-23,13615,1866,11749,86.3,80,55,68.8
0K,All Students,2018-19,12999,818,12181,93.7,76,15,19.7
0K,All Students,2019-20,7531,518,7013,93.1,66,14,21.2
0K,All Students,2020-21,11934,685,11249,94.3,70,10,14.3
0K,All Students,2021-22,10437,966,9471,90.7,61,20,32.8
0K,All Students,2022-23,11321,1314,10007,88.4,69,33,47.8
1,All Students,2018-19,13484,709,12775,94.7,77,6,7.8
1,All Students,2019-20,7936,469,7467,94.1,72,11,15.3
1,All Students,2020-21,11044,540,10504,95.1,64,8,12.5
1,All Students,2021-22,12184,1203,10981,90.1,70,26,37.1
1,All Students,2022-23,10829,990,9839,90.9,62,22,35.5
2,All Students,2018-19,12785,490,12295,96.2,72,3,4.2
2,All Students,2019-20,8467,421,8046,95.0,74,8,10.8
2,All Students,2020-21,10150,344,9806,96.6,58,3,5.2
2,All Students,2021-22,11266,798,10468,92.9,64,16,25.0
2,All Students,2022-23,11745,933,10812,92.1,69,21,30.4
3,All Students,2018-19,11473,582,10891,94.9,65,7,10.8
3,All Students,2019-20,8051,351,7700,95.6,70,4,5.7
3,All Students,2020-21,13255,538,12717,95.9,78,5,6.4
3,All Students,2021-22,10683,852,9831,92.0,61,11,18.0
3,All Students,2022-23,11090,760,10330,93.1,63,10,15.9
4,All Students,2018-19,14133,623,13510,95.6,80,7,8.8
4,All Students,2019-20,7433,374,7059,95.0,65,6,9.2
4,All Students,2020-21,10574,265,10309,97.5,61,3,4.9
4,All Students,2021-22,12413,883,11530,92.9,71,16,22.5
4,All Students,2022-23,11337,788,10549,93.0,65,13,20.0
5,All Students,2018-19,12496,557,11939,95.5,72,7,9.7
5,All Students,2019-20,8855,442,8413,95.0,77,7,9.1
5,All Students,2020-21,12483,339,12144,97.3,72,2,2.8
5,All Students,2021-22,11003,841,10162,92.4,63,15,23.8
5,All Students,2022-23,13228,924,12304,93.0,76,17,22.4
6,All Students,2018-19,11320,466,10854,95.9,64,4,6.3
6,All Students,2019-20,6623,411,6212,93.8,59,12,20.3
6,All Students,2020-21,10096,234,9862,97.7,58,2,3.4
6,All Students,2021-22,10762,772,9990,92.8,62,14,22.6
6,All Students,2022-23,10938,650,10288,94.1,63,9,14.3
7,All Students,2018-19,8072,452,7620,94.4,46,9,19.6
7,All Students,2019-20,7148,380,6768,94.7,64,12,18.8
7,All Students,2020-21,9883,403,9480,95.9,59,7,11.9
7,All Students,2021-22,9371,804,8567,91.4,53,16,30.2
7,All Students,2022-23,10728,722,10006,93.3,61,13,21.3
8,All Students,2018-19,12101,721,11380,94.0,68,9,13.2
8,All Students,2019-20,5878,416,5462,92.9,54,14,25.9
8,All Students,2020-21,11200,729,10471,93.5,64,8,12.5
8,All Students,2021-22,9547,873,8674,90.9,55,21,38.2
8,All Students,2022-23,9480,853,8627,91.0,54,18,33.3
All Grades,All Students,2018-19,339071,25004,314067,92.6,2010,501,24.9
All Grades,All Students,2019-20,207589,13922,193667,93.3,1887,427,22.6
All Grades,All Students,2020-21,297218,41655,255563,86.0,1750,818,46.7
All Grades,All Students,2021-22,273046,29371,243675,89.2,1655,662,40.0
All Grades,All Students,2022-23,266542,25755,240787,90.3,1625,611,37.6
4,All Students,2022-23,68,s,s,s,s,s,s
6,All Students,2018-19,114847,7125,107722,93.8,683,140,20.5
6,All Students,2019-20,63296,3861,59435,93.9,575,112,19.5
6,All Students,2020-21,88513,11798,76715,86.7,523,228,43.6
6,All Students,2021-22,87254,8847,78407,89.9,529,189,35.7
6,All Students,2022-23,87261,7134,80127,91.8,534,159,29.8
7,All Students,2018-19,109952,7610,102342,93.1,658,157,23.9
7,All Students,2019-20,73401,5026,68375,93.2,670,156,23.3
7,All Students,2020-21,97478,13973,83505,85.7,575,292,50.8
7,All Students,2021-22,87242,9019,78223,89.7,539,202,37.5
7,All Students,2022-23,88515,8591,79924,90.3,538,196,36.4
8,All Students,2018-19,114272,10269,104003,91.0,669,204,30.5
8,All Students,2019-20,70892,5035,65857,92.9,642,159,24.8
8,All Students,2020-21,111227,15884,95343,85.7,652,298,45.7
8,All Students,2021-22,98550,11505,87045,88.3,587,271,46.2
8,All Students,2022-23,90691,9997,80694,89.0,552,255,46.2
9,All Students,2022-23,7,s,s,s,s,s,s
All Grades,All Students,2018-19,101337,8910,92427,91.2,619,216,34.9
All Grades,All Students,2019-20,61637,5258,56379,91.5,565,196,34.7
All Grades,All Students,2020-21,82499,9295,73204,88.7,505,212,42.0
All Grades,All Students,2021-22,83819,10864,72955,87.0,523,298,57.0
All Grades,All Students,2022-23,84847,10255,74592,87.9,519,270,52.0
PK in K-12 Schools,All Students,2018-19,12714,1902,10812,85.0,77,48,62.3
PK in K-12 Schools,All Students,2019-20,8064,1252,6812,84.5,76,53,69.7
PK in K-12 Schools,All Students,2020-21,8603,s,s,s,s,s,s
PK in K-12 Schools,All Students,2021-22,10143,1749,8394,82.8,64,55,85.9
PK in K-12 Schools,All Students,2022-23,11075,s,s,s,s,s,s
0K,All Students,2018-19,17144,1635,15509,90.5,107,43,40.2
0K,All Students,2019-20,8933,868,8065,90.3,82,33,40.2
0K,All Students,2020-21,11579,1619,9960,86.0,74,39,52.7
0K,All Students,2021-22,11115,1649,9466,85.2,73,45,61.6
0K,All Students,2022-23,11246,1661,9585,85.2,74,49,66.2
1,All Students,2018-19,12726,1194,11532,90.6,78,27,34.6
1,All Students,2019-20,9708,687,9021,92.9,89,25,28.1
1,All Students,2020-21,11919,1374,10545,88.5,71,29,40.8
1,All Students,2021-22,12976,1509,11467,88.4,79,41,51.9
1,All Students,2022-23,12237,1415,10822,88.4,76,39,51.3
2,All Students,2018-19,12381,929,11452,92.5,79,27,34.2
2,All Students,2019-20,7820,617,7203,92.1,72,24,33.3
2,All Students,2020-21,13296,1378,11918,89.6,80,30,37.5
2,All Students,2021-22,11299,1335,9964,88.2,72,34,47.2
2,All Students,2022-23,12019,1311,10708,89.1,70,31,44.3
3,All Students,2018-19,14151,1020,13131,92.8,84,23,27.4
3,All Students,2019-20,7382,494,6888,93.3,68,18,26.5
3,All Students,2020-21,11874,1052,10822,91.1,72,24,33.3
3,All Students,2021-22,15012,1734,13278,88.4,93,47,50.5
3,All Students,2022-23,11599,1314,10285,88.7,71,34,47.9
4,All Students,2018-19,16181,1161,15020,92.8,98,25,25.5
4,All Students,2019-20,9307,639,8668,93.1,84,22,26.2
4,All Students,2020-21,12023,1409,10614,88.3,71,30,42.3
4,All Students,2021-22,11934,1513,10421,87.3,74,38,51.4
4,All Students,2022-23,14819,1497,13322,89.9,87,35,40.2
5,All Students,2018-19,16040,1069,14971,93.3,96,23,24.0
5,All Students,2019-20,10423,701,9722,93.3,94,21,22.3
5,All Students,2020-21,13038,1276,11762,90.2,76,27,35.5
5,All Students,2021-22,11340,1375,9965,87.9,68,38,55.9
5,All Students,2022-23,11747,1226,10521,89.6,70,34,48.6
6,All Students,2020-21,167,s,s,s,s,s,s
6,All Students,2022-23,105,s,s,s,s,s,s
All Grades,All Students,2018-19,164663,13835,150828,91.6,1025,337,32.9
All Grades,All Students,2019-20,104973,8473,96500,91.9,976,278,28.5
All Grades,All Students,2020-21,152022,19235,132787,87.3,896,338,37.7
All Grades,All Students,2021-22,154137,19634,134503,87.3,922,443,48.0
All Grades,All Students,2022-23,143121,15055,128066,89.5,893,368,41.2
6,All Students,2018-19,52593,4311,48282,91.8,346,115,33.2
6,All Students,2019-20,33016,2640,30376,92.0,311,89,28.6
6,All Students,2020-21,45078,4887,40191,89.2,266,87,32.7
6,All Students,2021-22,50875,6146,44729,87.9,309,148,47.9
6,All Students,2022-23,38856,4201,34655,89.2,255,106,41.6
7,All Students,2018-19,52862,4131,48731,92.2,328,103,31.4
7,All Students,2019-20,35474,2639,32835,92.6,328,80,24.4
7,All Students,2020-21,52779,7156,45623,86.4,313,128,40.9
7,All Students,2021-22,50837,6222,44615,87.8,299,134,44.8
7,All Students,2022-23,50840,5145,45695,89.9,311,124,39.9
8,All Students,2018-19,59208,5393,53815,90.9,351,119,33.9
8,All Students,2019-20,36483,3194,33289,91.2,337,109,32.3
8,All Students,2020-21,54165,7192,46973,86.7,317,123,38.8
8,All Students,2021-22,52425,7266,45159,86.1,314,161,51.3
8,All Students,2022-23,53425,5709,47716,89.3,327,138,42.2
All Grades,All Students,2018-19,168933,9759,159174,94.2,985,197,20.0
All Grades,All Students,2019-20,108422,5747,102675,94.7,957,147,15.4
All Grades,All Students,2020-21,155467,8252,147215,94.7,910,136,14.9
All Grades,All Students,2021-22,150376,13240,137136,91.2,872,294,33.7
All Grades,All Students,2022-23,145140,13020,132120,91.0,865,316,36.5
PK in K-12 Schools,All Students,2018-19,5841,531,5310,90.9,33,12,36.4
PK in K-12 Schools,All Students,2019-20,5809,547,5262,90.6,51,15,29.4
PK in K-12 Schools,All Students,2020-21,8402,614,7788,92.7,51,12,23.5
PK in K-12 Schools,All Students,2021-22,8793,1319,7474,85.0,51,29,56.9
PK in K-12 Schools,All Students,2022-23,8901,s,s,s,s,s,s
0K,All Students,2018-19,15576,1369,14207,91.2,94,31,33.0
0K,All Students,2019-20,9076,688,8388,92.4,81,21,25.9
0K,All Students,2020-21,13519,1418,12101,89.5,83,24,28.9
0K,All Students,2021-22,14314,1623,12691,88.7,83,41,49.4
0K,All Students,2022-23,13035,1445,11590,88.9,78,32,41.0
1,All Students,2018-19,14096,906,13190,93.6,82,17,20.7
1,All Students,2019-20,10364,586,9778,94.3,91,17,18.7
1,All Students,2020-21,13754,758,12996,94.5,81,13,16.0
1,All Students,2021-22,13984,1295,12689,90.7,81,27,33.3
1,All Students,2022-23,14453,1473,12980,89.8,85,40,47.1
2,All Students,2018-19,18854,1036,17818,94.5,112,18,16.1
2,All Students,2019-20,9352,576,8776,93.8,82,20,24.4
2,All Students,2020-21,14511,669,13842,95.4,85,8,9.4
2,All Students,2021-22,13360,1238,12122,90.7,79,28,35.4
2,All Students,2022-23,14494,1186,13308,91.8,87,29,33.3
3,All Students,2018-19,17142,952,16190,94.4,100,19,19.0
3,All Students,2019-20,12626,573,12053,95.5,112,13,11.6
3,All Students,2020-21,12111,307,11804,97.5,71,2,2.8
3,All Students,2021-22,15060,1255,13805,91.7,87,32,36.8
3,All Students,2022-23,13738,1245,12493,90.9,86,32,37.2
4,All Students,2018-19,17740,893,16847,95.0,102,18,17.6
4,All Students,2019-20,11154,558,10596,95.0,100,10,10.0
4,All Students,2020-21,18408,602,17806,96.7,108,12,11.1
4,All Students,2021-22,13777,1091,12686,92.1,79,24,30.4
4,All Students,2022-23,14725,1102,13623,92.5,89,30,33.7
5,All Students,2018-19,20410,1096,19314,94.6,120,22,18.3
5,All Students,2019-20,11480,591,10889,94.9,100,14,14.0
5,All Students,2020-21,17158,1103,16055,93.6,101,18,17.8
5,All Students,2021-22,19183,1555,17628,91.9,112,37,33.0
5,All Students,2022-23,14156,1052,13104,92.6,83,23,27.7
6,All Students,2018-19,21431,1221,20210,94.3,125,30,24.0
6,All Students,2019-20,13218,489,12729,96.3,117,7,6.0
6,All Students,2020-21,16409,822,15587,95.0,94,13,13.8
6,All Students,2021-22,17015,1329,15686,92.2,99,27,27.3
6,All Students,2022-23,18724,1482,17242,92.1,111,33,29.7
7,All Students,2018-19,18138,721,17417,96.0,104,10,9.6
7,All Students,2019-20,14288,663,13625,95.4,126,18,14.3
7,All Students,2020-21,20129,761,19368,96.2,115,12,10.4
7,All Students,2021-22,15084,1127,13957,92.5,88,25,28.4
7,All Students,2022-23,17905,1463,16442,91.8,107,34,31.8
8,All Students,2018-19,19705,1034,18671,94.8,113,20,17.7
8,All Students,2019-20,11055,476,10579,95.7,97,12,12.4
8,All Students,2020-21,21066,1198,19868,94.3,121,22,18.2
8,All Students,2021-22,19806,1408,18398,92.9,113,24,21.2
8,All Students,2022-23,14840,1179,13661,92.1,86,28,32.6
9,All Students,2022-23,169,s,s,s,s,s,s
All Grades,All Students,2018-19,100981,8478,92503,91.6,613,194,31.6
All Grades,All Students,2019-20,63381,5163,58218,91.9,587,186,31.7
All Grades,All Students,2020-21,89454,14656,74798,83.6,536,279,52.1
All Grades,All Students,2021-22,87403,12289,75114,85.9,530,296,55.8
All Grades,All Students,2022-23,90277,10450,79827,88.4,548,256,46.7
PK in K-12 Schools,All Students,2018-19,7874,645,7229,91.8,45,13,28.9
PK in K-12 Schools,All Students,2019-20,5154,425,4729,91.8,45,17,37.8
PK in K-12 Schools,All Students,2020-21,7043,1058,5985,85.0,44,26,59.1
PK in K-12 Schools,All Students,2021-22,7956,979,6977,87.7,48,27,56.3
PK in K-12 Schools,All Students,2022-23,7958,813,7145,89.8,45,22,48.9
0K,All Students,2018-19,13577,1454,12123,89.3,82,30,36.6
0K,All Students,2019-20,8566,685,7881,92.0,83,28,33.7
0K,All Students,2020-21,12790,2490,10300,80.5,77,46,59.7
0K,All Students,2021-22,12897,2030,10867,84.3,78,51,65.4
0K,All Students,2022-23,12079,1411,10668,88.3,78,41,52.6
1,All Students,2018-19,15725,1417,14308,91.0,96,36,37.5
1,All Students,2019-20,9282,751,8531,91.9,86,21,24.4
1,All Students,2020-21,13176,1910,11266,85.5,77,39,50.6
1,All Students,2021-22,13482,2186,11296,83.8,81,49,60.5
1,All Students,2022-23,14369,1924,12445,86.6,91,47,51.6
2,All Students,2018-19,12755,981,11774,92.3,79,23,29.1
2,All Students,2019-20,9923,866,9057,91.3,91,38,41.8
2,All Students,2020-21,14027,2722,11305,80.6,84,43,51.2
2,All Students,2021-22,12973,1638,11335,87.4,79,41,51.9
2,All Students,2022-23,13808,1567,12241,88.7,84,38,45.2
3,All Students,2018-19,17547,1619,15928,90.8,112,41,36.6
3,All Students,2019-20,8448,639,7809,92.4,78,18,23.1
3,All Students,2020-21,14076,2558,11518,81.8,85,40,47.1
3,All Students,2021-22,12612,1826,10786,85.5,80,40,50.0
3,All Students,2022-23,14260,1598,12662,88.8,85,36,42.4
4,All Students,2018-19,17091,1368,15723,92.0,102,31,30.4
4,All Students,2019-20,11018,870,10148,92.1,101,33,32.7
4,All Students,2020-21,12572,1915,10657,84.8,74,40,54.1
4,All Students,2021-22,14244,2105,12139,85.2,84,47,56.0
4,All Students,2022-23,13209,1432,11777,89.2,77,32,41.6
5,All Students,2018-19,16412,994,15418,93.9,97,20,20.6
5,All Students,2019-20,10990,927,10063,91.6,103,31,30.1
5,All Students,2020-21,15770,2003,13767,87.3,95,45,47.4
5,All Students,2021-22,13239,1525,11714,88.5,80,41,51.3
5,All Students,2022-23,14594,1705,12889,88.3,88,40,45.5
All Grades,All Students,2018-19,108371,6555,101816,94.0,638,113,17.7
All Grades,All Students,2019-20,70764,4577,66187,93.5,637,125,19.6
All Grades,All Students,2020-21,100932,8580,92352,91.5,604,177,29.3
All Grades,All Students,2021-22,94922,10680,84242,88.7,569,263,46.2
All Grades,All Students,2022-23,94024,9620,84404,89.8,591,254,43.0
PK in K-12 Schools,All Students,2018-19,6367,578,5789,90.9,36,12,33.3
PK in K-12 Schools,All Students,2019-20,7622,650,6972,91.5,71,21,29.6
PK in K-12 Schools,All Students,2020-21,13306,1901,11405,85.7,79,39,49.4
PK in K-12 Schools,All Students,2021-22,14396,2379,12017,83.5,89,62,69.7
PK in K-12 Schools,All Students,2022-23,14418,2270,12148,84.3,88,60,68.2
0K,All Students,2018-19,15141,1035,14106,93.2,90,14,15.6
0K,All Students,2019-20,8544,780,7764,90.9,77,27,35.1
0K,All Students,2020-21,12274,1172,11102,90.5,76,23,30.3
0K,All Students,2021-22,12622,1685,10937,86.7,77,46,59.7
0K,All Students,2022-23,13909,1612,12297,88.4,89,44,49.4
1,All Students,2018-19,16986,1238,15748,92.7,101,26,25.7
1,All Students,2019-20,9268,694,8574,92.5,83,19,22.9
1,All Students,2020-21,12142,885,11257,92.7,73,21,28.8
1,All Students,2021-22,13783,1521,12262,89.0,80,30,37.5
1,All Students,2022-23,13079,1264,11815,90.3,83,32,38.6
2,All Students,2018-19,17048,983,16065,94.2,100,18,18.0
2,All Students,2019-20,11026,692,10334,93.7,101,19,18.8
2,All Students,2020-21,13427,953,12474,92.9,80,19,23.8
2,All Students,2021-22,12619,1307,11312,89.6,74,34,45.9
2,All Students,2022-23,13629,1180,12449,91.3,89,36,40.4
3,All Students,2018-19,17747,803,16944,95.5,102,10,9.8
3,All Students,2019-20,11615,674,10941,94.2,105,15,14.3
3,All Students,2020-21,15912,1004,14908,93.7,94,21,22.3
3,All Students,2021-22,11518,1021,10497,91.1,70,24,34.3
3,All Students,2022-23,12489,1184,11305,90.5,79,33,41.8
4,All Students,2018-19,17561,981,16580,94.4,104,18,17.3
4,All Students,2019-20,11315,563,10752,95.0,100,13,13.0
4,All Students,2020-21,17338,1601,15737,90.8,103,34,33.0
4,All Students,2021-22,13512,1350,12162,90.0,81,31,38.3
4,All Students,2022-23,12027,847,11180,93.0,73,17,23.3
5,All Students,2018-19,17521,937,16584,94.7,105,15,14.3
5,All Students,2019-20,11374,524,10850,95.4,100,11,11.0
5,All Students,2020-21,16533,1064,15469,93.6,99,20,20.2
5,All Students,2021-22,16472,1417,15055,91.4,98,36,36.7
5,All Students,2022-23,14473,1263,13210,91.3,90,32,35.6
All Grades,All Students,2018-19,53723,11559,42164,78.5,357,213,59.7
All Grades,All Students,2019-20,33337,7059,26278,78.8,326,199,61.0
All Grades,All Students,2020-21,43157,19184,23973,55.5,251,198,78.9
All Grades,All Students,2021-22,42642,10503,32139,75.4,283,197,69.6
All Grades,All Students,2022-23,41978,7119,34859,83.0,295,137,46.4
9,All Students,2018-19,15275,4009,11266,73.8,106,62,58.5
9,All Students,2019-20,9716,2513,7203,74.1,98,67,68.4
9,All Students,2020-21,11302,6081,5221,46.2,63,50,79.4
9,All Students,2021-22,14137,3465,10672,75.5,97,61,62.9
9,All Students,2022-23,12372,2053,10319,83.4,89,39,43.8
10,All Students,2018-19,16282,3945,12337,75.8,111,76,68.5
10,All Students,2019-20,10861,2407,8454,77.8,107,65,60.7
10,All Students,2020-21,15753,8183,7570,48.1,94,83,88.3
10,All Students,2021-22,10059,3020,7039,70.0,70,54,77.1
10,All Students,2022-23,13804,2568,11236,81.4,103,53,51.5
11,All Students,2018-19,9460,1386,8074,85.3,61,30,49.2
11,All Students,2019-20,4830,870,3960,82.0,49,30,61.2
11,All Students,2020-21,8455,2537,5918,70.0,49,32,65.3
11,All Students,2021-22,9019,2148,6871,76.2,58,43,74.1
11,All Students,2022-23,6155,808,5347,86.9,41,16,39.0
12,All Students,2018-19,12706,2219,10487,82.5,79,45,57.0
12,All Students,2019-20,7930,1269,6661,84.0,77,41,53.2
12,All Students,2020-21,7647,2383,5264,68.8,45,33,73.3
12,All Students,2021-22,9427,1870,7557,80.2,58,39,67.2
12,All Students,2022-23,9647,1690,7957,82.5,62,29,46.8
All Grades,All Students,2018-19,165080,12900,152180,92.2,983,264,26.9
All Grades,All Students,2019-20,119925,8221,111704,93.1,1098,242,22.0
All Grades,All Students,2020-21,198326,11685,186641,94.1,1189,222,18.7
All Grades,All Students,2021-22,203222,24207,179015,88.1,1215,545,44.9
All Grades,All Students,2022-23,201822,24237,177585,88.0,1239,576,46.5
6,All Students,2018-19,26081,1093,24988,95.8,148,13,8.8
6,All Students,2019-20,19239,1089,18150,94.3,174,27,15.5
6,All Students,2020-21,29239,1156,28083,96.0,169,19,11.2
6,All Students,2021-22,22187,2219,19968,90.0,132,55,41.7
6,All Students,2022-23,23944,2009,21935,91.6,139,46,33.1
7,All Students,2018-19,23814,1359,22455,94.3,136,22,16.2
7,All Students,2019-20,17345,849,16496,95.1,155,19,12.3
7,All Students,2020-21,28214,1686,26528,94.0,163,30,18.4
7,All Students,2021-22,27242,2399,24843,91.2,160,48,30.0
7,All Students,2022-23,20540,2203,18337,89.3,119,49,41.2
8,All Students,2018-19,23931,1344,22587,94.4,139,26,18.7
8,All Students,2019-20,15440,857,14583,94.4,139,22,15.8
8,All Students,2020-21,25401,956,24445,96.2,146,16,11.0
8,All Students,2021-22,27857,3122,24735,88.8,159,60,37.7
8,All Students,2022-23,26947,2474,24473,90.8,156,53,34.0
9,All Students,2018-19,25528,1981,23547,92.2,160,42,26.3
9,All Students,2019-20,21424,1503,19921,93.0,202,50,24.8
9,All Students,2020-21,38611,2574,36037,93.3,224,52,23.2
9,All Students,2021-22,37639,4539,33100,87.9,225,105,46.7
9,All Students,2022-23,37305,4491,32814,88.0,236,107,45.3
10,All Students,2018-19,25395,1863,23532,92.7,156,34,21.8
10,All Students,2019-20,16031,1234,14797,92.3,148,37,25.0
10,All Students,2020-21,32890,2264,30626,93.1,190,45,23.7
10,All Students,2021-22,34663,3839,30824,88.9,213,96,45.1
10,All Students,2022-23,34892,4511,30381,87.1,216,104,48.1
11,All Students,2018-19,21406,2245,19161,89.5,129,47,36.4
11,All Students,2019-20,16546,1264,15282,92.4,152,38,25.0
11,All Students,2020-21,25636,1662,23974,93.5,148,27,18.2
11,All Students,2021-22,29899,4456,25443,85.1,182,93,51.1
11,All Students,2022-23,31782,4100,27682,87.1,199,100,50.3
12,All Students,2018-19,18925,3015,15910,84.1,115,80,69.6
12,All Students,2019-20,13900,1425,12475,89.7,128,49,38.3
12,All Students,2020-21,18335,1387,16948,92.4,149,33,22.1
12,All Students,2021-22,23735,3633,20102,84.7,144,88,61.1
12,All Students,2022-23,26412,4449,21963,83.2,174,117,67.2
All Grades,All Students,2018-19,55999,4264,51735,92.4,338,86,25.4
All Grades,All Students,2019-20,35492,2653,32839,92.5,323,91,28.2
All Grades,All Students,2020-21,52640,5475,47165,89.6,308,123,39.9
All Grades,All Students,2021-22,55870,5599,50271,90.0,338,139,41.1
All Grades,All Students,2022-23,56103,6086,50017,89.2,340,145,42.6
PK in K-12 Schools,All Students,2018-19,6273,660,5613,89.5,40,17,42.5
PK in K-12 Schools,All Students,2019-20,4093,413,3680,89.9,38,16,42.1
PK in K-12 Schools,All Students,2020-21,5586,782,4804,86.0,32,23,71.9
PK in K-12 Schools,All Students,2021-22,5369,840,4529,84.4,35,21,60.0
PK in K-12 Schools,All Students,2022-23,5699,1118,4581,80.4,35,29,82.9
0K,All Students,2018-19,9370,856,8514,90.9,55,17,30.9
0K,All Students,2019-20,6152,672,5480,89.1,56,24,42.9
0K,All Students,2020-21,7754,700,7054,91.0,46,15,32.6
0K,All Students,2021-22,8691,944,7747,89.1,51,24,47.1
0K,All Students,2022-23,7608,934,6674,87.7,47,24,51.1
1,All Students,2018-19,7560,512,7048,93.2,45,11,24.4
1,All Students,2019-20,5711,432,5279,92.4,53,15,28.3
1,All Students,2020-21,9302,958,8344,89.7,54,23,42.6
1,All Students,2021-22,8869,863,8006,90.3,55,18,32.7
1,All Students,2022-23,8541,797,7744,90.7,50,18,36.0
2,All Students,2018-19,8533,526,8007,93.8,53,10,18.9
2,All Students,2019-20,4825,332,4493,93.1,43,13,30.2
2,All Students,2020-21,8224,948,7276,88.5,50,25,50.0
2,All Students,2021-22,8685,899,7786,89.6,50,21,42.0
2,All Students,2022-23,8360,779,7581,90.7,52,20,38.5
3,All Students,2018-19,7282,418,6864,94.3,47,6,12.8
3,All Students,2019-20,5362,235,5127,95.6,49,6,12.2
3,All Students,2020-21,6602,627,5975,90.5,38,9,23.7
3,All Students,2021-22,8946,799,8147,91.1,55,23,41.8
3,All Students,2022-23,8561,747,7814,91.3,50,16,32.0
4,All Students,2018-19,7339,608,6731,91.7,42,13,31.0
4,All Students,2019-20,4787,309,4478,93.5,43,11,25.6
4,All Students,2020-21,8049,730,7319,90.9,47,13,27.7
4,All Students,2021-22,6673,559,6114,91.6,41,17,41.5
4,All Students,2022-23,9738,1084,8654,88.9,59,23,39.0
5,All Students,2018-19,9642,684,8958,92.9,56,12,21.4
5,All Students,2019-20,4562,260,4302,94.3,41,6,14.6
5,All Students,2020-21,7123,730,6393,89.8,41,15,36.6
5,All Students,2021-22,8637,695,7942,92.0,51,15,29.4
5,All Students,2022-23,7596,627,6969,91.7,47,15,31.9
All Grades,All Students,2018-19,46336,1423,44913,96.9,265,9,3.4
All Grades,All Students,2019-20,31921,1039,30882,96.7,279,17,6.1
All Grades,All Students,2020-21,48374,1371,47003,97.2,283,16,5.7
All Grades,All Students,2021-22,46342,2943,43399,93.6,267,59,22.1
All Grades,All Students,2022-23,46299,3109,43190,93.3,264,53,20.1
6,All Students,2018-19,15900,468,15432,97.1,91,4,4.4
6,All Students,2019-20,11419,307,11112,97.3,100,2,2.0
6,All Students,2020-21,16447,620,15827,96.2,97,10,10.3
6,All Students,2021-22,15054,1093,13961,92.7,86,23,26.7
6,All Students,2022-23,15909,921,14988,94.2,91,13,14.3
7,All Students,2018-19,15905,513,15392,96.8,91,2,2.2
7,All Students,2019-20,10395,386,10009,96.3,91,10,11.0
7,All Students,2020-21,16624,328,16296,98.0,96,0,0.0
7,All Students,2021-22,15554,1003,14551,93.6,89,22,24.7
7,All Students,2022-23,15377,1113,14264,92.8,88,24,27.3
8,All Students,2018-19,14531,442,14089,97.0,83,3,3.6
8,All Students,2019-20,10107,346,9761,96.6,88,5,5.7
8,All Students,2020-21,15303,423,14880,97.2,90,6,6.7
8,All Students,2021-22,15734,847,14887,94.6,92,14,15.2
8,All Students,2022-23,15013,1075,13938,92.8,85,16,18.8
All Grades,All Students,2018-19,66905,3903,63002,94.2,384,70,18.2
All Grades,All Students,2019-20,44508,2293,42215,94.8,396,66,16.7
All Grades,All Students,2020-21,68690,2359,66331,96.6,397,31,7.8
All Grades,All Students,2021-22,67318,6469,60849,90.4,394,143,36.3
All Grades,All Students,2022-23,68776,5836,62940,91.5,413,123,29.8
6,All Students,2018-19,23263,1258,22005,94.6,134,24,17.9
6,All Students,2019-20,14881,689,14192,95.4,132,18,13.6
6,All Students,2020-21,22752,808,21944,96.4,132,9,6.8
6,All Students,2021-22,23088,2199,20889,90.5,135,52,38.5
6,All Students,2022-23,23179,1784,21395,92.3,138,35,25.4
7,All Students,2018-19,22126,1222,20904,94.5,127,18,14.2
7,All Students,2019-20,15012,878,14134,94.2,134,32,23.9
7,All Students,2020-21,22957,425,22532,98.1,132,3,2.3
7,All Students,2021-22,22676,2312,20364,89.8,132,50,37.9
7,All Students,2022-23,22935,1968,20967,91.4,140,41,29.3
8,All Students,2018-19,21516,1423,20093,93.4,123,28,22.8
8,All Students,2019-20,14615,726,13889,95.0,130,16,12.3
8,All Students,2020-21,22981,1126,21855,95.1,133,19,14.3
8,All Students,2021-22,21554,1958,19596,90.9,127,41,32.3
8,All Students,2022-23,22662,2084,20578,90.8,135,47,34.8
All Grades,All Students,2018-19,77307,11703,65604,84.9,499,219,43.9
All Grades,All Students,2019-20,52347,7400,44947,85.9,501,211,42.1
All Grades,All Students,2020-21,82664,10905,71759,86.8,487,152,31.2
All Grades,All Students,2021-22,81957,13701,68256,83.3,522,202,38.7
All Grades,All Students,2022-23,79969,12276,67693,84.6,513,184,35.9
9,All Students,2018-19,18515,1720,16795,90.7,124,39,31.5
9,All Students,2019-20,15072,1450,13622,90.4,143,42,29.4
9,All Students,2020-21,23261,3153,20108,86.4,135,44,32.6
9,All Students,2021-22,22916,3274,19642,85.7,150,51,34.0
9,All Students,2022-23,20051,3026,17025,84.9,132,43,32.6
10,All Students,2018-19,19853,2470,17383,87.6,125,46,36.8
10,All Students,2019-20,12721,1515,11206,88.1,125,48,38.4
10,All Students,2020-21,23874,2670,21204,88.8,139,40,28.8
10,All Students,2021-22,21203,3431,17772,83.8,139,54,38.8
10,All Students,2022-23,21680,3498,18182,83.9,137,49,35.8
11,All Students,2018-19,21667,3662,18005,83.1,134,62,46.3
11,All Students,2019-20,12119,2007,10112,83.4,115,63,54.8
11,All Students,2020-21,19219,2885,16334,85.0,110,35,31.8
11,All Students,2021-22,22507,4014,18493,82.2,134,50,37.3
11,All Students,2022-23,18134,2798,15336,84.6,114,42,36.8
12,All Students,2018-19,17272,3851,13421,77.7,116,72,62.1
12,All Students,2019-20,12435,2428,10007,80.5,118,58,49.2
12,All Students,2020-21,16310,2197,14113,86.5,103,33,32.0
12,All Students,2021-22,15331,2982,12349,80.5,99,47,47.5
12,All Students,2022-23,20104,2954,17150,85.3,130,50,38.5
All Grades,All Students,2018-19,69452,5288,64164,92.4,414,102,24.6
All Grades,All Students,2019-20,43000,3245,39755,92.5,399,106,26.6
All Grades,All Students,2020-21,60507,3612,56895,94.0,368,76,20.7
All Grades,All Students,2021-22,62094,7521,54573,87.9,382,193,50.5
All Grades,All Students,2022-23,62409,6761,55648,89.2,384,170,44.3
PK in K-12 Schools,All Students,2018-19,6265,746,5519,88.1,39,17,43.6
PK in K-12 Schools,All Students,2019-20,3865,440,3425,88.6,38,16,42.1
PK in K-12 Schools,All Students,2020-21,5861,565,5296,90.4,38,14,36.8
PK in K-12 Schools,All Students,2021-22,5014,810,4204,83.8,31,23,74.2
PK in K-12 Schools,All Students,2022-23,4544,762,3782,83.2,28,17,60.7
0K,All Students,2018-19,8742,784,7958,91.0,53,15,28.3
0K,All Students,2019-20,5291,583,4708,89.0,51,22,43.1
0K,All Students,2020-21,7176,645,6531,91.0,48,19,39.6
0K,All Students,2021-22,9201,1476,7725,84.0,56,39,69.6
0K,All Students,2022-23,7940,1037,6903,86.9,49,25,51.0
1,All Students,2018-19,11943,1052,10891,91.2,71,19,26.8
1,All Students,2019-20,5723,416,5307,92.7,53,16,30.2
1,All Students,2020-21,7310,450,6860,93.8,44,11,25.0
1,All Students,2021-22,8361,965,7396,88.5,51,24,47.1
1,All Students,2022-23,10131,1163,8968,88.5,65,33,50.8
2,All Students,2018-19,10692,816,9876,92.4,64,12,18.8
2,All Students,2019-20,8039,555,7484,93.1,76,16,21.1
2,All Students,2020-21,8918,608,8310,93.2,53,9,17.0
2,All Students,2021-22,8048,957,7091,88.1,52,26,50.0
2,All Students,2022-23,8696,865,7831,90.1,52,19,36.5
3,All Students,2018-19,10643,668,9975,93.7,63,12,19.0
3,All Students,2019-20,6769,478,6291,92.9,61,14,23.0
3,All Students,2020-21,12131,611,11520,95.0,70,10,14.3
3,All Students,2021-22,8943,906,8037,89.9,52,24,46.2
3,All Students,2022-23,9140,1036,8104,88.7,59,26,44.1
4,All Students,2018-19,10744,634,10110,94.1,64,14,21.9
4,All Students,2019-20,6449,375,6074,94.2,59,13,22.0
4,All Students,2020-21,9692,228,9464,97.6,59,4,6.8
4,All Students,2021-22,11952,1219,10733,89.8,75,31,41.3
4,All Students,2022-23,10250,782,9468,92.4,61,18,29.5
5,All Students,2018-19,10423,588,9835,94.4,60,13,21.7
5,All Students,2019-20,6864,398,6466,94.2,61,9,14.8
5,All Students,2020-21,9419,505,8914,94.6,56,9,16.1
5,All Students,2021-22,10575,1188,9387,88.8,65,26,40.0
5,All Students,2022-23,11708,1116,10592,90.5,70,32,45.7
All Grades,All Students,2018-19,104118,6877,97241,93.4,642,121,18.8
All Grades,All Students,2019-20,67249,4224,63025,93.7,621,112,18.0
All Grades,All Students,2020-21,104718,9480,95238,90.9,609,183,30.0
All Grades,All Students,2021-22,100439,6587,93852,93.4,604,126,20.9
All Grades,All Students,2022-23,98365,9570,88795,90.3,609,209,34.3
9,All Students,2018-19,27436,1728,25708,93.7,172,24,14.0
9,All Students,2019-20,17205,1020,16185,94.1,159,30,18.9
9,All Students,2020-21,26249,1702,24547,93.5,154,30,19.5
9,All Students,2021-22,26637,1214,25423,95.4,159,19,11.9
9,All Students,2022-23,27291,2408,24883,91.2,170,54,31.8
10,All Students,2018-19,27841,1418,26423,94.9,171,21,12.3
10,All Students,2019-20,17885,1170,16715,93.5,166,32,19.3
10,All Students,2020-21,27075,2605,24470,90.4,158,55,34.8
10,All Students,2021-22,26598,1570,25028,94.1,163,27,16.6
10,All Students,2022-23,26608,2435,24173,90.8,168,50,29.8
11,All Students,2018-19,24540,1298,23242,94.7,151,23,15.2
11,All Students,2019-20,16345,716,15629,95.6,149,11,7.4
11,All Students,2020-21,24141,2336,21805,90.3,140,46,32.9
11,All Students,2021-22,23319,1694,21625,92.7,141,38,27.0
11,All Students,2022-23,22134,2074,20060,90.6,135,45,33.3
12,All Students,2018-19,24301,2433,21868,90.0,148,53,35.8
12,All Students,2019-20,15814,1318,14496,91.7,147,39,26.5
12,All Students,2020-21,27253,2837,24416,89.6,157,52,33.1
12,All Students,2021-22,23885,2109,21776,91.2,141,42,29.8
12,All Students,2022-23,22332,2653,19679,88.1,136,60,44.1
All Grades,All Students,2018-19,106888,12238,94650,88.6,667,251,37.6
All Grades,All Students,2019-20,74897,10981,63916,85.3,682,261,38.3
All Grades,All Students,2020-21,120165,26587,93578,77.9,707,301,42.6
All Grades,All Students,2021-22,112565,24124,88441,78.6,692,432,62.4
All Grades,All Students,2022-23,108692,19584,89108,82.0,693,415,59.9
6,All Students,2018-19,14355,888,13467,93.8,83,20,24.1
6,All Students,2019-20,10532,920,9612,91.3,96,34,35.4
6,All Students,2020-21,16174,1659,14515,89.7,93,28,30.1
6,All Students,2021-22,12661,1709,10952,86.5,78,43,55.1
6,All Students,2022-23,13496,1858,11638,86.2,87,44,50.6
7,All Students,2018-19,14179,1144,13035,91.9,85,21,24.7
7,All Students,2019-20,8760,676,8084,92.3,83,25,30.1
7,All Students,2020-21,14984,1779,13205,88.1,86,32,37.2
7,All Students,2021-22,12958,2082,10876,83.9,80,49,61.3
7,All Students,2022-23,13315,1988,11327,85.1,85,48,56.5
8,All Students,2018-19,12496,956,11540,92.3,75,17,22.7
8,All Students,2019-20,9000,874,8126,90.3,79,23,29.1
8,All Students,2020-21,12442,1349,11093,89.2,73,23,31.5
8,All Students,2021-22,13568,2116,11452,84.4,85,51,60.0
8,All Students,2022-23,13161,1998,11163,84.8,81,43,53.1
9,All Students,2018-19,20580,2811,17769,86.3,139,59,42.4
9,All Students,2019-20,15194,2703,12491,82.2,136,57,41.9
9,All Students,2020-21,27516,7567,19949,72.5,156,75,48.1
9,All Students,2021-22,20954,5296,15658,74.7,132,77,58.3
9,All Students,2022-23,21650,4765,16885,78.0,137,87,63.5
10,All Students,2018-19,17094,2577,14517,84.9,111,49,44.1
10,All Students,2019-20,13832,2465,11367,82.2,128,53,41.4
10,All Students,2020-21,20115,5247,14868,73.9,115,55,47.8
10,All Students,2021-22,21260,4916,16344,76.9,128,79,61.7
10,All Students,2022-23,17495,3061,14434,82.5,114,64,56.1
11,All Students,2018-19,13359,1582,11777,88.2,83,31,37.3
11,All Students,2019-20,8145,1260,6885,84.5,74,28,37.8
11,All Students,2020-21,15649,4745,10904,69.7,87,42,48.3
11,All Students,2021-22,14399,3776,10623,73.8,89,63,70.8
11,All Students,2022-23,13944,2714,11230,80.5,89,58,65.2
12,All Students,2018-19,14825,2280,12545,84.6,91,54,59.3
12,All Students,2019-20,9434,2083,7351,77.9,85,40,47.1
12,All Students,2020-21,13285,4241,9044,68.1,97,46,47.4
12,All Students,2021-22,16765,4229,12536,74.8,100,70,70.0
12,All Students,2022-23,15631,3200,12431,79.5,100,71,71.0
All Grades,All Students,2018-19,63767,10005,53762,84.3,417,219,52.5
All Grades,All Students,2019-20,44913,6104,38809,86.4,423,190,44.9
All Grades,All Students,2020-21,69998,7099,62899,89.9,421,129,30.6
All Grades,All Students,2021-22,67462,11066,56396,83.6,438,243,55.5
All Grades,All Students,2022-23,65710,10190,55520,84.5,438,240,54.8
9,All Students,2018-19,23811,4024,19787,83.1,164,88,53.7
9,All Students,2019-20,15651,2167,13484,86.2,149,66,44.3
9,All Students,2020-21,15359,1747,13612,88.6,96,29,30.2
9,All Students,2021-22,18905,2824,16081,85.1,123,62,50.4
9,All Students,2022-23,17009,2129,14880,87.5,128,63,49.2
10,All Students,2018-19,14641,2306,12335,84.2,93,46,49.5
10,All Students,2019-20,14382,1807,12575,87.4,135,58,43.0
10,All Students,2020-21,17560,1309,16251,92.5,101,23,22.8
10,All Students,2021-22,14537,2110,12427,85.5,102,55,53.9
10,All Students,2022-23,17605,2811,14794,84.0,114,58,50.9
11,All Students,2018-19,12629,1653,10976,86.9,82,44,53.7
11,All Students,2019-20,5916,963,4953,83.7,56,27,48.2
11,All Students,2020-21,21325,2259,19066,89.4,130,44,33.8
11,All Students,2021-22,16422,2987,13435,81.8,108,64,59.3
11,All Students,2022-23,14996,2523,12473,83.2,95,56,58.9
12,All Students,2018-19,12686,2022,10664,84.1,78,41,52.6
12,All Students,2019-20,8964,1167,7797,87.0,83,39,47.0
12,All Students,2020-21,15754,1784,13970,88.7,94,33,35.1
12,All Students,2021-22,17598,3145,14453,82.1,105,62,59.0
12,All Students,2022-23,16100,2727,13373,83.1,101,63,62.4
All Grades,All Students,2018-19,70531,4607,65924,93.5,406,83,20.4
All Grades,All Students,2019-20,53426,3626,49800,93.2,473,108,22.8
All Grades,All Students,2020-21,80878,5571,75307,93.1,471,99,21.0
All Grades,All Students,2021-22,75227,7607,67620,89.9,436,185,42.4
All Grades,All Students,2022-23,68493,6296,62197,90.8,401,153,38.2
PK in K-12 Schools,All Students,2018-19,7803,655,7148,91.6,45,12,26.7
PK in K-12 Schools,All Students,2019-20,4860,415,4445,91.5,44,17,38.6
PK in K-12 Schools,All Students,2020-21,7684,597,7087,92.2,46,10,21.7
PK in K-12 Schools,All Students,2021-22,7322,933,6389,87.3,42,27,64.3
PK in K-12 Schools,All Students,2022-23,7230,958,6272,86.7,43,26,60.5
0K,All Students,2018-19,13027,904,12123,93.1,75,16,21.3
0K,All Students,2019-20,8037,569,7468,92.9,72,14,19.4
0K,All Students,2020-21,11504,857,10647,92.6,69,22,31.9
0K,All Students,2021-22,10436,1014,9422,90.3,61,22,36.1
0K,All Students,2022-23,11296,1317,9979,88.3,66,34,51.5
1,All Students,2018-19,11966,714,11252,94.0,69,11,15.9
1,All Students,2019-20,8388,533,7855,93.6,73,12,16.4
1,All Students,2020-21,12082,997,11085,91.7,70,18,25.7
1,All Students,2021-22,11147,1114,10033,90.0,67,31,46.3
1,All Students,2022-23,8725,658,8067,92.5,53,15,28.3
2,All Students,2018-19,12844,751,12093,94.2,73,17,23.3
2,All Students,2019-20,8143,550,7593,93.2,72,15,20.8
2,All Students,2020-21,11832,727,11105,93.9,69,9,13.0
2,All Students,2021-22,12165,1342,10823,89.0,70,32,45.7
2,All Students,2022-23,9708,788,8920,91.9,58,23,39.7
3,All Students,2018-19,13049,812,12237,93.8,76,13,17.1
3,All Students,2019-20,8902,531,8371,94.0,78,17,21.8
3,All Students,2020-21,11884,869,11015,92.7,68,19,27.9
3,All Students,2021-22,11430,1005,10425,91.2,65,18,27.7
3,All Students,2022-23,11043,928,10115,91.6,63,19,30.2
4,All Students,2018-19,11842,771,11071,93.5,68,14,20.6
4,All Students,2019-20,7991,542,7449,93.2,71,17,23.9
4,All Students,2020-21,13876,808,13068,94.2,80,13,16.3
4,All Students,2021-22,10713,1165,9548,89.1,62,27,43.5
4,All Students,2022-23,10675,894,9781,91.6,61,17,27.9
5,All Students,2019-20,7105,486,6619,93.2,63,16,25.4
5,All Students,2020-21,12016,716,11300,94.0,69,8,11.6
5,All Students,2021-22,12014,1034,10980,91.4,69,28,40.6
5,All Students,2022-23,9816,753,9063,92.3,57,19,33.3
All Grades,All Students,2018-19,92506,5956,86550,93.6,543,117,21.5
All Grades,All Students,2019-20,58290,3877,54413,93.3,525,124,23.6
All Grades,All Students,2020-21,84229,7569,76660,91.0,495,147,29.7
All Grades,All Students,2021-22,81504,8025,73479,90.2,477,198,41.5
All Grades,All Students,2022-23,78696,7846,70850,90.0,464,194,41.8
PK in K-12 Schools,All Students,2018-19,9363,849,8514,90.9,55,21,38.2
PK in K-12 Schools,All Students,2019-20,4048,383,3665,90.5,38,15,39.5
PK in K-12 Schools,All Students,2020-21,6115,631,5484,89.7,36,12,33.3
PK in K-12 Schools,All Students,2021-22,6092,922,5170,84.9,36,21,58.3
PK in K-12 Schools,All Students,2022-23,6134,1010,5124,83.5,36,28,77.8
0K,All Students,2018-19,14318,1177,13141,91.8,85,27,31.8
0K,All Students,2019-20,8233,747,7486,90.9,74,29,39.2
0K,All Students,2020-21,10485,1382,9103,86.8,64,23,35.9
0K,All Students,2021-22,11039,1212,9827,89.0,64,33,51.6
0K,All Students,2022-23,11162,1193,9969,89.3,66,30,45.5
1,All Students,2018-19,13345,853,12492,93.6,80,15,18.8
1,All Students,2019-20,9777,691,9086,92.9,90,26,28.9
1,All Students,2020-21,12486,928,11558,92.6,73,18,24.7
1,All Students,2021-22,11703,1096,10607,90.6,68,29,42.6
1,All Students,2022-23,11812,1173,10639,90.1,70,28,40.0
2,All Students,2018-19,13060,719,12341,94.5,76,13,17.1
2,All Students,2019-20,8649,541,8108,93.7,78,15,19.2
2,All Students,2020-21,14439,1044,13395,92.8,85,22,25.9
2,All Students,2021-22,11972,1245,10727,89.6,70,34,48.6
2,All Students,2022-23,12162,1162,11000,90.4,71,29,40.8
3,All Students,2018-19,12719,835,11884,93.4,78,19,24.4
3,All Students,2019-20,8919,431,8488,95.2,80,9,11.3
3,All Students,2020-21,13114,941,12173,92.8,77,16,20.8
3,All Students,2021-22,13368,1204,12164,91.0,80,29,36.3
3,All Students,2022-23,10677,1087,9590,89.8,67,32,47.8
4,All Students,2018-19,15229,726,14503,95.2,86,9,10.5
4,All Students,2019-20,8664,585,8079,93.2,77,17,22.1
4,All Students,2020-21,14210,1064,13146,92.5,82,21,25.6
4,All Students,2021-22,13080,1196,11884,90.9,76,25,32.9
4,All Students,2022-23,13534,1116,12418,91.8,79,25,31.6
5,All Students,2018-19,14472,797,13675,94.5,83,13,15.7
5,All Students,2019-20,10000,499,9501,95.0,88,13,14.8
5,All Students,2020-21,13380,1579,11801,88.2,78,35,44.9
5,All Students,2021-22,14250,1150,13100,91.9,83,27,32.5
5,All Students,2022-23,13215,1105,12110,91.6,75,22,29.3
All Grades,All Students,2018-19,42134,4209,37925,90.0,249,103,41.4
All Grades,All Students,2019-20,25162,1899,23263,92.5,231,66,28.6
All Grades,All Students,2020-21,33780,2517,31263,92.5,203,42,20.7
All Grades,All Students,2021-22,29193,3628,25565,87.6,172,86,50.0
All Grades,All Students,2022-23,29736,2998,26738,89.9,177,71,40.1
6,All Students,2018-19,13930,1250,12680,91.0,83,29,34.9
6,All Students,2019-20,8006,598,7408,92.5,74,17,23.0
6,All Students,2020-21,9563,650,8913,93.2,59,13,22.0
6,All Students,2021-22,10944,1503,9441,86.3,65,36,55.4
6,All Students,2022-23,9239,915,8324,90.1,57,23,40.4
7,All Students,2018-19,14306,1511,12795,89.4,83,40,48.2
7,All Students,2019-20,8743,577,8166,93.4,80,21,26.3
7,All Students,2020-21,11189,753,10436,93.3,67,12,17.9
7,All Students,2021-22,8871,1099,7772,87.6,52,25,48.1
7,All Students,2022-23,11684,1216,10468,89.6,70,28,40.0
8,All Students,2018-19,13898,1448,12450,89.6,83,34,41.0
8,All Students,2019-20,8413,724,7689,91.4,77,28,36.4
8,All Students,2020-21,13028,1114,11914,91.4,77,17,22.1
8,All Students,2021-22,9378,1026,8352,89.1,55,25,45.5
8,All Students,2022-23,8798,s,s,s,s,s,s
9,All Students,2022-23,15,s,s,s,s,s,s
All Grades,All Students,2018-19,67572,5794,61778,91.4,415,135,32.5
All Grades,All Students,2019-20,42695,3305,39390,92.3,402,105,26.1
All Grades,All Students,2020-21,64906,7236,57670,88.9,385,126,32.7
All Grades,All Students,2021-22,55643,7862,47781,85.9,349,185,53.0
All Grades,All Students,2022-23,53564,7156,46408,86.6,315,166,52.7
6,All Students,2018-19,25359,2017,23342,92.0,156,47,30.1
6,All Students,2019-20,12433,883,11550,92.9,121,26,21.5
6,All Students,2020-21,19972,2121,17851,89.4,119,40,33.6
6,All Students,2021-22,16350,s,s,s,s,s,s
6,All Students,2022-23,14471,s,s,s,s,s,s
7,All Students,2018-19,21006,1810,19196,91.4,129,49,38.0
7,All Students,2019-20,17314,1272,16042,92.7,161,40,24.8
7,All Students,2020-21,18278,2068,16210,88.7,110,33,30.0
7,All Students,2021-22,21477,2662,18815,87.6,133,67,50.4
7,All Students,2022-23,16315,2354,13961,85.6,95,51,53.7
8,All Students,2018-19,21207,1967,19240,90.7,130,39,30.0
8,All Students,2019-20,12948,1150,11798,91.1,120,39,32.5
8,All Students,2020-21,26656,3047,23609,88.6,156,53,34.0
8,All Students,2021-22,17812,2583,15229,85.5,110,57,51.8
8,All Students,2022-23,22763,3134,19629,86.2,134,78,58.2
9,All Students,2022-23,15,s,s,s,s,s,s
11,All Students,2021-22,4,s,s,s,s,s,s
All Grades,All Students,2018-19,233104,10473,222631,95.5,1353,134,9.9
All Grades,All Students,2019-20,146521,6004,140517,95.9,1315,127,9.7
All Grades,All Students,2020-21,216569,20977,195592,90.3,1243,370,29.8
All Grades,All Students,2021-22,197770,14214,183556,92.8,1177,261,22.2
All Grades,All Students,2022-23,202841,13314,189527,93.4,1191,223,18.7
6,All Students,2018-19,35225,910,34315,97.4,199,6,3.0
6,All Students,2019-20,22639,469,22170,97.9,199,4,2.0
6,All Students,2020-21,33973,1701,32272,95.0,195,27,13.8
6,All Students,2021-22,33000,2132,30868,93.5,204,44,21.6
6,All Students,2022-23,33830,1875,31955,94.5,194,27,13.9
7,All Students,2018-19,41092,1051,40041,97.4,231,4,1.7
7,All Students,2019-20,22539,615,21924,97.3,200,7,3.5
7,All Students,2020-21,34260,2179,32081,93.6,197,42,21.3
7,All Students,2021-22,32291,1596,30695,95.1,188,19,10.1
7,All Students,2022-23,33324,2210,31114,93.4,192,34,17.7
8,All Students,2018-19,40636,1304,39332,96.8,231,9,3.9
8,All Students,2019-20,26306,817,25489,96.9,231,15,6.5
8,All Students,2020-21,33872,2899,30973,91.4,194,53,27.3
8,All Students,2021-22,32858,1586,31272,95.2,189,21,11.1
8,All Students,2022-23,32288,1657,30631,94.9,189,25,13.2
9,All Students,2018-19,27645,999,26646,96.4,165,10,6.1
9,All Students,2019-20,17760,621,17139,96.5,162,11,6.8
9,All Students,2020-21,28721,2289,26432,92.0,167,44,26.3
9,All Students,2021-22,22421,1691,20730,92.5,134,31,23.1
9,All Students,2022-23,28909,1479,27430,94.9,172,21,12.2
10,All Students,2018-19,31592,1811,29781,94.3,189,22,11.6
10,All Students,2019-20,17817,919,16898,94.8,163,19,11.7
10,All Students,2020-21,27637,3134,24503,88.7,158,59,37.3
10,All Students,2021-22,26117,1818,24299,93.0,156,31,19.9
10,All Students,2022-23,23943,1782,22161,92.6,144,28,19.4
11,All Students,2018-19,30409,1751,28658,94.2,181,28,15.5
11,All Students,2019-20,19760,942,18818,95.2,181,22,12.2
11,All Students,2020-21,26779,3544,23235,86.8,153,61,39.9
11,All Students,2021-22,25697,1857,23840,92.8,154,34,22.1
11,All Students,2022-23,25515,1694,23821,93.4,151,22,14.6
12,All Students,2018-19,26505,2647,23858,90.0,157,55,35.0
12,All Students,2019-20,19700,1621,18079,91.8,179,49,27.4
12,All Students,2020-21,31327,5231,26096,83.3,179,84,46.9
12,All Students,2021-22,25386,3534,21852,86.1,152,81,53.3
12,All Students,2022-23,25032,2617,22415,89.5,149,66,44.3
All Grades,All Students,2018-19,48949,10899,38050,77.7,325,207,63.7
All Grades,All Students,2019-20,31607,7326,24281,76.8,307,181,59.0
All Grades,All Students,2020-21,43793,5891,37902,86.5,255,91,35.7
All Grades,All Students,2021-22,42140,12829,29311,69.6,272,220,80.9
All Grades,All Students,2022-23,36281,6600,29681,81.8,266,148,55.6
9,All Students,2018-19,16742,4486,12256,73.2,110,71,64.5
9,All Students,2019-20,11239,3193,8046,71.6,107,62,57.9
9,All Students,2020-21,10281,2150,8131,79.1,62,35,56.5
9,All Students,2021-22,12296,3664,8632,70.2,82,62,75.6
9,All Students,2022-23,8353,1190,7163,85.8,65,33,50.8
10,All Students,2018-19,10973,2385,8588,78.3,77,50,64.9
10,All Students,2019-20,8843,2017,6826,77.2,88,58,65.9
10,All Students,2020-21,14730,1842,12888,87.5,85,26,30.6
10,All Students,2021-22,9832,3517,6315,64.2,65,55,84.6
10,All Students,2022-23,11756,2657,9099,77.4,87,54,62.1
11,All Students,2018-19,8144,1889,6255,76.8,56,34,60.7
11,All Students,2019-20,5592,1098,4494,80.4,55,27,49.1
11,All Students,2020-21,9360,670,8690,92.8,54,12,22.2
11,All Students,2021-22,8400,2060,6340,75.5,53,40,75.5
11,All Students,2022-23,7961,1275,6686,84.0,55,31,56.4
12,All Students,2018-19,13090,2139,10951,83.7,82,52,63.4
12,All Students,2019-20,5933,1018,4915,82.8,56,33,58.9
12,All Students,2020-21,9422,1229,8193,87.0,54,18,33.3
12,All Students,2021-22,11612,3588,8024,69.1,72,63,87.5
12,All Students,2022-23,8211,1478,6733,82.0,59,30,50.8
All Grades,All Students,2018-19,69144,3741,65403,94.6,408,67,16.4
All Grades,All Students,2019-20,47204,2458,44746,94.8,429,63,14.7
All Grades,All Students,2020-21,62702,11113,51589,82.3,365,170,46.6
All Grades,All Students,2021-22,61929,6873,55056,88.9,380,164,43.2
All Grades,All Students,2022-23,62567,7517,55050,88.0,374,179,47.9
PK in K-12 Schools,All Students,2018-19,5805,391,5414,93.3,36,6,16.7
PK in K-12 Schools,All Students,2019-20,5260,435,4825,91.7,47,10,21.3
PK in K-12 Schools,All Students,2020-21,3687,669,3018,81.9,22,14,63.6
PK in K-12 Schools,All Students,2021-22,4591,894,3697,80.5,35,25,71.4
PK in K-12 Schools,All Students,2022-23,4546,837,3709,81.6,29,19,65.5
0K,All Students,2018-19,7420,504,6916,93.2,44,10,22.7
0K,All Students,2019-20,3856,280,3576,92.7,36,7,19.4
0K,All Students,2020-21,7300,2057,5243,71.8,43,29,67.4
0K,All Students,2021-22,6613,1052,5561,84.1,41,23,56.1
0K,All Students,2022-23,6165,1124,5041,81.8,38,28,73.7
1,All Students,2018-19,8421,576,7845,93.2,51,14,27.5
1,All Students,2019-20,4560,242,4318,94.7,40,7,17.5
1,All Students,2020-21,5748,1326,4422,76.9,34,20,58.8
1,All Students,2021-22,7553,955,6598,87.4,47,22,46.8
1,All Students,2022-23,7180,1033,6147,85.6,42,22,52.4
2,All Students,2018-19,8674,587,8087,93.2,51,13,25.5
2,All Students,2019-20,5621,295,5326,94.8,51,9,17.6
2,All Students,2020-21,5674,1134,4540,80.0,33,14,42.4
2,All Students,2021-22,5433,539,4894,90.1,34,13,38.2
2,All Students,2022-23,7287,967,6320,86.7,43,20,46.5
3,All Students,2018-19,6416,307,6109,95.2,36,5,13.9
3,All Students,2019-20,4974,272,4702,94.5,46,8,17.4
3,All Students,2020-21,7744,1435,6309,81.5,45,23,51.1
3,All Students,2021-22,5599,405,5194,92.8,33,8,24.2
3,All Students,2022-23,5710,665,5045,88.4,36,15,41.7
4,All Students,2018-19,10333,377,9956,96.4,62,3,4.8
4,All Students,2019-20,3779,146,3633,96.1,34,5,14.7
4,All Students,2020-21,6999,874,6125,87.5,40,14,35.0
4,All Students,2021-22,7877,806,7071,89.8,46,18,39.1
4,All Students,2022-23,6400,599,5801,90.6,37,13,35.1
5,All Students,2018-19,7156,242,6914,96.6,42,2,4.8
5,All Students,2019-20,6938,261,6677,96.2,61,4,6.6
5,All Students,2020-21,6125,644,5481,89.5,35,11,31.4
5,All Students,2021-22,5971,509,5462,91.5,34,11,32.4
5,All Students,2022-23,8578,798,7780,90.7,51,23,45.1
6,All Students,2018-19,5958,382,5576,93.6,34,7,20.6
6,All Students,2019-20,5207,235,4972,95.5,49,7,14.3
6,All Students,2020-21,9450,1324,8126,86.0,56,22,39.3
6,All Students,2021-22,5056,517,4539,89.8,32,15,46.9
6,All Students,2022-23,4438,418,4020,90.6,26,10,38.5
7,All Students,2018-19,5335,163,5172,96.9,30,2,6.7
7,All Students,2019-20,3364,s,s,s,s,s,s
7,All Students,2020-21,5425,1039,4386,80.8,31,15,48.4
7,All Students,2021-22,8266,754,7512,90.9,49,20,40.8
7,All Students,2022-23,5044,416,4628,91.8,30,11,36.7
8,All Students,2018-19,3626,212,3414,94.2,22,5,22.7
8,All Students,2019-20,3643,126,3517,96.5,32,2,6.3
8,All Students,2020-21,4550,611,3939,86.6,26,8,30.8
8,All Students,2021-22,4970,442,4528,91.1,29,9,31.0
8,All Students,2022-23,7219,660,6559,90.9,42,18,42.9
9,All Students,2019-20,2,s,s,s,s,s,s
All Grades,All Students,2018-19,67459,9928,57531,85.3,432,200,46.3
All Grades,All Students,2019-20,49163,7839,41324,84.1,467,235,50.3
All Grades,All Students,2020-21,71223,10534,60689,85.2,420,155,36.9
All Grades,All Students,2021-22,67108,12787,54321,80.9,425,268,63.1
All Grades,All Students,2022-23,63167,11632,51535,81.6,410,221,53.9
9,All Students,2018-19,18863,2470,16393,86.9,124,37,29.8
9,All Students,2019-20,17560,2691,14869,84.7,168,76,45.2
9,All Students,2020-21,15345,2259,13086,85.3,90,34,37.8
9,All Students,2021-22,17294,2712,14582,84.3,114,53,46.5
9,All Students,2022-23,13803,2461,11342,82.2,91,37,40.7
10,All Students,2018-19,20195,3114,17081,84.6,128,59,46.1
10,All Students,2019-20,14234,2463,11771,82.7,135,73,54.1
10,All Students,2020-21,20267,3378,16889,83.3,117,43,36.8
10,All Students,2021-22,14363,2396,11967,83.3,91,53,58.2
10,All Students,2022-23,16259,2512,13747,84.6,106,48,45.3
11,All Students,2018-19,15370,2165,13205,85.9,99,55,55.6
11,All Students,2019-20,8496,1269,7227,85.1,83,37,44.6
11,All Students,2020-21,17186,2126,15060,87.6,101,32,31.7
11,All Students,2021-22,19545,4463,15082,77.2,122,86,70.5
11,All Students,2022-23,16332,3147,13185,80.7,105,66,62.9
12,All Students,2018-19,13031,2179,10852,83.3,81,49,60.5
12,All Students,2019-20,8873,1416,7457,84.0,81,49,60.5
12,All Students,2020-21,18425,2771,15654,85.0,112,46,41.1
12,All Students,2021-22,15906,3216,12690,79.8,98,76,77.6
12,All Students,2022-23,16773,3512,13261,79.1,108,70,64.8
All Grades,All Students,2022-23,128915,26801,102114,79.2,808,652,80.7
PK in K-12 Schools,All Students,2022-23,128914,s,s,s,s,s,s
0K,All Students,2022-23,1,s,s,s,s,s,s
All Grades,All Students,2018-19,50753,10068,40685,80.2,344,203,59.0
All Grades,All Students,2019-20,36031,7154,28877,80.1,346,200,57.8
All Grades,All Students,2020-21,49674,12265,37409,75.3,301,177,58.8
All Grades,All Students,2021-22,44920,11887,33033,73.5,309,227,73.5
All Grades,All Students,2022-23,43592,9388,34204,78.5,320,230,71.9
9,All Students,2018-19,14634,3609,11025,75.3,105,70,66.7
9,All Students,2019-20,11526,2626,8900,77.2,111,64,57.7
9,All Students,2020-21,12137,4642,7495,61.8,73,52,71.2
9,All Students,2021-22,12284,3255,9029,73.5,97,72,74.2
9,All Students,2022-23,10245,2421,7824,76.4,88,58,65.9
10,All Students,2018-19,15170,2966,12204,80.4,102,63,61.8
10,All Students,2019-20,8809,1702,7107,80.7,83,53,63.9
10,All Students,2020-21,16507,4259,12248,74.2,100,63,63.0
10,All Students,2021-22,8838,2770,6068,68.7,64,44,68.8
10,All Students,2022-23,13642,2953,10689,78.4,99,72,72.7
11,All Students,2018-19,10214,1475,8739,85.6,71,29,40.8
11,All Students,2019-20,6421,992,5429,84.6,64,35,54.7
11,All Students,2020-21,10113,1482,8631,85.3,61,26,42.6
11,All Students,2021-22,10574,2348,8226,77.8,66,45,68.2
11,All Students,2022-23,6698,1318,5380,80.3,48,38,79.2
12,All Students,2018-19,10735,2018,8717,81.2,66,41,62.1
12,All Students,2019-20,9275,1834,7441,80.2,88,48,54.5
12,All Students,2020-21,10917,1882,9035,82.8,67,36,53.7
12,All Students,2021-22,13224,3514,9710,73.4,82,66,80.5
12,All Students,2022-23,13007,2696,10311,79.3,85,62,72.9
All Grades,All Students,2018-19,98261,6621,91640,93.3,608,154,25.3
All Grades,All Students,2019-20,59058,4187,54871,92.9,542,141,26.0
All Grades,All Students,2020-21,82541,8827,73714,89.3,491,171,34.8
All Grades,All Students,2021-22,80885,8726,72159,89.2,500,222,44.4
All Grades,All Students,2022-23,79930,7559,72371,90.5,494,197,39.9
PK in K-12 Schools,All Students,2018-19,8719,s,s,s,s,s,s
PK in K-12 Schools,All Students,2019-20,5589,517,5072,90.7,52,18,34.6
PK in K-12 Schools,All Students,2020-21,7379,916,6463,87.6,45,18,40.0
PK in K-12 Schools,All Students,2021-22,7767,s,s,s,s,s,s
PK in K-12 Schools,All Students,2022-23,7854,1185,6669,84.9,47,34,72.3
0K,All Students,2018-19,13729,994,12735,92.8,85,25,29.4
0K,All Students,2019-20,8099,780,7319,90.4,78,35,44.9
0K,All Students,2020-21,12639,1852,10787,85.3,74,38,51.4
0K,All Students,2021-22,13791,1763,12028,87.2,89,49,55.1
0K,All Students,2022-23,12797,1549,11248,87.9,85,42,49.4
1,All Students,2018-19,17570,1359,16211,92.3,112,37,33.0
1,All Students,2019-20,10100,686,9414,93.2,91,23,25.3
1,All Students,2020-21,12603,1161,11442,90.8,77,26,33.8
1,All Students,2021-22,12143,1504,10639,87.6,77,37,48.1
1,All Students,2022-23,12554,1019,11535,91.9,76,23,30.3
2,All Students,2018-19,15216,947,14269,93.8,94,19,20.2
2,All Students,2019-20,10174,723,9451,92.9,94,24,25.5
2,All Students,2020-21,11978,1226,10752,89.8,72,23,31.9
2,All Students,2021-22,11034,1273,9761,88.5,70,34,48.6
2,All Students,2022-23,11797,1232,10565,89.6,75,32,42.7
3,All Students,2018-19,13139,731,12408,94.4,80,16,20.0
3,All Students,2019-20,8183,474,7709,94.2,73,13,17.8
3,All Students,2020-21,13148,1454,11694,88.9,77,26,33.8
3,All Students,2021-22,11940,1043,10897,91.3,72,24,33.3
3,All Students,2022-23,10682,859,9823,92.0,64,20,31.3
4,All Students,2018-19,12928,686,12242,94.7,80,17,21.3
4,All Students,2019-20,8641,550,8091,93.6,80,16,20.0
4,All Students,2020-21,11743,1194,10549,89.8,70,19,27.1
4,All Students,2021-22,12537,1111,11426,91.1,75,26,34.7
4,All Students,2022-23,11897,853,11044,92.8,74,23,31.1
5,All Students,2018-19,16853,1135,15718,93.3,103,23,22.3
5,All Students,2019-20,8272,457,7815,94.5,74,12,16.2
5,All Students,2020-21,13051,1024,12027,92.2,76,21,27.6
5,All Students,2021-22,11670,1177,10493,89.9,72,30,41.7
5,All Students,2022-23,12349,862,11487,93.0,73,23,31.5
6,All Students,2018-19,107,s,s,s,s,s,s
7,All Students,2021-22,3,s,s,s,s,s,s
All Grades,All Students,2018-19,51335,5269,46066,89.7,308,142,46.1
All Grades,All Students,2019-20,38947,3245,35702,91.7,356,113,31.7
All Grades,All Students,2020-21,68991,7190,61801,89.6,413,143,34.6
All Grades,All Students,2021-22,72446,8643,63803,88.1,429,224,52.2
All Grades,All Students,2022-23,87510,9129,78381,89.6,535,235,43.9
PK in K-12 Schools,All Students,2018-19,29122,3261,25861,88.8,176,92,52.3
PK in K-12 Schools,All Students,2019-20,17645,1667,15978,90.6,161,60,37.3
PK in K-12 Schools,All Students,2020-21,23986,3160,20826,86.8,146,67,45.9
PK in K-12 Schools,All Students,2021-22,19591,3054,16537,84.4,116,81,69.8
PK in K-12 Schools,All Students,2022-23,19824,2798,17026,85.9,120,75,62.5
0K,All Students,2018-19,13460,1285,12175,90.5,78,31,39.7
0K,All Students,2019-20,8599,727,7872,91.5,80,29,36.3
0K,All Students,2020-21,13251,1276,11975,90.4,78,24,30.8
0K,All Students,2021-22,12522,1469,11053,88.3,73,37,50.7
0K,All Students,2022-23,13505,1515,11990,88.8,83,40,48.2
1,All Students,2018-19,8753,723,8030,91.7,54,19,35.2
1,All Students,2019-20,7675,549,7126,92.8,68,15,22.1
1,All Students,2020-21,13302,1248,12054,90.6,80,21,26.3
1,All Students,2021-22,12357,1282,11075,89.6,75,32,42.7
1,All Students,2022-23,13667,1225,12442,91.0,88,35,39.8
2,All Students,2019-20,5028,302,4726,94.0,47,9,19.1
2,All Students,2020-21,11469,1026,10443,91.1,68,22,32.4
2,All Students,2021-22,10374,1027,9347,90.1,64,28,43.8
2,All Students,2022-23,11717,1063,10654,90.9,67,22,32.8
3,All Students,2020-21,6983,480,6503,93.1,41,9,22.0
3,All Students,2021-22,10867,1285,9582,88.2,63,35,55.6
3,All Students,2022-23,11208,1070,10138,90.5,70,27,38.6
4,All Students,2021-22,6735,526,6209,92.2,38,11,28.9
4,All Students,2022-23,10896,998,9898,90.8,69,28,40.6
5,All Students,2022-23,6693,460,6233,93.1,38,8,21.1
All Grades,All Students,2018-19,50504,5818,44686,88.5,330,127,38.5
All Grades,All Students,2019-20,41480,4526,36954,89.1,406,147,36.2
All Grades,All Students,2020-21,72632,11614,61018,84.0,428,201,47.0
All Grades,All Students,2021-22,79322,12369,66953,84.4,505,233,46.1
All Grades,All Students,2022-23,85774,12472,73302,85.5,577,240,41.6
9,All Students,2018-19,18128,2146,15982,88.2,123,48,39.0
9,All Students,2019-20,13769,1443,12326,89.5,141,46,32.6
9,All Students,2020-21,20280,2915,17365,85.6,123,53,43.1
9,All Students,2021-22,25475,3115,22360,87.8,166,67,40.4
9,All Students,2022-23,28827,3978,24849,86.2,201,83,41.3
10,All Students,2018-19,13583,1723,11860,87.3,90,36,40.0
10,All Students,2019-20,11633,1313,10320,88.7,111,41,36.9
10,All Students,2020-21,21416,3368,18048,84.3,126,51,40.5
10,All Students,2021-22,19038,3065,15973,83.9,124,56,45.2
10,All Students,2022-23,22533,3082,19451,86.3,152,57,37.5
11,All Students,2018-19,11058,1192,9866,89.2,70,24,34.3
11,All Students,2019-20,8065,733,7332,90.9,77,25,32.5
11,All Students,2020-21,17155,3078,14077,82.1,100,54,54.0
11,All Students,2021-22,20081,3610,16471,82.0,124,59,47.6
11,All Students,2022-23,18526,2845,15681,84.6,120,55,45.8
12,All Students,2018-19,7735,757,6978,90.2,47,19,40.4
12,All Students,2019-20,8013,1037,6976,87.1,77,35,45.5
12,All Students,2020-21,13781,2253,11528,83.7,79,43,54.4
12,All Students,2021-22,14728,2579,12149,82.5,91,51,56.0
12,All Students,2022-23,15888,2567,13321,83.8,104,45,43.3
All Grades,All Students,2018-19,258623,32106,226517,87.6,1691,613,36.3
All Grades,All Students,2019-20,178314,21662,156652,87.9,1718,676,39.3
All Grades,All Students,2020-21,276492,33511,242981,87.9,1655,550,33.2
All Grades,All Students,2021-22,270295,30006,240289,88.9,1704,683,40.1
All Grades,All Students,2022-23,271685,27597,244088,89.8,1772,598,33.7
9,All Students,2018-19,78025,11083,66942,85.8,524,195,37.2
9,All Students,2019-20,56592,7541,49051,86.7,559,221,39.5
9,All Students,2020-21,76766,10476,66290,86.4,467,173,37.0
9,All Students,2021-22,75095,8681,66414,88.4,488,190,38.9
9,All Students,2022-23,75824,6789,69035,91.0,508,138,27.2
10,All Students,2018-19,76101,9992,66109,86.9,505,190,37.6
10,All Students,2019-20,48207,5856,42351,87.9,473,184,38.9
10,All Students,2020-21,77245,10216,67029,86.8,471,163,34.6
10,All Students,2021-22,68130,8018,60112,88.2,441,195,44.2
10,All Students,2022-23,73121,7342,65779,90.0,481,156,32.4
11,All Students,2018-19,50375,4518,45857,91.0,325,82,25.2
11,All Students,2019-20,39652,3948,35704,90.0,375,140,37.3
11,All Students,2020-21,64917,5418,59499,91.7,380,95,25.0
11,All Students,2021-22,64711,6114,58597,90.6,402,129,32.1
11,All Students,2022-23,59884,6470,53414,89.2,390,143,36.7
12,All Students,2018-19,54122,6513,47609,88.0,337,146,43.3
12,All Students,2019-20,33863,4317,29546,87.3,311,131,42.1
12,All Students,2020-21,57564,7401,50163,87.1,337,119,35.3
12,All Students,2021-22,62359,7193,55166,88.5,373,169,45.3
12,All Students,2022-23,62856,6996,55860,88.9,393,161,41.0
All Grades,All Students,2018-19,388733,50255,338478,87.1,2550,1010,39.6
All Grades,All Students,2019-20,272578,34492,238086,87.3,2623,950,36.2
All Grades,All Students,2020-21,415019,42186,372833,89.8,2499,611,24.4
All Grades,All Students,2021-22,391091,69221,321870,82.3,2522,1383,54.8
All Grades,All Students,2022-23,387440,52064,335376,86.6,2585,1014,39.2
6,All Students,2018-19,5,s,s,s,s,s,s
8,All Students,2022-23,7,s,s,s,s,s,s
9,All Students,2018-19,116194,16276,99918,86.0,788,298,37.8
9,All Students,2019-20,82193,10994,71199,86.6,820,294,35.9
9,All Students,2020-21,107122,9787,97335,90.9,641,134,20.9
9,All Students,2021-22,108722,17562,91160,83.8,733,337,46.0
9,All Students,2022-23,104271,14211,90060,86.4,724,261,36.0
10,All Students,2018-19,107262,12855,94407,88.0,699,258,36.9
10,All Students,2019-20,70376,9033,61343,87.2,677,244,36.0
10,All Students,2020-21,119268,13665,105603,88.5,714,188,26.3
10,All Students,2021-22,98879,15160,83719,84.7,621,307,49.4
10,All Students,2022-23,100510,11659,88851,88.4,676,222,32.8
11,All Students,2018-19,94092,11976,82116,87.3,616,250,40.6
11,All Students,2019-20,65183,8168,57015,87.5,615,211,34.3
11,All Students,2020-21,97061,8493,88568,91.2,577,130,22.5
11,All Students,2021-22,101764,19141,82623,81.2,640,392,61.3
11,All Students,2022-23,94739,12158,82581,87.2,621,247,39.8
12,All Students,2018-19,71180,s,s,s,s,s,s
12,All Students,2019-20,54826,6297,48529,88.5,512,202,39.5
12,All Students,2020-21,91568,10241,81327,88.8,567,159,28.0
12,All Students,2021-22,81726,17358,64368,78.8,528,347,65.7
12,All Students,2022-23,87913,s,s,s,s,s,s
All Grades,All Students,2018-19,177539,10357,167182,94.2,1072,174,16.2
All Grades,All Students,2019-20,119790,5525,114265,95.4,1101,145,13.2
All Grades,All Students,2020-21,191640,14295,177345,92.5,1102,253,23.0
All Grades,All Students,2021-22,184060,14440,169620,92.2,1105,291,26.3
All Grades,All Students,2022-23,177800,12092,165708,93.2,1088,233,21.4
9,All Students,2018-19,48713,1632,47081,96.6,295,15,5.1
9,All Students,2019-20,31275,932,30343,97.0,288,19,6.6
9,All Students,2020-21,47770,2928,44842,93.9,276,51,18.5
9,All Students,2021-22,42851,2716,40135,93.7,262,52,19.8
9,All Students,2022-23,45031,2957,42074,93.4,277,54,19.5
10,All Students,2018-19,45182,1913,43269,95.8,273,32,11.7
10,All Students,2019-20,31710,1195,30515,96.2,291,27,9.3
10,All Students,2020-21,49104,3407,45697,93.1,282,61,21.6
10,All Students,2021-22,47666,2951,44715,93.8,289,52,18.0
10,All Students,2022-23,42416,2815,39601,93.4,259,56,21.6
11,All Students,2018-19,44060,2416,41644,94.5,264,31,11.7
11,All Students,2019-20,28350,1385,26965,95.1,262,43,16.4
11,All Students,2020-21,49891,3608,46283,92.8,286,55,19.2
11,All Students,2021-22,46465,3641,42824,92.2,276,78,28.3
11,All Students,2022-23,45874,2290,43584,95.0,280,33,11.8
12,All Students,2018-19,39584,4396,35188,88.9,240,96,40.0
12,All Students,2019-20,28455,2013,26442,92.9,260,56,21.5
12,All Students,2020-21,44875,4352,40523,90.3,258,86,33.3
12,All Students,2021-22,47078,5132,41946,89.1,278,109,39.2
12,All Students,2022-23,44479,4030,40449,90.9,272,90,33.1
All Grades,All Students,2018-19,68264,5541,62723,91.9,418,120,28.7
All Grades,All Students,2019-20,51377,4075,47302,92.1,468,123,26.3
All Grades,All Students,2020-21,77333,7443,69890,90.4,462,130,28.1
All Grades,All Students,2021-22,71345,9902,61443,86.1,449,228,50.8
All Grades,All Students,2022-23,59942,7577,52365,87.4,392,199,50.8
5,All Students,2022-23,5,s,s,s,s,s,s
6,All Students,2018-19,24090,1874,22216,92.2,151,42,27.8
6,All Students,2019-20,20543,1496,19047,92.7,188,53,28.2
6,All Students,2020-21,22932,s,s,s,s,s,s
6,All Students,2021-22,22658,3462,19196,84.7,144,79,54.9
6,All Students,2022-23,16328,s,s,s,s,s,s
7,All Students,2018-19,21983,s,s,s,s,s,s
7,All Students,2019-20,16106,1422,14684,91.2,146,42,28.8
7,All Students,2020-21,31096,3151,27945,89.9,183,51,27.9
7,All Students,2021-22,20349,2489,17860,87.8,129,58,45.0
7,All Students,2022-23,22117,2942,19175,86.7,142,72,50.7
8,All Students,2018-19,22156,1815,20341,91.8,131,39,29.8
8,All Students,2019-20,14728,1157,13571,92.1,134,28,20.9
8,All Students,2020-21,23303,2273,21030,90.2,140,40,28.6
8,All Students,2021-22,28338,3951,24387,86.1,176,91,51.7
8,All Students,2022-23,21492,2703,18789,87.4,139,79,56.8
9,All Students,2018-19,35,s,s,s,s,s,s
9,All Students,2020-21,2,s,s,s,s,s,s
All Grades,All Students,2018-19,69477,6704,62773,90.4,442,197,44.6
All Grades,All Students,2019-20,42578,3699,38879,91.3,407,138,33.9
All Grades,All Students,2020-21,60785,8212,52573,86.5,381,187,49.1
All Grades,All Students,2021-22,61472,9501,51971,84.5,381,238,62.5
All Grades,All Students,2022-23,59882,7327,52555,87.8,400,213,53.3
PK in K-12 Schools,All Students,2018-19,5484,642,4842,88.3,38,25,65.8
PK in K-12 Schools,All Students,2019-20,3831,427,3404,88.9,40,18,45.0
PK in K-12 Schools,All Students,2020-21,4586,571,4015,87.5,30,15,50.0
PK in K-12 Schools,All Students,2021-22,5876,962,4914,83.6,36,24,66.7
PK in K-12 Schools,All Students,2022-23,7595,1426,6169,81.2,54,41,75.9
0K,All Students,2018-19,9087,1031,8056,88.7,59,30,50.8
0K,All Students,2019-20,6048,665,5383,89.0,56,25,44.6
0K,All Students,2020-21,8938,1846,7092,79.3,58,37,63.8
0K,All Students,2021-22,8172,1407,6765,82.8,52,38,73.1
0K,All Students,2022-23,8022,1134,6888,85.9,55,32,58.2
1,All Students,2018-19,8336,861,7475,89.7,54,24,44.4
1,All Students,2019-20,6517,669,5848,89.7,60,25,41.7
1,All Students,2020-21,9017,1323,7694,85.3,55,28,50.9
1,All Students,2021-22,9653,1484,8169,84.6,59,37,62.7
1,All Students,2022-23,7948,937,7011,88.2,55,30,54.5
2,All Students,2018-19,8538,805,7733,90.6,57,25,43.9
2,All Students,2019-20,5748,409,5339,92.9,56,18,32.1
2,All Students,2020-21,9364,1127,8237,88.0,60,29,48.3
2,All Students,2021-22,9754,1769,7985,81.9,59,40,67.8
2,All Students,2022-23,9189,971,8218,89.4,60,31,51.7
3,All Students,2018-19,12622,1076,11546,91.5,80,35,43.8
3,All Students,2019-20,6330,477,5853,92.5,63,15,23.8
3,All Students,2020-21,8692,1021,7671,88.3,55,24,43.6
3,All Students,2021-22,9617,1509,8108,84.3,59,37,62.7
3,All Students,2022-23,8383,1042,7341,87.6,60,34,56.7
4,All Students,2018-19,10153,1115,9038,89.0,61,26,42.6
4,All Students,2019-20,7953,546,7407,93.1,75,18,24.0
4,All Students,2020-21,9147,1139,8008,87.5,56,26,46.4
4,All Students,2021-22,8879,909,7970,89.8,57,29,50.9
4,All Students,2022-23,9973,1113,8860,88.8,61,30,49.2
5,All Students,2018-19,15257,1174,14083,92.3,93,32,34.4
5,All Students,2019-20,6151,506,5645,91.8,57,19,33.3
5,All Students,2020-21,11041,1185,9856,89.3,67,28,41.8
5,All Students,2021-22,9521,1461,8060,84.7,59,33,55.9
5,All Students,2022-23,8772,704,8068,92.0,55,15,27.3
All Grades,All Students,2018-19,100292,8028,92264,92.0,621,185,29.8
All Grades,All Students,2019-20,63225,4840,58385,92.3,586,162,27.6
All Grades,All Students,2020-21,89339,9087,80252,89.8,543,193,35.5
All Grades,All Students,2021-22,79652,8939,70713,88.8,496,228,46.0
All Grades,All Students,2022-23,73622,8037,65585,89.1,473,207,43.8
PK in K-12 Schools,All Students,2018-19,9168,933,8235,89.8,57,21,36.8
PK in K-12 Schools,All Students,2019-20,6024,616,5408,89.8,58,24,41.4
PK in K-12 Schools,All Students,2020-21,6347,s,s,s,s,s,s
PK in K-12 Schools,All Students,2021-22,7677,1294,6383,83.1,48,29,60.4
PK in K-12 Schools,All Students,2022-23,8215,1448,6767,82.4,56,39,69.6
0K,All Students,2018-19,12869,1254,11615,90.3,83,36,43.4
0K,All Students,2019-20,8387,912,7475,89.1,80,34,42.5
0K,All Students,2020-21,12713,1540,11173,87.9,81,34,42.0
0K,All Students,2021-22,9986,1253,8733,87.5,64,35,54.7
0K,All Students,2022-23,9805,1312,8493,86.6,64,33,51.6
1,All Students,2018-19,14721,1230,13491,91.6,92,30,32.6
1,All Students,2019-20,8311,701,7610,91.6,76,29,38.2
1,All Students,2020-21,14925,1455,13470,90.3,87,25,28.7
1,All Students,2021-22,13584,1567,12017,88.5,82,36,43.9
1,All Students,2022-23,9557,1156,8401,87.9,66,32,48.5
2,All Students,2018-19,13835,966,12869,93.0,91,21,23.1
2,All Students,2019-20,9402,626,8776,93.3,85,19,22.4
2,All Students,2020-21,10922,822,10100,92.5,66,13,19.7
2,All Students,2021-22,11895,1346,10549,88.7,77,38,49.4
2,All Students,2022-23,11949,1096,10853,90.8,76,27,35.5
3,All Students,2018-19,17258,1397,15861,91.9,105,36,34.3
3,All Students,2019-20,9157,592,8565,93.5,86,17,19.8
3,All Students,2020-21,13756,1334,12422,90.3,83,30,36.1
3,All Students,2021-22,10395,1152,9243,88.9,63,32,50.8
3,All Students,2022-23,11927,1147,10780,90.4,72,26,36.1
4,All Students,2018-19,15907,1099,14808,93.1,97,22,22.7
4,All Students,2019-20,11497,738,10759,93.6,105,20,19.0
4,All Students,2020-21,13554,1116,12438,91.8,81,26,32.1
4,All Students,2021-22,12939,1154,11785,91.1,83,31,37.3
4,All Students,2022-23,9989,942,9047,90.6,64,29,45.3
5,All Students,2018-19,16534,1149,15385,93.1,96,19,19.8
5,All Students,2019-20,10447,655,9792,93.7,96,19,19.8
5,All Students,2020-21,16924,1926,14998,88.6,98,39,39.8
5,All Students,2021-22,13176,1173,12003,91.1,79,27,34.2
5,All Students,2022-23,12180,936,11244,92.3,75,21,28.0
6,All Students,2020-21,167,s,s,s,s,s,s
All Grades,All Students,2018-19,151146,10333,140813,93.2,899,206,22.9
All Grades,All Students,2019-20,97433,6474,90959,93.4,888,220,24.8
All Grades,All Students,2020-21,138191,11062,127129,92.0,831,220,26.5
All Grades,All Students,2021-22,134708,15154,119554,88.8,814,375,46.1
All Grades,All Students,2022-23,149958,16237,133721,89.2,947,446,47.1
PK in K-12 Schools,All Students,2018-19,15504,s,s,s,s,s,s
PK in K-12 Schools,All Students,2019-20,10138,1107,9031,89.1,97,51,52.6
PK in K-12 Schools,All Students,2020-21,12589,s,s,s,s,s,s
PK in K-12 Schools,All Students,2021-22,14300,1948,12352,86.4,84,52,61.9
PK in K-12 Schools,All Students,2022-23,14574,2131,12443,85.4,95,66,69.5
0K,All Students,2018-19,22385,1647,20738,92.6,136,36,26.5
0K,All Students,2019-20,14661,1046,13615,92.9,130,31,23.8
0K,All Students,2020-21,22538,1932,20606,91.4,137,41,29.9
0K,All Students,2021-22,19783,2781,17002,85.9,125,72,57.6
0K,All Students,2022-23,18333,2106,16227,88.5,107,58,54.2
1,All Students,2018-19,21885,1574,20311,92.8,129,33,25.6
1,All Students,2019-20,15587,1055,14532,93.2,144,37,25.7
1,All Students,2020-21,20342,1522,18820,92.5,124,31,25.0
1,All Students,2021-22,21358,2467,18891,88.4,124,60,48.4
1,All Students,2022-23,25277,3049,22228,87.9,160,84,52.5
2,All Students,2018-19,21693,1347,20346,93.8,130,23,17.7
2,All Students,2019-20,13736,962,12774,93.0,124,38,30.6
2,All Students,2020-21,22280,1668,20612,92.5,135,28,20.7
2,All Students,2021-22,19448,1948,17500,90.0,120,51,42.5
2,All Students,2022-23,25891,2785,23106,89.2,166,76,45.8
3,All Students,2018-19,22636,1357,21279,94.0,137,28,20.4
3,All Students,2019-20,13309,728,12581,94.5,124,23,18.5
3,All Students,2020-21,19470,1486,17984,92.4,115,33,28.7
3,All Students,2021-22,21101,2379,18722,88.7,127,53,41.7
3,All Students,2022-23,22453,2073,20380,90.8,140,46,32.9
4,All Students,2018-19,22664,1218,21446,94.6,133,21,15.8
4,All Students,2019-20,14941,857,14084,94.3,136,25,18.4
4,All Students,2020-21,19671,1185,18486,94.0,117,19,16.2
4,All Students,2021-22,18654,1919,16735,89.7,114,46,40.4
4,All Students,2022-23,23244,2220,21024,90.4,150,63,42.0
5,All Students,2018-19,24209,1452,22757,94.0,139,30,21.6
5,All Students,2019-20,15061,719,14342,95.2,133,15,11.3
5,All Students,2020-21,21116,1524,19592,92.8,124,31,25.0
5,All Students,2021-22,20064,1712,18352,91.5,120,41,34.2
5,All Students,2022-23,20186,1873,18313,90.7,129,53,41.1
6,All Students,2018-19,170,s,s,s,s,s,s
6,All Students,2020-21,185,s,s,s,s,s,s
All Grades,All Students,2018-19,95634,6947,88687,92.7,574,159,27.7
All Grades,All Students,2019-20,59471,3891,55580,93.5,538,108,20.1
All Grades,All Students,2020-21,82020,5264,76756,93.6,490,92,18.8
All Grades,All Students,2021-22,75595,8549,67046,88.7,463,223,48.2
All Grades,All Students,2022-23,77907,7081,70826,90.9,473,159,33.6
0K,All Students,2018-19,12807,1200,11607,90.6,83,37,44.6
0K,All Students,2019-20,11067,897,10170,91.9,102,27,26.5
0K,All Students,2020-21,12595,1193,11402,90.5,76,19,25.0
0K,All Students,2021-22,12515,1666,10849,86.7,80,46,57.5
0K,All Students,2022-23,13705,1407,12298,89.7,80,33,41.3
1,All Students,2018-19,16618,1229,15389,92.6,99,26,26.3
1,All Students,2019-20,7686,583,7103,92.4,71,15,21.1
1,All Students,2020-21,16156,1156,15000,92.8,96,21,21.9
1,All Students,2021-22,11589,1373,10216,88.2,71,39,54.9
1,All Students,2022-23,13152,1399,11753,89.4,81,32,39.5
2,All Students,2018-19,15025,1114,13911,92.6,92,24,26.1
2,All Students,2019-20,10887,714,10173,93.4,99,21,21.2
2,All Students,2020-21,10848,834,10014,92.3,64,13,20.3
2,All Students,2021-22,14798,1590,13208,89.3,90,37,41.1
2,All Students,2022-23,11082,969,10113,91.3,70,27,38.6
3,All Students,2018-19,14914,785,14129,94.7,87,12,13.8
3,All Students,2019-20,9309,581,8728,93.8,85,16,18.8
3,All Students,2020-21,14717,900,13817,93.9,90,20,22.2
3,All Students,2021-22,10458,1134,9324,89.2,64,30,46.9
3,All Students,2022-23,14916,1266,13650,91.5,90,25,27.8
4,All Students,2018-19,18780,1321,17459,93.0,111,30,27.0
4,All Students,2019-20,9517,458,9059,95.2,85,8,9.4
4,All Students,2020-21,13870,745,13125,94.6,81,12,14.8
4,All Students,2021-22,14350,1513,12837,89.5,86,35,40.7
4,All Students,2022-23,11097,984,10113,91.1,68,22,32.4
5,All Students,2018-19,17490,1298,16192,92.6,102,30,29.4
5,All Students,2019-20,11005,658,10347,94.0,96,21,21.9
5,All Students,2020-21,13834,436,13398,96.8,83,7,8.4
5,All Students,2021-22,11885,1273,10612,89.3,72,36,50.0
5,All Students,2022-23,13955,1056,12899,92.4,84,20,23.8
All Grades,All Students,2018-19,91334,6505,84829,92.9,539,134,24.9
All Grades,All Students,2019-20,56919,3938,52981,93.1,518,118,22.8
All Grades,All Students,2020-21,85811,7723,78088,91.0,510,128,25.1
All Grades,All Students,2021-22,80353,8484,71869,89.4,482,201,41.7
All Grades,All Students,2022-23,87506,10194,77312,88.4,549,275,50.1
PK in K-12 Schools,All Students,2018-19,12534,1306,11228,89.6,72,31,43.1
PK in K-12 Schools,All Students,2019-20,8009,911,7098,88.6,76,35,46.1
PK in K-12 Schools,All Students,2020-21,9277,872,8405,90.6,57,22,38.6
PK in K-12 Schools,All Students,2021-22,8622,1146,7476,86.7,54,32,59.3
PK in K-12 Schools,All Students,2022-23,14927,2245,12682,85.0,93,63,67.7
0K,All Students,2018-19,12379,1087,11292,91.2,76,25,32.9
0K,All Students,2019-20,9106,693,8413,92.4,82,22,26.8
0K,All Students,2020-21,13505,1520,11985,88.7,82,27,32.9
0K,All Students,2021-22,12487,1341,11146,89.3,76,36,47.4
0K,All Students,2022-23,10844,1619,9225,85.1,81,50,61.7
1,All Students,2018-19,12905,922,11983,92.9,77,20,26.0
1,All Students,2019-20,7324,453,6871,93.8,68,11,16.2
1,All Students,2020-21,14270,1558,12712,89.1,84,25,29.8
1,All Students,2021-22,12431,1163,11268,90.6,77,27,35.1
1,All Students,2022-23,13623,1572,12051,88.5,83,46,55.4
2,All Students,2018-19,12501,855,11646,93.2,76,20,26.3
2,All Students,2019-20,8299,530,7769,93.6,75,16,21.3
2,All Students,2020-21,10862,766,10096,92.9,64,12,18.8
2,All Students,2021-22,14430,1307,13123,90.9,85,27,31.8
2,All Students,2022-23,11332,1130,10202,90.0,65,28,43.1
3,All Students,2018-19,13983,835,13148,94.0,80,15,18.8
3,All Students,2019-20,7954,460,7494,94.2,71,13,18.3
3,All Students,2020-21,12875,1178,11697,90.9,76,21,27.6
3,All Students,2021-22,9198,843,8355,90.8,55,16,29.1
3,All Students,2022-23,15894,1372,14522,91.4,96,28,29.2
4,All Students,2018-19,12024,580,11444,95.2,69,6,8.7
4,All Students,2019-20,8604,516,8088,94.0,78,16,20.5
4,All Students,2020-21,12275,855,11420,93.0,73,13,17.8
4,All Students,2021-22,12190,1438,10752,88.2,71,34,47.9
4,All Students,2022-23,8946,s,s,s,s,s,s
5,All Students,2018-19,15008,920,14088,93.9,89,17,19.1
5,All Students,2019-20,7623,375,7248,95.1,68,5,7.4
5,All Students,2020-21,12747,974,11773,92.4,74,8,10.8
5,All Students,2021-22,10995,1246,9749,88.7,64,29,45.3
5,All Students,2022-23,11886,1415,10471,88.1,73,39,53.4
6,All Students,2022-23,54,s,s,s,s,s,s
All Grades,All Students,2018-19,59484,5731,53753,90.4,365,133,36.4
All Grades,All Students,2019-20,31914,2693,29221,91.6,304,91,29.9
All Grades,All Students,2020-21,42985,5587,37398,87.0,261,101,38.7
All Grades,All Students,2021-22,45234,5637,39597,87.5,273,135,49.5
All Grades,All Students,2022-23,50727,5626,45101,88.9,323,146,45.2
6,All Students,2018-19,17657,1628,16029,90.8,115,38,33.0
6,All Students,2019-20,8623,781,7842,90.9,79,31,39.2
6,All Students,2020-21,11284,1463,9821,87.0,68,26,38.2
6,All Students,2021-22,16670,2201,14469,86.8,100,53,53.0
6,All Students,2022-23,15072,1308,13764,91.3,95,37,38.9
7,All Students,2018-19,18059,1649,16410,90.9,106,36,34.0
7,All Students,2019-20,11575,907,10668,92.2,112,26,23.2
7,All Students,2020-21,13345,1515,11830,88.6,85,31,36.5
7,All Students,2021-22,14058,1650,12408,88.3,86,46,53.5
7,All Students,2022-23,19389,2344,17045,87.9,124,61,49.2
8,All Students,2018-19,23768,2454,21314,89.7,144,59,41.0
8,All Students,2019-20,11716,1005,10711,91.4,113,34,30.1
8,All Students,2020-21,18356,2609,15747,85.8,108,44,40.7
8,All Students,2021-22,14506,1786,12720,87.7,87,36,41.4
8,All Students,2022-23,16266,1974,14292,87.9,104,48,46.2
All Grades,All Students,2018-19,85022,6604,78418,92.2,526,158,30.0
All Grades,All Students,2019-20,53878,3686,50192,93.2,500,119,23.8
All Grades,All Students,2020-21,68618,8331,60287,87.9,418,179,42.8
All Grades,All Students,2021-22,66471,8288,58183,87.5,412,202,49.0
All Grades,All Students,2022-23,65191,7223,57968,88.9,413,186,45.0
PK in K-12 Schools,All Students,2018-19,5819,715,5104,87.7,39,20,51.3
PK in K-12 Schools,All Students,2019-20,3968,352,3616,91.1,37,11,29.7
PK in K-12 Schools,All Students,2020-21,3124,447,2677,85.7,19,10,52.6
PK in K-12 Schools,All Students,2021-22,7533,1533,6000,79.6,48,36,75.0
PK in K-12 Schools,All Students,2022-23,8533,1345,7188,84.2,54,38,70.4
0K,All Students,2018-19,11836,1121,10715,90.5,76,31,40.8
0K,All Students,2019-20,8063,663,7400,91.8,76,27,35.5
0K,All Students,2020-21,9737,1328,8409,86.4,63,33,52.4
0K,All Students,2021-22,9676,1347,8329,86.1,60,33,55.0
0K,All Students,2022-23,9981,1330,8651,86.7,65,33,50.8
1,All Students,2018-19,10493,921,9572,91.2,66,22,33.3
1,All Students,2019-20,7723,640,7083,91.7,72,24,33.3
1,All Students,2020-21,11770,1818,9952,84.6,74,39,52.7
1,All Students,2021-22,8712,944,7768,89.2,55,20,36.4
1,All Students,2022-23,8928,842,8086,90.6,58,24,41.4
2,All Students,2018-19,12029,877,11152,92.7,77,19,24.7
2,All Students,2019-20,7025,443,6582,93.7,65,13,20.0
2,All Students,2020-21,10912,1528,9384,86.0,64,29,45.3
2,All Students,2021-22,10866,1231,9635,88.7,67,33,49.3
2,All Students,2022-23,9451,852,8599,91.0,58,15,25.9
3,All Students,2018-19,12323,783,11540,93.6,71,19,26.8
3,All Students,2019-20,7498,498,7000,93.4,70,13,18.6
3,All Students,2020-21,9975,1037,8938,89.6,60,20,33.3
3,All Students,2021-22,10046,1146,8900,88.6,61,31,50.8
3,All Students,2022-23,9422,1005,8417,89.3,59,26,44.1
4,All Students,2018-19,16914,1218,15696,92.8,106,31,29.2
4,All Students,2019-20,8422,507,7915,94.0,78,14,17.9
4,All Students,2020-21,10585,981,9604,90.7,64,20,31.3
4,All Students,2021-22,9401,1116,8285,88.1,62,27,43.5
4,All Students,2022-23,9549,949,8600,90.1,59,28,47.5
5,All Students,2018-19,15608,969,14639,93.8,91,16,17.6
5,All Students,2019-20,11179,583,10596,94.8,102,17,16.7
5,All Students,2020-21,12515,1192,11323,90.5,74,28,37.8
5,All Students,2021-22,10237,971,9266,90.5,59,22,37.3
5,All Students,2022-23,9327,900,8427,90.4,60,22,36.7
All Grades,All Students,2018-19,116828,6477,110351,94.5,702,114,16.2
All Grades,All Students,2019-20,70041,4511,65530,93.6,636,132,20.8
All Grades,All Students,2020-21,99726,8382,91344,91.6,594,167,28.1
All Grades,All Students,2021-22,100308,9255,91053,90.8,613,231,37.7
All Grades,All Students,2022-23,104401,10882,93519,89.6,666,285,42.8
0K,All Students,2018-19,18303,1720,16583,90.6,113,35,31.0
0K,All Students,2019-20,10156,1044,9112,89.7,92,37,40.2
0K,All Students,2020-21,14008,1732,12276,87.6,84,34,40.5
0K,All Students,2021-22,16362,1807,14555,89.0,110,59,53.6
0K,All Students,2022-23,15868,s,s,s,s,s,s
1,All Students,2018-19,20012,1088,18924,94.6,122,21,17.2
1,All Students,2019-20,11516,768,10748,93.3,105,21,20.0
1,All Students,2020-21,16701,1758,14943,89.5,100,36,36.0
1,All Students,2021-22,15706,s,s,s,s,s,s
1,All Students,2022-23,17076,1901,15175,88.9,111,50,45.0
2,All Students,2018-19,19401,973,18428,95.0,119,18,15.1
2,All Students,2019-20,12477,766,11711,93.9,115,22,19.1
2,All Students,2020-21,15710,1342,14368,91.5,92,23,25.0
2,All Students,2021-22,16163,1675,14488,89.6,97,38,39.2
2,All Students,2022-23,17495,1857,15638,89.4,108,49,45.4
3,All Students,2018-19,17826,772,17054,95.7,106,10,9.4
3,All Students,2019-20,12201,678,11523,94.4,111,18,16.2
3,All Students,2020-21,19101,1200,17901,93.7,115,24,20.9
3,All Students,2021-22,16604,1352,15252,91.9,99,29,29.3
3,All Students,2022-23,18312,1753,16559,90.4,121,47,38.8
4,All Students,2018-19,20633,946,19687,95.4,119,12,10.1
4,All Students,2019-20,11836,642,11194,94.6,108,19,17.6
4,All Students,2020-21,17135,1194,15941,93.0,101,25,24.8
4,All Students,2021-22,18662,1469,17193,92.1,111,39,35.1
4,All Students,2022-23,17256,1565,15691,90.9,107,39,36.4
5,All Students,2018-19,20653,978,19675,95.3,123,18,14.6
5,All Students,2019-20,11855,613,11242,94.8,105,15,14.3
5,All Students,2020-21,17071,1156,15915,93.2,102,25,24.5
5,All Students,2021-22,16809,1044,15765,93.8,99,15,15.2
5,All Students,2022-23,18387,1261,17126,93.1,114,30,26.3
6,All Students,2021-22,2,s,s,s,s,s,s
6,All Students,2022-23,7,s,s,s,s,s,s
All Grades,All Students,2018-19,152667,11379,141288,92.5,924,248,26.8
All Grades,All Students,2019-20,88565,6357,82208,92.8,812,198,24.4
All Grades,All Students,2020-21,122438,8287,114151,93.2,734,171,23.3
All Grades,All Students,2021-22,111951,12114,99837,89.2,691,309,44.7
All Grades,All Students,2022-23,114459,11605,102854,89.9,708,299,42.2
PK in K-12 Schools,All Students,2018-19,6161,s,s,s,s,s,s
PK in K-12 Schools,All Students,2019-20,4069,585,3484,85.6,39,21,53.8
PK in K-12 Schools,All Students,2020-21,5845,420,5425,92.8,35,9,25.7
PK in K-12 Schools,All Students,2021-22,5847,s,s,s,s,s,s
PK in K-12 Schools,All Students,2022-23,6150,917,5233,85.1,36,24,66.7
0K,All Students,2018-19,22803,2424,20379,89.4,138,65,47.1
0K,All Students,2019-20,14730,1420,13310,90.4,136,49,36.0
0K,All Students,2020-21,19581,1858,17723,90.5,119,42,35.3
0K,All Students,2021-22,18208,2285,15923,87.5,110,58,52.7
0K,All Students,2022-23,17434,2374,15060,86.4,107,62,57.9
1,All Students,2018-19,20725,2071,18654,90.0,130,54,41.5
1,All Students,2019-20,14088,1147,12941,91.9,133,40,30.1
1,All Students,2020-21,19782,1580,18202,92.0,119,30,25.2
1,All Students,2021-22,18805,2492,16313,86.7,117,68,58.1
1,All Students,2022-23,18188,1844,16344,89.9,114,46,40.4
2,All Students,2018-19,20262,1218,19044,94.0,121,20,16.5
2,All Students,2019-20,12769,908,11861,92.9,118,29,24.6
2,All Students,2020-21,20468,1082,19386,94.7,120,21,17.5
2,All Students,2021-22,17541,1870,15671,89.3,110,53,48.2
2,All Students,2022-23,17849,2047,15802,88.5,111,58,52.3
3,All Students,2018-19,21192,1320,19872,93.8,128,26,20.3
3,All Students,2019-20,12376,682,11694,94.5,111,15,13.5
3,All Students,2020-21,18959,1089,17870,94.3,118,24,20.3
3,All Students,2021-22,16300,1413,14887,91.3,100,32,32.0
3,All Students,2022-23,21717,1864,19853,91.4,135,50,37.0
4,All Students,2018-19,28612,1732,26880,93.9,171,32,18.7
4,All Students,2019-20,12937,638,12299,95.1,118,14,11.9
4,All Students,2020-21,18533,945,17588,94.9,109,19,17.4
4,All Students,2021-22,18073,1859,16214,89.7,112,43,38.4
4,All Students,2022-23,15647,1206,14441,92.3,98,23,23.5
5,All Students,2018-19,32911,1772,31139,94.6,196,30,15.3
5,All Students,2019-20,17596,977,16619,94.4,157,30,19.1
5,All Students,2020-21,19270,1313,17957,93.2,114,26,22.8
5,All Students,2021-22,17168,1126,16042,93.4,105,28,26.7
5,All Students,2022-23,17474,1353,16121,92.3,107,36,33.6
6,All Students,2018-19,1,s,s,s,s,s,s
6,All Students,2021-22,9,s,s,s,s,s,s
All Grades,All Students,2018-19,136822,7543,129279,94.5,808,123,15.2
All Grades,All Students,2019-20,81572,4653,76919,94.3,728,129,17.7
All Grades,All Students,2020-21,121923,3093,118830,97.5,715,53,7.4
All Grades,All Students,2021-22,119208,8616,110592,92.8,715,173,24.2
All Grades,All Students,2022-23,124890,10832,114058,91.3,751,246,32.8
0K,All Students,2018-19,21927,1563,20364,92.9,134,35,26.1
0K,All Students,2019-20,13158,926,12232,93.0,121,34,28.1
0K,All Students,2020-21,19585,890,18695,95.5,115,20,17.4
0K,All Students,2021-22,19777,1774,18003,91.0,120,39,32.5
0K,All Students,2022-23,22019,2328,19691,89.4,130,59,45.4
1,All Students,2018-19,18824,1030,17794,94.5,112,16,14.3
1,All Students,2019-20,12589,878,11711,93.0,111,27,24.3
1,All Students,2020-21,19335,482,18853,97.5,115,8,7.0
1,All Students,2021-22,19126,1520,17606,92.1,116,33,28.4
1,All Students,2022-23,19698,1996,17702,89.9,121,47,38.8
2,All Students,2018-19,19659,1215,18444,93.8,117,21,17.9
2,All Students,2019-20,12122,600,11522,95.1,111,16,14.4
2,All Students,2020-21,17869,526,17343,97.1,105,7,6.7
2,All Students,2021-22,17769,1177,16592,93.4,104,24,23.1
2,All Students,2022-23,18758,1401,17357,92.5,113,30,26.5
3,All Students,2018-19,18864,907,17957,95.2,112,12,10.7
3,All Students,2019-20,11703,597,11106,94.9,103,12,11.7
3,All Students,2020-21,18477,401,18076,97.8,108,7,6.5
3,All Students,2021-22,17945,1143,16802,93.6,108,16,14.8
3,All Students,2022-23,17675,1273,16402,92.8,106,26,24.5
4,All Students,2018-19,20932,1056,19876,95.0,123,20,16.3
4,All Students,2019-20,11269,495,10774,95.6,99,10,10.1
4,All Students,2020-21,17447,244,17203,98.6,101,2,2.0
4,All Students,2021-22,17725,1105,16620,93.8,105,24,22.9
4,All Students,2022-23,18232,1419,16813,92.2,107,29,27.1
5,All Students,2018-19,22111,1113,20998,95.0,127,13,10.2
5,All Students,2019-20,12005,603,11402,95.0,107,14,13.1
5,All Students,2020-21,16811,233,16578,98.6,99,2,2.0
5,All Students,2021-22,16132,1150,14982,92.9,98,23,23.5
5,All Students,2022-23,17998,1493,16505,91.7,112,34,30.4
6,All Students,2018-19,14505,659,13846,95.5,83,6,7.2
6,All Students,2019-20,8726,554,8172,93.7,76,16,21.1
6,All Students,2020-21,12399,317,12082,97.4,72,7,9.7
6,All Students,2021-22,10734,747,9987,93.0,64,14,21.9
6,All Students,2022-23,10510,922,9588,91.2,62,21,33.9
All Grades,All Students,2018-19,120186,5502,114684,95.4,700,74,10.6
All Grades,All Students,2019-20,78070,3622,74448,95.4,697,86,12.3
All Grades,All Students,2020-21,104136,2568,101568,97.5,620,28,4.5
All Grades,All Students,2021-22,93236,4971,88265,94.7,549,77,14.0
All Grades,All Students,2022-23,105069,7170,97899,93.2,613,126,20.6
PK in K-12 Schools,All Students,2018-19,3177,262,2915,91.8,19,8,42.1
PK in K-12 Schools,All Students,2019-20,2067,77,1990,96.3,18,1,5.6
PK in K-12 Schools,All Students,2020-21,3080,143,2937,95.4,18,2,11.1
PK in K-12 Schools,All Students,2021-22,3097,110,2987,96.4,18,0,0.0
PK in K-12 Schools,All Students,2022-23,3186,264,2922,91.7,18,4,22.2
0K,All Students,2018-19,21097,1233,19864,94.2,127,21,16.5
0K,All Students,2019-20,13403,859,12544,93.6,120,28,23.3
0K,All Students,2020-21,16722,581,16141,96.5,101,8,7.9
0K,All Students,2021-22,15705,1010,14695,93.6,95,18,18.9
0K,All Students,2022-23,21980,1704,20276,92.2,130,37,28.5
1,All Students,2018-19,18867,905,17962,95.2,109,14,12.8
1,All Students,2019-20,13605,679,12926,95.0,121,17,14.0
1,All Students,2020-21,18563,469,18094,97.5,110,6,5.5
1,All Students,2021-22,15257,817,14440,94.6,89,18,20.2
1,All Students,2022-23,17028,1340,15688,92.1,99,27,27.3
2,All Students,2018-19,18888,908,17980,95.2,109,9,8.3
2,All Students,2019-20,12283,618,11665,95.0,109,14,12.8
2,All Students,2020-21,18289,294,17995,98.4,109,2,1.8
2,All Students,2021-22,17568,1014,16554,94.2,103,14,13.6
2,All Students,2022-23,15994,1249,14745,92.2,93,18,19.4
3,All Students,2018-19,20217,723,19494,96.4,116,3,2.6
3,All Students,2019-20,12031,552,11479,95.4,108,12,11.1
3,All Students,2020-21,16309,459,15850,97.2,97,5,5.2
3,All Students,2021-22,15981,774,15207,95.2,93,14,15.1
3,All Students,2022-23,17795,1112,16683,93.8,104,19,18.3
4,All Students,2018-19,20062,734,19328,96.3,117,8,6.8
4,All Students,2019-20,11815,327,11488,97.2,107,1,0.9
4,All Students,2020-21,15823,321,15502,98.0,96,5,5.2
4,All Students,2021-22,13715,663,13052,95.2,81,6,7.4
4,All Students,2022-23,15561,783,14778,95.0,90,14,15.6
5,All Students,2018-19,15208,625,14583,95.9,88,11,12.5
5,All Students,2019-20,12866,510,12356,96.0,114,13,11.4
5,All Students,2020-21,15350,301,15049,98.0,89,0,0.0
5,All Students,2021-22,11913,583,11330,95.1,70,7,10.0
5,All Students,2022-23,13525,718,12807,94.7,79,7,8.9
6,All Students,2018-19,2670,112,2558,95.8,15,0,0.0
All Grades,All Students,2018-19,173635,13589,160046,92.2,1062,319,30.0
All Grades,All Students,2019-20,106531,9163,97368,91.4,977,291,29.8
All Grades,All Students,2020-21,150066,12058,138008,92.0,914,245,26.8
All Grades,All Students,2021-22,140418,17596,122822,87.5,893,470,52.6
All Grades,All Students,2022-23,139232,15741,123491,88.7,885,413,46.7
PK in K-12 Schools,All Students,2018-19,12216,1456,10760,88.1,77,42,54.5
PK in K-12 Schools,All Students,2019-20,7437,879,6558,88.2,69,37,53.6
PK in K-12 Schools,All Students,2020-21,11098,1778,9320,84.0,67,37,55.2
PK in K-12 Schools,All Students,2021-22,11103,2209,8894,80.1,73,59,80.8
PK in K-12 Schools,All Students,2022-23,12407,2128,10279,82.8,75,55,73.3
0K,All Students,2018-19,23987,2135,21852,91.1,157,66,42.0
0K,All Students,2019-20,15218,1459,13759,90.4,140,53,37.9
0K,All Students,2020-21,22532,2573,19959,88.6,144,57,39.6
0K,All Students,2021-22,19636,2697,16939,86.3,127,72,56.7
0K,All Students,2022-23,22433,3385,19048,84.9,145,91,62.8
1,All Students,2018-19,27976,2280,25696,91.9,172,49,28.5
1,All Students,2019-20,15590,1602,13988,89.7,143,53,37.1
1,All Students,2020-21,22484,1824,20660,91.9,133,31,23.3
1,All Students,2021-22,22233,3132,19101,85.9,143,94,65.7
1,All Students,2022-23,22026,2558,19468,88.4,143,72,50.3
2,All Students,2018-19,29428,2064,27364,93.0,178,47,26.4
2,All Students,2019-20,17847,1388,16459,92.2,161,40,24.8
2,All Students,2020-21,21346,1454,19892,93.2,133,33,24.8
2,All Students,2021-22,21101,2636,18465,87.5,134,60,44.8
2,All Students,2022-23,19830,2132,17698,89.2,128,51,39.8
3,All Students,2018-19,22710,1848,20862,91.9,136,35,25.7
3,All Students,2019-20,18269,1395,16874,92.4,167,32,19.2
3,All Students,2020-21,25481,1652,23829,93.5,155,32,20.6
3,All Students,2021-22,20381,2382,17999,88.3,134,69,51.5
3,All Students,2022-23,20507,2054,18453,90.0,130,52,40.0
4,All Students,2018-19,30668,2116,28552,93.1,185,52,28.1
4,All Students,2019-20,13763,1130,12633,91.8,129,42,32.6
4,All Students,2020-21,26001,2016,23985,92.2,156,38,24.4
4,All Students,2021-22,21359,2225,19134,89.6,132,61,46.2
4,All Students,2022-23,19948,1662,18286,91.7,125,44,35.2
5,All Students,2018-19,26650,1690,24960,93.7,157,28,17.8
5,All Students,2019-20,18407,1310,17097,92.9,168,34,20.2
5,All Students,2020-21,21124,761,20363,96.4,126,17,13.5
5,All Students,2021-22,24605,2315,22290,90.6,150,55,36.7
5,All Students,2022-23,22081,1822,20259,91.7,139,48,34.5
All Grades,All Students,2018-19,156448,12084,144364,92.3,930,251,27.0
All Grades,All Students,2019-20,94656,6189,88467,93.5,848,187,22.1
All Grades,All Students,2020-21,135177,6799,128378,95.0,793,127,16.0
All Grades,All Students,2021-22,128645,12070,116575,90.6,767,274,35.7
All Grades,All Students,2022-23,128083,11243,116840,91.2,773,266,34.4
PK in K-12 Schools,All Students,2018-19,6079,836,5243,86.2,39,20,51.3
PK in K-12 Schools,All Students,2019-20,4134,394,3740,90.5,36,15,41.7
PK in K-12 Schools,All Students,2020-21,6050,s,s,s,s,s,s
PK in K-12 Schools,All Students,2021-22,6131,981,5150,84.0,38,25,65.8
PK in K-12 Schools,All Students,2022-23,6296,874,5422,86.1,37,24,64.9
0K,All Students,2018-19,21137,1960,19177,90.7,125,46,36.8
0K,All Students,2019-20,11768,1073,10695,90.9,105,31,29.5
0K,All Students,2020-21,18460,1419,17041,92.3,112,28,25.0
0K,All Students,2021-22,20678,2171,18507,89.5,122,51,41.8
0K,All Students,2022-23,17581,1998,15583,88.6,111,54,48.6
1,All Students,2018-19,20894,2053,18841,90.2,124,45,36.3
1,All Students,2019-20,14736,1087,13649,92.6,135,42,31.1
1,All Students,2020-21,19896,1469,18427,92.6,117,28,23.9
1,All Students,2021-22,18396,1788,16608,90.3,109,38,34.9
1,All Students,2022-23,20029,1748,18281,91.3,119,40,33.6
2,All Students,2018-19,24933,1624,23309,93.5,148,33,22.3
2,All Students,2019-20,14152,925,13227,93.5,129,25,19.4
2,All Students,2020-21,22836,975,21861,95.7,132,18,13.6
2,All Students,2021-22,18153,1703,16450,90.6,109,38,34.9
2,All Students,2022-23,20760,1822,18938,91.2,126,42,33.3
3,All Students,2018-19,24945,1670,23275,93.3,147,34,23.1
3,All Students,2019-20,15893,835,15058,94.7,142,23,16.2
3,All Students,2020-21,22453,672,21781,97.0,133,12,9.0
3,All Students,2021-22,22109,1781,20328,91.9,131,40,30.5
3,All Students,2022-23,20683,1718,18965,91.7,128,43,33.6
4,All Students,2018-19,30531,1976,28555,93.5,181,34,18.8
4,All Students,2019-20,15095,832,14263,94.5,135,23,17.0
4,All Students,2020-21,23077,913,22164,96.0,135,20,14.8
4,All Students,2021-22,21633,1960,19673,90.9,130,45,34.6
4,All Students,2022-23,21330,1493,19837,93.0,126,33,26.2
5,All Students,2018-19,27929,1965,25964,93.0,166,39,23.5
5,All Students,2019-20,18878,1043,17835,94.5,166,28,16.9
5,All Students,2020-21,22396,900,21496,96.0,128,12,9.4
5,All Students,2021-22,21545,1686,19859,92.2,128,37,28.9
5,All Students,2022-23,21404,1590,19814,92.6,126,30,23.8
6,All Students,2020-21,9,s,s,s,s,s,s
All Grades,All Students,2018-19,131358,6804,124554,94.8,774,108,14.0
All Grades,All Students,2019-20,81596,4636,76960,94.3,736,121,16.4
All Grades,All Students,2020-21,111458,4778,106680,95.7,678,94,13.9
All Grades,All Students,2021-22,101638,8811,92827,91.3,609,186,30.5
All Grades,All Students,2022-23,101513,8977,92536,91.2,622,214,34.4
0K,All Students,2018-19,21494,1238,20256,94.2,129,19,14.7
0K,All Students,2019-20,14540,877,13663,94.0,129,24,18.6
0K,All Students,2020-21,16629,1066,15563,93.6,110,28,25.5
0K,All Students,2021-22,17299,1758,15541,89.8,105,42,40.0
0K,All Students,2022-23,18264,1853,16411,89.9,113,47,41.6
1,All Students,2018-19,21750,1291,20459,94.1,132,26,19.7
1,All Students,2019-20,12351,757,11594,93.9,112,26,23.2
1,All Students,2020-21,20560,951,19609,95.4,122,15,12.3
1,All Students,2021-22,14980,1252,13728,91.6,95,25,26.3
1,All Students,2022-23,17201,1717,15484,90.0,108,50,46.3
2,All Students,2018-19,19537,s,s,s,s,s,s
2,All Students,2019-20,13772,841,12931,93.9,124,19,15.3
2,All Students,2020-21,16894,814,16080,95.2,107,17,15.9
2,All Students,2021-22,18226,1659,16567,90.9,107,33,30.8
2,All Students,2022-23,13649,1250,12399,90.8,82,28,34.1
3,All Students,2018-19,21794,1126,20668,94.8,126,19,15.1
3,All Students,2019-20,12607,702,11905,94.4,117,19,16.2
3,All Students,2020-21,18334,757,17577,95.9,109,13,11.9
3,All Students,2021-22,18179,1485,16694,91.8,107,33,30.8
3,All Students,2022-23,18342,1677,16665,90.9,113,38,33.6
4,All Students,2018-19,23286,1022,22264,95.6,135,9,6.7
4,All Students,2019-20,13970,768,13202,94.5,128,17,13.3
4,All Students,2020-21,18503,741,17762,96.0,110,14,12.7
4,All Students,2021-22,16690,1288,15402,92.3,100,26,26.0
4,All Students,2022-23,18313,1265,17048,93.1,113,26,23.0
5,All Students,2018-19,23397,1105,22292,95.3,135,17,12.6
5,All Students,2019-20,14356,691,13665,95.2,126,16,12.7
5,All Students,2020-21,20538,449,20089,97.8,120,7,5.8
5,All Students,2021-22,16264,1369,14895,91.6,95,27,28.4
5,All Students,2022-23,15744,1215,14529,92.3,93,25,26.9
6,All Students,2018-19,100,s,s,s,s,s,s
All Grades,All Students,2018-19,83044,7833,75211,90.6,523,199,38.0
All Grades,All Students,2019-20,49694,3982,45712,92.0,467,141,30.2
All Grades,All Students,2020-21,67880,9918,57962,85.4,412,160,38.8
All Grades,All Students,2021-22,66617,7563,59054,88.6,409,179,43.8
All Grades,All Students,2022-23,61161,7651,53510,87.5,382,201,52.6
PK in K-12 Schools,All Students,2018-19,5126,700,4426,86.3,35,21,60.0
PK in K-12 Schools,All Students,2019-20,3367,398,2969,88.2,32,14,43.8
PK in K-12 Schools,All Students,2020-21,1739,s,s,s,s,s,s
PK in K-12 Schools,All Students,2021-22,5523,842,4681,84.8,34,19,55.9
PK in K-12 Schools,All Students,2022-23,4748,929,3819,80.4,31,20,64.5
0K,All Students,2018-19,14137,1606,12531,88.6,89,37,41.6
0K,All Students,2019-20,7255,605,6650,91.7,71,25,35.2
0K,All Students,2020-21,10369,1786,8583,82.8,64,26,40.6
0K,All Students,2021-22,8978,1247,7731,86.1,55,30,54.5
0K,All Students,2022-23,8957,1264,7693,85.9,59,31,52.5
1,All Students,2018-19,12919,1166,11753,91.0,82,28,34.1
1,All Students,2019-20,9469,799,8670,91.6,88,26,29.5
1,All Students,2020-21,9150,1672,7478,81.7,59,28,47.5
1,All Students,2021-22,10196,1021,9175,90.0,62,25,40.3
1,All Students,2022-23,8271,1229,7042,85.1,54,34,63.0
2,All Students,2018-19,12543,1082,11461,91.4,80,31,38.8
2,All Students,2019-20,7510,601,6909,92.0,74,23,31.1
2,All Students,2020-21,13708,1876,11832,86.3,81,31,38.3
2,All Students,2021-22,8302,750,7552,91.0,50,18,36.0
2,All Students,2022-23,9027,884,8143,90.2,53,22,41.5
3,All Students,2018-19,12188,1157,11031,90.5,76,27,35.5
3,All Students,2019-20,7874,541,7333,93.1,74,22,29.7
3,All Students,2020-21,10899,1366,9533,87.5,63,17,27.0
3,All Students,2021-22,13539,1477,12062,89.1,83,32,38.6
3,All Students,2022-23,8387,776,7611,90.7,51,25,49.0
4,All Students,2018-19,10077,843,9234,91.6,65,23,35.4
4,All Students,2019-20,7204,630,6574,91.3,64,20,31.3
4,All Students,2020-21,12158,1308,10850,89.2,74,28,37.8
4,All Students,2021-22,9544,1203,8341,87.4,58,31,53.4
4,All Students,2022-23,12926,1480,11446,88.6,78,37,47.4
5,All Students,2018-19,16054,1279,14775,92.0,96,32,33.3
5,All Students,2019-20,7015,408,6607,94.2,64,11,17.2
5,All Students,2020-21,9690,1511,8179,84.4,59,24,40.7
5,All Students,2021-22,10535,1023,9512,90.3,67,24,35.8
5,All Students,2022-23,8845,1089,7756,87.7,56,32,57.1
6,All Students,2020-21,167,s,s,s,s,s,s
All Grades,All Students,2018-19,160058,7486,152572,95.3,934,85,9.1
All Grades,All Students,2019-20,107276,5185,102091,95.2,959,107,11.2
All Grades,All Students,2020-21,154523,2661,151862,98.3,910,23,2.5
All Grades,All Students,2021-22,145423,8573,136850,94.1,867,160,18.5
All Grades,All Students,2022-23,146861,10505,136356,92.8,862,219,25.4
PK in K-12 Schools,All Students,2018-19,9289,671,8618,92.8,55,9,16.4
PK in K-12 Schools,All Students,2019-20,8133,528,7605,93.5,73,13,17.8
PK in K-12 Schools,All Students,2020-21,11235,371,10864,96.7,65,6,9.2
PK in K-12 Schools,All Students,2021-22,13260,1293,11967,90.2,79,33,41.8
PK in K-12 Schools,All Students,2022-23,17125,1791,15334,89.5,99,46,46.5
0K,All Students,2018-19,30780,1726,29054,94.4,180,22,12.2
0K,All Students,2019-20,17899,1192,16707,93.3,160,33,20.6
0K,All Students,2020-21,24870,448,24422,98.2,147,1,0.7
0K,All Students,2021-22,20133,1353,18780,93.3,127,26,20.5
0K,All Students,2022-23,19477,1673,17804,91.4,117,41,35.0
1,All Students,2018-19,26814,1175,25639,95.6,162,14,8.6
1,All Students,2019-20,20109,1073,19036,94.7,180,18,10.0
1,All Students,2020-21,26276,402,25874,98.5,154,4,2.6
1,All Students,2021-22,23423,1315,22108,94.4,138,19,13.8
1,All Students,2022-23,21576,1634,19942,92.4,127,35,27.6
2,All Students,2018-19,26247,1258,24989,95.2,150,14,9.3
2,All Students,2019-20,16607,730,15877,95.6,148,14,9.5
2,All Students,2020-21,26693,426,26267,98.4,157,4,2.5
2,All Students,2021-22,24424,1419,23005,94.2,144,29,20.1
2,All Students,2022-23,23255,1522,21733,93.5,136,25,18.4
3,All Students,2018-19,25662,998,24664,96.1,149,11,7.4
3,All Students,2019-20,15927,660,15267,95.9,144,11,7.6
3,All Students,2020-21,22895,390,22505,98.3,136,2,1.5
3,All Students,2021-22,24448,1251,23197,94.9,145,24,16.6
3,All Students,2022-23,23187,1425,21762,93.9,137,25,18.2
4,All Students,2018-19,19908,706,19202,96.5,116,4,3.4
4,All Students,2019-20,15638,535,15103,96.6,139,9,6.5
4,All Students,2020-21,21985,245,21740,98.9,131,2,1.5
4,All Students,2021-22,21548,1023,20525,95.3,126,14,11.1
4,All Students,2022-23,22789,1368,21421,94.0,131,27,20.6
5,All Students,2018-19,21358,952,20406,95.5,122,11,9.0
5,All Students,2019-20,12963,467,12496,96.4,115,9,7.8
5,All Students,2020-21,20569,379,20190,98.2,120,4,3.3
5,All Students,2021-22,18187,919,17268,94.9,108,15,13.9
5,All Students,2022-23,19452,1092,18360,94.4,115,20,17.4
All Grades,All Students,2018-19,292202,14693,277509,95.0,1693,237,14.0
All Grades,All Students,2019-20,193461,9155,184306,95.3,1716,207,12.1
All Grades,All Students,2020-21,287630,22137,265493,92.3,1675,394,23.5
All Grades,All Students,2021-22,275909,21247,254662,92.3,1624,441,27.2
All Grades,All Students,2022-23,275577,20439,255138,92.6,1625,404,24.9
6,All Students,2018-19,96203,4358,91845,95.5,558,66,11.8
6,All Students,2019-20,62651,2759,59892,95.6,554,59,10.6
6,All Students,2020-21,89306,6766,82540,92.4,523,118,22.6
6,All Students,2021-22,91826,6965,84861,92.4,539,142,26.3
6,All Students,2022-23,89463,5714,83749,93.6,530,113,21.3
7,All Students,2018-19,97010,4609,92401,95.2,560,68,12.1
7,All Students,2019-20,64285,2772,61513,95.7,569,59,10.4
7,All Students,2020-21,97268,7308,89960,92.5,567,126,22.2
7,All Students,2021-22,83631,5710,77921,93.2,495,113,22.8
7,All Students,2022-23,95723,7140,88583,92.5,564,143,25.4
8,All Students,2018-19,92708,5177,87531,94.4,536,89,16.6
8,All Students,2019-20,62420,3304,59116,94.7,557,77,13.8
8,All Students,2020-21,97203,7431,89772,92.4,563,142,25.2
8,All Students,2021-22,94917,7798,87119,91.8,555,167,30.1
8,All Students,2022-23,85794,6984,78810,91.9,502,136,27.1
9,All Students,2018-19,6274,s,s,s,s,s,s
9,All Students,2019-20,4105,320,3785,92.2,36,12,33.3
9,All Students,2020-21,3853,632,3221,83.6,22,8,36.4
9,All Students,2021-22,5535,774,4761,86.0,35,19,54.3
9,All Students,2022-23,4597,601,3996,86.9,29,12,41.4
10,All Students,2018-19,7,s,s,s,s,s,s
All Grades,All Students,2018-19,109903,10350,99553,90.6,663,248,37.4
All Grades,All Students,2019-20,69871,5901,63970,91.6,654,201,30.7
All Grades,All Students,2020-21,110206,10456,99750,90.5,649,195,30.0
All Grades,All Students,2021-22,104285,14476,89809,86.1,647,367,56.7
All Grades,All Students,2022-23,106429,13069,93360,87.7,681,357,52.4
PK in K-12 Schools,All Students,2018-19,10939,1685,9254,84.6,69,48,69.6
PK in K-12 Schools,All Students,2019-20,7883,948,6935,88.0,76,36,47.4
PK in K-12 Schools,All Students,2020-21,11362,1286,10076,88.7,71,26,36.6
PK in K-12 Schools,All Students,2021-22,11314,2271,9043,79.9,75,58,77.3
PK in K-12 Schools,All Students,2022-23,13796,2382,11414,82.7,92,63,68.5
0K,All Students,2018-19,16662,1919,14743,88.5,104,51,49.0
0K,All Students,2019-20,10437,1136,9301,89.1,98,42,42.9
0K,All Students,2020-21,16948,2543,14405,85.0,101,46,45.5
0K,All Students,2021-22,17553,2665,14888,84.8,109,69,63.3
0K,All Students,2022-23,17268,2575,14693,85.1,116,74,63.8
1,All Students,2018-19,13361,1229,12132,90.8,80,29,36.3
1,All Students,2019-20,10490,776,9714,92.6,98,26,26.5
1,All Students,2020-21,15441,1851,13590,88.0,91,34,37.4
1,All Students,2021-22,16463,2372,14091,85.6,102,60,58.8
1,All Students,2022-23,18254,2262,15992,87.6,117,68,58.1
2,All Students,2018-19,16633,1145,15488,93.1,101,27,26.7
2,All Students,2019-20,8365,754,7611,91.0,79,24,30.4
2,All Students,2020-21,16394,1365,15029,91.7,95,25,26.3
2,All Students,2021-22,14532,1884,12648,87.0,90,46,51.1
2,All Students,2022-23,13631,1510,12121,88.9,83,40,48.2
3,All Students,2018-19,17941,1455,16486,91.9,105,30,28.6
3,All Students,2019-20,11084,694,10390,93.7,103,22,21.4
3,All Students,2020-21,14244,1226,13018,91.4,84,27,32.1
3,All Students,2021-22,14172,1891,12281,86.7,89,48,53.9
3,All Students,2022-23,13270,1174,12096,91.2,84,31,36.9
4,All Students,2018-19,14987,1279,13708,91.5,89,29,32.6
4,All Students,2019-20,11735,941,10794,92.0,108,31,28.7
4,All Students,2020-21,17158,874,16284,94.9,99,10,10.1
4,All Students,2021-22,14244,1696,12548,88.1,84,41,48.8
4,All Students,2022-23,14877,1577,13300,89.4,95,43,45.3
5,All Students,2018-19,19380,1638,17742,91.5,115,34,29.6
5,All Students,2019-20,9877,652,9225,93.4,92,20,21.7
5,All Students,2020-21,18659,1311,17348,93.0,108,27,25.0
5,All Students,2021-22,16007,1697,14310,89.4,98,45,45.9
5,All Students,2022-23,15333,1589,13744,89.6,94,38,40.4
All Grades,All Students,2018-19,111701,7961,103740,92.9,659,157,23.8
All Grades,All Students,2019-20,67773,4677,63096,93.1,620,138,22.3
All Grades,All Students,2020-21,103304,5528,97776,94.6,609,91,14.9
All Grades,All Students,2021-22,94920,10946,83974,88.5,580,267,46.0
All Grades,All Students,2022-23,96672,10436,86236,89.2,587,264,45.0
PK in K-12 Schools,All Students,2018-19,11021,1510,9511,86.3,67,34,50.7
PK in K-12 Schools,All Students,2019-20,7317,721,6596,90.1,71,27,38.0
PK in K-12 Schools,All Students,2020-21,11002,1161,9841,89.4,66,22,33.3
PK in K-12 Schools,All Students,2021-22,10119,2052,8067,79.7,66,54,81.8
PK in K-12 Schools,All Students,2022-23,11718,1807,9911,84.6,71,54,76.1
0K,All Students,2018-19,13374,1150,12224,91.4,80,28,35.0
0K,All Students,2019-20,10821,1123,9698,89.6,100,39,39.0
0K,All Students,2020-21,15009,897,14112,94.0,90,13,14.4
0K,All Students,2021-22,15520,1980,13540,87.2,95,46,48.4
0K,All Students,2022-23,15960,1953,14007,87.8,99,48,48.5
1,All Students,2018-19,13609,1075,12534,92.1,81,23,28.4
1,All Students,2019-20,8505,602,7903,92.9,80,18,22.5
1,All Students,2020-21,15801,890,14911,94.4,92,13,14.1
1,All Students,2021-22,14181,1227,12954,91.3,88,28,31.8
1,All Students,2022-23,15363,1702,13661,88.9,93,42,45.2
2,All Students,2018-19,17972,1130,16842,93.7,105,19,18.1
2,All Students,2019-20,8058,531,7527,93.4,74,17,23.0
2,All Students,2020-21,13585,639,12946,95.3,81,12,14.8
2,All Students,2021-22,15134,1608,13526,89.4,90,37,41.1
2,All Students,2022-23,14423,1346,13077,90.7,89,31,34.8
3,All Students,2018-19,19829,999,18830,95.0,116,15,12.9
3,All Students,2019-20,10715,583,10132,94.6,99,16,16.2
3,All Students,2020-21,12676,706,11970,94.4,75,15,20.0
3,All Students,2021-22,12224,1270,10954,89.6,74,27,36.5
3,All Students,2022-23,15174,1358,13816,91.1,91,35,38.5
4,All Students,2018-19,15963,813,15150,94.9,95,15,15.8
4,All Students,2019-20,12411,572,11839,95.4,108,9,8.3
4,All Students,2020-21,15721,642,15079,95.9,92,9,9.8
4,All Students,2021-22,12504,1393,11111,88.9,75,34,45.3
4,All Students,2022-23,11590,s,s,s,s,s,s
5,All Students,2018-19,19933,1284,18649,93.6,115,23,20.0
5,All Students,2019-20,9946,545,9401,94.5,88,12,13.6
5,All Students,2020-21,19510,593,18917,97.0,113,7,6.2
5,All Students,2021-22,15238,1416,13822,90.7,92,41,44.6
5,All Students,2022-23,12422,1194,11228,90.4,75,31,41.3
6,All Students,2022-23,22,s,s,s,s,s,s
All Grades,All Students,2018-19,142441,7368,135073,94.8,840,112,13.3
All Grades,All Students,2019-20,92314,4518,87796,95.1,838,109,13.0
All Grades,All Students,2020-21,145498,11788,133710,91.9,843,211,25.0
All Grades,All Students,2021-22,142791,12981,129810,90.9,841,273,32.5
All Grades,All Students,2022-23,142069,13264,128805,90.7,855,272,31.8
6,All Students,2018-19,23285,820,22465,96.5,134,6,4.5
6,All Students,2019-20,14820,447,14373,97.0,131,6,4.6
6,All Students,2020-21,23743,946,22797,96.0,138,16,11.6
6,All Students,2021-22,21775,1483,20292,93.2,125,29,23.2
6,All Students,2022-23,22383,1483,20900,93.4,131,22,16.8
7,All Students,2018-19,21232,882,20350,95.8,121,10,8.3
7,All Students,2019-20,14650,575,14075,96.1,130,10,7.7
7,All Students,2020-21,21911,1140,20771,94.8,128,17,13.3
7,All Students,2021-22,23525,1676,21849,92.9,136,34,25.0
7,All Students,2022-23,20769,1534,19235,92.6,121,28,23.1
8,All Students,2018-19,22323,979,21344,95.6,129,14,10.9
8,All Students,2019-20,13632,617,13015,95.5,120,14,11.7
8,All Students,2020-21,21461,1118,20343,94.8,124,18,14.5
8,All Students,2021-22,20939,1711,19228,91.8,120,31,25.8
8,All Students,2022-23,23166,2054,21112,91.1,132,40,30.3
9,All Students,2018-19,20697,1032,19665,95.0,125,17,13.6
9,All Students,2019-20,13673,780,12893,94.3,130,21,16.2
9,All Students,2020-21,20143,1757,18386,91.3,116,31,26.7
9,All Students,2021-22,20179,1915,18264,90.5,122,43,35.2
9,All Students,2022-23,21853,1799,20054,91.8,138,38,27.5
10,All Students,2018-19,19478,1212,18266,93.8,118,16,13.6
10,All Students,2019-20,12789,672,12117,94.7,117,21,17.9
10,All Students,2020-21,20169,2574,17595,87.2,117,46,39.3
10,All Students,2021-22,18831,1772,17059,90.6,112,34,30.4
10,All Students,2022-23,18320,1853,16467,89.9,112,39,34.8
11,All Students,2018-19,18070,983,17087,94.6,109,16,14.7
11,All Students,2019-20,11378,703,10675,93.8,105,17,16.2
11,All Students,2020-21,19975,2011,17964,89.9,116,38,32.8
11,All Students,2021-22,19050,2070,16980,89.1,116,49,42.2
11,All Students,2022-23,17962,1962,16000,89.1,112,47,42.0
12,All Students,2018-19,17356,1460,15896,91.6,104,33,31.7
12,All Students,2019-20,11372,724,10648,93.6,105,20,19.0
12,All Students,2020-21,18096,2242,15854,87.6,104,45,43.3
12,All Students,2021-22,18492,2354,16138,87.3,110,53,48.2
12,All Students,2022-23,17616,2579,15037,85.4,109,58,53.2
All Grades,All Students,2018-19,120599,5777,114822,95.2,702,92,13.1
All Grades,All Students,2019-20,76187,3778,72409,95.0,685,89,13.0
All Grades,All Students,2020-21,103814,2577,101237,97.5,617,36,5.8
All Grades,All Students,2021-22,97479,5831,91648,94.0,583,105,18.0
All Grades,All Students,2022-23,95404,5950,89454,93.8,578,110,19.0
PK in K-12 Schools,All Students,2018-19,5895,464,5431,92.1,36,10,27.8
PK in K-12 Schools,All Students,2019-20,3788,307,3481,91.9,37,10,27.0
0K,All Students,2018-19,20460,1135,19325,94.5,121,19,15.7
0K,All Students,2019-20,12638,798,11840,93.7,116,24,20.7
0K,All Students,2020-21,16993,436,16557,97.4,101,8,7.9
0K,All Students,2021-22,18959,1479,17480,92.2,117,27,23.1
0K,All Students,2022-23,14009,1299,12710,90.7,90,29,32.2
1,All Students,2018-19,19613,1115,18498,94.3,115,23,20.0
1,All Students,2019-20,12634,607,12027,95.2,114,13,11.4
1,All Students,2020-21,18571,512,18059,97.2,113,10,8.8
1,All Students,2021-22,15707,805,14902,94.9,93,11,11.8
1,All Students,2022-23,18679,1250,17429,93.3,113,23,20.4
2,All Students,2018-19,17503,738,16765,95.8,103,8,7.8
2,All Students,2019-20,12511,694,11817,94.5,110,18,16.4
2,All Students,2020-21,18276,311,17965,98.3,109,1,0.9
2,All Students,2021-22,17601,934,16667,94.7,104,19,18.3
2,All Students,2022-23,15416,847,14569,94.5,94,15,16.0
3,All Students,2018-19,19161,719,18442,96.2,111,8,7.2
3,All Students,2019-20,10672,432,10240,96.0,96,10,10.4
3,All Students,2020-21,17764,507,17257,97.1,103,6,5.8
3,All Students,2021-22,17443,883,16560,94.9,102,15,14.7
3,All Students,2022-23,17120,851,16269,95.0,100,12,12.0
4,All Students,2018-19,18701,743,17958,96.0,107,10,9.3
4,All Students,2019-20,12613,461,12152,96.3,112,5,4.5
4,All Students,2020-21,14590,335,14255,97.7,87,5,5.7
4,All Students,2021-22,15170,1005,14165,93.4,90,20,22.2
4,All Students,2022-23,16335,796,15539,95.1,98,13,13.3
5,All Students,2018-19,19266,863,18403,95.5,109,14,12.8
5,All Students,2019-20,11331,479,10852,95.8,100,9,9.0
5,All Students,2020-21,17620,476,17144,97.3,104,6,5.8
5,All Students,2021-22,12599,725,11874,94.2,77,13,16.9
5,All Students,2022-23,13845,907,12938,93.4,83,18,21.7
All Grades,All Students,2018-19,144481,9667,134814,93.3,843,192,22.8
All Grades,All Students,2019-20,93000,6080,86920,93.5,825,178,21.6
All Grades,All Students,2020-21,131826,7756,124070,94.1,786,136,17.3
All Grades,All Students,2021-22,118790,11213,107577,90.6,714,264,37.0
All Grades,All Students,2022-23,119211,10998,108213,90.8,709,253,35.7
PK in K-12 Schools,All Students,2018-19,8740,784,7956,91.0,55,22,40.0
PK in K-12 Schools,All Students,2019-20,7596,s,s,s,s,s,s
PK in K-12 Schools,All Students,2020-21,8242,737,7505,91.1,53,15,28.3
PK in K-12 Schools,All Students,2021-22,8409,1163,7246,86.2,53,27,50.9
PK in K-12 Schools,All Students,2022-23,8229,1177,7052,85.7,52,33,63.5
0K,All Students,2018-19,22674,1898,20776,91.6,134,42,31.3
0K,All Students,2019-20,15492,1117,14375,92.8,139,31,22.3
0K,All Students,2020-21,21880,1420,20460,93.5,136,24,17.6
0K,All Students,2021-22,18377,1754,16623,90.5,114,39,34.2
0K,All Students,2022-23,17849,1790,16059,90.0,105,41,39.0
1,All Students,2018-19,22199,1641,20558,92.6,127,36,28.3
1,All Students,2019-20,14030,1063,12967,92.4,123,37,30.1
1,All Students,2020-21,21796,1396,20400,93.6,128,21,16.4
1,All Students,2021-22,20761,1895,18866,90.9,123,48,39.0
1,All Students,2022-23,18072,1872,16200,89.6,104,45,43.3
2,All Students,2018-19,24462,1548,22914,93.7,144,24,16.7
2,All Students,2019-20,13887,937,12950,93.3,124,29,23.4
2,All Students,2020-21,18416,1036,17380,94.4,108,16,14.8
2,All Students,2021-22,18174,1846,16328,89.8,106,42,39.6
2,All Students,2022-23,21501,1869,19632,91.3,130,43,33.1
3,All Students,2018-19,22090,1322,20768,94.0,126,23,18.3
3,All Students,2019-20,14401,810,13591,94.4,128,21,16.4
3,All Students,2020-21,20526,940,19586,95.4,121,17,14.0
3,All Students,2021-22,16137,1439,14698,91.1,99,32,32.3
3,All Students,2022-23,18065,1519,16546,91.6,110,36,32.7
4,All Students,2018-19,21677,1281,20396,94.1,127,24,18.9
4,All Students,2019-20,14287,934,13353,93.5,126,25,19.8
4,All Students,2020-21,20288,1221,19067,94.0,118,22,18.6
4,All Students,2021-22,19396,1709,17687,91.2,117,48,41.0
4,All Students,2022-23,16554,1066,15488,93.6,96,17,17.7
5,All Students,2018-19,22639,1193,21446,94.7,130,21,16.2
5,All Students,2019-20,13303,561,12742,95.8,117,10,8.5
5,All Students,2020-21,20678,1006,19672,95.1,122,21,17.2
5,All Students,2021-22,17536,1407,16129,92.0,102,28,27.5
5,All Students,2022-23,18941,1705,17236,91.0,112,38,33.9
6,All Students,2019-20,4,s,s,s,s,s,s
All Grades,All Students,2018-19,127892,8947,118945,93.0,764,186,24.3
All Grades,All Students,2019-20,78106,5165,72941,93.4,716,156,21.8
All Grades,All Students,2020-21,110045,10117,99928,90.8,660,215,32.6
All Grades,All Students,2021-22,108716,11638,97078,89.3,663,284,42.8
All Grades,All Students,2022-23,114242,11051,103191,90.3,699,265,37.9
PK in K-12 Schools,All Students,2019-20,2042,189,1853,90.7,20,5,25.0
PK in K-12 Schools,All Students,2020-21,2932,448,2484,84.7,20,13,65.0
PK in K-12 Schools,All Students,2021-22,5725,934,4791,83.7,33,20,60.6
PK in K-12 Schools,All Students,2022-23,8431,1087,7344,87.1,50,32,64.0
0K,All Students,2018-19,19916,2001,17915,90.0,117,49,41.9
0K,All Students,2019-20,13284,1115,12169,91.6,123,37,30.1
0K,All Students,2020-21,18664,2187,16477,88.3,117,53,45.3
0K,All Students,2021-22,20208,2772,17436,86.3,129,75,58.1
0K,All Students,2022-23,17815,2569,15246,85.6,112,63,56.3
1,All Students,2018-19,22224,1706,20518,92.3,140,39,27.9
1,All Students,2019-20,11653,908,10745,92.2,108,32,29.6
1,All Students,2020-21,18847,1941,16906,89.7,113,39,34.5
1,All Students,2021-22,17562,2033,15529,88.4,107,53,49.5
1,All Students,2022-23,20382,2195,18187,89.2,123,59,48.0
2,All Students,2018-19,18561,1274,17287,93.1,114,26,22.8
2,All Students,2019-20,12847,747,12100,94.2,118,20,16.9
2,All Students,2020-21,16685,1391,15294,91.7,97,27,27.8
2,All Students,2021-22,16907,1850,15057,89.1,106,51,48.1
2,All Students,2022-23,18159,1728,16431,90.5,112,42,37.5
3,All Students,2018-19,21114,1327,19787,93.7,123,25,20.3
3,All Students,2019-20,11446,675,10771,94.1,105,19,18.1
3,All Students,2020-21,17590,1223,16367,93.0,104,28,26.9
3,All Students,2021-22,15926,1480,14446,90.7,93,28,30.1
3,All Students,2022-23,16348,1226,15122,92.5,99,23,23.2
4,All Students,2018-19,22971,1420,21551,93.8,137,27,19.7
4,All Students,2019-20,12950,740,12210,94.3,117,20,17.1
4,All Students,2020-21,17438,1624,15814,90.7,103,35,34.0
4,All Students,2021-22,16192,1232,14960,92.4,98,29,29.6
4,All Students,2022-23,16308,1057,15251,93.5,102,22,21.6
5,All Students,2018-19,23106,1219,21887,94.7,133,20,15.0
5,All Students,2019-20,13884,791,13093,94.3,125,23,18.4
5,All Students,2020-21,17889,1303,16586,92.7,106,20,18.9
5,All Students,2021-22,16196,1337,14859,91.7,97,28,28.9
5,All Students,2022-23,16799,1189,15610,92.9,101,24,23.8
All Grades,All Students,2018-19,191899,11043,180856,94.2,1120,201,17.9
All Grades,All Students,2019-20,128739,8186,120553,93.6,1147,201,17.5
All Grades,All Students,2020-21,197339,23764,173575,88.0,1149,390,33.9
All Grades,All Students,2021-22,185399,17903,167496,90.3,1106,355,32.1
All Grades,All Students,2022-23,179574,13572,166002,92.4,1066,254,23.8
6,All Students,2018-19,62835,3191,59644,94.9,368,52,14.1
6,All Students,2019-20,39923,2615,37308,93.4,354,50,14.1
6,All Students,2020-21,66973,8296,58677,87.6,392,139,35.5
6,All Students,2021-22,56858,s,s,s,s,s,s
6,All Students,2022-23,53850,s,s,s,s,s,s
7,All Students,2018-19,68699,3500,65199,94.9,400,66,16.5
7,All Students,2019-20,43738,2590,41148,94.1,392,72,18.4
7,All Students,2020-21,64292,s,s,s,s,s,s
7,All Students,2021-22,66800,6095,60705,90.9,403,112,27.8
7,All Students,2022-23,61344,4811,56533,92.2,364,97,26.6
8,All Students,2018-19,60365,4352,56013,92.8,352,83,23.6
8,All Students,2019-20,45078,2981,42097,93.4,401,79,19.7
8,All Students,2020-21,66069,7951,58118,88.0,384,135,35.2
8,All Students,2021-22,61732,6701,55031,89.1,360,133,36.9
8,All Students,2022-23,64375,5210,59165,91.9,380,91,23.9
9,All Students,2020-21,5,s,s,s,s,s,s
9,All Students,2021-22,9,s,s,s,s,s,s
9,All Students,2022-23,5,s,s,s,s,s,s
All Grades,All Students,2018-19,181758,7625,174133,95.8,1047,74,7.1
All Grades,All Students,2019-20,122763,5962,116801,95.1,1098,121,11.0
All Grades,All Students,2020-21,161589,3657,157932,97.7,969,45,4.6
All Grades,All Students,2021-22,145037,7446,137591,94.9,847,109,12.9
All Grades,All Students,2022-23,141195,7785,133410,94.5,822,119,14.5
PK in K-12 Schools,All Students,2018-19,3186,174,3012,94.5,18,1,5.6
PK in K-12 Schools,All Students,2019-20,2046,119,1927,94.2,19,2,10.5
PK in K-12 Schools,All Students,2020-21,3147,93,3054,97.0,18,0,0.0
PK in K-12 Schools,All Students,2021-22,3173,322,2851,89.9,18,7,38.9
PK in K-12 Schools,All Students,2022-23,3178,201,2977,93.7,18,4,22.2
0K,All Students,2018-19,35989,2032,33957,94.4,207,26,12.6
0K,All Students,2019-20,20231,1337,18894,93.4,187,37,19.8
0K,All Students,2020-21,22421,607,21814,97.3,138,7,5.1
0K,All Students,2021-22,22260,1352,20908,93.9,130,20,15.4
0K,All Students,2022-23,21104,1618,19486,92.3,124,32,25.8
1,All Students,2018-19,33777,1699,32078,95.0,195,15,7.7
1,All Students,2019-20,23701,1310,22391,94.5,212,30,14.2
1,All Students,2020-21,27825,633,27192,97.7,166,5,3.0
1,All Students,2021-22,20701,1075,19626,94.8,123,17,13.8
1,All Students,2022-23,21259,1245,20014,94.1,125,19,15.2
2,All Students,2018-19,28886,1172,27714,95.9,170,17,10.0
2,All Students,2019-20,20885,946,19939,95.5,186,16,8.6
2,All Students,2020-21,32704,702,32002,97.9,195,12,6.2
2,All Students,2021-22,24271,1136,23135,95.3,142,14,9.9
2,All Students,2022-23,21082,1122,19960,94.7,123,13,10.6
3,All Students,2018-19,28080,1005,27075,96.4,160,4,2.5
3,All Students,2019-20,18394,789,17605,95.7,163,15,9.2
3,All Students,2020-21,26823,513,26310,98.1,161,6,3.7
3,All Students,2021-22,29583,1700,27883,94.3,172,24,14.0
3,All Students,2022-23,23859,1170,22689,95.1,139,15,10.8
4,All Students,2018-19,28557,892,27665,96.9,163,6,3.7
4,All Students,2019-20,19456,704,18752,96.4,170,8,4.7
4,All Students,2020-21,23185,582,22603,97.5,140,8,5.7
4,All Students,2021-22,24865,952,23913,96.2,145,11,7.6
4,All Students,2022-23,28181,1501,26680,94.7,164,24,14.6
5,All Students,2018-19,23283,651,22632,97.2,134,5,3.7
5,All Students,2019-20,18050,757,17293,95.8,161,13,8.1
5,All Students,2020-21,25484,527,24957,97.9,151,7,4.6
5,All Students,2021-22,20184,909,19275,95.5,117,16,13.7
5,All Students,2022-23,22532,928,21604,95.9,129,12,9.3
All Grades,All Students,2018-19,107915,6812,101103,93.7,650,142,21.8
All Grades,All Students,2019-20,64942,4093,60849,93.7,611,127,20.8
All Grades,All Students,2020-21,95274,10188,85086,89.3,595,222,37.3
All Grades,All Students,2021-22,88431,8643,79788,90.2,552,205,37.1
All Grades,All Students,2022-23,90279,8341,81938,90.8,556,193,34.7
PK in K-12 Schools,All Students,2018-19,6081,548,5533,91.0,40,13,32.5
PK in K-12 Schools,All Students,2019-20,3930,457,3473,88.4,39,16,41.0
PK in K-12 Schools,All Students,2020-21,5562,698,4864,87.5,37,18,48.6
PK in K-12 Schools,All Students,2021-22,6270,1031,5239,83.6,41,25,61.0
PK in K-12 Schools,All Students,2022-23,5637,908,4729,83.9,40,26,65.0
0K,All Students,2018-19,17032,1271,15761,92.5,100,29,29.0
0K,All Students,2019-20,11773,752,11021,93.6,115,23,20.0
0K,All Students,2020-21,14637,2318,12319,84.2,97,57,58.8
0K,All Students,2021-22,13753,1473,12280,89.3,89,40,44.9
0K,All Students,2022-23,16436,1844,14592,88.8,100,42,42.0
1,All Students,2018-19,17602,1297,16305,92.6,107,28,26.2
1,All Students,2019-20,9761,562,9199,94.2,91,14,15.4
1,All Students,2020-21,16417,1948,14469,88.1,106,40,37.7
1,All Students,2021-22,12698,1527,11171,88.0,83,41,49.4
1,All Students,2022-23,13727,1284,12443,90.6,87,30,34.5
2,All Students,2018-19,17507,1043,16464,94.0,104,18,17.3
2,All Students,2019-20,10881,716,10165,93.4,99,28,28.3
2,All Students,2020-21,14585,784,13801,94.6,86,15,17.4
2,All Students,2021-22,15019,1446,13573,90.4,92,31,33.7
2,All Students,2022-23,12709,1149,11560,91.0,78,28,35.9
3,All Students,2018-19,16949,866,16083,94.9,104,17,16.3
3,All Students,2019-20,10636,589,10047,94.5,101,16,15.8
3,All Students,2020-21,15021,1901,13120,87.3,93,39,41.9
3,All Students,2021-22,13603,994,12609,92.7,83,21,25.3
3,All Students,2022-23,14049,1064,12985,92.4,87,23,26.4
4,All Students,2018-19,16222,927,15295,94.3,97,20,20.6
4,All Students,2019-20,9871,548,9323,94.4,89,15,16.9
4,All Students,2020-21,15705,1307,14398,91.7,95,27,28.4
4,All Students,2021-22,13392,1213,12179,90.9,81,25,30.9
4,All Students,2022-23,14709,1078,13631,92.7,88,20,22.7
5,All Students,2018-19,16522,860,15662,94.8,98,17,17.3
5,All Students,2019-20,8090,469,7621,94.2,77,15,19.5
5,All Students,2020-21,13347,1232,12115,90.8,81,26,32.1
5,All Students,2021-22,13696,959,12737,93.0,83,22,26.5
5,All Students,2022-23,13012,1014,11998,92.2,76,24,31.6
All Grades,All Students,2018-19,297482,23282,274200,92.2,1757,477,27.1
All Grades,All Students,2019-20,196621,14875,181746,92.4,1765,426,24.1
All Grades,All Students,2020-21,278886,53178,225708,80.9,1635,1004,61.4
All Grades,All Students,2021-22,255993,29293,226700,88.6,1538,655,42.6
All Grades,All Students,2022-23,238211,25628,212583,89.2,1417,571,40.3
5,All Students,2020-21,2,s,s,s,s,s,s
6,All Students,2018-19,98676,7224,91452,92.7,586,144,24.6
6,All Students,2019-20,64451,4598,59853,92.9,579,126,21.8
6,All Students,2020-21,83832,s,s,s,s,s,s
6,All Students,2021-22,76290,s,s,s,s,s,s
6,All Students,2022-23,74149,6795,67354,90.8,447,155,34.7
7,All Students,2018-19,100582,7313,93269,92.7,591,143,24.2
7,All Students,2019-20,65516,4623,60893,92.9,586,145,24.7
7,All Students,2020-21,96677,18328,78349,81.0,568,356,62.7
7,All Students,2021-22,83251,10013,73238,88.0,499,229,45.9
7,All Students,2022-23,77865,8605,69260,88.9,463,191,41.3
8,All Students,2018-19,98224,8745,89479,91.1,580,190,32.8
8,All Students,2019-20,66654,5654,61000,91.5,600,155,25.8
8,All Students,2020-21,98375,17226,81149,82.5,571,309,54.1
8,All Students,2021-22,96438,11055,85383,88.5,577,238,41.2
8,All Students,2022-23,86197,10228,75969,88.1,507,225,44.4
9,All Students,2021-22,14,s,s,s,s,s,s
All Grades,All Students,2018-19,124398,7091,117307,94.3,745,136,18.3
All Grades,All Students,2019-20,77181,5154,72027,93.3,708,152,21.5
All Grades,All Students,2020-21,109801,9118,100683,91.7,660,196,29.7
All Grades,All Students,2021-22,103549,9431,94118,90.9,626,213,34.0
All Grades,All Students,2022-23,104526,9258,95268,91.1,630,230,36.5
PK in K-12 Schools,All Students,2018-19,6282,519,5763,91.7,38,14,36.8
PK in K-12 Schools,All Students,2019-20,4068,422,3646,89.6,40,17,42.5
PK in K-12 Schools,All Students,2020-21,5780,788,4992,86.4,35,19,54.3
PK in K-12 Schools,All Students,2021-22,6298,899,5399,85.7,38,22,57.9
PK in K-12 Schools,All Students,2022-23,6032,733,5299,87.8,39,17,43.6
0K,All Students,2018-19,16906,1081,15825,93.6,101,18,17.8
0K,All Students,2019-20,11731,960,10771,91.8,113,36,31.9
0K,All Students,2020-21,15963,1687,14276,89.4,100,33,33.0
0K,All Students,2021-22,15800,1513,14287,90.4,96,34,35.4
0K,All Students,2022-23,16300,1781,14519,89.1,99,49,49.5
1,All Students,2018-19,18518,1107,17411,94.0,115,20,17.4
1,All Students,2019-20,11194,742,10452,93.4,101,21,20.8
1,All Students,2020-21,16291,1548,14743,90.5,99,33,33.3
1,All Students,2021-22,14989,1615,13374,89.2,89,39,43.8
1,All Students,2022-23,17051,1827,15224,89.3,101,47,46.5
2,All Students,2018-19,19726,1010,18716,94.9,116,17,14.7
2,All Students,2019-20,12608,804,11804,93.6,116,20,17.2
2,All Students,2020-21,16976,1089,15887,93.6,101,26,25.7
2,All Students,2021-22,16988,1579,15409,90.7,105,41,39.0
2,All Students,2022-23,16280,1520,14760,90.7,99,36,36.4
3,All Students,2018-19,22208,1484,20724,93.3,133,28,21.1
3,All Students,2019-20,12730,599,12131,95.3,112,9,8.0
3,All Students,2020-21,18437,1397,17040,92.4,110,27,24.5
3,All Students,2021-22,15851,1261,14590,92.0,94,25,26.6
3,All Students,2022-23,17422,1371,16051,92.1,106,39,36.8
4,All Students,2018-19,18367,695,17672,96.2,111,12,10.8
4,All Students,2019-20,12618,1016,11602,91.9,118,32,27.1
4,All Students,2020-21,18979,1210,17769,93.6,114,29,25.4
4,All Students,2021-22,17192,1239,15953,92.8,101,23,22.8
4,All Students,2022-23,15088,867,14221,94.3,91,18,19.8
5,All Students,2018-19,22391,1195,21196,94.7,131,27,20.6
5,All Students,2019-20,12232,611,11621,95.0,108,17,15.7
5,All Students,2020-21,17375,1399,15976,91.9,101,29,28.7
5,All Students,2021-22,16431,1325,15106,91.9,103,29,28.2
5,All Students,2022-23,16353,1159,15194,92.9,95,24,25.3
All Grades,All Students,2018-19,111071,6130,104941,94.5,661,94,14.2
All Grades,All Students,2019-20,70992,3482,67510,95.1,647,95,14.7
All Grades,All Students,2020-21,109601,4611,104990,95.8,630,65,10.3
All Grades,All Students,2021-22,102355,8196,94159,92.0,613,176,28.7
All Grades,All Students,2022-23,100633,9651,90982,90.4,615,198,32.2
6,All Students,2018-19,15907,595,15312,96.3,90,6,6.7
6,All Students,2019-20,10255,517,9738,95.0,92,10,10.9
6,All Students,2020-21,15266,339,14927,97.8,89,5,5.6
6,All Students,2021-22,13927,1158,12769,91.7,87,28,32.2
6,All Students,2022-23,15793,1311,14482,91.7,92,25,27.2
7,All Students,2018-19,17195,740,16455,95.7,98,12,12.2
7,All Students,2019-20,10215,372,9843,96.4,91,10,11.0
7,All Students,2020-21,15311,623,14688,95.9,88,9,10.2
7,All Students,2021-22,14396,1129,13267,92.2,83,25,30.1
7,All Students,2022-23,14916,1460,13456,90.2,92,35,38.0
8,All Students,2018-19,17502,803,16699,95.4,101,12,11.9
8,All Students,2019-20,10921,320,10601,97.1,96,6,6.3
8,All Students,2020-21,15400,468,14932,97.0,88,5,5.7
8,All Students,2021-22,15273,1387,13886,90.9,88,28,31.8
8,All Students,2022-23,14585,1109,13476,92.4,89,24,27.0
9,All Students,2018-19,16751,970,15781,94.2,102,15,14.7
9,All Students,2019-20,10223,572,9651,94.4,96,18,18.8
9,All Students,2020-21,15424,715,14709,95.4,89,10,11.2
9,All Students,2021-22,14132,1244,12888,91.2,85,30,35.3
9,All Students,2022-23,14850,1588,13262,89.3,94,27,28.7
10,All Students,2018-19,15772,907,14865,94.2,95,18,18.9
10,All Students,2019-20,10575,691,9884,93.5,98,22,22.4
10,All Students,2020-21,15889,408,15481,97.4,91,4,4.4
10,All Students,2021-22,14534,1091,13443,92.5,87,22,25.3
10,All Students,2022-23,13163,1237,11926,90.6,80,25,31.3
11,All Students,2018-19,14608,698,13910,95.2,87,10,11.5
11,All Students,2019-20,10116,540,9576,94.7,92,16,17.4
11,All Students,2020-21,16625,1237,15388,92.6,95,19,20.0
11,All Students,2021-22,15067,1018,14049,93.2,91,24,26.4
11,All Students,2022-23,13776,1218,12558,91.2,84,22,26.2
12,All Students,2018-19,13336,1417,11919,89.4,88,21,23.9
12,All Students,2019-20,8687,470,8217,94.6,82,13,15.9
12,All Students,2020-21,15686,821,14865,94.8,90,13,14.4
12,All Students,2021-22,15026,1169,13857,92.2,92,19,20.7
12,All Students,2022-23,13550,1728,11822,87.2,84,40,47.6
All Grades,All Students,2018-19,63211,5807,57404,90.8,370,111,30.0
All Grades,All Students,2019-20,41550,3413,38137,91.8,382,114,29.8
All Grades,All Students,2020-21,67882,13146,54736,80.6,399,202,50.6
All Grades,All Students,2021-22,62162,8850,53312,85.8,385,216,56.1
All Grades,All Students,2022-23,53913,8218,45695,84.8,364,225,61.8
5,All Students,2021-22,27,s,s,s,s,s,s
6,All Students,2018-19,22113,1672,20441,92.4,130,38,29.2
6,All Students,2019-20,15546,1244,14302,92.0,144,45,31.3
6,All Students,2020-21,22508,4603,17905,79.5,133,76,57.1
6,All Students,2021-22,18146,s,s,s,s,s,s
6,All Students,2022-23,13581,s,s,s,s,s,s
7,All Students,2018-19,17687,1763,15924,90.0,104,29,27.9
7,All Students,2019-20,14043,1092,12951,92.2,127,33,26.0
7,All Students,2020-21,23743,4616,19127,80.6,140,69,49.3
7,All Students,2021-22,20208,2879,17329,85.8,128,75,58.6
7,All Students,2022-23,19785,2889,16896,85.4,130,68,52.3
8,All Students,2018-19,23411,2372,21039,89.9,136,44,32.4
8,All Students,2019-20,11961,1077,10884,91.0,111,36,32.4
8,All Students,2020-21,21631,3927,17704,81.8,126,57,45.2
8,All Students,2021-22,23781,3621,20160,84.8,144,86,59.7
8,All Students,2022-23,20444,3149,17295,84.6,136,88,64.7
9,All Students,2022-23,103,s,s,s,s,s,s
All Grades,All Students,2018-19,36934,1289,35645,96.5,213,9,4.2
All Grades,All Students,2019-20,32208,1336,30872,95.9,286,25,8.7
All Grades,All Students,2020-21,64315,1327,62988,97.9,383,10,2.6
All Grades,All Students,2021-22,74564,4552,70012,93.9,426,62,14.6
All Grades,All Students,2022-23,83709,5720,77989,93.2,480,102,21.3
PK in K-12 Schools,All Students,2018-19,6290,231,6059,96.3,37,4,10.8
PK in K-12 Schools,All Students,2019-20,4021,224,3797,94.4,36,6,16.7
PK in K-12 Schools,All Students,2020-21,9727,208,9519,97.9,60,1,1.7
PK in K-12 Schools,All Students,2021-22,12209,1383,10826,88.7,71,32,45.1
PK in K-12 Schools,All Students,2022-23,12362,1211,11151,90.2,72,31,43.1
0K,All Students,2018-19,8667,366,8301,95.8,51,2,3.9
0K,All Students,2019-20,11204,519,10685,95.4,101,11,10.9
0K,All Students,2020-21,16181,556,15625,96.6,98,7,7.1
0K,All Students,2021-22,17276,976,16300,94.4,100,15,15.0
0K,All Students,2022-23,16915,1548,15367,90.8,99,39,39.4
1,All Students,2018-19,8053,236,7817,97.1,46,2,4.3
1,All Students,2019-20,5092,225,4867,95.6,45,4,8.9
1,All Students,2020-21,15417,188,15229,98.8,91,0,0.0
1,All Students,2021-22,12930,673,12257,94.8,73,4,5.5
1,All Students,2022-23,15507,933,14574,94.0,88,13,14.8
2,All Students,2018-19,7832,271,7561,96.5,44,1,2.3
2,All Students,2019-20,4646,144,4502,96.9,41,0,0.0
2,All Students,2020-21,7328,120,7208,98.4,42,0,0.0
2,All Students,2021-22,13806,642,13164,95.3,78,3,3.8
2,All Students,2022-23,13245,793,12452,94.0,75,10,13.3
3,All Students,2018-19,6092,185,5907,97.0,35,0,0.0
3,All Students,2019-20,4945,148,4797,97.0,43,3,7.0
3,All Students,2020-21,6059,65,5994,98.9,37,1,2.7
3,All Students,2021-22,6372,359,6013,94.4,36,3,8.3
3,All Students,2022-23,13806,643,13163,95.3,78,3,3.8
4,All Students,2019-20,2300,76,2224,96.7,20,1,5.0
4,All Students,2020-21,6825,96,6729,98.6,39,0,0.0
4,All Students,2021-22,5776,252,5524,95.6,33,4,12.1
4,All Students,2022-23,6389,350,6039,94.5,37,4,10.8
5,All Students,2020-21,2778,94,2684,96.6,16,1,6.3
5,All Students,2021-22,6195,267,5928,95.7,35,1,2.9
5,All Students,2022-23,5485,242,5243,95.6,31,2,6.5
All Grades,All Students,2018-19,114359,12529,101830,89.0,695,236,34.0
All Grades,All Students,2019-20,74598,8413,66185,88.7,702,241,34.3
All Grades,All Students,2020-21,111758,17347,94411,84.5,652,261,40.0
All Grades,All Students,2021-22,108312,14916,93396,86.2,674,330,49.0
All Grades,All Students,2022-23,111611,8644,102967,92.3,717,188,26.2
6,All Students,2018-19,16156,853,15303,94.7,92,13,14.1
6,All Students,2019-20,10165,609,9556,94.0,94,18,19.1
6,All Students,2020-21,17332,1496,15836,91.4,99,27,27.3
6,All Students,2021-22,16528,1422,15106,91.4,97,33,34.0
6,All Students,2022-23,16609,942,15667,94.3,99,23,23.2
7,All Students,2018-19,15541,1138,14403,92.7,90,25,27.8
7,All Students,2019-20,10380,668,9712,93.6,96,20,20.8
7,All Students,2020-21,14927,2639,12288,82.3,88,41,46.6
7,All Students,2021-22,14825,1490,13335,89.9,90,38,42.2
7,All Students,2022-23,16165,1017,15148,93.7,98,21,21.4
8,All Students,2018-19,13428,1216,12212,90.9,77,23,29.9
8,All Students,2019-20,10166,666,9500,93.4,90,23,25.6
8,All Students,2020-21,15757,2842,12915,82.0,91,42,46.2
8,All Students,2021-22,13893,1619,12274,88.3,86,37,43.0
8,All Students,2022-23,13564,657,12907,95.2,89,19,21.3
9,All Students,2018-19,15775,1735,14040,89.0,103,35,34.0
9,All Students,2019-20,10932,1444,9488,86.8,106,37,34.9
9,All Students,2020-21,15432,2358,13074,84.7,91,35,38.5
9,All Students,2021-22,19812,2567,17245,87.0,132,59,44.7
9,All Students,2022-23,18228,1368,16860,92.5,124,28,22.6
10,All Students,2018-19,18219,2127,16092,88.3,115,41,35.7
10,All Students,2019-20,11007,1497,9510,86.4,111,51,45.9
10,All Students,2020-21,16268,3194,13074,80.4,95,41,43.2
10,All Students,2021-22,16250,2945,13305,81.9,104,59,56.7
10,All Students,2022-23,18524,1860,16664,90.0,126,45,35.7
11,All Students,2018-19,18079,3122,14957,82.7,114,50,43.9
11,All Students,2019-20,11471,1800,9671,84.3,108,48,44.4
11,All Students,2020-21,13816,2462,11354,82.2,83,38,45.8
11,All Students,2021-22,14139,2510,11629,82.2,88,47,53.4
11,All Students,2022-23,15117,1805,13312,88.1,99,32,32.3
12,All Students,2018-19,17161,2338,14823,86.4,104,49,47.1
12,All Students,2019-20,10477,1729,8748,83.5,97,44,45.4
12,All Students,2020-21,18226,2356,15870,87.1,105,37,35.2
12,All Students,2021-22,12865,2363,10502,81.6,77,57,74.0
12,All Students,2022-23,13404,995,12409,92.6,82,20,24.4
All Grades,All Students,2018-19,35209,2277,32932,93.5,213,52,24.4
All Grades,All Students,2019-20,26692,1772,24920,93.4,244,54,22.1
All Grades,All Students,2020-21,41804,4903,36901,88.3,247,88,35.6
All Grades,All Students,2021-22,39536,4807,34729,87.8,242,118,48.8
All Grades,All Students,2022-23,40372,4404,35968,89.1,250,111,44.4
PK in K-12 Schools,All Students,2022-23,156,s,s,s,s,s,s
0K,All Students,2018-19,8736,759,7977,91.3,55,24,43.6
0K,All Students,2019-20,4759,474,4285,90.0,46,18,39.1
0K,All Students,2020-21,8041,786,7255,90.2,47,13,27.7
0K,All Students,2021-22,7829,1237,6592,84.2,50,31,62.0
0K,All Students,2022-23,6119,711,5408,88.4,39,23,59.0
1,All Students,2018-19,6411,377,6034,94.1,37,7,18.9
1,All Students,2019-20,4936,346,4590,93.0,44,10,22.7
1,All Students,2020-21,6925,940,5985,86.4,42,20,47.6
1,All Students,2021-22,6969,688,6281,90.1,42,16,38.1
1,All Students,2022-23,8659,1243,7416,85.6,55,30,54.5
2,All Students,2018-19,7180,376,6804,94.8,44,4,9.1
2,All Students,2019-20,3834,277,3557,92.8,35,8,22.9
2,All Students,2020-21,7770,1018,6752,86.9,45,15,33.3
2,All Students,2021-22,6745,843,5902,87.5,41,24,58.5
2,All Students,2022-23,7501,724,6777,90.3,44,19,43.2
3,All Students,2018-19,7421,479,6942,93.5,45,13,28.9
3,All Students,2019-20,4500,225,4275,95.0,41,5,12.2
3,All Students,2020-21,5107,918,4189,82.0,31,16,51.6
3,All Students,2021-22,7901,918,6983,88.4,46,22,47.8
3,All Students,2022-23,5802,468,5334,91.9,35,8,22.9
4,All Students,2018-19,5461,286,5175,94.8,32,4,12.5
4,All Students,2019-20,5106,296,4810,94.2,47,10,21.3
4,All Students,2020-21,6338,609,5729,90.4,37,12,32.4
4,All Students,2021-22,4236,423,3813,90.0,28,11,39.3
4,All Students,2022-23,7797,796,7001,89.8,48,19,39.6
5,All Students,2019-20,3557,154,3403,95.7,31,3,9.7
5,All Students,2020-21,7623,632,6991,91.7,45,12,26.7
5,All Students,2021-22,5856,698,5158,88.1,35,14,40.0
5,All Students,2022-23,4338,s,s,s,s,s,s
All Grades,All Students,2018-19,73020,9381,63639,87.2,469,187,39.9
All Grades,All Students,2019-20,49522,6197,43325,87.5,469,176,37.5
All Grades,All Students,2020-21,77507,3809,73698,95.1,463,49,10.6
All Grades,All Students,2021-22,69924,10981,58943,84.3,428,205,47.9
All Grades,All Students,2022-23,66283,8717,57566,86.8,431,164,38.1
9,All Students,2018-19,19119,1663,17456,91.3,126,45,35.7
9,All Students,2019-20,12623,1246,11377,90.1,124,37,29.8
9,All Students,2020-21,18638,1074,17564,94.2,112,12,10.7
9,All Students,2021-22,15457,1569,13888,89.8,97,30,30.9
9,All Students,2022-23,16187,1778,14409,89.0,112,39,34.8
10,All Students,2018-19,16944,1766,15178,89.6,111,33,29.7
10,All Students,2019-20,12917,1251,11666,90.3,125,42,33.6
10,All Students,2020-21,19943,1126,18817,94.4,120,19,15.8
10,All Students,2021-22,16608,1870,14738,88.7,105,47,44.8
10,All Students,2022-23,16267,2322,13945,85.7,108,45,41.7
11,All Students,2018-19,19048,2574,16474,86.5,119,41,34.5
11,All Students,2019-20,11615,1199,10416,89.7,108,33,30.6
11,All Students,2020-21,20321,919,19402,95.5,122,13,10.7
11,All Students,2021-22,18397,3295,15102,82.1,111,52,46.8
11,All Students,2022-23,16181,1233,14948,92.4,103,26,25.2
12,All Students,2018-19,17909,3378,14531,81.1,113,68,60.2
12,All Students,2019-20,12367,2501,9866,79.8,113,65,57.5
12,All Students,2020-21,18605,690,17915,96.3,109,5,4.6
12,All Students,2021-22,19462,4247,15215,78.2,115,76,66.1
12,All Students,2022-23,17648,3384,14264,80.8,108,54,50.0
All Grades,All Students,2018-19,78221,12043,66178,84.6,490,252,51.4
All Grades,All Students,2019-20,49776,7376,42400,85.2,475,206,43.4
All Grades,All Students,2020-21,81117,5634,75483,93.1,477,84,17.6
All Grades,All Students,2021-22,78215,14931,63284,80.9,475,292,61.5
All Grades,All Students,2022-23,78296,12138,66158,84.5,509,282,55.4
9,All Students,2018-19,20852,2635,18217,87.4,137,58,42.3
9,All Students,2019-20,12755,1694,11061,86.7,127,46,36.2
9,All Students,2020-21,22615,2128,20487,90.6,133,32,24.1
9,All Students,2021-22,21847,2549,19298,88.3,133,58,43.6
9,All Students,2022-23,23344,3169,20175,86.4,158,76,48.1
10,All Students,2018-19,19741,3015,16726,84.7,123,63,51.2
10,All Students,2019-20,12254,1357,10897,88.9,117,36,30.8
10,All Students,2020-21,17927,1252,16675,93.0,106,14,13.2
10,All Students,2021-22,20261,3770,16491,81.4,126,77,61.1
10,All Students,2022-23,19346,2397,16949,87.6,127,62,48.8
11,All Students,2018-19,19106,2848,16258,85.1,118,61,51.7
11,All Students,2019-20,12854,1885,10969,85.3,119,52,43.7
11,All Students,2020-21,20346,1065,19281,94.8,122,19,15.6
11,All Students,2021-22,17080,3414,13666,80.0,103,62,60.2
11,All Students,2022-23,18781,2641,16140,85.9,121,59,48.8
12,All Students,2018-19,18522,3545,14977,80.9,112,70,62.5
12,All Students,2019-20,11913,2440,9473,79.5,112,72,64.3
12,All Students,2020-21,20229,1189,19040,94.1,116,19,16.4
12,All Students,2021-22,19027,5198,13829,72.7,113,95,84.1
12,All Students,2022-23,16825,3931,12894,76.6,103,85,82.5
All Grades,All Students,2018-19,57653,5310,52343,90.8,339,101,29.8
All Grades,All Students,2019-20,31425,2569,28856,91.8,283,80,28.3
All Grades,All Students,2020-21,48467,8910,39557,81.6,284,165,58.1
All Grades,All Students,2021-22,38477,4741,33736,87.7,239,107,44.8
All Grades,All Students,2022-23,44523,5253,39270,88.2,276,130,47.1
5,All Students,2022-23,17,s,s,s,s,s,s
6,All Students,2018-19,21547,1762,19785,91.8,123,28,22.8
6,All Students,2019-20,11128,762,10366,93.2,99,22,22.2
6,All Students,2020-21,14712,2454,12258,83.3,88,46,52.3
6,All Students,2021-22,10994,s,s,s,s,s,s
6,All Students,2022-23,16539,1798,14741,89.1,102,46,45.1
7,All Students,2018-19,15399,s,s,s,s,s,s
7,All Students,2019-20,11761,875,10886,92.6,108,25,23.1
7,All Students,2020-21,16331,3656,12675,77.6,96,64,66.7
7,All Students,2021-22,12786,1462,11324,88.6,78,32,41.0
7,All Students,2022-23,13444,1630,11814,87.9,86,42,48.8
8,All Students,2018-19,20704,2224,18480,89.3,123,45,36.6
8,All Students,2019-20,8536,932,7604,89.1,76,33,43.4
8,All Students,2020-21,17424,2800,14624,83.9,100,55,55.0
8,All Students,2021-22,14681,1819,12862,87.6,89,41,46.1
8,All Students,2022-23,14504,1798,12706,87.6,87,41,47.1
9,All Students,2018-19,3,s,s,s,s,s,s
9,All Students,2021-22,16,s,s,s,s,s,s
9,All Students,2022-23,19,s,s,s,s,s,s
All Grades,All Students,2022-23,37398,7823,29575,79.1,241,178,73.9
PK in K-12 Schools,All Students,2022-23,37308,s,s,s,s,s,s
0K,All Students,2022-23,90,s,s,s,s,s,s
All Grades,All Students,2018-19,75016,5981,69035,92.0,463,140,30.2
All Grades,All Students,2019-20,59305,3573,55732,94.0,540,105,19.4
All Grades,All Students,2020-21,106041,7830,98211,92.6,626,148,23.6
All Grades,All Students,2021-22,101157,11644,89513,88.5,598,278,46.5
All Grades,All Students,2022-23,105571,10168,95403,90.4,643,253,39.3
PK in K-12 Schools,All Students,2018-19,6259,469,5790,92.5,36,11,30.6
PK in K-12 Schools,All Students,2019-20,4053,264,3789,93.5,37,8,21.6
PK in K-12 Schools,All Students,2020-21,5966,663,5303,88.9,37,14,37.8
PK in K-12 Schools,All Students,2021-22,6284,1069,5215,83.0,37,23,62.2
PK in K-12 Schools,All Students,2022-23,6360,861,5499,86.5,36,24,66.7
0K,All Students,2018-19,17223,1561,15662,90.9,106,37,34.9
0K,All Students,2019-20,8948,687,8261,92.3,81,24,29.6
0K,All Students,2020-21,15946,1381,14565,91.3,96,29,30.2
0K,All Students,2021-22,13262,1602,11660,87.9,81,42,51.9
0K,All Students,2022-23,13683,1653,12030,87.9,85,46,54.1
1,All Students,2018-19,18125,1592,16533,91.2,114,39,34.2
1,All Students,2019-20,11664,799,10865,93.1,105,22,21.0
1,All Students,2020-21,14486,1200,13286,91.7,85,25,29.4
1,All Students,2021-22,17289,2389,14900,86.2,100,60,60.0
1,All Students,2022-23,16932,1846,15086,89.1,105,48,45.7
2,All Students,2018-19,16795,1446,15349,91.4,105,36,34.3
2,All Students,2019-20,11792,756,11036,93.6,109,21,19.3
2,All Students,2020-21,17392,1273,16119,92.7,103,20,19.4
2,All Students,2021-22,15615,1667,13948,89.3,94,40,42.6
2,All Students,2022-23,17311,1600,15711,90.8,106,38,35.8
3,All Students,2018-19,16614,913,15701,94.5,102,17,16.7
3,All Students,2019-20,11119,591,10528,94.7,102,17,16.7
3,All Students,2020-21,17659,877,16782,95.0,104,15,14.4
3,All Students,2021-22,16121,1546,14575,90.4,96,34,35.4
3,All Students,2022-23,17232,1569,15663,90.9,108,38,35.2
4,All Students,2019-20,11729,476,11253,95.9,106,13,12.3
4,All Students,2020-21,16856,1296,15560,92.3,98,26,26.5
4,All Students,2021-22,17511,1799,15712,89.7,100,44,44.0
4,All Students,2022-23,15836,1230,14606,92.2,97,24,24.7
5,All Students,2020-21,17736,1140,16596,93.6,103,19,18.4
5,All Students,2021-22,15075,1572,13503,89.6,90,35,38.9
5,All Students,2022-23,18217,1409,16808,92.3,106,35,33.0
All Grades,All Students,2018-19,83166,8353,74813,90.0,519,172,33.1
All Grades,All Students,2019-20,53586,4677,48909,91.3,506,150,29.6
All Grades,All Students,2020-21,85511,6599,78912,92.3,508,118,23.2
All Grades,All Students,2021-22,86076,11463,74613,86.7,529,249,47.1
All Grades,All Students,2022-23,82708,8740,73968,89.4,544,190,34.9
9,All Students,2018-19,22183,2323,19860,89.5,141,42,29.8
9,All Students,2019-20,15127,1374,13753,90.9,143,40,28.0
9,All Students,2020-21,22363,1910,20453,91.5,137,33,24.1
9,All Students,2021-22,22572,2709,19863,88.0,142,56,39.4
9,All Students,2022-23,21855,2150,19705,90.2,146,43,29.5
10,All Students,2018-19,21444,2064,19380,90.4,134,37,27.6
10,All Students,2019-20,13652,952,12700,93.0,131,30,22.9
10,All Students,2020-21,22409,1976,20433,91.2,132,35,26.5
10,All Students,2021-22,21384,2903,18481,86.4,132,59,44.7
10,All Students,2022-23,21145,2202,18943,89.6,145,48,33.1
11,All Students,2018-19,19784,1663,18121,91.6,125,42,33.6
11,All Students,2019-20,12613,960,11653,92.4,119,31,26.1
11,All Students,2020-21,20582,1167,19415,94.3,123,25,20.3
11,All Students,2021-22,21597,2872,18725,86.7,132,66,50.0
11,All Students,2022-23,20735,1903,18832,90.8,133,41,30.8
12,All Students,2018-19,19755,2303,17452,88.3,119,51,42.9
12,All Students,2019-20,12194,1391,10803,88.6,113,49,43.4
12,All Students,2020-21,20157,1546,18611,92.3,116,25,21.6
12,All Students,2021-22,20523,2979,17544,85.5,123,68,55.3
12,All Students,2022-23,18973,2485,16488,86.9,120,58,48.3
All Grades,All Students,2018-19,103630,7523,96107,92.7,618,160,25.9
All Grades,All Students,2019-20,61320,3910,57410,93.6,562,120,21.4
All Grades,All Students,2020-21,84194,12166,72028,85.6,500,224,44.8
All Grades,All Students,2021-22,89563,11358,78205,87.3,535,278,52.0
All Grades,All Students,2022-23,89372,10025,79347,88.8,548,249,45.4
PK in K-12 Schools,All Students,2018-19,6222,647,5575,89.6,36,15,41.7
PK in K-12 Schools,All Students,2019-20,2633,282,2351,89.3,27,13,48.1
PK in K-12 Schools,All Students,2020-21,3992,881,3111,77.9,24,12,50.0
PK in K-12 Schools,All Students,2021-22,11249,2006,9243,82.2,67,51,76.1
PK in K-12 Schools,All Students,2022-23,10895,1847,9048,83.0,66,42,63.6
0K,All Students,2018-19,13756,1211,12545,91.2,85,27,31.8
0K,All Students,2019-20,8961,576,8385,93.6,81,15,18.5
0K,All Students,2020-21,11304,1653,9651,85.4,69,26,37.7
0K,All Students,2021-22,11381,1578,9803,86.1,69,39,56.5
0K,All Students,2022-23,14684,1749,12935,88.1,95,54,56.8
1,All Students,2018-19,16592,1283,15309,92.3,99,27,27.3
1,All Students,2019-20,9307,694,8613,92.5,86,24,27.9
1,All Students,2020-21,13149,1616,11533,87.7,77,33,42.9
1,All Students,2021-22,10748,1395,9353,87.0,64,35,54.7
1,All Students,2022-23,10790,1370,9420,87.3,67,29,43.3
2,All Students,2018-19,14149,835,13314,94.1,86,17,19.8
2,All Students,2019-20,10066,656,9410,93.5,92,19,20.7
2,All Students,2020-21,13250,1772,11478,86.6,80,31,38.8
2,All Students,2021-22,12904,1263,11641,90.2,79,32,40.5
2,All Students,2022-23,11093,1091,10002,90.2,67,28,41.8
3,All Students,2018-19,15932,1024,14908,93.6,97,24,24.7
3,All Students,2019-20,9691,597,9094,93.8,89,20,22.5
3,All Students,2020-21,13307,2132,11175,84.0,79,40,50.6
3,All Students,2021-22,13323,1457,11866,89.1,80,36,45.0
3,All Students,2022-23,12757,1166,11591,90.9,78,31,39.7
4,All Students,2018-19,17968,1110,16858,93.8,104,20,19.2
4,All Students,2019-20,10067,558,9509,94.5,90,15,16.7
4,All Students,2020-21,14504,2692,11812,81.4,86,55,64.0
4,All Students,2021-22,14673,1825,12848,87.6,85,43,50.6
4,All Students,2022-23,12637,1183,11454,90.6,77,28,36.4
5,All Students,2018-19,19011,1413,17598,92.6,111,30,27.0
5,All Students,2019-20,10595,547,10048,94.8,97,14,14.4
5,All Students,2020-21,14688,1420,13268,90.3,85,27,31.8
5,All Students,2021-22,15285,1834,13451,88.0,91,42,46.2
5,All Students,2022-23,16516,1619,14897,90.2,98,37,37.8
All Grades,All Students,2018-19,64553,3940,60613,93.9,376,70,18.6
All Grades,All Students,2019-20,41564,1890,39674,95.5,364,43,11.8
All Grades,All Students,2020-21,60812,8272,52540,86.4,354,162,45.8
All Grades,All Students,2021-22,60083,5055,55028,91.6,354,115,32.5
All Grades,All Students,2022-23,60027,5361,54666,91.1,352,111,31.5
6,All Students,2018-19,18691,974,17717,94.8,108,15,13.9
6,All Students,2019-20,11799,470,11329,96.0,104,10,9.6
6,All Students,2020-21,16514,2261,14253,86.3,96,51,53.1
6,All Students,2021-22,17207,1552,15655,91.0,102,35,34.3
6,All Students,2022-23,18386,1835,16551,90.0,106,40,37.7
7,All Students,2018-19,22425,1208,21217,94.6,136,23,16.9
7,All Students,2019-20,15045,701,14344,95.3,131,15,11.5
7,All Students,2020-21,21666,2915,18751,86.5,126,53,42.1
7,All Students,2021-22,20652,1794,18858,91.3,123,41,33.3
7,All Students,2022-23,20549,1631,18918,92.1,123,36,29.3
8,All Students,2018-19,23437,1758,21679,92.5,132,32,24.2
8,All Students,2019-20,14720,719,14001,95.1,129,18,14.0
8,All Students,2020-21,22632,3096,19536,86.3,132,58,43.9
8,All Students,2021-22,22224,1709,20515,92.3,129,39,30.2
8,All Students,2022-23,21092,1895,19197,91.0,123,35,28.5
All Grades,All Students,2018-19,625841,71753,554088,88.5,3890,1109,28.5
All Grades,All Students,2019-20,407049,42289,364760,89.6,3818,992,26.0
All Grades,All Students,2020-21,656342,52640,603702,92.0,3799,713,18.8
All Grades,All Students,2021-22,606020,70965,535055,88.3,3631,1316,36.2
All Grades,All Students,2022-23,569175,43299,525876,92.4,3604,748,20.8
8,All Students,2018-19,8,s,s,s,s,s,s
9,All Students,2018-19,161833,15181,146652,90.6,1023,222,21.7
9,All Students,2019-20,112952,12072,100880,89.3,1078,297,27.6
9,All Students,2020-21,178992,13771,165221,92.3,1038,187,18.0
9,All Students,2021-22,156726,18739,137987,88.0,947,335,35.4
9,All Students,2022-23,144197,10933,133264,92.4,932,193,20.7
10,All Students,2018-19,156666,20711,135955,86.8,987,310,31.4
10,All Students,2019-20,102420,9728,92692,90.5,973,233,23.9
10,All Students,2020-21,171321,15017,156304,91.2,999,210,21.0
10,All Students,2021-22,157942,18242,139700,88.5,954,320,33.5
10,All Students,2022-23,143545,11567,131978,91.9,921,203,22.0
11,All Students,2018-19,149820,s,s,s,s,s,s
11,All Students,2019-20,97700,9804,87896,90.0,912,231,25.3
11,All Students,2020-21,159867,10054,149813,93.7,922,137,14.9
11,All Students,2021-22,146476,15607,130869,89.3,877,282,32.2
11,All Students,2022-23,144693,10126,134567,93.0,899,158,17.6
12,All Students,2018-19,157514,19614,137900,87.5,957,340,35.5
12,All Students,2019-20,93977,10685,83292,88.6,858,234,27.3
12,All Students,2020-21,146162,13798,132364,90.6,840,179,21.3
12,All Students,2021-22,144876,18377,126499,87.3,853,379,44.4
12,All Students,2022-23,136740,10673,126067,92.2,852,194,22.8
All Grades,All Students,2018-19,530667,70806,459861,86.7,3323,1127,33.9
All Grades,All Students,2019-20,334501,36099,298402,89.2,3158,910,28.8
All Grades,All Students,2020-21,492147,65427,426720,86.7,2944,1074,36.5
All Grades,All Students,2021-22,428501,62810,365691,85.3,2680,1289,48.1
All Grades,All Students,2022-23,386538,45472,341066,88.2,2576,998,38.7
8,All Students,2021-22,8,s,s,s,s,s,s
9,All Students,2018-19,153175,22767,130408,85.1,981,349,35.6
9,All Students,2019-20,94649,11717,82932,87.6,915,276,30.2
9,All Students,2020-21,134652,22555,112097,83.2,813,346,42.6
9,All Students,2021-22,116661,18039,98622,84.5,738,337,45.7
9,All Students,2022-23,105940,11536,94404,89.1,752,282,37.5
10,All Students,2018-19,141133,18302,122831,87.0,882,274,31.1
10,All Students,2019-20,89912,9608,80304,89.3,854,257,30.1
10,All Students,2020-21,129665,18144,111521,86.0,779,301,38.6
10,All Students,2021-22,104887,14880,90007,85.8,668,314,47.0
10,All Students,2022-23,100798,12779,88019,87.3,643,241,37.5
11,All Students,2018-19,110266,10976,99290,90.0,692,185,26.7
11,All Students,2019-20,72093,5863,66230,91.9,672,144,21.4
11,All Students,2020-21,111201,11036,100165,90.1,650,176,27.1
11,All Students,2021-22,99198,s,s,s,s,s,s
11,All Students,2022-23,82257,9410,72847,88.6,530,200,37.7
12,All Students,2018-19,126093,18761,107332,85.1,768,319,41.5
12,All Students,2019-20,77847,8911,68936,88.6,719,235,32.7
12,All Students,2020-21,116629,13692,102937,88.3,702,251,35.8
12,All Students,2021-22,107747,17158,90589,84.1,668,379,56.7
12,All Students,2022-23,97543,11747,85796,88.0,651,275,42.2
All Grades,All Students,2018-19,363105,22060,341045,93.9,2193,300,13.7
All Grades,All Students,2019-20,243780,13880,229900,94.3,2244,325,14.5
All Grades,All Students,2020-21,404643,20476,384167,94.9,2337,260,11.1
All Grades,All Students,2021-22,377761,35415,342346,90.6,2281,733,32.1
All Grades,All Students,2022-23,361852,22331,339521,93.8,2233,387,17.3
9,All Students,2018-19,95952,5052,90900,94.7,582,60,10.3
9,All Students,2019-20,61570,3492,58078,94.3,571,72,12.6
9,All Students,2020-21,106831,4377,102454,95.9,618,56,9.1
9,All Students,2021-22,86695,6400,80295,92.6,535,134,25.0
9,All Students,2022-23,92682,4917,87765,94.7,577,83,14.4
10,All Students,2018-19,101932,4767,97165,95.3,618,59,9.5
10,All Students,2019-20,65316,3246,62070,95.0,606,76,12.5
10,All Students,2020-21,103089,5804,97285,94.4,594,72,12.1
10,All Students,2021-22,102319,8092,94227,92.1,622,164,26.4
10,All Students,2022-23,83549,4919,78630,94.1,520,75,14.4
11,All Students,2018-19,81527,4553,76974,94.4,490,52,10.6
11,All Students,2019-20,63247,3326,59921,94.7,581,72,12.4
11,All Students,2020-21,100145,5264,94881,94.7,578,71,12.3
11,All Students,2021-22,93388,8256,85132,91.2,559,162,29.0
11,All Students,2022-23,97279,5285,91994,94.6,595,84,14.1
12,All Students,2018-19,83694,7688,76006,90.8,503,129,25.6
12,All Students,2019-20,53647,3816,49831,92.9,486,105,21.6
12,All Students,2020-21,94578,5031,89547,94.7,547,61,11.2
12,All Students,2021-22,95359,12667,82692,86.7,565,273,48.3
12,All Students,2022-23,88342,7210,81132,91.8,541,145,26.8
All Grades,All Students,2018-19,121744,5815,115929,95.2,711,77,10.8
All Grades,All Students,2019-20,78179,2603,75576,96.7,702,58,8.3
All Grades,All Students,2020-21,114457,5459,108998,95.2,707,88,12.4
All Grades,All Students,2021-22,117858,9974,107884,91.5,695,190,27.3
All Grades,All Students,2022-23,113949,8777,105172,92.3,670,161,24.0
6,All Students,2018-19,16671,382,16289,97.7,94,3,3.2
6,All Students,2019-20,10743,199,10544,98.1,96,2,2.1
6,All Students,2020-21,16131,836,15295,94.8,100,13,13.0
6,All Students,2021-22,19127,1419,17708,92.6,110,30,27.3
6,All Students,2022-23,16724,879,15845,94.7,96,12,12.5
7,All Students,2018-19,17225,319,16906,98.1,97,1,1.0
7,All Students,2019-20,9805,234,9571,97.6,86,2,2.3
7,All Students,2020-21,14680,477,14203,96.8,90,7,7.8
7,All Students,2021-22,15155,639,14516,95.8,88,10,11.4
7,All Students,2022-23,16844,1201,15643,92.9,96,24,25.0
8,All Students,2018-19,16422,415,16007,97.5,94,2,2.1
8,All Students,2019-20,10716,144,10572,98.7,94,0,0.0
8,All Students,2020-21,13213,991,12222,92.5,81,16,19.8
8,All Students,2021-22,14296,601,13695,95.8,84,12,14.3
8,All Students,2022-23,13772,688,13084,95.0,79,15,19.0
9,All Students,2018-19,21995,1381,20614,93.7,130,14,10.8
9,All Students,2019-20,13436,511,12925,96.2,119,10,8.4
9,All Students,2020-21,19083,1203,17880,93.7,118,21,17.8
9,All Students,2021-22,17195,1396,15799,91.9,104,22,21.2
9,All Students,2022-23,20216,1576,18640,92.2,121,22,18.2
10,All Students,2018-19,17326,1163,16163,93.3,102,18,17.6
10,All Students,2019-20,12647,568,12079,95.5,115,15,13.0
10,All Students,2020-21,18816,757,18059,96.0,118,9,7.6
10,All Students,2021-22,16675,1589,15086,90.5,100,29,29.0
10,All Students,2022-23,14711,1432,13279,90.3,88,22,25.0
11,All Students,2018-19,16507,991,15516,94.0,99,19,19.2
11,All Students,2019-20,10715,458,10257,95.7,99,16,16.2
11,All Students,2020-21,17604,605,16999,96.6,108,13,12.0
11,All Students,2021-22,17724,1623,16101,90.8,106,32,30.2
11,All Students,2022-23,15334,1047,14287,93.2,92,22,23.9
12,All Students,2018-19,15598,1164,14434,92.5,95,20,21.1
12,All Students,2019-20,10117,489,9628,95.2,93,13,14.0
12,All Students,2020-21,14930,590,14340,96.0,92,9,9.8
12,All Students,2021-22,17686,2707,14979,84.7,103,55,53.4
12,All Students,2022-23,16348,1954,14394,88.0,98,44,44.9
All Grades,All Students,2018-19,181587,14331,167256,92.1,1122,257,22.9
All Grades,All Students,2019-20,125648,8785,116863,93.0,1166,239,20.5
All Grades,All Students,2020-21,184071,9076,174995,95.1,1066,117,11.0
All Grades,All Students,2021-22,172314,20579,151735,88.1,1045,391,37.4
All Grades,All Students,2022-23,166997,16680,150317,90.0,1046,317,30.3
9,All Students,2018-19,46977,2810,44167,94.0,287,53,18.5
9,All Students,2019-20,33934,1944,31990,94.3,315,55,17.5
9,All Students,2020-21,37561,1061,36500,97.2,218,9,4.1
9,All Students,2021-22,39498,2934,36564,92.6,242,53,21.9
9,All Students,2022-23,41454,2795,38659,93.3,258,49,19.0
10,All Students,2018-19,43737,3095,40642,92.9,269,51,19.0
10,All Students,2019-20,32063,2522,29541,92.1,302,72,23.8
10,All Students,2020-21,57115,3362,53753,94.1,334,47,14.1
10,All Students,2021-22,38247,4080,34167,89.3,232,76,32.8
10,All Students,2022-23,40291,3460,36831,91.4,255,63,24.7
11,All Students,2018-19,48166,3221,44945,93.3,299,50,16.7
11,All Students,2019-20,28117,1827,26290,93.5,259,49,18.9
11,All Students,2020-21,48034,2350,45684,95.1,275,27,9.8
11,All Students,2021-22,50288,6059,44229,88.0,301,117,38.9
11,All Students,2022-23,36039,3755,32284,89.6,226,69,30.5
12,All Students,2018-19,42707,5205,37502,87.8,267,103,38.6
12,All Students,2019-20,31534,2492,29042,92.1,292,65,22.3
12,All Students,2020-21,41361,2303,39058,94.4,239,34,14.2
12,All Students,2021-22,44281,7506,36775,83.0,270,145,53.7
12,All Students,2022-23,49213,6670,42543,86.4,307,136,44.3
All Grades,All Students,2018-19,79274,2284,76990,97.1,476,31,6.5
All Grades,All Students,2019-20,52701,1286,51415,97.6,480,23,4.8
All Grades,All Students,2020-21,88939,2643,86296,97.0,512,30,5.9
All Grades,All Students,2021-22,88127,2889,85238,96.7,520,36,6.9
All Grades,All Students,2022-23,86714,2669,84045,96.9,520,31,6.0
9,All Students,2018-19,20547,270,20277,98.7,124,3,2.4
9,All Students,2019-20,12249,128,12121,99.0,112,1,0.9
9,All Students,2020-21,22994,558,22436,97.6,133,4,3.0
9,All Students,2021-22,22249,363,21886,98.4,131,3,2.3
9,All Students,2022-23,21083,414,20669,98.0,127,3,2.4
10,All Students,2018-19,21504,381,21123,98.2,129,1,0.8
10,All Students,2019-20,13860,155,13705,98.9,126,1,0.8
10,All Students,2020-21,21576,320,21256,98.5,124,2,1.6
10,All Students,2021-22,24337,676,23661,97.2,144,7,4.9
10,All Students,2022-23,21877,333,21544,98.5,131,1,0.8
11,All Students,2018-19,18878,503,18375,97.3,113,4,3.5
11,All Students,2019-20,14162,311,13851,97.8,129,4,3.1
11,All Students,2020-21,21924,797,21127,96.4,126,11,8.7
11,All Students,2021-22,20462,530,19932,97.4,121,4,3.3
11,All Students,2022-23,23714,729,22985,96.9,142,9,6.3
12,All Students,2018-19,18345,1130,17215,93.8,110,23,20.9
12,All Students,2019-20,12430,692,11738,94.4,113,17,15.0
12,All Students,2020-21,22445,968,21477,95.7,129,13,10.1
12,All Students,2021-22,21079,1320,19759,93.7,124,22,17.7
12,All Students,2022-23,20040,1193,18847,94.0,120,18,15.0
All Grades,All Students,2018-19,75019,9799,65220,86.9,482,187,38.8
All Grades,All Students,2019-20,42509,5857,36652,86.2,404,156,38.6
All Grades,All Students,2020-21,67171,13372,53799,80.1,393,210,53.4
All Grades,All Students,2021-22,63883,12359,51524,80.7,445,270,60.7
All Grades,All Students,2022-23,76073,13553,62520,82.2,523,260,49.7
8,All Students,2022-23,2,s,s,s,s,s,s
9,All Students,2018-19,23186,3121,20065,86.5,151,54,35.8
9,All Students,2019-20,11138,1620,9518,85.5,111,51,45.9
9,All Students,2020-21,20561,4806,15755,76.6,120,80,66.7
9,All Students,2021-22,18966,4472,14494,76.4,143,98,68.5
9,All Students,2022-23,27396,5034,22362,81.6,185,97,52.4
10,All Students,2018-19,22260,2971,19289,86.7,148,63,42.6
10,All Students,2019-20,13083,1761,11322,86.5,124,51,41.1
10,All Students,2020-21,16327,3876,12451,76.3,96,55,57.3
10,All Students,2021-22,19359,3994,15365,79.4,131,80,61.1
10,All Students,2022-23,21698,4226,17472,80.5,156,76,48.7
11,All Students,2018-19,12319,1245,11074,89.9,76,23,30.3
11,All Students,2019-20,9854,1229,8625,87.5,93,32,34.4
11,All Students,2020-21,16096,2279,13817,85.8,93,38,40.9
11,All Students,2021-22,12137,2024,10113,83.3,86,49,57.0
11,All Students,2022-23,14635,2075,12560,85.8,96,38,39.6
12,All Students,2018-19,17254,2462,14792,85.7,107,47,43.9
12,All Students,2019-20,8434,1247,7187,85.2,76,22,28.9
12,All Students,2020-21,14187,2411,11776,83.0,84,37,44.0
12,All Students,2021-22,13421,1869,11552,86.1,85,43,50.6
12,All Students,2022-23,12342,s,s,s,s,s,s
All Grades,All Students,2018-19,93532,5272,88260,94.4,549,85,15.5
All Grades,All Students,2019-20,62600,3096,59504,95.1,568,83,14.6
All Grades,All Students,2020-21,101305,4862,96443,95.2,582,62,10.7
All Grades,All Students,2021-22,95140,8838,86302,90.7,571,207,36.3
All Grades,All Students,2022-23,91712,6938,84774,92.4,569,155,27.2
6,All Students,2018-19,15611,470,15141,97.0,89,5,5.6
6,All Students,2019-20,9055,361,8694,96.0,82,8,9.8
6,All Students,2020-21,16385,232,16153,98.6,94,2,2.1
6,All Students,2021-22,15911,1416,14495,91.1,93,36,38.7
6,All Students,2022-23,16229,1160,15069,92.9,98,24,24.5
7,All Students,2018-19,15088,422,14666,97.2,86,3,3.5
7,All Students,2019-20,10275,269,10006,97.4,91,3,3.3
7,All Students,2020-21,13437,245,13192,98.2,77,5,6.5
7,All Students,2021-22,13607,750,12857,94.5,82,13,15.9
7,All Students,2022-23,14546,1058,13488,92.7,88,24,27.3
8,All Students,2018-19,12971,533,12438,95.9,74,2,2.7
8,All Students,2019-20,9604,393,9211,95.9,85,10,11.8
8,All Students,2020-21,15250,524,14726,96.6,88,6,6.8
8,All Students,2021-22,12381,757,11624,93.9,71,14,19.7
8,All Students,2022-23,13126,792,12334,94.0,79,14,17.7
9,All Students,2018-19,13930,652,13278,95.3,83,7,8.4
9,All Students,2019-20,9619,439,9180,95.4,88,10,11.4
9,All Students,2020-21,16523,850,15673,94.9,96,9,9.4
9,All Students,2021-22,15020,1313,13707,91.3,93,32,34.4
9,All Students,2022-23,12529,1123,11406,91.0,82,27,32.9
10,All Students,2018-19,11441,774,10667,93.2,69,13,18.8
10,All Students,2019-20,9141,459,8682,95.0,84,14,16.7
10,All Students,2020-21,14520,1054,13466,92.7,83,14,16.9
10,All Students,2021-22,12522,1073,11449,91.4,76,23,30.3
10,All Students,2022-23,12632,625,12007,95.1,79,9,11.4
11,All Students,2018-19,11875,703,11172,94.1,73,11,15.1
11,All Students,2019-20,7263,509,6754,93.0,68,16,23.5
11,All Students,2020-21,13990,600,13390,95.7,80,8,10.0
11,All Students,2021-22,12845,1545,11300,88.0,78,37,47.4
11,All Students,2022-23,11177,790,10387,92.9,70,19,27.1
12,All Students,2018-19,12616,1718,10898,86.4,75,44,58.7
12,All Students,2019-20,7643,666,6977,91.3,70,22,31.4
12,All Students,2020-21,11200,1357,9843,87.9,64,18,28.1
12,All Students,2021-22,12854,1984,10870,84.6,78,52,66.7
12,All Students,2022-23,11473,1390,10083,87.9,73,38,52.1
All Grades,All Students,2018-19,78150,5657,72493,92.8,470,121,25.7
All Grades,All Students,2019-20,45528,3242,42286,92.9,432,111,25.7
All Grades,All Students,2020-21,64054,5587,58467,91.3,387,123,31.8
All Grades,All Students,2021-22,63757,7385,56372,88.4,401,189,47.1
All Grades,All Students,2022-23,57949,5914,52035,89.8,365,153,41.9
PK in K-12 Schools,All Students,2018-19,6275,462,5813,92.6,36,9,25.0
PK in K-12 Schools,All Students,2019-20,2628,258,2370,90.2,29,10,34.5
PK in K-12 Schools,All Students,2020-21,4229,726,3503,82.8,28,18,64.3
PK in K-12 Schools,All Students,2021-22,5431,768,4663,85.9,34,20,58.8
PK in K-12 Schools,All Students,2022-23,4358,586,3772,86.6,28,14,50.0
0K,All Students,2018-19,13004,1336,11668,89.7,82,32,39.0
0K,All Students,2019-20,6915,623,6292,91.0,68,25,36.8
0K,All Students,2020-21,7759,1099,6660,85.8,49,30,61.2
0K,All Students,2021-22,8194,1133,7061,86.2,57,34,59.6
0K,All Students,2022-23,7374,905,6469,87.7,48,24,50.0
1,All Students,2018-19,11758,903,10855,92.3,71,20,28.2
1,All Students,2019-20,7842,640,7202,91.8,75,19,25.3
1,All Students,2020-21,9905,829,9076,91.6,58,18,31.0
1,All Students,2021-22,9300,952,8348,89.8,58,24,41.4
1,All Students,2022-23,7617,815,6802,89.3,51,26,51.0
2,All Students,2018-19,11660,823,10837,92.9,72,18,25.0
2,All Students,2019-20,7002,467,6535,93.3,69,14,20.3
2,All Students,2020-21,10992,805,10187,92.7,66,19,28.8
2,All Students,2021-22,9932,1196,8736,88.0,62,28,45.2
2,All Students,2022-23,9843,857,8986,91.3,60,25,41.7
3,All Students,2018-19,11479,812,10667,92.9,70,20,28.6
3,All Students,2019-20,7779,526,7253,93.2,69,17,24.6
3,All Students,2020-21,10449,565,9884,94.6,63,10,15.9
3,All Students,2021-22,9932,1248,8684,87.4,63,30,47.6
3,All Students,2022-23,9960,963,8997,90.3,63,26,41.3
4,All Students,2018-19,10941,658,10283,94.0,65,13,20.0
4,All Students,2019-20,6766,380,6386,94.4,63,15,23.8
4,All Students,2020-21,11186,792,10394,92.9,66,17,25.8
4,All Students,2021-22,9736,953,8783,90.2,59,21,35.6
4,All Students,2022-23,9173,1003,8170,89.1,57,23,40.4
5,All Students,2018-19,13033,663,12370,94.9,74,9,12.2
5,All Students,2019-20,6596,348,6248,94.7,59,11,18.6
5,All Students,2020-21,9534,771,8763,91.9,57,11,19.3
5,All Students,2021-22,11232,1135,10097,89.9,68,32,47.1
5,All Students,2022-23,9624,785,8839,91.8,58,15,25.9
All Grades,All Students,2018-19,167949,9945,158004,94.1,995,176,17.7
All Grades,All Students,2019-20,108860,7162,101698,93.4,995,220,22.1
All Grades,All Students,2020-21,154252,7667,146585,95.0,912,143,15.7
All Grades,All Students,2021-22,140161,15447,124714,89.0,847,387,45.7
All Grades,All Students,2022-23,136329,12603,123726,90.8,835,305,36.5
PK in K-12 Schools,All Students,2019-20,4012,435,3577,89.2,36,17,47.2
PK in K-12 Schools,All Students,2020-21,6104,587,5517,90.4,36,13,36.1
PK in K-12 Schools,All Students,2021-22,6347,1208,5139,81.0,37,29,78.4
PK in K-12 Schools,All Students,2022-23,5905,781,5124,86.8,42,25,59.5
0K,All Students,2018-19,25744,2068,23676,92.0,157,51,32.5
0K,All Students,2019-20,17188,1471,15717,91.4,162,55,34.0
0K,All Students,2020-21,22041,1502,20539,93.2,133,30,22.6
0K,All Students,2021-22,21539,2995,18544,86.1,135,79,58.5
0K,All Students,2022-23,22730,2717,20013,88.0,140,74,52.9
1,All Students,2018-19,27317,1853,25464,93.2,159,32,20.1
1,All Students,2019-20,16543,1190,15353,92.8,154,38,24.7
1,All Students,2020-21,25744,954,24790,96.3,152,17,11.2
1,All Students,2021-22,21480,2189,19291,89.8,130,53,40.8
1,All Students,2022-23,21099,2070,19029,90.2,131,58,44.3
2,All Students,2018-19,28413,1582,26831,94.4,169,26,15.4
2,All Students,2019-20,16515,1031,15484,93.8,150,26,17.3
2,All Students,2020-21,24219,1069,23150,95.6,145,22,15.2
2,All Students,2021-22,22196,2488,19708,88.8,133,66,49.6
2,All Students,2022-23,21175,1782,19393,91.6,130,34,26.2
3,All Students,2018-19,28535,1435,27100,95.0,171,25,14.6
3,All Students,2019-20,18438,1154,17284,93.7,166,30,18.1
3,All Students,2020-21,23235,1413,21822,93.9,137,25,18.2
3,All Students,2021-22,20869,2002,18867,90.4,125,46,36.8
3,All Students,2022-23,22334,1862,20472,91.7,134,39,29.1
4,All Students,2018-19,29085,1544,27541,94.7,169,21,12.4
4,All Students,2019-20,18128,976,17152,94.6,163,26,16.0
4,All Students,2020-21,26540,1202,25338,95.5,155,19,12.3
4,All Students,2021-22,22400,2119,20281,90.5,133,53,39.8
4,All Students,2022-23,20262,1534,18728,92.4,121,30,24.8
5,All Students,2018-19,28855,1463,27392,94.9,170,21,12.4
5,All Students,2019-20,18036,905,17131,95.0,164,28,17.1
5,All Students,2020-21,26369,940,25429,96.4,154,17,11.0
5,All Students,2021-22,25330,2446,22884,90.3,154,61,39.6
5,All Students,2022-23,22824,1857,20967,91.9,137,45,32.8
All Grades,All Students,2018-19,106698,7352,99346,93.1,644,152,23.6
All Grades,All Students,2019-20,65977,4036,61941,93.9,609,126,20.7
All Grades,All Students,2020-21,94807,8299,86508,91.2,558,155,27.8
All Grades,All Students,2021-22,88127,10256,77871,88.4,531,230,43.3
All Grades,All Students,2022-23,85306,7694,77612,91.0,521,183,35.1
PK in K-12 Schools,All Students,2018-19,6087,655,5432,89.2,37,12,32.4
PK in K-12 Schools,All Students,2019-20,4105,318,3787,92.3,38,10,26.3
PK in K-12 Schools,All Students,2020-21,5835,199,5636,96.6,35,1,2.9
PK in K-12 Schools,All Students,2021-22,6345,861,5484,86.4,37,23,62.2
PK in K-12 Schools,All Students,2022-23,6271,958,5313,84.7,37,26,70.3
0K,All Students,2018-19,17000,1558,15442,90.8,101,37,36.6
0K,All Students,2019-20,8977,738,8239,91.8,79,28,35.4
0K,All Students,2020-21,11543,1561,9982,86.5,70,35,50.0
0K,All Students,2021-22,11890,1688,10202,85.8,76,38,50.0
0K,All Students,2022-23,11222,1130,10092,89.9,69,32,46.4
1,All Students,2018-19,16522,1213,15309,92.7,98,25,25.5
1,All Students,2019-20,11426,757,10669,93.4,107,26,24.3
1,All Students,2020-21,14192,1291,12901,90.9,84,21,25.0
1,All Students,2021-22,11322,1406,9916,87.6,68,32,47.1
1,All Students,2022-23,12136,1135,11001,90.6,75,22,29.3
2,All Students,2018-19,14250,749,13501,94.7,90,16,17.8
2,All Students,2019-20,10232,602,9630,94.1,95,19,20.0
2,All Students,2020-21,16648,1464,15184,91.2,96,25,26.0
2,All Students,2021-22,14627,1675,12952,88.5,89,39,43.8
2,All Students,2022-23,11557,978,10579,91.5,72,24,33.3
3,All Students,2018-19,18044,988,17056,94.5,109,19,17.4
3,All Students,2019-20,9103,471,8632,94.8,86,14,16.3
3,All Students,2020-21,14870,1294,13576,91.3,88,27,30.7
3,All Students,2021-22,15831,1494,14337,90.6,94,35,37.2
3,All Students,2022-23,14226,1147,13079,91.9,86,27,31.4
4,All Students,2018-19,17210,1115,16095,93.5,102,23,22.5
4,All Students,2019-20,12011,647,11364,94.6,109,14,12.8
4,All Students,2020-21,14087,934,13153,93.4,82,18,22.0
4,All Students,2021-22,14423,2064,12359,85.7,86,42,48.8
4,All Students,2022-23,16858,1299,15559,92.3,100,25,25.0
5,All Students,2018-19,17585,1074,16511,93.9,107,20,18.7
5,All Students,2019-20,10123,503,9620,95.0,95,15,15.8
5,All Students,2020-21,17632,1556,16076,91.2,103,28,27.2
5,All Students,2021-22,13689,1068,12621,92.2,81,21,25.9
5,All Students,2022-23,13036,1047,11989,92.0,82,27,32.9
All Grades,All Students,2018-19,120121,7947,112174,93.4,731,162,22.2
All Grades,All Students,2019-20,79012,5762,73250,92.7,722,186,25.8
All Grades,All Students,2020-21,113094,9561,103533,91.5,681,190,27.9
All Grades,All Students,2021-22,101135,12342,88793,87.8,615,293,47.6
All Grades,All Students,2022-23,102844,11583,91261,88.7,629,283,45.0
PK in K-12 Schools,All Students,2018-19,6129,544,5585,91.1,41,11,26.8
PK in K-12 Schools,All Students,2019-20,4061,409,3652,89.9,36,15,41.7
PK in K-12 Schools,All Students,2020-21,5385,421,4964,92.2,32,7,21.9
PK in K-12 Schools,All Students,2021-22,6306,1400,4906,77.8,37,27,73.0
PK in K-12 Schools,All Students,2022-23,6287,1155,5132,81.6,39,28,71.8
0K,All Students,2018-19,19281,1392,17889,92.8,115,25,21.7
0K,All Students,2019-20,11848,1209,10639,89.8,113,49,43.4
0K,All Students,2020-21,16985,1673,15312,90.2,104,33,31.7
0K,All Students,2021-22,16363,2579,13784,84.2,104,64,61.5
0K,All Students,2022-23,17862,2727,15135,84.7,111,69,62.2
1,All Students,2018-19,19992,1507,18485,92.5,124,31,25.0
1,All Students,2019-20,13823,1099,12724,92.0,127,39,30.7
1,All Students,2020-21,17035,2090,14945,87.7,104,44,42.3
1,All Students,2021-22,14093,1581,12512,88.8,88,41,46.6
1,All Students,2022-23,16480,2106,14374,87.2,100,52,52.0
2,All Students,2018-19,19657,1278,18379,93.5,122,29,23.8
2,All Students,2019-20,12048,813,11235,93.3,109,27,24.8
2,All Students,2020-21,19615,1724,17891,91.2,120,37,30.8
2,All Students,2021-22,15216,1825,13391,88.0,91,46,50.5
2,All Students,2022-23,14503,1497,13006,89.7,88,31,35.2
3,All Students,2018-19,21094,1339,19755,93.7,127,28,22.0
3,All Students,2019-20,11402,692,10710,93.9,103,18,17.5
3,All Students,2020-21,15864,1283,14581,91.9,94,25,26.6
3,All Students,2021-22,17993,1756,16237,90.2,109,38,34.9
3,All Students,2022-23,14219,1298,12921,90.9,89,41,46.1
4,All Students,2018-19,16770,899,15871,94.6,101,19,18.8
4,All Students,2019-20,15084,946,14138,93.7,134,22,16.4
4,All Students,2020-21,16850,880,15970,94.8,99,16,16.2
4,All Students,2021-22,13742,1461,12281,89.4,84,36,42.9
4,All Students,2022-23,17217,1468,15749,91.5,101,29,28.7
5,All Students,2018-19,17198,988,16210,94.3,101,19,18.8
5,All Students,2019-20,10746,594,10152,94.5,100,16,16.0
5,All Students,2020-21,21360,1490,19870,93.0,128,28,21.9
5,All Students,2021-22,17422,1740,15682,90.0,102,41,40.2
5,All Students,2022-23,16276,1332,14944,91.8,101,33,32.7
All Grades,All Students,2018-19,72511,5539,66972,92.4,446,118,26.5
All Grades,All Students,2019-20,41880,3130,38750,92.5,394,92,23.4
All Grades,All Students,2020-21,58093,6459,51634,88.9,347,144,41.5
All Grades,All Students,2021-22,51429,6281,45148,87.8,320,156,48.8
All Grades,All Students,2022-23,50140,5149,44991,89.7,317,133,42.0
PK in K-12 Schools,All Students,2019-20,1580,183,1397,88.4,17,9,52.9
PK in K-12 Schools,All Students,2020-21,3048,257,2791,91.6,20,6,30.0
PK in K-12 Schools,All Students,2021-22,2037,292,1745,85.7,13,6,46.2
PK in K-12 Schools,All Students,2022-23,3170,339,2831,89.3,19,7,36.8
0K,All Students,2018-19,11346,1024,10322,91.0,70,26,37.1
0K,All Students,2019-20,5392,582,4810,89.2,51,18,35.3
0K,All Students,2020-21,7431,816,6615,89.0,48,19,39.6
0K,All Students,2021-22,7108,957,6151,86.5,45,28,62.2
0K,All Students,2022-23,6717,851,5866,87.3,43,23,53.5
1,All Students,2018-19,12515,983,11532,92.1,78,23,29.5
1,All Students,2019-20,7283,622,6661,91.5,69,21,30.4
1,All Students,2020-21,7661,1025,6636,86.6,47,20,42.6
1,All Students,2021-22,8983,1155,7828,87.1,54,31,57.4
1,All Students,2022-23,7846,874,6972,88.9,50,22,44.0
2,All Students,2018-19,11141,909,10232,91.8,70,18,25.7
2,All Students,2019-20,7661,583,7078,92.4,69,14,20.3
2,All Students,2020-21,10642,1325,9317,87.5,61,28,45.9
2,All Students,2021-22,7563,1042,6521,86.2,49,27,55.1
2,All Students,2022-23,7540,819,6721,89.1,47,21,44.7
3,All Students,2018-19,9889,775,9114,92.2,64,18,28.1
3,All Students,2019-20,5998,333,5665,94.4,58,9,15.5
3,All Students,2020-21,9924,976,8948,90.2,59,26,44.1
3,All Students,2021-22,9122,966,8156,89.4,55,20,36.4
3,All Students,2022-23,6915,677,6238,90.2,47,22,46.8
4,All Students,2018-19,12990,772,12218,94.1,78,12,15.4
4,All Students,2019-20,6486,401,6085,93.8,61,12,19.7
4,All Students,2020-21,8747,855,7892,90.2,51,16,31.4
4,All Students,2021-22,8834,1069,7765,87.9,57,27,47.4
4,All Students,2022-23,8654,707,7947,91.8,54,19,35.2
5,All Students,2018-19,14630,1076,13554,92.6,86,21,24.4
5,All Students,2019-20,7480,426,7054,94.3,69,9,13.0
5,All Students,2020-21,10640,1205,9435,88.7,61,29,47.5
5,All Students,2021-22,7782,800,6982,89.7,47,17,36.2
5,All Students,2022-23,9298,882,8416,90.5,57,19,33.3
All Grades,All Students,2018-19,76740,7080,69660,90.8,482,177,36.7
All Grades,All Students,2019-20,40379,3967,36412,90.2,383,143,37.3
All Grades,All Students,2020-21,50914,5588,45326,89.0,307,118,38.4
All Grades,All Students,2021-22,50112,6605,43507,86.8,326,159,48.8
All Grades,All Students,2022-23,50451,6543,43908,87.0,332,171,51.5
PK in K-12 Schools,All Students,2018-19,5436,823,4613,84.9,39,26,66.7
PK in K-12 Schools,All Students,2019-20,3024,439,2585,85.5,33,16,48.5
PK in K-12 Schools,All Students,2020-21,2838,290,2548,89.8,19,6,31.6
PK in K-12 Schools,All Students,2021-22,3384,554,2830,83.6,28,17,60.7
PK in K-12 Schools,All Students,2022-23,2696,359,2337,86.7,19,11,57.9
0K,All Students,2018-19,8257,972,7285,88.2,52,24,46.2
0K,All Students,2019-20,4593,505,4088,89.0,46,22,47.8
0K,All Students,2020-21,6296,907,5389,85.6,40,19,47.5
0K,All Students,2021-22,7501,1190,6311,84.1,52,32,61.5
0K,All Students,2022-23,8399,1360,7039,83.8,59,38,64.4
1,All Students,2018-19,10274,1132,9142,89.0,67,28,41.8
1,All Students,2019-20,4522,542,3980,88.0,43,19,44.2
1,All Students,2020-21,5928,876,5052,85.2,35,18,51.4
1,All Students,2021-22,6112,910,5202,85.1,39,22,56.4
1,All Students,2022-23,8510,923,7587,89.2,53,26,49.1
2,All Students,2018-19,11148,953,10195,91.5,72,28,38.9
2,All Students,2019-20,5861,660,5201,88.7,57,25,43.9
2,All Students,2020-21,6401,882,5519,86.2,39,20,51.3
2,All Students,2021-22,6352,692,5660,89.1,40,16,40.0
2,All Students,2022-23,6875,963,5912,86.0,45,24,53.3
3,All Students,2018-19,13190,1008,12182,92.4,82,28,34.1
3,All Students,2019-20,6584,546,6038,91.7,61,22,36.1
3,All Students,2020-21,7962,829,7133,89.6,48,17,35.4
3,All Students,2021-22,7904,1098,6806,86.1,53,27,50.9
3,All Students,2022-23,7001,712,6289,89.8,47,20,42.6
4,All Students,2018-19,12704,912,11792,92.8,76,18,23.7
4,All Students,2019-20,7582,620,6962,91.8,70,20,28.6
4,All Students,2020-21,10582,1019,9563,90.4,61,21,34.4
4,All Students,2021-22,8277,1000,7277,87.9,50,19,38.0
4,All Students,2022-23,7815,1162,6653,85.1,52,26,50.0
5,All Students,2018-19,15731,1280,14451,91.9,94,25,26.6
5,All Students,2019-20,8213,655,7558,92.0,74,19,25.7
5,All Students,2020-21,10904,785,10119,92.8,65,17,26.2
5,All Students,2021-22,10582,1161,9421,89.0,64,26,40.6
5,All Students,2022-23,9155,1064,8091,88.4,57,26,45.6
All Grades,All Students,2018-19,50736,3554,47182,93.0,302,65,21.5
All Grades,All Students,2019-20,31093,1984,29109,93.6,289,54,18.7
All Grades,All Students,2020-21,43309,3029,40280,93.0,261,61,23.4
All Grades,All Students,2021-22,44349,5185,39164,88.3,269,117,43.5
All Grades,All Students,2022-23,41968,4029,37939,90.4,264,93,35.2
0K,All Students,2018-19,7671,842,6829,89.0,43,11,25.6
0K,All Students,2019-20,4845,394,4451,91.9,48,10,20.8
0K,All Students,2020-21,4898,442,4456,91.0,30,12,40.0
0K,All Students,2021-22,6355,710,5645,88.8,38,14,36.8
0K,All Students,2022-23,5901,534,5367,91.0,41,13,31.7
1,All Students,2018-19,9384,674,8710,92.8,59,11,18.6
1,All Students,2019-20,4379,340,4039,92.2,42,10,23.8
1,All Students,2020-21,7179,698,6481,90.3,43,15,34.9
1,All Students,2021-22,7189,993,6196,86.2,47,22,46.8
1,All Students,2022-23,7427,815,6612,89.0,48,20,41.7
2,All Students,2018-19,10371,629,9742,93.9,61,15,24.6
2,All Students,2019-20,5549,350,5199,93.7,52,10,19.2
2,All Students,2020-21,6220,450,5770,92.8,38,10,26.3
2,All Students,2021-22,7074,1033,6041,85.4,45,26,57.8
2,All Students,2022-23,7327,577,6750,92.1,45,12,26.7
3,All Students,2018-19,7738,551,7187,92.9,48,12,25.0
3,All Students,2019-20,7060,403,6657,94.3,63,11,17.5
3,All Students,2020-21,8039,592,7447,92.6,48,10,20.8
3,All Students,2021-22,6770,875,5895,87.1,40,19,47.5
3,All Students,2022-23,6993,871,6122,87.5,45,21,46.7
4,All Students,2018-19,7732,494,7238,93.6,45,10,22.2
4,All Students,2019-20,4642,271,4371,94.2,43,9,20.9
4,All Students,2020-21,10140,440,9700,95.7,60,6,10.0
4,All Students,2021-22,6988,689,6299,90.1,41,15,36.6
4,All Students,2022-23,6592,542,6050,91.8,40,11,27.5
5,All Students,2018-19,7840,364,7476,95.4,46,6,13.0
5,All Students,2019-20,4618,226,4392,95.1,41,4,9.8
5,All Students,2020-21,6833,407,6426,94.0,42,8,19.0
5,All Students,2021-22,9973,885,9088,91.1,58,21,36.2
5,All Students,2022-23,7728,690,7038,91.1,45,16,35.6
All Grades,All Students,2018-19,72597,7400,65197,89.8,492,208,42.3
All Grades,All Students,2019-20,42687,4234,38453,90.1,433,176,40.6
All Grades,All Students,2020-21,58213,12915,45298,77.8,352,215,61.1
All Grades,All Students,2021-22,50105,7655,42450,84.7,341,215,63.0
All Grades,All Students,2022-23,48760,6768,41992,86.1,376,236,62.8
PK in K-12 Schools,All Students,2018-19,5753,1017,4736,82.3,47,33,70.2
PK in K-12 Schools,All Students,2019-20,3977,538,3439,86.5,40,23,57.5
PK in K-12 Schools,All Students,2020-21,3808,1347,2461,64.6,25,21,84.0
PK in K-12 Schools,All Students,2021-22,4752,1121,3631,76.4,37,31,83.8
PK in K-12 Schools,All Students,2022-23,5616,997,4619,82.2,46,36,78.3
0K,All Students,2018-19,9773,1326,8447,86.4,68,39,57.4
0K,All Students,2019-20,5852,806,5046,86.2,67,36,53.7
0K,All Students,2020-21,9856,2405,7451,75.6,62,38,61.3
0K,All Students,2021-22,6613,1196,5417,81.9,50,40,80.0
0K,All Students,2022-23,6607,1333,5274,79.8,59,48,81.4
1,All Students,2018-19,12433,1260,11173,89.9,87,38,43.7
1,All Students,2019-20,5520,696,4824,87.4,61,29,47.5
1,All Students,2020-21,9178,2477,6701,73.0,56,40,71.4
1,All Students,2021-22,8153,1200,6953,85.3,56,34,60.7
1,All Students,2022-23,7472,1271,6201,83.0,66,46,69.7
2,All Students,2018-19,12036,1070,10966,91.1,80,31,38.8
2,All Students,2019-20,6912,543,6369,92.1,67,18,26.9
2,All Students,2020-21,7189,1720,5469,76.1,42,28,66.7
2,All Students,2021-22,6783,1010,5773,85.1,46,29,63.0
2,All Students,2022-23,8499,801,7698,90.6,57,23,40.4
3,All Students,2018-19,10642,837,9805,92.1,68,19,27.9
3,All Students,2019-20,6308,584,5724,90.7,62,26,41.9
3,All Students,2020-21,9274,1756,7518,81.1,54,31,57.4
3,All Students,2021-22,7680,1084,6596,85.9,51,32,62.7
3,All Students,2022-23,6033,830,5203,86.2,42,27,64.3
4,All Students,2018-19,12109,1196,10913,90.1,80,32,40.0
4,All Students,2019-20,6698,555,6143,91.7,64,23,35.9
4,All Students,2020-21,8856,1657,7199,81.3,53,24,45.3
4,All Students,2021-22,7445,994,6451,86.6,47,25,53.2
4,All Students,2022-23,6850,654,6196,90.5,51,24,47.1
5,All Students,2018-19,9851,694,9157,93.0,62,16,25.8
5,All Students,2019-20,7420,512,6908,93.1,72,21,29.2
5,All Students,2020-21,10052,1553,8499,84.6,60,33,55.0
5,All Students,2021-22,8679,1050,7629,87.9,54,24,44.4
5,All Students,2022-23,7683,882,6801,88.5,55,32,58.2
All Grades,All Students,2018-19,106018,10258,95760,90.3,618,186,30.1
All Grades,All Students,2019-20,66577,6159,60418,90.7,603,169,28.0
All Grades,All Students,2020-21,89966,15080,74886,83.2,533,280,52.5
All Grades,All Students,2021-22,78624,9009,69615,88.5,478,201,42.1
All Grades,All Students,2022-23,71350,6626,64724,90.7,435,151,34.7
6,All Students,2018-19,35734,3027,32707,91.5,215,52,24.2
6,All Students,2019-20,21321,s,s,s,s,s,s
6,All Students,2020-21,26153,s,s,s,s,s,s
6,All Students,2021-22,24965,3046,21919,87.8,152,67,44.1
6,All Students,2022-23,25858,2203,23655,91.5,161,50,31.1
7,All Students,2018-19,34882,s,s,s,s,s,s
7,All Students,2019-20,22698,2070,20628,90.9,203,52,25.6
7,All Students,2020-21,31151,4502,26649,85.5,185,82,44.3
7,All Students,2021-22,21757,2193,19564,89.9,137,48,35.0
7,All Students,2022-23,23552,2340,21212,90.1,146,58,39.7
8,All Students,2018-19,35395,3945,31450,88.9,200,73,36.5
8,All Students,2019-20,22453,2269,20184,89.9,203,63,31.0
8,All Students,2020-21,32544,6602,25942,79.7,191,111,58.1
8,All Students,2021-22,31902,3770,28132,88.2,189,86,45.5
8,All Students,2022-23,21940,2083,19857,90.5,128,43,33.6
9,All Students,2018-19,7,s,s,s,s,s,s
9,All Students,2019-20,105,s,s,s,s,s,s
9,All Students,2020-21,118,s,s,s,s,s,s
All Grades,All Students,2018-19,255850,24727,231123,90.3,1528,566,37.0
All Grades,All Students,2019-20,165025,14881,150144,91.0,1520,517,34.0
All Grades,All Students,2020-21,242013,20140,221873,91.7,1443,389,27.0
All Grades,All Students,2021-22,211723,34824,176899,83.6,1332,823,61.8
All Grades,All Students,2022-23,203450,27830,175620,86.3,1264,691,54.7
0K,All Students,2018-19,41092,4904,36188,88.1,247,120,48.6
0K,All Students,2019-20,26627,2948,23679,88.9,250,109,43.6
0K,All Students,2020-21,39712,3368,36344,91.5,242,78,32.2
0K,All Students,2021-22,32196,5894,26302,81.7,208,138,66.3
0K,All Students,2022-23,30216,4489,25727,85.1,191,115,60.2
1,All Students,2018-19,40064,4579,35485,88.6,241,102,42.3
1,All Students,2019-20,26674,2891,23783,89.2,245,101,41.2
1,All Students,2020-21,39293,2843,36450,92.8,234,55,23.5
1,All Students,2021-22,37176,6561,30615,82.4,233,145,62.2
1,All Students,2022-23,32116,4625,27491,85.6,199,118,59.3
2,All Students,2018-19,42093,3615,38478,91.4,254,76,29.9
2,All Students,2019-20,26634,2652,23982,90.0,247,98,39.7
2,All Students,2020-21,40258,3314,36944,91.8,239,55,23.0
2,All Students,2021-22,34114,5620,28494,83.5,214,146,68.2
2,All Students,2022-23,37730,5125,32605,86.4,233,122,52.4
3,All Students,2018-19,40483,3663,36820,91.0,245,89,36.3
3,All Students,2019-20,27747,2003,25744,92.8,255,69,27.1
3,All Students,2020-21,38651,s,s,s,s,s,s
3,All Students,2021-22,36249,5607,30642,84.5,234,128,54.7
3,All Students,2022-23,35579,4896,30683,86.2,222,119,53.6
4,All Students,2018-19,45322,3606,41716,92.0,271,83,30.6
4,All Students,2019-20,27912,2419,25493,91.3,256,85,33.2
4,All Students,2020-21,42941,2631,40310,93.9,254,50,19.7
4,All Students,2021-22,34575,5337,29238,84.6,214,125,58.4
4,All Students,2022-23,35286,4375,30911,87.6,218,106,48.6
5,All Students,2018-19,46796,4360,42436,90.7,270,96,35.6
5,All Students,2019-20,29431,1968,27463,93.3,267,55,20.6
5,All Students,2020-21,41145,4830,36315,88.3,246,90,36.6
5,All Students,2021-22,37413,5805,31608,84.5,229,141,61.6
5,All Students,2022-23,32523,4320,28203,86.7,201,111,55.2
6,All Students,2020-21,13,s,s,s,s,s,s
All Grades,All Students,2018-19,207026,13465,193561,93.5,1205,248,20.6
All Grades,All Students,2019-20,134556,8118,126438,94.0,1203,214,17.8
All Grades,All Students,2020-21,197095,11954,185141,93.9,1150,236,20.5
All Grades,All Students,2021-22,177904,14248,163656,92.0,1062,298,28.1
All Grades,All Students,2022-23,169166,14048,155118,91.7,1041,351,33.7
6,All Students,2018-19,72837,4092,68745,94.4,425,66,15.5
6,All Students,2019-20,44551,2520,42031,94.3,399,67,16.8
6,All Students,2020-21,60139,s,s,s,s,s,s
6,All Students,2021-22,55387,4187,51200,92.4,329,76,23.1
6,All Students,2022-23,49537,s,s,s,s,s,s
7,All Students,2018-19,70216,4687,65529,93.3,407,93,22.9
7,All Students,2019-20,47042,2828,44214,94.0,419,72,17.2
7,All Students,2020-21,67278,5243,62035,92.2,396,117,29.5
7,All Students,2021-22,60600,4607,55993,92.4,369,104,28.2
7,All Students,2022-23,57559,4836,52723,91.6,358,118,33.0
8,All Students,2018-19,63973,4686,59287,92.7,373,89,23.9
8,All Students,2019-20,42963,2770,40193,93.6,385,75,19.5
8,All Students,2020-21,69652,3291,66361,95.3,402,60,14.9
8,All Students,2021-22,61917,5454,56463,91.2,364,118,32.4
8,All Students,2022-23,62064,5069,56995,91.8,371,121,32.6
9,All Students,2020-21,26,s,s,s,s,s,s
9,All Students,2022-23,6,s,s,s,s,s,s
All Grades,All Students,2018-19,138476,12911,125565,90.7,879,342,38.9
All Grades,All Students,2019-20,94453,8328,86125,91.2,876,267,30.5
All Grades,All Students,2020-21,141862,25263,116599,82.2,858,525,61.2
All Grades,All Students,2021-22,137217,21102,116115,84.6,860,530,61.6
All Grades,All Students,2022-23,144487,19538,124949,86.5,906,523,57.7
PK in K-12 Schools,All Students,2018-19,8061,984,7077,87.8,54,34,63.0
PK in K-12 Schools,All Students,2019-20,5417,607,4810,88.8,53,21,39.6
PK in K-12 Schools,All Students,2020-21,6926,1069,5857,84.6,46,27,58.7
PK in K-12 Schools,All Students,2021-22,6860,1132,5728,83.5,48,29,60.4
PK in K-12 Schools,All Students,2022-23,8670,1588,7082,81.7,59,46,78.0
0K,All Students,2018-19,14490,1735,12755,88.0,100,52,52.0
0K,All Students,2019-20,11238,1423,9815,87.3,109,50,45.9
0K,All Students,2020-21,15254,2845,12409,81.3,97,55,56.7
0K,All Students,2021-22,12864,2269,10595,82.4,84,59,70.2
0K,All Students,2022-23,13563,2227,11336,83.6,91,63,69.2
1,All Students,2018-19,20818,2168,18650,89.6,132,58,43.9
1,All Students,2019-20,11399,989,10410,91.3,104,30,28.8
1,All Students,2020-21,16903,2954,13949,82.5,103,55,53.4
1,All Students,2021-22,15406,2081,13325,86.5,101,59,58.4
1,All Students,2022-23,13019,2214,10805,83.0,87,59,67.8
2,All Students,2018-19,14660,1345,13315,90.8,95,41,43.2
2,All Students,2019-20,12210,1065,11145,91.3,114,34,29.8
2,All Students,2020-21,16855,2481,14374,85.3,103,61,59.2
2,All Students,2021-22,14999,2391,12608,84.1,94,59,62.8
2,All Students,2022-23,16578,2206,14372,86.7,102,61,59.8
3,All Students,2018-19,12517,1094,11423,91.3,81,27,33.3
3,All Students,2019-20,8530,702,7828,91.8,80,24,30.0
3,All Students,2020-21,17653,3157,14496,82.1,108,70,64.8
3,All Students,2021-22,15732,2350,13382,85.1,100,62,62.0
3,All Students,2022-23,17467,2361,15106,86.5,107,63,58.9
4,All Students,2018-19,16033,1303,14730,91.9,104,36,34.6
4,All Students,2019-20,8727,620,8107,92.9,79,19,24.1
4,All Students,2020-21,13418,2381,11037,82.3,80,50,62.5
4,All Students,2021-22,18659,2477,16182,86.7,114,64,56.1
4,All Students,2022-23,15057,1890,13167,87.4,99,57,57.6
5,All Students,2018-19,14162,1301,12861,90.8,86,33,38.4
5,All Students,2019-20,10314,817,9497,92.1,99,27,27.3
5,All Students,2020-21,13137,1852,11285,85.9,77,41,53.2
5,All Students,2021-22,13072,2054,11018,84.3,83,48,57.8
5,All Students,2022-23,18895,2003,16892,89.4,115,54,47.0
6,All Students,2018-19,14401,1209,13192,91.6,90,24,26.7
6,All Students,2019-20,9041,780,8261,91.4,81,26,32.1
6,All Students,2020-21,15847,3435,12412,78.3,93,67,72.0
6,All Students,2021-22,13199,1902,11297,85.6,78,44,56.4
6,All Students,2022-23,13443,1836,11607,86.3,82,43,52.4
7,All Students,2018-19,12912,1098,11814,91.5,75,22,29.3
7,All Students,2019-20,8908,672,8236,92.5,82,21,25.6
7,All Students,2020-21,12636,2605,10031,79.4,74,50,67.6
7,All Students,2021-22,14786,2580,12206,82.6,87,59,67.8
7,All Students,2022-23,12622,1307,11315,89.6,74,32,43.2
8,All Students,2018-19,10422,674,9748,93.5,62,15,24.2
8,All Students,2019-20,8669,653,8016,92.5,76,16,21.1
8,All Students,2020-21,13230,2482,10748,81.2,77,49,63.6
8,All Students,2021-22,11640,1866,9774,84.0,71,47,66.2
8,All Students,2022-23,15173,1906,13267,87.4,90,45,50.0
All Grades,All Students,2018-19,80968,5735,75233,92.9,500,126,25.2
All Grades,All Students,2019-20,49493,4052,45441,91.8,475,150,31.6
All Grades,All Students,2020-21,70462,9215,61247,86.9,431,198,45.9
All Grades,All Students,2021-22,65885,8651,57234,86.9,413,219,53.0
All Grades,All Students,2022-23,67759,7348,60411,89.2,422,189,44.8
PK in K-12 Schools,All Students,2018-19,5701,585,5116,89.7,40,20,50.0
PK in K-12 Schools,All Students,2019-20,3726,510,3216,86.3,36,22,61.1
PK in K-12 Schools,All Students,2020-21,4705,1064,3641,77.4,28,16,57.1
PK in K-12 Schools,All Students,2021-22,8158,1536,6622,81.2,53,38,71.7
PK in K-12 Schools,All Students,2022-23,7753,1344,6409,82.7,48,34,70.8
0K,All Students,2018-19,11117,1198,9919,89.2,72,33,45.8
0K,All Students,2019-20,7809,814,6995,89.6,76,27,35.5
0K,All Students,2020-21,11382,1461,9921,87.2,74,33,44.6
0K,All Students,2021-22,8478,1423,7055,83.2,56,34,60.7
0K,All Students,2022-23,12164,1517,10647,87.5,79,46,58.2
1,All Students,2018-19,12171,767,11404,93.7,76,17,22.4
1,All Students,2019-20,7366,865,6501,88.3,72,35,48.6
1,All Students,2020-21,11617,1690,9927,85.5,70,36,51.4
1,All Students,2021-22,9556,1515,8041,84.1,59,37,62.7
1,All Students,2022-23,8343,949,7394,88.6,50,25,50.0
2,All Students,2018-19,12494,781,11713,93.7,75,15,20.0
2,All Students,2019-20,7340,555,6785,92.4,71,17,23.9
2,All Students,2020-21,8966,1396,7570,84.4,58,34,58.6
2,All Students,2021-22,9817,925,8892,90.6,61,22,36.1
2,All Students,2022-23,10053,1144,8909,88.6,63,30,47.6
3,All Students,2018-19,11276,751,10525,93.3,69,14,20.3
3,All Students,2019-20,8697,620,8077,92.9,84,28,33.3
3,All Students,2020-21,11098,1145,9953,89.7,67,27,40.3
3,All Students,2021-22,7508,773,6735,89.7,48,25,52.1
3,All Students,2022-23,10480,869,9611,91.7,65,19,29.2
4,All Students,2018-19,12327,673,11654,94.5,76,11,14.5
4,All Students,2019-20,7037,430,6607,93.9,65,16,24.6
4,All Students,2020-21,12339,1173,11166,90.5,73,24,32.9
4,All Students,2021-22,10457,1047,9410,90.0,63,27,42.9
4,All Students,2022-23,7689,799,6890,89.6,49,20,40.8
5,All Students,2018-19,15882,980,14902,93.8,92,16,17.4
5,All Students,2019-20,7518,258,7260,96.6,71,5,7.0
5,All Students,2020-21,10355,1286,9069,87.6,61,28,45.9
5,All Students,2021-22,11911,1432,10479,88.0,73,36,49.3
5,All Students,2022-23,11277,726,10551,93.6,68,15,22.1
All Grades,All Students,2018-19,134080,8093,125987,94.0,803,159,19.8
All Grades,All Students,2019-20,81630,4267,77363,94.8,729,99,13.6
All Grades,All Students,2020-21,119290,4244,115046,96.4,713,68,9.5
All Grades,All Students,2021-22,117550,10112,107438,91.4,715,246,34.4
All Grades,All Students,2022-23,117172,10092,107080,91.4,712,233,32.7
PK in K-12 Schools,All Students,2022-23,2577,391,2186,84.8,16,12,75.0
0K,All Students,2018-19,18050,1898,16152,89.5,111,53,47.7
0K,All Students,2019-20,11961,1161,10800,90.3,109,39,35.8
0K,All Students,2020-21,16830,1035,15795,93.9,101,21,20.8
0K,All Students,2021-22,16611,2218,14393,86.6,104,64,61.5
0K,All Students,2022-23,21183,2672,18511,87.4,127,62,48.8
1,All Students,2018-19,17369,1359,16010,92.2,104,31,29.8
1,All Students,2019-20,12886,849,12037,93.4,117,24,20.5
1,All Students,2020-21,18271,756,17515,95.9,109,11,10.1
1,All Students,2021-22,19137,2016,17121,89.5,118,50,42.4
1,All Students,2022-23,17913,1736,16177,90.3,112,40,35.7
2,All Students,2018-19,23444,1285,22159,94.5,142,23,16.2
2,All Students,2019-20,11221,577,10644,94.9,100,14,14.0
2,All Students,2020-21,19945,628,19317,96.9,118,10,8.5
2,All Students,2021-22,18924,1797,17127,90.5,114,45,39.5
2,All Students,2022-23,18779,1594,17185,91.5,115,42,36.5
3,All Students,2018-19,24257,1285,22972,94.7,144,18,12.5
3,All Students,2019-20,15434,632,14802,95.9,138,7,5.1
3,All Students,2020-21,17268,579,16689,96.6,104,8,7.7
3,All Students,2021-22,20523,1579,18944,92.3,122,33,27.0
3,All Students,2022-23,18667,1326,17341,92.9,114,31,27.2
4,All Students,2018-19,23027,1032,21995,95.5,137,17,12.4
4,All Students,2019-20,15066,613,14453,95.9,134,11,8.2
4,All Students,2020-21,23630,494,23136,97.9,144,8,5.6
4,All Students,2021-22,16614,1076,15538,93.5,107,28,26.2
4,All Students,2022-23,20441,1327,19114,93.5,123,25,20.3
5,All Students,2018-19,27933,1234,26699,95.6,165,17,10.3
5,All Students,2019-20,15062,435,14627,97.1,131,4,3.1
5,All Students,2020-21,23346,752,22594,96.8,137,10,7.3
5,All Students,2021-22,25741,1426,24315,94.5,150,26,17.3
5,All Students,2022-23,17612,1046,16566,94.1,105,21,20.0
All Grades,All Students,2018-19,64387,4950,59437,92.3,398,100,25.1
All Grades,All Students,2019-20,37984,2735,35249,92.8,354,83,23.4
All Grades,All Students,2020-21,56329,3475,52854,93.8,342,75,21.9
All Grades,All Students,2021-22,55450,6868,48582,87.6,338,162,47.9
All Grades,All Students,2022-23,56247,5943,50304,89.4,342,140,40.9
PK in K-12 Schools,All Students,2018-19,5672,903,4769,84.1,36,23,63.9
PK in K-12 Schools,All Students,2019-20,3088,300,2788,90.3,31,11,35.5
PK in K-12 Schools,All Students,2020-21,5722,171,5551,97.0,35,3,8.6
PK in K-12 Schools,All Students,2021-22,5633,978,4655,82.6,37,23,62.2
PK in K-12 Schools,All Students,2022-23,5222,694,4528,86.7,33,17,51.5
0K,All Students,2018-19,10572,849,9723,92.0,65,15,23.1
0K,All Students,2019-20,4856,512,4344,89.5,46,19,41.3
0K,All Students,2020-21,8206,645,7561,92.1,53,21,39.6
0K,All Students,2021-22,9285,1243,8042,86.6,58,31,53.4
0K,All Students,2022-23,7322,1076,6246,85.3,46,30,65.2
1,All Students,2018-19,10751,763,9988,92.9,65,14,21.5
1,All Students,2019-20,5813,448,5365,92.3,52,14,26.9
1,All Students,2020-21,6978,476,6502,93.2,42,9,21.4
1,All Students,2021-22,6598,779,5819,88.2,38,15,39.5
1,All Students,2022-23,9210,1046,8164,88.6,59,22,37.3
2,All Students,2018-19,9315,600,8715,93.6,56,10,17.9
2,All Students,2019-20,6237,365,5872,94.1,57,8,14.0
2,All Students,2020-21,8584,302,8282,96.5,51,4,7.8
2,All Students,2021-22,7270,938,6332,87.1,46,23,50.0
2,All Students,2022-23,6673,590,6083,91.2,41,13,31.7
3,All Students,2018-19,11332,843,10489,92.6,77,19,24.7
3,All Students,2019-20,5607,337,5270,94.0,52,11,21.2
3,All Students,2020-21,8743,469,8274,94.6,52,9,17.3
3,All Students,2021-22,8849,961,7888,89.1,53,24,45.3
3,All Students,2022-23,7438,735,6703,90.1,45,19,42.2
4,All Students,2018-19,9183,605,8578,93.4,52,9,17.3
4,All Students,2019-20,6241,373,5868,94.0,61,11,18.0
4,All Students,2020-21,7826,614,7212,92.2,48,13,27.1
4,All Students,2021-22,9340,826,8514,91.2,56,18,32.1
4,All Students,2022-23,10312,1025,9287,90.1,60,23,38.3
5,All Students,2018-19,7562,387,7175,94.9,47,10,21.3
5,All Students,2019-20,6142,400,5742,93.5,55,9,16.4
5,All Students,2020-21,10239,797,9442,92.2,60,16,26.7
5,All Students,2021-22,8475,1143,7332,86.5,50,28,56.0
5,All Students,2022-23,10070,777,9293,92.3,58,16,27.6
All Grades,All Students,2018-19,60013,5075,54938,91.5,374,118,31.6
All Grades,All Students,2019-20,37035,3042,33993,91.8,340,100,29.4
All Grades,All Students,2020-21,50393,5968,44425,88.2,308,123,39.9
All Grades,All Students,2021-22,54033,6125,47908,88.7,341,158,46.3
All Grades,All Students,2022-23,54572,5109,49463,90.6,348,137,39.4
PK in K-12 Schools,All Students,2018-19,4148,656,3492,84.2,26,15,57.7
PK in K-12 Schools,All Students,2019-20,2593,417,2176,83.9,27,18,66.7
PK in K-12 Schools,All Students,2020-21,3273,431,2842,86.8,21,12,57.1
PK in K-12 Schools,All Students,2021-22,3810,732,3078,80.8,26,20,76.9
PK in K-12 Schools,All Students,2022-23,3231,557,2674,82.8,23,17,73.9
0K,All Students,2018-19,9420,938,8482,90.0,57,24,42.1
0K,All Students,2019-20,5998,697,5301,88.4,54,22,40.7
0K,All Students,2020-21,5705,666,5039,88.3,39,18,46.2
0K,All Students,2021-22,8290,1114,7176,86.6,52,32,61.5
0K,All Students,2022-23,7616,944,6672,87.6,48,26,54.2
1,All Students,2018-19,8264,612,7652,92.6,54,15,27.8
1,All Students,2019-20,6663,522,6141,92.2,61,16,26.2
1,All Students,2020-21,9245,1651,7594,82.1,56,28,50.0
1,All Students,2021-22,5984,872,5112,85.4,40,27,67.5
1,All Students,2022-23,8332,695,7637,91.7,52,18,34.6
2,All Students,2018-19,8640,651,7989,92.5,57,20,35.1
2,All Students,2019-20,5378,364,5014,93.2,49,13,26.5
2,All Students,2020-21,10064,1117,8947,88.9,61,25,41.0
2,All Students,2021-22,8576,843,7733,90.2,54,19,35.2
2,All Students,2022-23,7178,747,6431,89.6,47,24,51.1
3,All Students,2018-19,9547,714,8833,92.5,62,16,25.8
3,All Students,2019-20,4531,265,4266,94.2,42,8,19.0
3,All Students,2020-21,8005,620,7385,92.3,47,12,25.5
3,All Students,2021-22,10492,1014,9478,90.3,65,23,35.4
3,All Students,2022-23,8069,580,7489,92.8,51,12,23.5
4,All Students,2018-19,10384,620,9764,94.0,61,7,11.5
4,All Students,2019-20,5210,405,4805,92.2,47,13,27.7
4,All Students,2020-21,6735,744,5991,89.0,41,14,34.1
4,All Students,2021-22,8857,807,8050,90.9,54,19,35.2
4,All Students,2022-23,11121,908,10213,91.8,71,23,32.4
5,All Students,2018-19,9610,884,8726,90.8,57,21,36.8
5,All Students,2019-20,6662,372,6290,94.4,60,10,16.7
5,All Students,2020-21,7366,739,6627,90.0,43,14,32.6
5,All Students,2021-22,8024,743,7281,90.7,50,18,36.0
5,All Students,2022-23,9025,678,8347,92.5,56,17,30.4
All Grades,All Students,2018-19,166470,11317,155153,93.2,996,246,24.7
All Grades,All Students,2019-20,101681,7656,94025,92.5,927,246,26.5
All Grades,All Students,2020-21,137613,13339,124274,90.3,828,256,30.9
All Grades,All Students,2021-22,130819,16803,114016,87.2,814,410,50.4
All Grades,All Students,2022-23,132593,16563,116030,87.5,840,438,52.1
PK in K-12 Schools,All Students,2018-19,15040,1562,13478,89.6,94,41,43.6
PK in K-12 Schools,All Students,2019-20,7794,1288,6506,83.5,74,50,67.6
PK in K-12 Schools,All Students,2020-21,9006,507,8499,94.4,60,13,21.7
PK in K-12 Schools,All Students,2021-22,12606,2492,10114,80.2,79,55,69.6
PK in K-12 Schools,All Students,2022-23,14757,2872,11885,80.5,95,76,80.0
0K,All Students,2018-19,25610,2161,23449,91.6,155,52,33.5
0K,All Students,2019-20,14884,1385,13499,90.7,141,57,40.4
0K,All Students,2020-21,16822,2174,14648,87.1,108,43,39.8
0K,All Students,2021-22,17844,2953,14891,83.5,123,78,63.4
0K,All Students,2022-23,20892,3336,17556,84.0,134,91,67.9
1,All Students,2018-19,24626,1751,22875,92.9,148,35,23.6
1,All Students,2019-20,16384,1307,15077,92.0,149,44,29.5
1,All Students,2020-21,22698,2246,20452,90.1,134,41,30.6
1,All Students,2021-22,16047,2179,13868,86.4,102,61,59.8
1,All Students,2022-23,19100,2316,16784,87.9,122,66,54.1
2,All Students,2018-19,23307,1440,21867,93.8,140,31,22.1
2,All Students,2019-20,16097,1083,15014,93.3,148,32,21.6
2,All Students,2020-21,22002,1792,20210,91.9,133,38,28.6
2,All Students,2021-22,22029,2617,19412,88.1,133,62,46.6
2,All Students,2022-23,15574,1754,13820,88.7,105,46,43.8
3,All Students,2018-19,23744,1469,22275,93.8,141,31,22.0
3,All Students,2019-20,14478,835,13643,94.2,129,19,14.7
3,All Students,2020-21,23830,2172,21658,90.9,143,41,28.7
3,All Students,2021-22,20035,2099,17936,89.5,122,43,35.2
3,All Students,2022-23,21526,2320,19206,89.2,132,58,43.9
4,All Students,2018-19,25283,1403,23880,94.5,149,24,16.1
4,All Students,2019-20,14963,797,14166,94.7,134,22,16.4
4,All Students,2020-21,21053,1905,19148,91.0,123,36,29.3
4,All Students,2021-22,20852,2295,18557,89.0,127,55,43.3
4,All Students,2022-23,19806,1740,18066,91.2,125,48,38.4
5,All Students,2018-19,28860,1531,27329,94.7,169,32,18.9
5,All Students,2019-20,17081,961,16120,94.4,152,22,14.5
5,All Students,2020-21,22202,2543,19659,88.5,127,44,34.6
5,All Students,2021-22,21406,2168,19238,89.9,128,56,43.8
5,All Students,2022-23,20938,2225,18713,89.4,127,53,41.7
All Grades,All Students,2018-19,102478,9088,93390,91.1,621,201,32.4
All Grades,All Students,2019-20,58914,4685,54229,92.0,547,160,29.3
All Grades,All Students,2020-21,84691,5425,79266,93.6,507,100,19.7
All Grades,All Students,2021-22,78869,9313,69556,88.2,484,203,41.9
All Grades,All Students,2022-23,70417,6542,63875,90.7,434,169,38.9
PK in K-12 Schools,All Students,2018-19,8744,924,7820,89.4,53,22,41.5
PK in K-12 Schools,All Students,2019-20,3875,s,s,s,s,s,s
PK in K-12 Schools,All Students,2020-21,4897,306,4591,93.8,29,5,17.2
PK in K-12 Schools,All Students,2021-22,7010,s,s,s,s,s,s
PK in K-12 Schools,All Students,2022-23,8115,988,7127,87.8,52,31,59.6
0K,All Students,2018-19,12931,1281,11650,90.1,79,30,38.0
0K,All Students,2019-20,8226,747,7479,90.9,79,31,39.2
0K,All Students,2020-21,12786,958,11828,92.5,78,14,17.9
0K,All Students,2021-22,10094,1136,8958,88.7,63,29,46.0
0K,All Students,2022-23,8567,1095,7472,87.2,55,30,54.5
1,All Students,2018-19,15018,1733,13285,88.5,95,42,44.2
1,All Students,2019-20,8221,709,7512,91.4,75,22,29.3
1,All Students,2020-21,12250,925,11325,92.4,75,19,25.3
1,All Students,2021-22,10253,1912,8341,81.4,67,40,59.7
1,All Students,2022-23,10184,888,9296,91.3,63,22,34.9
2,All Students,2018-19,15622,1247,14375,92.0,97,26,26.8
2,All Students,2019-20,9568,719,8849,92.5,91,24,26.4
2,All Students,2020-21,12964,811,12153,93.7,76,14,18.4
2,All Students,2021-22,11389,1260,10129,88.9,69,30,43.5
2,All Students,2022-23,8679,798,7881,90.8,53,20,37.7
3,All Students,2018-19,16019,1463,14556,90.9,97,34,35.1
3,All Students,2019-20,9934,809,9125,91.9,91,24,26.4
3,All Students,2020-21,13444,811,12633,94.0,81,16,19.8
3,All Students,2021-22,12658,1116,11542,91.2,77,20,26.0
3,All Students,2022-23,10037,831,9206,91.7,62,23,37.1
4,All Students,2018-19,14398,992,13406,93.1,86,22,25.6
4,All Students,2019-20,10194,781,9413,92.3,92,25,27.2
4,All Students,2020-21,13791,828,12963,94.0,84,17,20.2
4,All Students,2021-22,13325,1469,11856,89.0,76,28,36.8
4,All Students,2022-23,11534,939,10595,91.9,69,18,26.1
5,All Students,2018-19,19746,1448,18298,92.7,114,25,21.9
5,All Students,2019-20,8894,564,8330,93.7,81,20,24.7
5,All Students,2020-21,14559,786,13773,94.6,84,15,17.9
5,All Students,2021-22,14137,1420,12717,90.0,86,27,31.4
5,All Students,2022-23,13301,1003,12298,92.5,80,25,31.3
6,All Students,2019-20,2,s,s,s,s,s,s
6,All Students,2021-22,3,s,s,s,s,s,s
All Grades,All Students,2018-19,125383,10342,115041,91.8,766,215,28.1
All Grades,All Students,2019-20,72183,5275,66908,92.7,681,163,23.9
All Grades,All Students,2020-21,103912,5217,98695,95.0,622,106,17.0
All Grades,All Students,2021-22,110069,11179,98890,89.8,700,291,41.6
All Grades,All Students,2022-23,109035,12155,96880,88.9,675,310,45.9
PK in K-12 Schools,All Students,2018-19,7087,917,6170,87.1,44,25,56.8
PK in K-12 Schools,All Students,2019-20,4418,581,3837,86.8,44,21,47.7
PK in K-12 Schools,All Students,2020-21,4307,92,4215,97.9,29,0,0.0
PK in K-12 Schools,All Students,2021-22,11680,1781,9899,84.8,75,55,73.3
PK in K-12 Schools,All Students,2022-23,11564,1777,9787,84.6,73,48,65.8
0K,All Students,2018-19,8994,1018,7976,88.7,58,23,39.7
0K,All Students,2019-20,4999,438,4561,91.2,48,15,31.3
0K,All Students,2020-21,7685,261,7424,96.6,48,5,10.4
0K,All Students,2021-22,7461,881,6580,88.2,51,27,52.9
0K,All Students,2022-23,8875,1324,7551,85.1,53,37,69.8
1,All Students,2018-19,9067,821,8246,90.9,59,21,35.6
1,All Students,2019-20,5090,468,4622,90.8,50,16,32.0
1,All Students,2020-21,8148,290,7858,96.4,50,5,10.0
1,All Students,2021-22,7894,983,6911,87.5,53,26,49.1
1,All Students,2022-23,8289,1085,7204,86.9,55,31,56.4
2,All Students,2018-19,9784,959,8825,90.2,62,24,38.7
2,All Students,2019-20,5389,406,4983,92.5,50,13,26.0
2,All Students,2020-21,7874,256,7618,96.7,48,6,12.5
2,All Students,2021-22,8022,718,7304,91.0,50,18,36.0
2,All Students,2022-23,6781,856,5925,87.4,46,25,54.3
3,All Students,2018-19,10599,801,9798,92.4,68,15,22.1
3,All Students,2019-20,6030,483,5547,92.0,59,16,27.1
3,All Students,2020-21,8547,225,8322,97.4,50,3,6.0
3,All Students,2021-22,8718,872,7846,90.0,56,26,46.4
3,All Students,2022-23,8218,727,7491,91.2,51,17,33.3
4,All Students,2018-19,10626,949,9677,91.1,67,18,26.9
4,All Students,2019-20,7002,454,6548,93.5,66,18,27.3
4,All Students,2020-21,9497,300,9197,96.8,57,4,7.0
4,All Students,2021-22,8878,692,8186,92.2,54,16,29.6
4,All Students,2022-23,9082,844,8238,90.7,59,24,40.7
5,All Students,2018-19,9133,563,8570,93.8,53,8,15.1
5,All Students,2019-20,6473,458,6015,92.9,61,14,23.0
5,All Students,2020-21,11063,450,10613,95.9,65,7,10.8
5,All Students,2021-22,9808,874,8934,91.1,64,22,34.4
5,All Students,2022-23,9720,894,8826,90.8,61,20,32.8
6,All Students,2018-19,18900,1347,17553,92.9,116,27,23.3
6,All Students,2019-20,9291,491,8800,94.7,87,13,14.9
6,All Students,2020-21,14676,657,14019,95.5,88,17,19.3
6,All Students,2021-22,16099,1483,14616,90.8,104,33,31.7
6,All Students,2022-23,16172,1430,14742,91.2,96,32,33.3
7,All Students,2018-19,21299,1373,19926,93.6,124,22,17.7
7,All Students,2019-20,11077,628,10449,94.3,102,16,15.7
7,All Students,2020-21,15467,1108,14359,92.8,90,25,27.8
7,All Students,2021-22,15946,1527,14419,90.4,100,37,37.0
7,All Students,2022-23,15198,1594,13604,89.5,91,37,40.7
8,All Students,2018-19,19894,1594,18300,92.0,115,32,27.8
8,All Students,2019-20,12414,868,11546,93.0,114,21,18.4
8,All Students,2020-21,16648,1578,15070,90.5,97,34,35.1
8,All Students,2021-22,15563,1368,14195,91.2,93,31,33.3
8,All Students,2022-23,15136,1624,13512,89.3,90,39,43.3
All Grades,All Students,2018-19,100795,7925,92870,92.1,615,167,27.2
All Grades,All Students,2019-20,64386,4957,59429,92.3,590,155,26.3
All Grades,All Students,2020-21,85932,10569,75363,87.7,514,185,36.0
All Grades,All Students,2021-22,74559,8748,65811,88.3,455,197,43.3
All Grades,All Students,2022-23,75214,7169,68045,90.5,466,155,33.3
PK in K-12 Schools,All Students,2018-19,2055,198,1857,90.4,15,5,33.3
PK in K-12 Schools,All Students,2019-20,2067,288,1779,86.1,18,9,50.0
PK in K-12 Schools,All Students,2020-21,1325,54,1271,95.9,9,1,11.1
PK in K-12 Schools,All Students,2021-22,1535,385,1150,74.9,11,9,81.8
PK in K-12 Schools,All Students,2022-23,2282,359,1923,84.3,16,13,81.3
0K,All Students,2018-19,7627,967,6660,87.3,49,23,46.9
0K,All Students,2019-20,5172,497,4675,90.4,49,17,34.7
0K,All Students,2020-21,6124,982,5142,84.0,38,19,50.0
0K,All Students,2021-22,5013,728,4285,85.5,30,16,53.3
0K,All Students,2022-23,6192,738,5454,88.1,41,20,48.8
1,All Students,2018-19,9644,985,8659,89.8,61,18,29.5
1,All Students,2019-20,5497,452,5045,91.8,53,18,34.0
1,All Students,2020-21,7692,1071,6621,86.1,46,21,45.7
1,All Students,2021-22,6804,906,5898,86.7,43,23,53.5
1,All Students,2022-23,4625,527,4098,88.6,30,17,56.7
2,All Students,2018-19,9529,922,8607,90.3,57,23,40.4
2,All Students,2019-20,7092,658,6434,90.7,64,16,25.0
2,All Students,2020-21,7001,932,6069,86.7,44,18,40.9
2,All Students,2021-22,8037,954,7083,88.1,48,22,45.8
2,All Students,2022-23,7491,734,6757,90.2,48,16,33.3
3,All Students,2018-19,9389,540,8849,94.2,56,10,17.9
3,All Students,2019-20,5182,355,4827,93.1,47,10,21.3
3,All Students,2020-21,7882,899,6983,88.6,47,16,34.0
3,All Students,2021-22,6070,540,5530,91.1,36,12,33.3
3,All Students,2022-23,7730,819,6911,89.4,47,15,31.9
4,All Students,2018-19,9373,726,8647,92.3,61,18,29.5
4,All Students,2019-20,6366,530,5836,91.7,61,17,27.9
4,All Students,2020-21,8256,1195,7061,85.5,49,16,32.7
4,All Students,2021-22,7629,764,6865,90.0,47,18,38.3
4,All Students,2022-23,6738,424,6314,93.7,43,7,16.3
5,All Students,2018-19,12535,789,11746,93.7,75,15,20.0
5,All Students,2019-20,5894,343,5551,94.2,53,7,13.2
5,All Students,2020-21,9347,1058,8289,88.7,56,21,37.5
5,All Students,2021-22,7739,1256,6483,83.8,49,28,57.1
5,All Students,2022-23,7980,576,7404,92.8,47,11,23.4
6,All Students,2018-19,15768,1065,14703,93.2,92,22,23.9
6,All Students,2019-20,8453,616,7837,92.7,77,21,27.3
6,All Students,2020-21,10501,1126,9375,89.3,62,17,27.4
6,All Students,2021-22,11174,1192,9982,89.3,65,25,38.5
6,All Students,2022-23,11375,1472,9903,87.1,72,29,40.3
7,All Students,2018-19,13261,947,12314,92.9,81,19,23.5
7,All Students,2019-20,10224,604,9620,94.1,92,22,23.9
7,All Students,2020-21,12388,2167,10221,82.5,73,36,49.3
7,All Students,2021-22,9025,843,8182,90.7,58,22,37.9
7,All Students,2022-23,11571,923,10648,92.0,67,15,22.4
8,All Students,2018-19,11614,786,10828,93.2,68,14,20.6
8,All Students,2019-20,8439,614,7825,92.7,76,18,23.7
8,All Students,2020-21,15416,1085,14331,93.0,90,20,22.2
8,All Students,2021-22,11533,1180,10353,89.8,68,22,32.4
8,All Students,2022-23,9230,597,8633,93.5,55,12,21.8
All Grades,All Students,2018-19,41157,5242,35915,87.3,255,117,45.9
All Grades,All Students,2019-20,22988,2495,20493,89.1,217,78,35.9
All Grades,All Students,2020-21,26691,3021,23670,88.7,164,60,36.6
All Grades,All Students,2021-22,29257,3336,25921,88.6,187,93,49.7
All Grades,All Students,2022-23,30739,3521,27218,88.5,195,88,45.1
PK in K-12 Schools,All Students,2018-19,2754,509,2245,81.5,20,13,65.0
PK in K-12 Schools,All Students,2019-20,1212,260,952,78.5,12,11,91.7
PK in K-12 Schools,All Students,2020-21,2476,308,2168,87.6,15,8,53.3
PK in K-12 Schools,All Students,2021-22,4421,641,3780,85.5,28,16,57.1
PK in K-12 Schools,All Students,2022-23,4806,681,4125,85.8,32,19,59.4
0K,All Students,2018-19,5086,674,4412,86.7,33,20,60.6
0K,All Students,2019-20,3000,373,2627,87.6,28,12,42.9
0K,All Students,2020-21,3319,581,2738,82.5,22,14,63.6
0K,All Students,2021-22,4446,591,3855,86.7,30,18,60.0
0K,All Students,2022-23,4122,713,3409,82.7,27,12,44.4
1,All Students,2018-19,4582,674,3908,85.3,29,15,51.7
1,All Students,2019-20,2819,238,2581,91.6,29,9,31.0
1,All Students,2020-21,3782,555,3227,85.3,22,7,31.8
1,All Students,2021-22,3815,456,3359,88.0,27,15,55.6
1,All Students,2022-23,4138,490,3648,88.2,26,15,57.7
2,All Students,2018-19,5553,507,5046,90.9,37,15,40.5
2,All Students,2019-20,2403,285,2118,88.1,22,10,45.5
2,All Students,2020-21,4449,235,4214,94.7,30,9,30.0
2,All Students,2021-22,3088,431,2657,86.0,19,10,52.6
2,All Students,2022-23,4066,483,3583,88.1,27,14,51.9
3,All Students,2018-19,7330,1162,6168,84.1,40,16,40.0
3,All Students,2019-20,2944,178,2766,94.0,28,5,17.9
3,All Students,2020-21,3337,281,3056,91.6,20,6,30.0
3,All Students,2021-22,5100,481,4619,90.6,32,15,46.9
3,All Students,2022-23,3008,241,2767,92.0,18,4,22.2
4,All Students,2018-19,9354,953,8401,89.8,58,23,39.7
4,All Students,2019-20,4550,584,3966,87.2,41,11,26.8
4,All Students,2020-21,3515,207,3308,94.1,22,5,22.7
4,All Students,2021-22,4515,394,4121,91.3,28,12,42.9
4,All Students,2022-23,5059,401,4658,92.1,32,10,31.3
5,All Students,2018-19,6498,763,5735,88.3,38,15,39.5
5,All Students,2019-20,6060,577,5483,90.5,57,20,35.1
5,All Students,2020-21,5813,854,4959,85.3,33,11,33.3
5,All Students,2021-22,3872,342,3530,91.2,23,7,30.4
5,All Students,2022-23,5540,512,5028,90.8,33,14,42.4
All Grades,All Students,2018-19,133585,7153,126432,94.6,775,106,13.7
All Grades,All Students,2019-20,83288,4236,79052,94.9,746,103,13.8
All Grades,All Students,2020-21,115907,2205,113702,98.1,683,32,4.7
All Grades,All Students,2021-22,110927,9546,101381,91.4,651,189,29.0
All Grades,All Students,2022-23,107346,7764,99582,92.8,626,147,23.5
PK in K-12 Schools,All Students,2018-19,9259,s,s,s,s,s,s
PK in K-12 Schools,All Students,2019-20,5146,394,4752,92.3,52,16,30.8
PK in K-12 Schools,All Students,2020-21,6925,239,6686,96.5,44,6,13.6
PK in K-12 Schools,All Students,2021-22,11770,1393,10377,88.2,68,31,45.6
PK in K-12 Schools,All Students,2022-23,11643,1177,10466,89.9,68,28,41.2
0K,All Students,2018-19,22653,1276,21377,94.4,134,22,16.4
0K,All Students,2019-20,12798,663,12135,94.8,116,14,12.1
0K,All Students,2020-21,13859,321,13538,97.7,82,4,4.9
0K,All Students,2021-22,13806,1698,12108,87.7,82,36,43.9
0K,All Students,2022-23,13768,1154,12614,91.6,81,22,27.2
1,All Students,2018-19,22588,1160,21428,94.9,131,17,13.0
1,All Students,2019-20,14408,702,13706,95.1,127,14,11.0
1,All Students,2020-21,17518,198,17320,98.9,103,1,1.0
1,All Students,2021-22,12888,1124,11764,91.3,78,25,32.1
1,All Students,2022-23,14210,1080,13130,92.4,85,21,24.7
2,All Students,2018-19,20352,1059,19293,94.8,116,16,13.8
2,All Students,2019-20,14764,667,14097,95.5,130,15,11.5
2,All Students,2020-21,20359,364,19995,98.2,122,7,5.7
2,All Students,2021-22,15918,1257,14661,92.1,94,23,24.5
2,All Students,2022-23,14583,1094,13489,92.5,85,24,28.2
3,All Students,2018-19,18081,1085,16996,94.0,103,13,12.6
3,All Students,2019-20,13440,644,12796,95.2,120,13,10.8
3,All Students,2020-21,21007,347,20660,98.3,121,4,3.3
3,All Students,2021-22,18059,1238,16821,93.1,103,18,17.5
3,All Students,2022-23,16305,1026,15279,93.7,93,16,17.2
4,All Students,2018-19,20151,1145,19006,94.3,117,18,15.4
4,All Students,2019-20,11441,607,10834,94.7,102,13,12.7
4,All Students,2020-21,19592,350,19242,98.2,114,5,4.4
4,All Students,2021-22,20207,1598,18609,92.1,120,32,26.7
4,All Students,2022-23,17231,1016,16215,94.1,101,16,15.8
5,All Students,2018-19,20498,895,19603,95.6,119,9,7.6
5,All Students,2019-20,11291,559,10732,95.0,99,18,18.2
5,All Students,2020-21,16647,386,16261,97.7,97,5,5.2
5,All Students,2021-22,18279,1238,17041,93.2,106,24,22.6
5,All Students,2022-23,19606,1217,18389,93.8,113,20,17.7
6,All Students,2018-19,3,s,s,s,s,s,s
All Grades,All Students,2018-19,57867,4964,52903,91.4,354,109,30.8
All Grades,All Students,2019-20,37251,2861,34390,92.3,347,89,25.6
All Grades,All Students,2020-21,50048,5496,44552,89.0,304,106,34.9
All Grades,All Students,2021-22,53476,6656,46820,87.6,330,167,50.6
All Grades,All Students,2022-23,55550,6474,49076,88.3,341,151,44.3
PK in K-12 Schools,All Students,2018-19,5262,592,4670,88.7,34,20,58.8
PK in K-12 Schools,All Students,2019-20,3440,330,3110,90.4,33,11,33.3
PK in K-12 Schools,All Students,2020-21,2091,s,s,s,s,s,s
PK in K-12 Schools,All Students,2021-22,8342,1440,6902,82.7,52,40,76.9
PK in K-12 Schools,All Students,2022-23,8104,1251,6853,84.6,53,28,52.8
0K,All Students,2018-19,6932,712,6220,89.7,43,17,39.5
0K,All Students,2019-20,5769,651,5118,88.7,55,24,43.6
0K,All Students,2020-21,9576,1535,8041,84.0,58,27,46.6
0K,All Students,2021-22,7090,935,6155,86.8,48,26,54.2
0K,All Students,2022-23,9456,1318,8138,86.1,58,35,60.3
1,All Students,2018-19,9215,725,8490,92.1,56,17,30.4
1,All Students,2019-20,4505,362,4143,92.0,42,12,28.6
1,All Students,2020-21,6312,752,5560,88.1,37,14,37.8
1,All Students,2021-22,9093,1295,7798,85.8,56,32,57.1
1,All Students,2022-23,9605,1058,8547,89.0,57,24,42.1
2,All Students,2018-19,9302,722,8580,92.2,57,14,24.6
2,All Students,2019-20,5781,354,5427,93.9,55,7,12.7
2,All Students,2020-21,6785,664,6121,90.2,43,17,39.5
2,All Students,2021-22,5565,585,4980,89.5,33,13,39.4
2,All Students,2022-23,7947,1009,6938,87.3,47,23,48.9
3,All Students,2018-19,9107,747,8360,91.8,57,16,28.1
3,All Students,2019-20,5238,411,4827,92.2,47,14,29.8
3,All Students,2020-21,8056,925,7131,88.5,48,14,29.2
3,All Students,2021-22,7226,696,6530,90.4,44,16,36.4
3,All Students,2022-23,4867,497,4370,89.8,30,10,33.3
4,All Students,2018-19,10239,737,9502,92.8,63,12,19.0
4,All Students,2019-20,5737,359,5378,93.7,54,10,18.5
4,All Students,2020-21,7818,600,7218,92.3,46,12,26.1
4,All Students,2021-22,8064,943,7121,88.3,49,24,49.0
4,All Students,2022-23,8156,684,7472,91.6,49,13,26.5
5,All Students,2018-19,7810,729,7081,90.7,44,13,29.5
5,All Students,2019-20,6781,394,6387,94.2,61,11,18.0
5,All Students,2020-21,9189,616,8573,93.3,55,13,23.6
5,All Students,2021-22,8096,762,7334,90.6,48,16,33.3
5,All Students,2022-23,7415,657,6758,91.1,47,18,38.3
6,All Students,2020-21,167,s,s,s,s,s,s
All Grades,All Students,2018-19,88417,3387,85030,96.2,543,48,8.8
All Grades,All Students,2019-20,54174,3241,50933,94.0,507,101,19.9
All Grades,All Students,2020-21,71432,10819,60613,84.9,422,214,50.7
All Grades,All Students,2021-22,69564,6992,62572,89.9,437,171,39.1
All Grades,All Students,2022-23,61107,5968,55139,90.2,386,147,38.1
5,All Students,2019-20,25,s,s,s,s,s,s
6,All Students,2018-19,23618,s,s,s,s,s,s
6,All Students,2019-20,16667,1126,15541,93.2,163,46,28.2
6,All Students,2020-21,23530,3894,19636,83.5,143,71,49.7
6,All Students,2021-22,18931,s,s,s,s,s,s
6,All Students,2022-23,17357,1814,15543,89.5,106,44,41.5
7,All Students,2018-19,32577,1059,31518,96.7,202,12,5.9
7,All Students,2019-20,15896,s,s,s,s,s,s
7,All Students,2020-21,24767,3594,21173,85.5,145,79,54.5
7,All Students,2021-22,22951,2358,20593,89.7,151,59,39.1
7,All Students,2022-23,21324,2115,19209,90.1,135,53,39.3
8,All Students,2018-19,32214,1306,30908,95.9,197,21,10.7
8,All Students,2019-20,21586,1203,20383,94.4,198,34,17.2
8,All Students,2020-21,23135,3331,19804,85.6,134,64,47.8
8,All Students,2021-22,27672,2804,24868,89.9,165,63,38.2
8,All Students,2022-23,22426,2039,20387,90.9,145,50,34.5
9,All Students,2018-19,8,s,s,s,s,s,s
9,All Students,2021-22,10,s,s,s,s,s,s
All Grades,All Students,2018-19,93601,7576,86025,91.9,569,161,28.3
All Grades,All Students,2019-20,53842,3918,49924,92.7,498,117,23.5
All Grades,All Students,2020-21,72053,5628,66425,92.2,438,126,28.8
All Grades,All Students,2021-22,61905,7684,54221,87.6,396,197,49.7
All Grades,All Students,2022-23,59323,7099,52224,88.0,379,181,47.8
PK in K-12 Schools,All Students,2018-19,9277,1012,8265,89.1,57,23,40.4
PK in K-12 Schools,All Students,2019-20,5229,545,4684,89.6,51,21,41.2
PK in K-12 Schools,All Students,2020-21,6343,408,5935,93.6,40,8,20.0
PK in K-12 Schools,All Students,2021-22,8537,1485,7052,82.6,56,44,78.6
PK in K-12 Schools,All Students,2022-23,9369,1286,8083,86.3,60,33,55.0
0K,All Students,2018-19,13740,1320,12420,90.4,88,36,40.9
0K,All Students,2019-20,7250,549,6701,92.4,69,16,23.2
0K,All Students,2020-21,7612,692,6920,90.9,50,20,40.0
0K,All Students,2021-22,8827,1322,7505,85.0,56,30,53.6
0K,All Students,2022-23,8417,1172,7245,86.1,54,31,57.4
1,All Students,2018-19,13566,1154,12412,91.5,84,27,32.1
1,All Students,2019-20,7553,768,6785,89.8,69,25,36.2
1,All Students,2020-21,9705,735,8970,92.4,58,18,31.0
1,All Students,2021-22,6468,870,5598,86.5,41,25,61.0
1,All Students,2022-23,8118,1000,7118,87.7,55,26,47.3
2,All Students,2018-19,13766,886,12880,93.6,86,20,23.3
2,All Students,2019-20,8524,637,7887,92.5,80,17,21.3
2,All Students,2020-21,10606,1151,9455,89.1,66,25,37.9
2,All Students,2021-22,7145,771,6374,89.2,47,21,44.7
2,All Students,2022-23,5726,685,5041,88.0,36,16,44.4
3,All Students,2018-19,14945,1051,13894,93.0,88,21,23.9
3,All Students,2019-20,8346,471,7875,94.4,75,14,18.7
3,All Students,2020-21,12224,852,11372,93.0,73,20,27.4
3,All Students,2021-22,8429,1099,7330,87.0,56,25,44.6
3,All Students,2022-23,6915,744,6171,89.2,45,22,48.9
4,All Students,2018-19,14457,952,13505,93.4,85,12,14.1
4,All Students,2019-20,9003,531,8472,94.1,83,14,16.9
4,All Students,2020-21,12612,732,11880,94.2,75,16,21.3
4,All Students,2021-22,11500,1308,10192,88.6,75,35,46.7
4,All Students,2022-23,8920,1011,7909,88.7,57,26,45.6
5,All Students,2018-19,13850,1201,12649,91.3,81,22,27.2
5,All Students,2019-20,7937,417,7520,94.7,71,10,14.1
5,All Students,2020-21,12951,1058,11893,91.8,76,19,25.0
5,All Students,2021-22,10999,829,10170,92.5,65,17,26.2
5,All Students,2022-23,11858,1201,10657,89.9,72,27,37.5
All Grades,All Students,2018-19,126924,5148,121776,95.9,733,50,6.8
All Grades,All Students,2019-20,85309,3765,81544,95.6,760,72,9.5
All Grades,All Students,2020-21,126128,4841,121287,96.2,741,96,13.0
All Grades,All Students,2021-22,115766,10800,104966,90.7,675,194,28.7
All Grades,All Students,2022-23,107970,8230,99740,92.4,630,178,28.3
0K,All Students,2018-19,12111,630,11481,94.8,70,10,14.3
0K,All Students,2019-20,7177,429,6748,94.0,66,12,18.2
0K,All Students,2020-21,10421,419,10002,96.0,64,10,15.6
0K,All Students,2021-22,7116,790,6326,88.9,44,16,36.4
0K,All Students,2022-23,5761,537,5224,90.7,37,17,45.9
1,All Students,2018-19,12275,491,11784,96.0,73,5,6.8
1,All Students,2019-20,7341,461,6880,93.7,66,10,15.2
1,All Students,2020-21,10859,464,10395,95.7,64,8,12.5
1,All Students,2021-22,10080,1012,9068,90.0,61,18,29.5
1,All Students,2022-23,6921,569,6352,91.8,42,12,28.6
2,All Students,2018-19,11560,519,11041,95.5,67,6,9.0
2,All Students,2019-20,8203,327,7876,96.0,73,3,4.1
2,All Students,2020-21,10353,161,10192,98.4,61,2,3.3
2,All Students,2021-22,9996,931,9065,90.7,58,17,29.3
2,All Students,2022-23,10395,1007,9388,90.3,59,20,33.9
3,All Students,2018-19,14368,535,13833,96.3,82,4,4.9
3,All Students,2019-20,7534,321,7213,95.7,67,6,9.0
3,All Students,2020-21,12178,301,11877,97.5,71,5,7.0
3,All Students,2021-22,9514,950,8564,90.0,55,16,29.1
3,All Students,2022-23,9516,810,8706,91.5,59,23,39.0
4,All Students,2018-19,13895,569,13326,95.9,81,7,8.6
4,All Students,2019-20,9771,405,9366,95.9,87,9,10.3
4,All Students,2020-21,11340,209,11131,98.2,65,2,3.1
4,All Students,2021-22,11420,888,10532,92.2,67,15,22.4
4,All Students,2022-23,9415,631,8784,93.3,55,13,23.6
5,All Students,2018-19,13388,489,12899,96.3,76,2,2.6
5,All Students,2019-20,10131,367,9764,96.4,91,6,6.6
5,All Students,2020-21,14072,394,13678,97.2,81,6,7.4
5,All Students,2021-22,10974,955,10019,91.3,63,13,20.6
5,All Students,2022-23,11277,683,10594,93.9,64,10,15.6
6,All Students,2018-19,17108,533,16575,96.9,99,5,5.1
6,All Students,2019-20,13422,535,12887,96.0,120,10,8.3
6,All Students,2020-21,20844,718,20126,96.6,122,18,14.8
6,All Students,2021-22,18090,1701,16389,90.6,106,32,30.2
6,All Students,2022-23,17360,1245,16115,92.8,100,28,28.0
7,All Students,2018-19,16001,745,15256,95.3,93,9,9.7
7,All Students,2019-20,10806,384,10422,96.4,94,3,3.2
7,All Students,2020-21,19575,1272,18303,93.5,116,29,25.0
7,All Students,2021-22,20762,1974,18788,90.5,119,40,33.6
7,All Students,2022-23,17152,1310,15842,92.4,98,29,29.6
8,All Students,2018-19,16218,637,15581,96.1,92,2,2.2
8,All Students,2019-20,10924,536,10388,95.1,96,13,13.5
8,All Students,2020-21,16486,903,15583,94.5,97,16,16.5
8,All Students,2021-22,17814,1599,16215,91.0,102,27,26.5
8,All Students,2022-23,20173,1438,18735,92.9,116,26,22.4
All Grades,All Students,2018-19,234089,19666,214423,91.6,1389,397,28.6
All Grades,All Students,2019-20,143737,9223,134514,93.6,1297,238,18.4
All Grades,All Students,2020-21,198322,55837,142485,71.8,1162,909,78.2
All Grades,All Students,2021-22,182247,22917,159330,87.4,1116,513,46.0
All Grades,All Students,2022-23,166089,16128,149961,90.3,1043,341,32.7
6,All Students,2018-19,71932,4639,67293,93.6,432,102,23.6
6,All Students,2019-20,45084,2938,42146,93.5,409,69,16.9
6,All Students,2020-21,56142,s,s,s,s,s,s
6,All Students,2021-22,55041,s,s,s,s,s,s
6,All Students,2022-23,48180,s,s,s,s,s,s
7,All Students,2018-19,77624,5737,71887,92.6,459,115,25.1
7,All Students,2019-20,47404,3099,44305,93.5,426,86,20.2
7,All Students,2020-21,69734,19607,50127,71.9,410,328,80.0
7,All Students,2021-22,58328,6746,51582,88.4,360,147,40.8
7,All Students,2022-23,56605,5196,51409,90.8,358,113,31.6
8,All Students,2018-19,84533,9290,75243,89.0,498,180,36.1
8,All Students,2019-20,51249,3186,48063,93.8,462,83,18.0
8,All Students,2020-21,72413,21854,50559,69.8,422,351,83.2
8,All Students,2021-22,68860,9359,59501,86.4,413,200,48.4
8,All Students,2022-23,61290,6364,54926,89.6,381,129,33.9
9,All Students,2020-21,33,s,s,s,s,s,s
9,All Students,2021-22,18,s,s,s,s,s,s
9,All Students,2022-23,14,s,s,s,s,s,s
All Grades,All Students,2018-19,69968,8841,61127,87.4,452,203,44.9
All Grades,All Students,2019-20,49186,5325,43861,89.2,464,158,34.1
All Grades,All Students,2020-21,79198,10952,68246,86.2,488,186,38.1
All Grades,All Students,2021-22,77462,11273,66189,85.4,480,229,47.7
All Grades,All Students,2022-23,78448,10869,67579,86.1,505,243,48.1
8,All Students,2020-21,169,s,s,s,s,s,s
8,All Students,2021-22,44,s,s,s,s,s,s
9,All Students,2018-19,16927,1878,15049,88.9,119,47,39.5
9,All Students,2019-20,15294,1727,13567,88.7,146,45,30.8
9,All Students,2020-21,24562,3649,20913,85.1,152,66,43.4
9,All Students,2021-22,18312,2592,15720,85.8,113,47,41.6
9,All Students,2022-23,21447,2730,18717,87.3,141,64,45.4
10,All Students,2018-19,18639,2364,16275,87.3,122,46,37.7
10,All Students,2019-20,11515,1184,10331,89.7,108,39,36.1
10,All Students,2020-21,21858,2962,18896,86.4,138,42,30.4
10,All Students,2021-22,22318,3072,19246,86.2,137,61,44.5
10,All Students,2022-23,17409,2373,15036,86.4,119,53,44.5
11,All Students,2018-19,20279,2419,17860,88.1,124,54,43.5
11,All Students,2019-20,9566,830,8736,91.3,90,23,25.6
11,All Students,2020-21,16563,2752,13811,83.4,101,44,43.6
11,All Students,2021-22,20795,2763,18032,86.7,131,57,43.5
11,All Students,2022-23,20625,2870,17755,86.1,128,65,50.8
12,All Students,2018-19,14123,2180,11943,84.6,87,56,64.4
12,All Students,2019-20,12811,1584,11227,87.6,120,51,42.5
12,All Students,2020-21,16046,s,s,s,s,s,s
12,All Students,2021-22,15993,s,s,s,s,s,s
12,All Students,2022-23,18967,2896,16071,84.7,117,61,52.1
All Grades,All Students,2018-19,61827,11667,50160,81.1,401,183,45.6
All Grades,All Students,2019-20,30053,4004,26049,86.7,293,103,35.2
All Grades,All Students,2020-21,40415,7895,32520,80.5,240,112,46.7
All Grades,All Students,2021-22,40181,7965,32216,80.2,278,168,60.4
All Grades,All Students,2022-23,40944,7640,33304,81.3,301,155,51.5
9,All Students,2018-19,13435,3425,10010,74.5,100,56,56.0
9,All Students,2019-20,7293,1117,6176,84.7,77,34,44.2
9,All Students,2020-21,7869,1273,6596,83.8,51,24,47.1
9,All Students,2021-22,10266,1924,8342,81.3,81,46,56.8
9,All Students,2022-23,8944,1452,7492,83.8,70,35,50.0
10,All Students,2018-19,16351,2370,13981,85.5,104,41,39.4
10,All Students,2019-20,6534,859,5675,86.9,66,24,36.4
10,All Students,2020-21,12095,3101,8994,74.4,70,35,50.0
10,All Students,2021-22,9398,2012,7386,78.6,69,43,62.3
10,All Students,2022-23,11918,2886,9032,75.8,93,47,50.5
11,All Students,2018-19,16535,3120,13415,81.1,103,39,37.9
11,All Students,2019-20,7428,962,6466,87.0,70,17,24.3
11,All Students,2020-21,9677,1736,7941,82.1,56,24,42.9
11,All Students,2021-22,11572,2529,9043,78.1,73,46,63.0
11,All Students,2022-23,10244,1724,8520,83.2,77,42,54.5
12,All Students,2018-19,15506,2752,12754,82.3,94,47,50.0
12,All Students,2019-20,8798,1066,7732,87.9,80,28,35.0
12,All Students,2020-21,10774,1785,8989,83.4,63,29,46.0
12,All Students,2021-22,8945,1500,7445,83.2,55,33,60.0
12,All Students,2022-23,9838,1578,8260,84.0,61,31,50.8
All Grades,All Students,2018-19,61718,4364,57354,92.9,378,86,22.8
All Grades,All Students,2019-20,38901,2922,35979,92.5,358,94,26.3
All Grades,All Students,2020-21,52323,5698,46625,89.1,306,88,28.8
All Grades,All Students,2021-22,46537,5574,40963,88.0,290,132,45.5
All Grades,All Students,2022-23,43033,4255,38778,90.1,278,116,41.7
PK in K-12 Schools,All Students,2018-19,4896,470,4426,90.4,30,13,43.3
PK in K-12 Schools,All Students,2019-20,2454,241,2213,90.2,24,8,33.3
PK in K-12 Schools,All Students,2020-21,2879,269,2610,90.7,18,6,33.3
PK in K-12 Schools,All Students,2021-22,3740,754,2986,79.8,26,20,76.9
PK in K-12 Schools,All Students,2022-23,3353,455,2898,86.4,28,16,57.1
0K,All Students,2018-19,7677,828,6849,89.2,51,20,39.2
0K,All Students,2019-20,5624,609,5015,89.2,53,23,43.4
0K,All Students,2020-21,5575,895,4680,83.9,35,16,45.7
0K,All Students,2021-22,5001,692,4309,86.2,34,23,67.6
0K,All Students,2022-23,5071,548,4523,89.2,36,21,58.3
1,All Students,2018-19,7189,482,6707,93.3,45,8,17.8
1,All Students,2019-20,4840,497,4343,89.7,46,18,39.1
1,All Students,2020-21,8451,1216,7235,85.6,49,13,26.5
1,All Students,2021-22,5292,626,4666,88.2,33,15,45.5
1,All Students,2022-23,4188,498,3690,88.1,28,12,42.9
2,All Students,2018-19,7898,520,7378,93.4,50,12,24.0
2,All Students,2019-20,4669,259,4410,94.5,43,7,16.3
2,All Students,2020-21,5676,801,4875,85.9,33,14,42.4
2,All Students,2021-22,7593,1169,6424,84.6,47,26,55.3
2,All Students,2022-23,4985,527,4458,89.4,32,13,40.6
3,All Students,2018-19,12853,743,12110,94.2,78,12,15.4
3,All Students,2019-20,7310,369,6941,95.0,65,9,13.8
3,All Students,2020-21,9192,739,8453,92.0,53,11,20.8
3,All Students,2021-22,8382,861,7521,89.7,50,18,36.0
3,All Students,2022-23,7974,679,7295,91.5,50,18,36.0
4,All Students,2018-19,11188,741,10447,93.4,65,13,20.0
4,All Students,2019-20,7454,543,6911,92.7,67,16,23.9
4,All Students,2020-21,9793,1075,8718,89.0,56,18,32.1
4,All Students,2021-22,7944,674,7270,91.5,49,16,32.7
4,All Students,2022-23,8749,795,7954,90.9,52,22,42.3
5,All Students,2018-19,10017,580,9437,94.2,59,8,13.6
5,All Students,2019-20,6550,404,6146,93.8,60,13,21.7
5,All Students,2020-21,10757,703,10054,93.5,62,10,16.1
5,All Students,2021-22,8585,798,7787,90.7,51,14,27.5
5,All Students,2022-23,8713,753,7960,91.4,52,14,26.9
All Grades,All Students,2018-19,97618,7413,90205,92.4,586,102,17.4
All Grades,All Students,2019-20,64901,4740,60161,92.7,598,101,16.9
All Grades,All Students,2020-21,106820,8825,97995,91.7,624,123,19.7
All Grades,All Students,2021-22,105568,10019,95549,90.5,649,211,32.5
All Grades,All Students,2022-23,107849,5222,102627,95.2,677,93,13.7
6,All Students,2018-19,14782,535,14247,96.4,84,2,2.4
6,All Students,2019-20,9703,345,9358,96.4,86,5,5.8
6,All Students,2020-21,18890,787,18103,95.8,110,10,9.1
6,All Students,2021-22,17302,1444,15858,91.7,106,29,27.4
6,All Students,2022-23,17629,692,16937,96.1,107,10,9.3
7,All Students,2018-19,13914,736,13178,94.7,80,5,6.3
7,All Students,2019-20,9567,390,9177,95.9,88,5,5.7
7,All Students,2020-21,14490,1074,13416,92.6,83,19,22.9
7,All Students,2021-22,16679,1316,15363,92.1,101,28,27.7
7,All Students,2022-23,15038,773,14265,94.9,89,13,14.6
8,All Students,2018-19,13045,616,12429,95.3,74,7,9.5
8,All Students,2019-20,8857,482,8375,94.6,81,11,13.6
8,All Students,2020-21,15501,1006,14495,93.5,89,18,20.2
8,All Students,2021-22,13832,1084,12748,92.2,81,19,23.5
8,All Students,2022-23,15118,486,14632,96.8,90,5,5.6
9,All Students,2018-19,15362,670,14692,95.6,93,11,11.8
9,All Students,2019-20,10857,1228,9629,88.7,102,27,26.5
9,All Students,2020-21,13813,958,12855,93.1,83,16,19.3
9,All Students,2021-22,17282,1926,15356,88.9,110,37,33.6
9,All Students,2022-23,19084,1154,17930,94.0,125,25,20.0
10,All Students,2018-19,14738,1681,13057,88.6,90,21,23.3
10,All Students,2019-20,9623,755,8868,92.2,89,18,20.2
10,All Students,2020-21,15403,1727,13676,88.8,88,17,19.3
10,All Students,2021-22,12919,1097,11822,91.5,82,27,32.9
10,All Students,2022-23,16165,760,15405,95.3,106,14,13.2
11,All Students,2018-19,11912,930,10982,92.2,74,17,23.0
11,All Students,2019-20,8771,617,8154,93.0,83,14,16.9
11,All Students,2020-21,15533,1857,13676,88.0,91,27,29.7
11,All Students,2021-22,13622,1331,12291,90.2,83,30,36.1
11,All Students,2022-23,12380,672,11708,94.6,80,10,12.5
12,All Students,2018-19,13865,2245,11620,83.8,91,39,42.9
12,All Students,2019-20,7523,923,6600,87.7,69,21,30.4
12,All Students,2020-21,13190,1416,11774,89.3,80,16,20.0
12,All Students,2021-22,13932,1821,12111,86.9,86,41,47.7
12,All Students,2022-23,12435,685,11750,94.5,80,16,20.0
All Grades,All Students,2018-19,71218,9515,61703,86.6,453,175,38.6
All Grades,All Students,2019-20,45800,5785,40015,87.4,444,187,42.1
All Grades,All Students,2020-21,69773,8455,61318,87.9,416,149,35.8
All Grades,All Students,2021-22,65881,11049,54832,83.2,422,225,53.3
All Grades,All Students,2022-23,70692,6259,64433,91.1,477,137,28.7
9,All Students,2018-19,16629,2939,13690,82.3,111,45,40.5
9,All Students,2019-20,11353,1395,9958,87.7,117,48,41.0
9,All Students,2020-21,19953,1931,18022,90.3,121,29,24.0
9,All Students,2021-22,15732,2342,13390,85.1,106,51,48.1
9,All Students,2022-23,18821,1378,17443,92.7,130,30,23.1
10,All Students,2018-19,13697,1637,12060,88.0,90,38,42.2
10,All Students,2019-20,10992,1447,9545,86.8,105,43,41.0
10,All Students,2020-21,19161,2590,16571,86.5,114,45,39.5
10,All Students,2021-22,19482,3007,16475,84.6,124,56,45.2
10,All Students,2022-23,20216,1721,18495,91.5,130,36,27.7
11,All Students,2018-19,20513,2003,18510,90.2,129,39,30.2
11,All Students,2019-20,9333,1144,8189,87.7,91,46,50.5
11,All Students,2020-21,14286,1586,12700,88.9,83,31,37.3
11,All Students,2021-22,14603,2512,12091,82.8,95,59,62.1
11,All Students,2022-23,17494,1569,15925,91.0,113,31,27.4
12,All Students,2018-19,20379,2936,17443,85.6,123,53,43.1
12,All Students,2019-20,14122,1799,12323,87.3,131,50,38.2
12,All Students,2020-21,16373,2348,14025,85.7,98,44,44.9
12,All Students,2021-22,16064,3188,12876,80.2,97,59,60.8
12,All Students,2022-23,14161,1591,12570,88.8,104,40,38.5
All Grades,All Students,2018-19,112565,6996,105569,93.8,645,132,20.5
All Grades,All Students,2019-20,74015,4873,69142,93.4,663,152,22.9
All Grades,All Students,2020-21,109173,15269,93904,86.0,637,280,44.0
All Grades,All Students,2021-22,106736,11683,95053,89.1,646,280,43.3
All Grades,All Students,2022-23,113400,11133,102267,90.2,668,253,37.9
0K,All Students,2018-19,13345,1103,12242,91.7,80,27,33.8
0K,All Students,2019-20,8818,830,7988,90.6,80,32,40.0
0K,All Students,2020-21,10540,1941,8599,81.6,63,33,52.4
0K,All Students,2021-22,12754,1841,10913,85.6,82,51,62.2
0K,All Students,2022-23,13606,1637,11969,88.0,82,41,50.0
1,All Students,2018-19,14039,1023,13016,92.7,80,20,25.0
1,All Students,2019-20,8609,548,8061,93.6,77,16,20.8
1,All Students,2020-21,12832,1835,10997,85.7,75,31,41.3
1,All Students,2021-22,10980,1329,9651,87.9,73,41,56.2
1,All Students,2022-23,15274,1593,13681,89.6,94,37,39.4
2,All Students,2018-19,12695,801,11894,93.7,73,15,20.5
2,All Students,2019-20,9304,608,8696,93.5,85,18,21.2
2,All Students,2020-21,11900,1332,10568,88.8,70,27,38.6
2,All Students,2021-22,12901,1218,11683,90.6,79,30,38.0
2,All Students,2022-23,10983,1219,9764,88.9,64,28,43.8
3,All Students,2018-19,12749,735,12014,94.2,73,12,16.4
3,All Students,2019-20,8333,570,7763,93.2,74,19,25.7
3,All Students,2020-21,13714,1768,11946,87.1,81,36,44.4
3,All Students,2021-22,10983,1075,9908,90.2,63,23,36.5
3,All Students,2022-23,12654,909,11745,92.8,72,17,23.6
4,All Students,2018-19,12121,599,11522,95.1,70,9,12.9
4,All Students,2019-20,7855,568,7287,92.8,72,17,23.6
4,All Students,2020-21,11844,1390,10454,88.3,68,25,36.8
4,All Students,2021-22,13484,1509,11975,88.8,81,28,34.6
4,All Students,2022-23,11692,1028,10664,91.2,72,25,34.7
5,All Students,2018-19,12638,762,11876,94.0,71,17,23.9
5,All Students,2019-20,7677,336,7341,95.6,67,7,10.4
5,All Students,2020-21,12202,1695,10507,86.1,70,36,51.4
5,All Students,2021-22,10792,s,s,s,s,s,s
5,All Students,2022-23,14762,1298,13464,91.2,86,31,36.0
6,All Students,2018-19,13847,677,13170,95.1,79,10,12.7
6,All Students,2019-20,7632,454,7178,94.1,67,15,22.4
6,All Students,2020-21,11969,1629,10340,86.4,69,31,44.9
6,All Students,2021-22,11724,1299,10425,88.9,70,32,45.7
6,All Students,2022-23,11911,1315,10596,89.0,69,30,43.5
7,All Students,2018-19,10319,600,9719,94.2,58,10,17.2
7,All Students,2019-20,8838,487,8351,94.5,80,17,21.3
7,All Students,2020-21,11514,1580,9934,86.3,68,25,36.8
7,All Students,2021-22,11703,1215,10488,89.6,69,27,39.1
7,All Students,2022-23,11573,1207,10366,89.6,65,23,35.4
8,All Students,2018-19,10812,696,10116,93.6,61,12,19.7
8,All Students,2019-20,6949,472,6477,93.2,61,11,18.0
8,All Students,2020-21,12658,2099,10559,83.4,73,36,49.3
8,All Students,2021-22,11408,977,10431,91.4,65,19,29.2
8,All Students,2022-23,10943,s,s,s,s,s,s
9,All Students,2021-22,7,s,s,s,s,s,s
9,All Students,2022-23,2,s,s,s,s,s,s
All Grades,All Students,2018-19,133192,6682,126510,95.0,772,99,12.8
All Grades,All Students,2019-20,86918,4445,82473,94.9,767,97,12.6
All Grades,All Students,2020-21,121103,11372,109731,90.6,707,244,34.5
All Grades,All Students,2021-22,117758,15566,102192,86.8,694,286,41.2
All Grades,All Students,2022-23,114924,13176,101748,88.5,686,259,37.8
PK in K-12 Schools,All Students,2018-19,3185,290,2895,90.9,18,4,22.2
PK in K-12 Schools,All Students,2019-20,2009,s,s,s,s,s,s
PK in K-12 Schools,All Students,2020-21,3036,159,2877,94.8,18,1,5.6
PK in K-12 Schools,All Students,2021-22,3096,468,2628,84.9,19,11,57.9
PK in K-12 Schools,All Students,2022-23,3197,572,2625,82.1,20,13,65.0
0K,All Students,2018-19,7949,668,7281,91.6,47,13,27.7
0K,All Students,2019-20,6241,408,5833,93.5,55,13,23.6
0K,All Students,2020-21,8032,1069,6963,86.7,50,31,62.0
0K,All Students,2021-22,8477,1440,7037,83.0,52,26,50.0
0K,All Students,2022-23,7048,864,6184,87.7,46,26,56.5
1,All Students,2018-19,7929,503,7426,93.7,46,13,28.3
1,All Students,2019-20,6040,450,5590,92.5,54,12,22.2
1,All Students,2020-21,9539,974,8565,89.8,56,17,30.4
1,All Students,2021-22,8528,1160,7368,86.4,53,23,43.4
1,All Students,2022-23,8830,1292,7538,85.4,53,18,34.0
2,All Students,2018-19,9651,382,9269,96.0,56,3,5.4
2,All Students,2019-20,5407,271,5136,95.0,48,7,14.6
2,All Students,2020-21,9004,1054,7950,88.3,52,24,46.2
2,All Students,2021-22,9599,1372,8227,85.7,56,25,44.6
2,All Students,2022-23,8191,1054,7137,87.1,50,20,40.0
3,All Students,2018-19,13646,635,13011,95.3,82,8,9.8
3,All Students,2019-20,6459,280,6179,95.7,57,4,7.0
3,All Students,2020-21,8411,653,7758,92.2,50,13,26.0
3,All Students,2021-22,9207,1126,8081,87.8,53,25,47.2
3,All Students,2022-23,10929,1238,9691,88.7,63,20,31.7
4,All Students,2018-19,13690,634,13056,95.4,80,11,13.8
4,All Students,2019-20,10139,437,9702,95.7,90,7,7.8
4,All Students,2020-21,9030,861,8169,90.5,52,16,30.8
4,All Students,2021-22,9309,1300,8009,86.0,53,24,45.3
4,All Students,2022-23,9746,1205,8541,87.6,59,22,37.3
5,All Students,2018-19,14140,763,13377,94.6,80,12,15.0
5,All Students,2019-20,9913,440,9473,95.6,87,7,8.0
5,All Students,2020-21,15622,501,15121,96.8,91,6,6.6
5,All Students,2021-22,9578,880,8698,90.8,56,16,28.6
5,All Students,2022-23,9406,1135,8271,87.9,57,24,42.1
6,All Students,2018-19,23214,967,22247,95.8,136,14,10.3
6,All Students,2019-20,12116,568,11548,95.3,107,11,10.3
6,All Students,2020-21,18379,2395,15984,87.0,106,53,50.0
6,All Students,2021-22,22839,2852,19987,87.5,133,44,33.1
6,All Students,2022-23,18429,1551,16878,91.6,108,37,34.3
7,All Students,2018-19,22887,911,21976,96.0,132,9,6.8
7,All Students,2019-20,14870,719,14151,95.2,130,15,11.5
7,All Students,2020-21,18107,1499,16608,91.7,105,32,30.5
7,All Students,2021-22,17711,2202,15509,87.6,103,42,40.8
7,All Students,2022-23,22641,2555,20086,88.7,132,43,32.6
8,All Students,2018-19,16901,929,15972,94.5,95,12,12.6
8,All Students,2019-20,13698,738,12960,94.6,120,16,13.3
8,All Students,2020-21,21927,2207,19720,89.9,126,51,40.5
8,All Students,2021-22,19414,2766,16648,85.8,116,50,43.1
8,All Students,2022-23,16507,1710,14797,89.6,98,36,36.7
9,All Students,2019-20,26,s,s,s,s,s,s
All Grades,All Students,2018-19,70531,10581,59950,85.0,455,172,37.8
All Grades,All Students,2019-20,42050,5391,36659,87.2,408,176,43.1
All Grades,All Students,2020-21,57712,11039,46673,80.9,361,159,44.0
All Grades,All Students,2021-22,62626,10195,52431,83.7,423,227,53.7
All Grades,All Students,2022-23,60111,6867,53244,88.6,414,148,35.7
9,All Students,2018-19,18759,2567,16192,86.3,124,42,33.9
9,All Students,2019-20,11123,1300,9823,88.3,111,41,36.9
9,All Students,2020-21,13157,2801,10356,78.7,85,40,47.1
9,All Students,2021-22,20459,2190,18269,89.3,148,58,39.2
9,All Students,2022-23,14769,1484,13285,90.0,111,39,35.1
10,All Students,2018-19,17368,3115,14253,82.1,115,46,40.0
10,All Students,2019-20,9609,1347,8262,86.0,96,42,43.8
10,All Students,2020-21,12492,2527,9965,79.8,82,38,46.3
10,All Students,2021-22,13305,2381,10924,82.1,87,53,60.9
10,All Students,2022-23,19752,1788,17964,90.9,135,34,25.2
11,All Students,2018-19,18170,2003,16167,89.0,114,34,29.8
11,All Students,2019-20,9013,995,8018,89.0,89,36,40.4
11,All Students,2020-21,16001,2132,13869,86.7,96,34,35.4
11,All Students,2021-22,14430,2668,11762,81.5,100,54,54.0
11,All Students,2022-23,12886,1976,10910,84.7,87,36,41.4
12,All Students,2018-19,16234,2896,13338,82.2,102,50,49.0
12,All Students,2019-20,12305,1749,10556,85.8,113,58,51.3
12,All Students,2020-21,16062,3579,12483,77.7,98,47,48.0
12,All Students,2021-22,14432,2956,11476,79.5,88,62,70.5
12,All Students,2022-23,12704,1619,11085,87.3,81,39,48.1
All Grades,All Students,2018-19,97304,10716,86588,89.0,604,183,30.3
All Grades,All Students,2019-20,60870,6887,53983,88.7,579,207,35.8
All Grades,All Students,2020-21,92095,8049,84046,91.3,553,169,30.6
All Grades,All Students,2021-22,91714,13470,78244,85.3,594,263,44.3
All Grades,All Students,2022-23,91927,8933,82994,90.3,605,174,28.8
6,All Students,2018-19,13900,760,13140,94.5,83,10,12.0
6,All Students,2019-20,8459,419,8040,95.0,80,10,12.5
6,All Students,2020-21,12070,856,11214,92.9,74,16,21.6
6,All Students,2021-22,14654,1058,13596,92.8,87,15,17.2
6,All Students,2022-23,12822,839,11983,93.5,83,17,20.5
7,All Students,2018-19,10093,317,9776,96.9,59,2,3.4
7,All Students,2019-20,7790,196,7594,97.5,71,1,1.4
7,All Students,2020-21,12154,847,11307,93.0,71,17,23.9
7,All Students,2021-22,11434,932,10502,91.8,72,20,27.8
7,All Students,2022-23,14419,859,13560,94.0,87,12,13.8
8,All Students,2018-19,11876,333,11543,97.2,71,5,7.0
8,All Students,2019-20,6924,438,6486,93.7,65,14,21.5
8,All Students,2020-21,11581,667,10914,94.2,68,11,16.2
8,All Students,2021-22,10176,1202,8974,88.2,64,28,43.8
8,All Students,2022-23,10023,1122,8901,88.8,64,28,43.8
9,All Students,2018-19,12568,927,11641,92.6,83,15,18.1
9,All Students,2019-20,9010,619,8391,93.1,89,25,28.1
9,All Students,2020-21,12423,1153,11270,90.7,77,28,36.4
9,All Students,2021-22,14631,2000,12631,86.3,107,45,42.1
9,All Students,2022-23,11404,845,10559,92.6,88,27,30.7
10,All Students,2018-19,16631,2477,14154,85.1,108,39,36.1
10,All Students,2019-20,8593,1229,7364,85.7,85,42,49.4
10,All Students,2020-21,14909,1501,13408,89.9,89,35,39.3
10,All Students,2021-22,13167,1802,11365,86.3,86,46,53.5
10,All Students,2022-23,14193,1426,12767,90.0,97,28,28.9
11,All Students,2018-19,15530,2448,13082,84.2,97,44,45.4
11,All Students,2019-20,9580,1406,8174,85.3,92,47,51.1
11,All Students,2020-21,13727,1480,12247,89.2,83,35,42.2
11,All Students,2021-22,13985,1787,12198,87.2,91,39,42.9
11,All Students,2022-23,13743,1095,12648,92.0,88,19,21.6
12,All Students,2018-19,16706,3454,13252,79.3,103,68,66.0
12,All Students,2019-20,10514,2580,7934,75.5,97,68,70.1
12,All Students,2020-21,15231,1545,13686,89.9,91,27,29.7
12,All Students,2021-22,13667,4689,8978,65.7,87,70,80.5
12,All Students,2022-23,15323,2747,12576,82.1,98,43,43.9
All Grades,All Students,2018-19,30458,2667,27791,91.2,181,48,26.5
All Grades,All Students,2019-20,19678,1337,18341,93.2,184,46,25.0
All Grades,All Students,2020-21,30123,2409,27714,92.0,179,41,22.9
All Grades,All Students,2021-22,32436,3489,28947,89.2,195,75,38.5
All Grades,All Students,2022-23,34348,2846,31502,91.7,201,50,24.9
6,All Students,2018-19,10514,974,9540,90.7,64,19,29.7
6,All Students,2019-20,7501,531,6970,92.9,71,18,25.4
6,All Students,2020-21,10003,692,9311,93.1,60,9,15.0
6,All Students,2021-22,10857,1428,9429,86.8,68,34,50.0
6,All Students,2022-23,11997,737,11260,93.9,70,11,15.7
7,All Students,2018-19,8297,568,7729,93.2,49,7,14.3
7,All Students,2019-20,6494,432,6062,93.3,60,17,28.3
7,All Students,2020-21,10829,1054,9775,90.3,65,21,32.3
7,All Students,2021-22,11840,1323,10517,88.8,70,30,42.9
7,All Students,2022-23,10970,1075,9895,90.2,65,22,33.8
8,All Students,2018-19,11647,1125,10522,90.3,68,22,32.4
8,All Students,2019-20,5683,374,5309,93.4,53,11,20.8
8,All Students,2020-21,9291,663,8628,92.9,54,11,20.4
8,All Students,2021-22,9734,s,s,s,s,s,s
8,All Students,2022-23,11381,1034,10347,90.9,66,17,25.8
9,All Students,2021-22,5,s,s,s,s,s,s
All Grades,All Students,2018-19,86917,4284,82633,95.1,503,60,11.9
All Grades,All Students,2019-20,60615,3553,57062,94.1,558,110,19.7
All Grades,All Students,2020-21,93439,5031,88408,94.6,556,90,16.2
All Grades,All Students,2021-22,92463,9393,83070,89.8,553,242,43.8
All Grades,All Students,2022-23,94889,6930,87959,92.7,571,148,25.9
PK in K-12 Schools,All Students,2018-19,3167,241,2926,92.4,19,4,21.1
PK in K-12 Schools,All Students,2019-20,2031,139,1892,93.2,19,5,26.3
PK in K-12 Schools,All Students,2020-21,2968,223,2745,92.5,18,4,22.2
PK in K-12 Schools,All Students,2021-22,3044,481,2563,84.2,18,13,72.2
PK in K-12 Schools,All Students,2022-23,2927,395,2532,86.5,20,12,60.0
0K,All Students,2018-19,8635,492,8143,94.3,50,8,16.0
0K,All Students,2019-20,6060,485,5575,92.0,57,20,35.1
0K,All Students,2020-21,8288,440,7848,94.7,51,9,17.6
0K,All Students,2021-22,8008,1198,6810,85.0,51,37,72.5
0K,All Students,2022-23,9185,861,8324,90.6,57,24,42.1
1,All Students,2018-19,10215,545,9670,94.7,61,9,14.8
1,All Students,2019-20,5792,333,5459,94.3,55,6,10.9
1,All Students,2020-21,9656,493,9163,94.9,59,8,13.6
1,All Students,2021-22,8570,862,7708,89.9,53,22,41.5
1,All Students,2022-23,8863,754,8109,91.5,56,20,35.7
2,All Students,2018-19,8741,571,8170,93.5,51,9,17.6
2,All Students,2019-20,7342,449,6893,93.9,68,16,23.5
2,All Students,2020-21,9303,492,8811,94.7,55,9,16.4
2,All Students,2021-22,10005,1089,8916,89.1,60,34,56.7
2,All Students,2022-23,9460,582,8878,93.8,57,11,19.3
3,All Students,2018-19,9134,437,8697,95.2,52,4,7.7
3,All Students,2019-20,6090,363,5727,94.0,57,12,21.1
3,All Students,2020-21,9981,424,9557,95.8,59,6,10.2
3,All Students,2021-22,9165,862,8303,90.6,56,23,41.1
3,All Students,2022-23,9785,708,9077,92.8,59,14,23.7
4,All Students,2018-19,6723,236,6487,96.5,40,4,10.0
4,All Students,2019-20,6501,318,6183,95.1,60,11,18.3
4,All Students,2020-21,9770,583,9187,94.0,58,9,15.5
4,All Students,2021-22,10340,864,9476,91.6,62,19,30.6
4,All Students,2022-23,10370,719,9651,93.1,62,16,25.8
5,All Students,2018-19,9275,515,8760,94.4,53,9,17.0
5,All Students,2019-20,5425,332,5093,93.9,52,12,23.1
5,All Students,2020-21,10103,462,9641,95.4,62,11,17.7
5,All Students,2021-22,9895,837,9058,91.5,59,19,32.2
5,All Students,2022-23,10642,682,9960,93.6,65,12,18.5
6,All Students,2018-19,10773,465,10308,95.7,62,4,6.5
6,All Students,2019-20,7566,380,7186,95.0,68,11,16.2
6,All Students,2020-21,11519,699,10820,93.9,66,14,21.2
6,All Students,2021-22,11505,1132,10373,90.2,65,24,36.9
6,All Students,2022-23,11770,753,11017,93.6,69,12,17.4
7,All Students,2018-19,10499,440,10059,95.8,59,4,6.8
7,All Students,2019-20,6988,416,6572,94.0,63,10,15.9
7,All Students,2020-21,11437,663,10774,94.2,68,10,14.7
7,All Students,2021-22,10626,908,9718,91.5,62,21,33.9
7,All Students,2022-23,11397,882,10515,92.3,65,18,27.7
8,All Students,2018-19,9755,342,9413,96.5,56,5,8.9
8,All Students,2019-20,6820,338,6482,95.0,59,7,11.9
8,All Students,2020-21,10414,552,9862,94.7,60,10,16.7
8,All Students,2021-22,11305,1160,10145,89.7,67,30,44.8
8,All Students,2022-23,10490,594,9896,94.3,61,9,14.8
All Grades,All Students,2018-19,66385,10014,56371,84.9,430,211,49.1
All Grades,All Students,2019-20,44988,4871,40117,89.2,433,152,35.1
All Grades,All Students,2020-21,73766,7735,66031,89.5,451,130,28.8
All Grades,All Students,2021-22,65746,11211,54535,82.9,420,248,59.0
All Grades,All Students,2022-23,58410,9063,49347,84.5,411,211,51.3
9,All Students,2018-19,19663,2420,17243,87.7,131,55,42.0
9,All Students,2019-20,14617,2114,12503,85.5,142,62,43.7
9,All Students,2020-21,17647,1666,15981,90.6,115,35,30.4
9,All Students,2021-22,15923,2546,13377,84.0,112,62,55.4
9,All Students,2022-23,14970,2093,12877,86.0,116,54,46.6
10,All Students,2018-19,19329,3272,16057,83.1,128,60,46.9
10,All Students,2019-20,11927,1136,10791,90.5,118,40,33.9
10,All Students,2020-21,20831,2710,18121,87.0,128,40,31.3
10,All Students,2021-22,19302,3576,15726,81.5,125,83,66.4
10,All Students,2022-23,13897,1652,12245,88.1,103,46,44.7
11,All Students,2018-19,12973,1469,11504,88.7,81,28,34.6
11,All Students,2019-20,10426,793,9633,92.4,100,26,26.0
11,All Students,2020-21,17045,1243,15802,92.7,99,18,18.2
11,All Students,2021-22,14917,2019,12898,86.5,90,34,37.8
11,All Students,2022-23,13199,2291,10908,82.6,89,56,62.9
12,All Students,2018-19,14420,2853,11567,80.2,90,68,75.6
12,All Students,2019-20,8018,828,7190,89.7,73,24,32.9
12,All Students,2020-21,18243,2116,16127,88.4,109,37,33.9
12,All Students,2021-22,15604,3070,12534,80.3,93,69,74.2
12,All Students,2022-23,16344,3027,13317,81.5,103,55,53.4
All Grades,All Students,2018-19,62165,7892,54273,87.3,384,129,33.6
All Grades,All Students,2019-20,40398,5060,35338,87.5,370,117,31.6
All Grades,All Students,2020-21,62474,6828,55646,89.1,366,112,30.6
All Grades,All Students,2021-22,59457,8586,50871,85.6,371,178,48.0
All Grades,All Students,2022-23,58080,7361,50719,87.3,375,156,41.6
8,All Students,2018-19,1,s,s,s,s,s,s
9,All Students,2018-19,15818,1081,14737,93.2,103,21,20.4
9,All Students,2019-20,11123,864,10259,92.2,105,23,21.9
9,All Students,2020-21,13610,947,12663,93.0,82,22,26.8
9,All Students,2021-22,16760,2070,14690,87.6,106,44,41.5
9,All Students,2022-23,15316,1591,13725,89.6,104,35,33.7
10,All Students,2018-19,16024,1708,14316,89.3,101,32,31.7
10,All Students,2019-20,10549,862,9687,91.8,102,30,29.4
10,All Students,2020-21,16339,1654,14685,89.9,95,26,27.4
10,All Students,2021-22,13021,1719,11302,86.8,84,34,40.5
10,All Students,2022-23,14962,2333,12629,84.4,98,44,44.9
11,All Students,2018-19,13469,s,s,s,s,s,s
11,All Students,2019-20,10266,1325,8941,87.1,93,33,35.5
11,All Students,2020-21,15925,1390,14535,91.3,91,27,29.7
11,All Students,2021-22,15326,2056,13270,86.6,92,37,40.2
11,All Students,2022-23,13535,1732,11803,87.2,86,40,46.5
12,All Students,2018-19,16853,3241,13612,80.8,96,37,38.5
12,All Students,2019-20,8460,2009,6451,76.3,70,31,44.3
12,All Students,2020-21,16600,2837,13763,82.9,98,37,37.8
12,All Students,2021-22,14350,2741,11609,80.9,89,63,70.8
12,All Students,2022-23,14267,1705,12562,88.0,87,37,42.5
All Grades,All Students,2018-19,82430,7207,75223,91.3,513,141,27.5
All Grades,All Students,2019-20,47071,4057,43014,91.4,442,118,26.7
All Grades,All Students,2020-21,70992,15962,55030,77.5,415,306,73.7
All Grades,All Students,2021-22,67134,5857,61277,91.3,447,122,27.3
All Grades,All Students,2022-23,75309,3582,71727,95.2,477,69,14.5
6,All Students,2018-19,12801,593,12208,95.4,77,12,15.6
6,All Students,2019-20,7416,416,7000,94.4,70,14,20.0
6,All Students,2020-21,12034,2226,9808,81.5,70,48,68.6
6,All Students,2021-22,11940,853,11087,92.9,72,15,20.8
6,All Students,2022-23,13017,486,12531,96.3,76,8,10.5
7,All Students,2018-19,12164,475,11689,96.1,73,6,8.2
7,All Students,2019-20,7200,487,6713,93.2,66,15,22.7
7,All Students,2020-21,9806,1704,8102,82.6,56,35,62.5
7,All Students,2021-22,9334,524,8810,94.4,61,10,16.4
7,All Students,2022-23,11352,344,11008,97.0,72,6,8.3
8,All Students,2018-19,13191,464,12727,96.5,77,5,6.5
8,All Students,2019-20,7636,478,7158,93.7,69,14,20.3
8,All Students,2020-21,10449,2201,8248,78.9,61,54,88.5
8,All Students,2021-22,8230,493,7737,94.0,50,9,18.0
8,All Students,2022-23,10396,385,10011,96.3,66,4,6.1
9,All Students,2018-19,11341,851,10490,92.5,72,19,26.4
9,All Students,2019-20,6344,392,5952,93.8,63,13,20.6
9,All Students,2020-21,11202,2746,8456,75.5,67,45,67.2
9,All Students,2021-22,12641,1319,11322,89.6,99,35,35.4
9,All Students,2022-23,13166,637,12529,95.2,88,16,18.2
10,All Students,2018-19,12528,1889,10639,84.9,84,38,45.2
10,All Students,2019-20,5885,719,5166,87.8,57,22,38.6
10,All Students,2020-21,9600,2156,7444,77.5,57,42,73.7
10,All Students,2021-22,10328,1370,8958,86.7,69,27,39.1
10,All Students,2022-23,11572,651,10921,94.4,74,13,17.6
11,All Students,2018-19,10630,1189,9441,88.8,69,26,37.7
11,All Students,2019-20,6588,1017,5571,84.6,62,24,38.7
11,All Students,2020-21,8944,2703,6241,69.8,53,42,79.2
11,All Students,2021-22,7658,867,6791,88.7,54,20,37.0
11,All Students,2022-23,8906,617,8289,93.1,58,12,20.7
12,All Students,2018-19,9775,1746,8029,82.1,61,35,57.4
12,All Students,2019-20,6002,548,5454,90.9,55,16,29.1
12,All Students,2020-21,8957,2226,6731,75.1,51,40,78.4
12,All Students,2021-22,7003,431,6572,93.8,42,6,14.3
12,All Students,2022-23,6900,462,6438,93.3,43,10,23.3
All Grades,All Students,2018-19,57477,3840,53637,93.3,340,75,22.1
All Grades,All Students,2019-20,38663,2230,36433,94.2,353,56,15.9
All Grades,All Students,2020-21,67602,11560,56042,82.9,400,211,52.8
All Grades,All Students,2021-22,65157,9053,56104,86.1,392,215,54.8
All Grades,All Students,2022-23,60040,7190,52850,88.0,376,183,48.7
6,All Students,2018-19,22979,1447,21532,93.7,133,27,20.3
6,All Students,2019-20,13580,961,12619,92.9,126,32,25.4
6,All Students,2020-21,25560,3935,21625,84.6,151,69,45.7
6,All Students,2021-22,18926,s,s,s,s,s,s
6,All Students,2022-23,17974,2151,15823,88.0,110,52,47.3
7,All Students,2018-19,17973,1125,16848,93.7,108,21,19.4
7,All Students,2019-20,14389,718,13671,95.0,129,12,9.3
7,All Students,2020-21,20643,4184,16459,79.7,122,74,60.7
7,All Students,2021-22,26116,3195,22921,87.8,155,82,52.9
7,All Students,2022-23,16875,2065,14810,87.8,110,55,50.0
8,All Students,2018-19,16525,1268,15257,92.3,99,27,27.3
8,All Students,2019-20,10694,551,10143,94.8,98,12,12.2
8,All Students,2020-21,21399,3441,17958,83.9,127,68,53.5
8,All Students,2021-22,20113,2951,17162,85.3,122,69,56.6
8,All Students,2022-23,25191,2974,22217,88.2,156,76,48.7
9,All Students,2021-22,2,s,s,s,s,s,s
All Grades,All Students,2018-19,62937,6262,56675,90.1,385,142,36.9
All Grades,All Students,2019-20,39255,4092,35163,89.6,356,123,34.6
All Grades,All Students,2020-21,55962,9218,46744,83.5,333,160,48.0
All Grades,All Students,2021-22,55878,10689,45189,80.9,359,234,65.2
All Grades,All Students,2022-23,52087,7661,44426,85.3,325,153,47.1
6,All Students,2018-19,22468,2163,20305,90.4,138,43,31.2
6,All Students,2019-20,11142,1106,10036,90.1,104,33,31.7
6,All Students,2020-21,18598,2816,15782,84.9,113,51,45.1
6,All Students,2021-22,19697,4272,15425,78.3,127,79,62.2
6,All Students,2022-23,15026,s,s,s,s,s,s
7,All Students,2018-19,20887,2006,18881,90.4,127,47,37.0
7,All Students,2019-20,14377,1509,12868,89.5,131,52,39.7
7,All Students,2020-21,16788,2846,13942,83.0,99,53,53.5
7,All Students,2021-22,18382,3381,15001,81.6,115,80,69.6
7,All Students,2022-23,18107,2338,15769,87.1,113,46,40.7
8,All Students,2018-19,19562,s,s,s,s,s,s
8,All Students,2019-20,13736,1477,12259,89.2,121,38,31.4
8,All Students,2020-21,20574,3556,17018,82.7,121,56,46.3
8,All Students,2021-22,17784,s,s,s,s,s,s
8,All Students,2022-23,18953,3316,15637,82.5,116,63,54.3
9,All Students,2018-19,20,s,s,s,s,s,s
9,All Students,2021-22,15,s,s,s,s,s,s
9,All Students,2022-23,1,s,s,s,s,s,s
All Grades,All Students,2018-19,36915,1596,35319,95.7,212,20,9.4
All Grades,All Students,2019-20,31086,1355,29731,95.6,279,30,10.8
All Grades,All Students,2020-21,56690,2424,54266,95.7,327,32,9.8
All Grades,All Students,2021-22,54965,4422,50543,92.0,323,92,28.5
All Grades,All Students,2022-23,54853,4412,50441,92.0,335,83,24.8
PK in K-12 Schools,All Students,2018-19,3853,248,3605,93.6,22,4,18.2
PK in K-12 Schools,All Students,2019-20,3605,234,3371,93.5,32,9,28.1
PK in K-12 Schools,All Students,2020-21,5923,309,5614,94.8,35,6,17.1
PK in K-12 Schools,All Students,2021-22,6170,715,5455,88.4,36,15,41.7
PK in K-12 Schools,All Students,2022-23,4621,503,4118,89.1,30,15,50.0
0K,All Students,2018-19,7976,368,7608,95.4,47,7,14.9
0K,All Students,2019-20,5519,260,5259,95.3,50,5,10.0
0K,All Students,2020-21,8345,559,7786,93.3,48,8,16.7
0K,All Students,2021-22,7226,636,6590,91.2,41,10,24.4
0K,All Students,2022-23,6811,578,6233,91.5,41,12,29.3
1,All Students,2018-19,7901,296,7605,96.3,45,3,6.7
1,All Students,2019-20,5965,224,5741,96.2,52,5,9.6
1,All Students,2020-21,9099,529,8570,94.2,52,8,15.4
1,All Students,2021-22,8334,613,7721,92.6,49,12,24.5
1,All Students,2022-23,7993,709,7284,91.1,53,13,24.5
2,All Students,2018-19,8627,398,8229,95.4,50,4,8.0
2,All Students,2019-20,5502,203,5299,96.3,49,3,6.1
2,All Students,2020-21,9197,366,8831,96.0,54,4,7.4
2,All Students,2021-22,8910,655,8255,92.6,52,12,23.1
2,All Students,2022-23,8524,586,7938,93.1,50,10,20.0
3,All Students,2018-19,8558,286,8272,96.7,48,2,4.2
3,All Students,2019-20,4919,223,4696,95.5,47,8,17.0
3,All Students,2020-21,8574,235,8339,97.3,49,2,4.1
3,All Students,2021-22,9074,650,8424,92.8,54,16,29.6
3,All Students,2022-23,8977,599,8378,93.3,53,9,17.0
4,All Students,2019-20,5576,211,5365,96.2,49,0,0.0
4,All Students,2020-21,7337,218,7119,97.0,42,3,7.1
4,All Students,2021-22,8582,587,7995,93.2,50,12,24.0
4,All Students,2022-23,9561,713,8848,92.5,58,14,24.1
5,All Students,2020-21,8215,208,8007,97.5,47,1,2.1
5,All Students,2021-22,6669,566,6103,91.5,41,15,36.6
5,All Students,2022-23,8366,724,7642,91.3,50,10,20.0
All Grades,All Students,2022-23,47102,9305,37797,80.2,323,246,76.2
PK in K-12 Schools,All Students,2022-23,47102,9305,37797,80.2,323,246,76.2
All Grades,All Students,2018-19,65552,10417,55135,84.1,436,186,42.7
All Grades,All Students,2019-20,43446,6166,37280,85.8,417,135,32.4
All Grades,All Students,2020-21,59869,6535,53334,89.1,361,104,28.8
All Grades,All Students,2021-22,61279,10410,50869,83.0,380,183,48.2
All Grades,All Students,2022-23,65406,6839,58567,89.5,425,124,29.2
9,All Students,2018-19,18545,3487,15058,81.2,128,48,37.5
9,All Students,2019-20,11783,2029,9754,82.8,121,43,35.5
9,All Students,2020-21,13827,2540,11287,81.6,84,37,44.0
9,All Students,2021-22,20430,2904,17526,85.8,129,49,38.0
9,All Students,2022-23,21870,2118,19752,90.3,149,40,26.8
10,All Students,2018-19,13785,1576,12209,88.6,95,29,30.5
10,All Students,2019-20,10945,1488,9457,86.4,106,37,34.9
10,All Students,2020-21,15590,1476,14114,90.5,95,27,28.4
10,All Students,2021-22,12133,1958,10175,83.9,77,32,41.6
10,All Students,2022-23,18928,1474,17454,92.2,122,30,24.6
11,All Students,2018-19,15240,1943,13297,87.3,97,42,43.3
11,All Students,2019-20,9096,950,8146,89.6,86,20,23.3
11,All Students,2020-21,14125,817,13308,94.2,85,19,22.4
11,All Students,2021-22,14006,2304,11702,83.5,87,45,51.7
11,All Students,2022-23,11924,1427,10497,88.0,75,21,28.0
12,All Students,2018-19,17982,3411,14571,81.0,116,67,57.8
12,All Students,2019-20,11622,1699,9923,85.4,104,35,33.7
12,All Students,2020-21,16327,1702,14625,89.6,97,21,21.6
12,All Students,2021-22,14710,3244,11466,77.9,87,57,65.5
12,All Students,2022-23,12684,1820,10864,85.7,79,33,41.8
All Grades,All Students,2018-19,68671,9683,58988,85.9,443,184,41.5
All Grades,All Students,2019-20,40181,4946,35235,87.7,394,144,36.5
All Grades,All Students,2020-21,66514,7892,58622,88.1,405,129,31.9
All Grades,All Students,2021-22,76836,12199,64637,84.1,501,280,55.9
All Grades,All Students,2022-23,83727,12662,71065,84.9,557,273,49.0
9,All Students,2018-19,24186,4082,20104,83.1,159,72,45.3
9,All Students,2019-20,15171,2274,12897,85.0,153,68,44.4
9,All Students,2020-21,27412,3582,23830,86.9,167,49,29.3
9,All Students,2021-22,31575,4791,26784,84.8,209,107,51.2
9,All Students,2022-23,25475,3638,21837,85.7,178,76,42.7
10,All Students,2018-19,18311,2038,16273,88.9,114,34,29.8
10,All Students,2019-20,9449,968,8481,89.8,94,25,26.6
10,All Students,2020-21,15571,1896,13675,87.8,98,35,35.7
10,All Students,2021-22,21442,3258,18184,84.8,142,78,54.9
10,All Students,2022-23,28105,4154,23951,85.2,182,85,46.7
11,All Students,2018-19,8549,1050,7499,87.7,59,22,37.3
11,All Students,2019-20,6105,450,5655,92.6,56,11,19.6
11,All Students,2020-21,10431,624,9807,94.0,61,9,14.8
11,All Students,2021-22,12574,2002,10572,84.1,80,48,60.0
11,All Students,2022-23,17435,2639,14796,84.9,115,62,53.9
12,All Students,2018-19,17625,2513,15112,85.7,111,56,50.5
12,All Students,2019-20,9456,1254,8202,86.7,90,39,43.3
12,All Students,2020-21,13100,1790,11310,86.3,79,36,45.6
12,All Students,2021-22,11245,2148,9097,80.9,70,47,67.1
12,All Students,2022-23,12712,2231,10481,82.4,82,50,61.0
All Grades,All Students,2018-19,99873,5501,94372,94.5,610,97,15.9
All Grades,All Students,2019-20,60521,3346,57175,94.5,557,89,16.0
All Grades,All Students,2020-21,87774,4675,83099,94.7,538,99,18.4
All Grades,All Students,2021-22,92878,8741,84137,90.6,569,221,38.8
All Grades,All Students,2022-23,99874,9435,90439,90.6,613,233,38.0
PK in K-12 Schools,All Students,2021-22,2611,353,2258,86.5,17,13,76.5
PK in K-12 Schools,All Students,2022-23,8736,s,s,s,s,s,s
0K,All Students,2018-19,15529,1085,14444,93.0,99,27,27.3
0K,All Students,2019-20,11264,899,10365,92.0,105,31,29.5
0K,All Students,2020-21,14493,1053,13440,92.7,92,22,23.9
0K,All Students,2021-22,15234,1815,13419,88.1,96,51,53.1
0K,All Students,2022-23,14329,1646,12683,88.5,88,38,43.2
1,All Students,2018-19,16972,1049,15923,93.8,101,15,14.9
1,All Students,2019-20,9170,437,8733,95.2,85,9,10.6
1,All Students,2020-21,16843,912,15931,94.6,101,18,17.8
1,All Students,2021-22,14643,1326,13317,90.9,88,28,31.8
1,All Students,2022-23,15362,1530,13832,90.0,99,43,43.4
2,All Students,2018-19,15594,887,14707,94.3,98,18,18.4
2,All Students,2019-20,10817,647,10170,94.0,101,20,19.8
2,All Students,2020-21,13978,729,13249,94.8,86,14,16.3
2,All Students,2021-22,15583,1503,14080,90.4,97,41,42.3
2,All Students,2022-23,14503,1390,13113,90.4,87,33,37.9
3,All Students,2018-19,14859,678,14181,95.4,92,13,14.1
3,All Students,2019-20,9463,386,9077,95.9,86,5,5.8
3,All Students,2020-21,15200,968,14232,93.6,92,23,25.0
3,All Students,2021-22,15866,1349,14517,91.5,97,28,28.9
3,All Students,2022-23,15944,1442,14502,91.0,100,37,37.0
4,All Students,2018-19,16355,937,15418,94.3,97,13,13.4
4,All Students,2019-20,9485,404,9081,95.7,87,10,11.5
4,All Students,2020-21,13491,538,12953,96.0,84,11,13.1
4,All Students,2021-22,15309,1433,13876,90.6,91,35,38.5
4,All Students,2022-23,15102,1156,13946,92.3,91,28,30.8
5,All Students,2018-19,20564,865,19699,95.8,123,11,8.9
5,All Students,2019-20,10322,573,9749,94.4,93,14,15.1
5,All Students,2020-21,13769,475,13294,96.6,83,11,13.3
5,All Students,2021-22,13632,962,12670,92.9,83,25,30.1
5,All Students,2022-23,15895,1177,14718,92.6,95,25,26.3
6,All Students,2022-23,3,s,s,s,s,s,s
All Grades,All Students,2018-19,141067,8111,132956,94.3,828,149,18.0
All Grades,All Students,2019-20,92018,5020,86998,94.5,823,122,14.8
All Grades,All Students,2020-21,133283,13277,120006,90.0,778,248,31.9
All Grades,All Students,2021-22,131338,13016,118322,90.1,772,304,39.4
All Grades,All Students,2022-23,119616,11249,108367,90.6,739,270,36.5
6,All Students,2018-19,49595,2436,47159,95.1,290,41,14.1
6,All Students,2019-20,27888,1378,26510,95.1,251,36,14.3
6,All Students,2020-21,40227,4281,35946,89.4,240,80,33.3
6,All Students,2021-22,41687,4247,37440,89.8,247,100,40.5
6,All Students,2022-23,31767,2535,29232,92.0,200,56,28.0
7,All Students,2018-19,48462,2741,45721,94.3,288,50,17.4
7,All Students,2019-20,32451,1811,30640,94.4,291,43,14.8
7,All Students,2020-21,44478,3934,40544,91.2,257,74,28.8
7,All Students,2021-22,43907,4382,39525,90.0,259,102,39.4
7,All Students,2022-23,41896,4034,37862,90.4,259,98,37.8
8,All Students,2018-19,43010,2934,40076,93.2,250,58,23.2
8,All Students,2019-20,31679,1831,29848,94.2,281,43,15.3
8,All Students,2020-21,48578,5062,43516,89.6,281,94,33.5
8,All Students,2021-22,45744,4387,41357,90.4,266,102,38.3
8,All Students,2022-23,45953,4680,41273,89.8,280,116,41.4
All Grades,All Students,2018-19,171202,8732,162470,94.9,997,130,13.0
All Grades,All Students,2019-20,106197,6005,100192,94.3,960,154,16.0
All Grades,All Students,2020-21,143017,9004,134013,93.7,849,154,18.1
All Grades,All Students,2021-22,132062,11405,120657,91.4,798,251,31.5
All Grades,All Students,2022-23,130059,10679,119380,91.8,766,233,30.4
PK in K-12 Schools,All Students,2019-20,2052,175,1877,91.5,18,6,33.3
PK in K-12 Schools,All Students,2020-21,3048,321,2727,89.5,18,7,38.9
PK in K-12 Schools,All Students,2021-22,3065,409,2656,86.7,21,12,57.1
PK in K-12 Schools,All Students,2022-23,3162,404,2758,87.2,18,8,44.4
0K,All Students,2018-19,20067,1388,18679,93.1,121,27,22.3
0K,All Students,2019-20,13223,1081,12142,91.8,122,33,27.0
0K,All Students,2020-21,14640,1539,13101,89.5,93,31,33.3
0K,All Students,2021-22,16168,1837,14331,88.6,101,45,44.6
0K,All Students,2022-23,17995,2119,15876,88.2,109,55,50.5
1,All Students,2018-19,19331,1239,18092,93.6,112,19,17.0
1,All Students,2019-20,12613,875,11738,93.1,115,23,20.0
1,All Students,2020-21,18861,1147,17714,93.9,111,16,14.4
1,All Students,2021-22,15927,1523,14404,90.4,96,38,39.6
1,All Students,2022-23,15635,1385,14250,91.1,93,35,37.6
2,All Students,2018-19,23901,1217,22684,94.9,141,19,13.5
2,All Students,2019-20,12995,730,12265,94.4,120,18,15.0
2,All Students,2020-21,17942,1198,16744,93.3,104,19,18.3
2,All Students,2021-22,18884,1707,17177,91.0,114,34,29.8
2,All Students,2022-23,16040,1398,14642,91.3,96,33,34.4
3,All Students,2018-19,22762,1306,21456,94.3,133,22,16.5
3,All Students,2019-20,15331,757,14574,95.1,139,19,13.7
3,All Students,2020-21,19214,906,18308,95.3,116,16,13.8
3,All Students,2021-22,19447,1312,18135,93.3,118,29,24.6
3,All Students,2022-23,18647,1420,17227,92.4,110,30,27.3
4,All Students,2018-19,29686,1270,28416,95.7,173,15,8.7
4,All Students,2019-20,15496,861,14635,94.4,139,21,15.1
4,All Students,2020-21,23250,1412,21838,93.9,138,21,15.2
4,All Students,2021-22,18065,1259,16806,93.0,108,24,22.2
4,All Students,2022-23,18368,1145,17223,93.8,108,21,19.4
5,All Students,2018-19,29754,1238,28516,95.8,172,14,8.1
5,All Students,2019-20,19144,831,18313,95.7,170,17,10.0
5,All Students,2020-21,21784,1426,20358,93.5,127,26,20.5
5,All Students,2021-22,23450,1930,21520,91.8,142,38,26.8
5,All Students,2022-23,18861,1319,17542,93.0,108,22,20.4
6,All Students,2018-19,25701,1074,24627,95.8,145,14,9.7
6,All Students,2019-20,15343,695,14648,95.5,137,17,12.4
6,All Students,2020-21,24278,1055,23223,95.7,142,18,12.7
6,All Students,2021-22,17056,1428,15628,91.6,98,31,31.6
6,All Students,2022-23,21351,1489,19862,93.0,124,29,23.4
All Grades,All Students,2018-19,104096,7581,96515,92.7,616,148,24.0
All Grades,All Students,2019-20,67427,5401,62026,92.0,617,186,30.1
All Grades,All Students,2020-21,98684,12929,85755,86.9,592,231,39.0
All Grades,All Students,2021-22,96288,10558,85730,89.0,576,243,42.2
All Grades,All Students,2022-23,96055,10454,85601,89.1,606,278,45.9
PK in K-12 Schools,All Students,2018-19,9460,1209,8251,87.2,58,25,43.1
PK in K-12 Schools,All Students,2019-20,5996,s,s,s,s,s,s
PK in K-12 Schools,All Students,2020-21,7643,1223,6420,84.0,51,26,51.0
PK in K-12 Schools,All Students,2021-22,9053,1419,7634,84.3,56,34,60.7
PK in K-12 Schools,All Students,2022-23,9432,1272,8160,86.5,56,35,62.5
0K,All Students,2018-19,20933,1695,19238,91.9,127,33,26.0
0K,All Students,2019-20,12900,1410,11490,89.1,118,42,35.6
0K,All Students,2020-21,16818,2171,14647,87.1,101,38,37.6
0K,All Students,2021-22,13622,1674,11948,87.7,81,40,49.4
0K,All Students,2022-23,15808,2056,13752,87.0,100,57,57.0
1,All Students,2018-19,13937,1031,12906,92.6,83,21,25.3
1,All Students,2019-20,12202,964,11238,92.1,112,37,33.0
1,All Students,2020-21,17847,3000,14847,83.2,107,47,43.9
1,All Students,2021-22,16322,1909,14413,88.3,98,48,49.0
1,All Students,2022-23,12808,1496,11312,88.3,83,40,48.2
2,All Students,2018-19,14546,1000,13546,93.1,84,21,25.0
2,All Students,2019-20,8409,603,7806,92.8,76,22,28.9
2,All Students,2020-21,16618,1606,15012,90.3,98,30,30.6
2,All Students,2021-22,16703,1852,14851,88.9,102,37,36.3
2,All Students,2022-23,15452,1853,13599,88.0,99,47,47.5
3,All Students,2018-19,15119,1000,14119,93.4,90,16,17.8
3,All Students,2019-20,9531,622,8909,93.5,86,23,26.7
3,All Students,2020-21,11961,1671,10290,86.0,69,29,42.0
3,All Students,2021-22,15371,1290,14081,91.6,90,27,30.0
3,All Students,2022-23,16898,1562,15336,90.8,103,38,36.9
4,All Students,2018-19,14725,951,13774,93.5,86,21,24.4
4,All Students,2019-20,9627,676,8951,93.0,88,20,22.7
4,All Students,2020-21,13478,1521,11957,88.7,81,29,35.8
4,All Students,2021-22,11330,1030,10300,90.9,68,25,36.8
4,All Students,2022-23,14744,1224,13520,91.7,94,33,35.1
5,All Students,2018-19,15376,695,14681,95.5,88,11,12.5
5,All Students,2019-20,8699,524,8175,94.0,78,16,20.5
5,All Students,2020-21,14319,1737,12582,87.9,85,32,37.6
5,All Students,2021-22,13887,1384,12503,90.0,81,32,39.5
5,All Students,2022-23,10913,991,9922,90.9,71,28,39.4
6,All Students,2019-20,63,s,s,s,s,s,s
All Grades,All Students,2018-19,180337,8475,171862,95.3,1056,129,12.2
All Grades,All Students,2019-20,110677,5991,104686,94.6,999,153,15.3
All Grades,All Students,2020-21,151287,5974,145313,96.1,897,105,11.7
All Grades,All Students,2021-22,145185,11277,133908,92.2,872,255,29.2
All Grades,All Students,2022-23,143249,10126,133123,92.9,857,201,23.5
PK in K-12 Schools,All Students,2018-19,10483,814,9669,92.2,64,17,26.6
PK in K-12 Schools,All Students,2019-20,6143,530,5613,91.4,54,20,37.0
PK in K-12 Schools,All Students,2020-21,9171,430,8741,95.3,54,9,16.7
PK in K-12 Schools,All Students,2021-22,9455,1229,8226,87.0,59,30,50.8
PK in K-12 Schools,All Students,2022-23,9527,1172,8355,87.7,56,26,46.4
0K,All Students,2018-19,26001,1630,24371,93.7,153,33,21.6
0K,All Students,2019-20,14618,1018,13600,93.0,136,32,23.5
0K,All Students,2020-21,19316,1372,17944,92.9,120,25,20.8
0K,All Students,2021-22,19875,1709,18166,91.4,116,41,35.3
0K,All Students,2022-23,19937,1752,18185,91.2,121,42,34.7
1,All Students,2018-19,27671,1427,26244,94.8,164,22,13.4
1,All Students,2019-20,17201,1139,16062,93.4,154,31,20.1
1,All Students,2020-21,20873,820,20053,96.1,123,16,13.0
1,All Students,2021-22,18523,1449,17074,92.2,112,33,29.5
1,All Students,2022-23,19967,1389,18578,93.0,119,29,24.4
2,All Students,2018-19,23180,1069,22111,95.4,136,16,11.8
2,All Students,2019-20,17209,962,16247,94.4,154,19,12.3
2,All Students,2020-21,22914,957,21957,95.8,134,15,11.2
2,All Students,2021-22,20204,1342,18862,93.4,122,33,27.0
2,All Students,2022-23,18561,1219,17342,93.4,109,22,20.2
3,All Students,2018-19,28984,1256,27728,95.7,169,16,9.5
3,All Students,2019-20,17092,825,16267,95.2,155,20,12.9
3,All Students,2020-21,29469,636,28833,97.8,173,8,4.6
3,All Students,2021-22,25906,2035,23871,92.1,158,44,27.8
3,All Students,2022-23,22852,1398,21454,93.9,138,25,18.1
4,All Students,2018-19,34137,1144,32993,96.6,197,12,6.1
4,All Students,2019-20,18254,723,17531,96.0,167,12,7.2
4,All Students,2020-21,23979,791,23188,96.7,144,15,10.4
4,All Students,2021-22,28004,1883,26121,93.3,165,38,23.0
4,All Students,2022-23,26809,1723,25086,93.6,163,30,18.4
5,All Students,2018-19,29881,1135,28746,96.2,173,13,7.5
5,All Students,2019-20,20160,794,19366,96.1,179,19,10.6
5,All Students,2020-21,25551,961,24590,96.2,148,16,10.8
5,All Students,2021-22,23218,1630,21588,93.0,140,36,25.7
5,All Students,2022-23,25596,1473,24123,94.2,151,27,17.9
All Grades,All Students,2018-19,153806,9228,144578,94.0,906,177,19.5
All Grades,All Students,2019-20,93157,5705,87452,93.9,843,175,20.8
All Grades,All Students,2020-21,139088,10649,128439,92.3,837,226,27.0
All Grades,All Students,2021-22,139998,13218,126780,90.6,831,300,36.1
All Grades,All Students,2022-23,143206,13730,129476,90.4,863,330,38.2
PK in K-12 Schools,All Students,2018-19,15141,1440,13701,90.5,93,27,29.0
PK in K-12 Schools,All Students,2019-20,9503,754,8749,92.1,89,32,36.0
PK in K-12 Schools,All Students,2020-21,16331,1018,15313,93.8,102,25,24.5
PK in K-12 Schools,All Students,2021-22,20397,2736,17661,86.6,121,66,54.5
PK in K-12 Schools,All Students,2022-23,18643,2526,16117,86.5,114,65,57.0
0K,All Students,2018-19,23800,1879,21921,92.1,143,44,30.8
0K,All Students,2019-20,11766,1014,10752,91.4,110,34,30.9
0K,All Students,2020-21,18167,1134,17033,93.8,115,24,20.9
0K,All Students,2021-22,20900,2271,18629,89.1,125,50,40.0
0K,All Students,2022-23,21970,2712,19258,87.7,134,70,52.2
1,All Students,2018-19,22520,1309,21211,94.2,133,23,17.3
1,All Students,2019-20,13647,875,12772,93.6,123,25,20.3
1,All Students,2020-21,17919,1563,16356,91.3,110,36,32.7
1,All Students,2021-22,17020,1463,15557,91.4,100,33,33.0
1,All Students,2022-23,20222,1680,18542,91.7,122,37,30.3
2,All Students,2018-19,21913,1261,20652,94.2,129,31,24.0
2,All Students,2019-20,14951,920,14031,93.8,135,26,19.3
2,All Students,2020-21,19787,1386,18401,93.0,116,28,24.1
2,All Students,2021-22,18941,1859,17082,90.2,116,48,41.4
2,All Students,2022-23,18276,1440,16836,92.1,112,32,28.6
3,All Students,2018-19,24593,1197,23396,95.1,141,19,13.5
3,All Students,2019-20,13552,770,12782,94.3,122,27,22.1
3,All Students,2020-21,23872,1761,22111,92.6,140,37,26.4
3,All Students,2021-22,20139,1461,18678,92.7,120,33,27.5
3,All Students,2022-23,19263,2062,17201,89.3,114,49,43.0
4,All Students,2018-19,22429,1151,21278,94.9,131,19,14.5
4,All Students,2019-20,15542,651,14891,95.8,138,11,8.0
4,All Students,2020-21,19593,2042,17551,89.6,119,37,31.1
4,All Students,2021-22,23873,2048,21825,91.4,140,42,30.0
4,All Students,2022-23,20880,1405,19475,93.3,123,29,23.6
5,All Students,2018-19,23410,991,22419,95.8,136,14,10.3
5,All Students,2019-20,14196,721,13475,94.9,126,20,15.9
5,All Students,2020-21,23419,1745,21674,92.5,135,39,28.9
5,All Students,2021-22,18728,1380,17348,92.6,109,28,25.7
5,All Students,2022-23,23952,1905,22047,92.0,144,48,33.3
All Grades,All Students,2018-19,79676,6859,72817,91.4,484,162,33.5
All Grades,All Students,2019-20,48350,4141,44209,91.4,446,151,33.9
All Grades,All Students,2020-21,69165,10094,59071,85.4,412,179,43.4
All Grades,All Students,2021-22,69083,8953,60130,87.0,418,226,54.1
All Grades,All Students,2022-23,77851,10548,67303,86.5,565,331,58.6
PK in K-12 Schools,All Students,2018-19,6209,909,5300,85.4,44,28,63.6
PK in K-12 Schools,All Students,2019-20,3963,572,3391,85.6,41,26,63.4
PK in K-12 Schools,All Students,2020-21,6352,1462,4890,77.0,39,28,71.8
PK in K-12 Schools,All Students,2021-22,9853,2042,7811,79.3,64,52,81.3
PK in K-12 Schools,All Students,2022-23,10573,2151,8422,79.7,69,55,79.7
0K,All Students,2018-19,11599,1190,10409,89.7,71,28,39.4
0K,All Students,2019-20,7167,789,6378,89.0,68,32,47.1
0K,All Students,2020-21,10191,2472,7719,75.7,63,40,63.5
0K,All Students,2021-22,9515,1336,8179,86.0,57,34,59.6
0K,All Students,2022-23,10329,1459,8870,85.9,76,50,65.8
1,All Students,2018-19,12107,973,11134,92.0,72,23,31.9
1,All Students,2019-20,6745,642,6103,90.5,60,22,36.7
1,All Students,2020-21,11319,1581,9738,86.0,67,32,47.8
1,All Students,2021-22,10512,1176,9336,88.8,62,28,45.2
1,All Students,2022-23,11296,1556,9740,86.2,88,57,64.8
2,All Students,2018-19,12945,1052,11893,91.9,78,24,30.8
2,All Students,2019-20,7472,528,6944,92.9,68,16,23.5
2,All Students,2020-21,7648,811,6837,89.4,45,17,37.8
2,All Students,2021-22,10288,1280,9008,87.6,62,33,53.2
2,All Students,2022-23,12465,1513,10952,87.9,84,47,56.0
3,All Students,2018-19,13032,898,12134,93.1,79,19,24.1
3,All Students,2019-20,7583,524,7059,93.1,68,21,30.9
3,All Students,2020-21,11181,1270,9911,88.6,67,21,31.3
3,All Students,2021-22,7843,858,6985,89.1,46,21,45.7
3,All Students,2022-23,10630,1250,9380,88.2,85,41,48.2
4,All Students,2018-19,13097,1044,12053,92.0,78,18,23.1
4,All Students,2019-20,7723,505,7218,93.5,71,13,18.3
4,All Students,2020-21,11802,1154,10648,90.2,69,19,27.5
4,All Students,2021-22,10849,1100,9749,89.9,63,28,44.4
4,All Students,2022-23,9400,1009,8391,89.3,65,28,43.1
5,All Students,2018-19,10687,793,9894,92.6,62,22,35.5
5,All Students,2019-20,7697,581,7116,92.5,70,21,30.0
5,All Students,2020-21,10672,1344,9328,87.4,62,22,35.5
5,All Students,2021-22,10223,1161,9062,88.6,64,30,46.9
5,All Students,2022-23,13158,1610,11548,87.8,98,53,54.1
All Grades,All Students,2018-19,131922,7432,124490,94.4,772,123,15.9
All Grades,All Students,2019-20,85801,4819,80982,94.4,774,133,17.2
All Grades,All Students,2020-21,116282,1661,114621,98.6,708,11,1.6
All Grades,All Students,2021-22,124514,8695,115819,93.0,746,174,23.3
All Grades,All Students,2022-23,131570,10531,121039,92.0,809,232,28.7
PK in K-12 Schools,All Students,2018-19,6515,429,6086,93.4,38,7,18.4
PK in K-12 Schools,All Students,2019-20,3606,282,3324,92.2,33,11,33.3
PK in K-12 Schools,All Students,2020-21,5178,179,4999,96.5,34,4,11.8
PK in K-12 Schools,All Students,2021-22,5774,667,5107,88.4,38,19,50.0
PK in K-12 Schools,All Students,2022-23,5423,674,4749,87.6,36,17,47.2
0K,All Students,2018-19,17532,1369,16163,92.2,102,28,27.5
0K,All Students,2019-20,9989,575,9414,94.2,89,14,15.7
0K,All Students,2020-21,12856,211,12645,98.4,80,0,0.0
0K,All Students,2021-22,16664,1465,15199,91.2,99,38,38.4
0K,All Students,2022-23,17340,1467,15873,91.5,104,31,29.8
1,All Students,2018-19,20568,1080,19488,94.7,123,18,14.6
1,All Students,2019-20,10257,685,9572,93.3,93,21,22.6
1,All Students,2020-21,11099,147,10952,98.7,70,1,1.4
1,All Students,2021-22,13359,915,12444,93.2,81,15,18.5
1,All Students,2022-23,16910,1547,15363,90.9,106,36,34.0
2,All Students,2018-19,15642,906,14736,94.2,91,14,15.4
2,All Students,2019-20,12022,597,11425,95.0,108,16,14.8
2,All Students,2020-21,13794,196,13598,98.6,83,1,1.2
2,All Students,2021-22,12399,706,11693,94.3,74,9,12.2
2,All Students,2022-23,13964,1077,12887,92.3,89,23,25.8
3,All Students,2018-19,16688,897,15791,94.6,97,12,12.4
3,All Students,2019-20,9524,518,9006,94.6,85,12,14.1
3,All Students,2020-21,15068,155,14913,99.0,93,2,2.2
3,All Students,2021-22,13562,965,12597,92.9,84,16,19.0
3,All Students,2022-23,14709,1023,13686,93.0,95,23,24.2
4,All Students,2018-19,15201,753,14448,95.0,87,8,9.2
4,All Students,2019-20,10898,619,10279,94.3,98,20,20.4
4,All Students,2020-21,12296,121,12175,99.0,74,0,0.0
4,All Students,2021-22,15065,936,14129,93.8,87,19,21.8
4,All Students,2022-23,13142,860,12282,93.5,77,14,18.2
5,All Students,2018-19,15229,735,14494,95.2,91,14,15.4
5,All Students,2019-20,10185,423,9762,95.8,93,9,9.7
5,All Students,2020-21,14838,172,14666,98.8,90,0,0.0
5,All Students,2021-22,13505,859,12646,93.6,80,15,18.8
5,All Students,2022-23,15656,1227,14429,92.2,97,31,32.0
6,All Students,2018-19,9088,559,8529,93.8,54,9,16.7
6,All Students,2019-20,8618,436,8182,94.9,79,9,11.4
6,All Students,2020-21,11960,208,11752,98.3,70,1,1.4
6,All Students,2021-22,12984,887,12097,93.2,77,17,22.1
6,All Students,2022-23,12243,955,11288,92.2,75,18,24.0
7,All Students,2018-19,7719,317,7402,95.9,45,6,13.3
7,All Students,2019-20,5507,395,5112,92.8,50,13,26.0
7,All Students,2020-21,11149,149,11000,98.7,66,0,0.0
7,All Students,2021-22,10289,619,9670,94.0,60,11,18.3
7,All Students,2022-23,11966,930,11036,92.2,70,18,25.7
8,All Students,2018-19,7740,387,7353,95.0,44,7,15.9
8,All Students,2019-20,5195,289,4906,94.4,46,8,17.4
8,All Students,2020-21,7991,121,7870,98.5,47,2,4.3
8,All Students,2021-22,10913,676,10237,93.8,66,15,22.7
8,All Students,2022-23,10217,771,9446,92.5,60,21,35.0
All Grades,All Students,2018-19,49459,3371,46088,93.2,299,68,22.7
All Grades,All Students,2019-20,30453,1667,28786,94.5,276,41,14.9
All Grades,All Students,2020-21,47811,2713,45098,94.3,284,54,19.0
All Grades,All Students,2021-22,49928,4895,45033,90.2,302,115,38.1
All Grades,All Students,2022-23,58658,6080,52578,89.6,353,143,40.5
PK in K-12 Schools,All Students,2018-19,7520,733,6787,90.3,48,16,33.3
PK in K-12 Schools,All Students,2019-20,3481,309,3172,91.1,33,11,33.3
PK in K-12 Schools,All Students,2020-21,7018,750,6268,89.3,43,19,44.2
PK in K-12 Schools,All Students,2021-22,8524,1433,7091,83.2,55,39,70.9
PK in K-12 Schools,All Students,2022-23,9338,1480,7858,84.2,55,36,65.5
0K,All Students,2018-19,8476,758,7718,91.1,50,21,42.0
0K,All Students,2019-20,4587,288,4299,93.7,43,6,14.0
0K,All Students,2020-21,8584,561,8023,93.5,51,10,19.6
0K,All Students,2021-22,10527,982,9545,90.7,63,21,33.3
0K,All Students,2022-23,10136,1182,8954,88.3,61,33,54.1
1,All Students,2018-19,4876,336,4540,93.1,30,8,26.7
1,All Students,2019-20,5368,293,5075,94.5,47,5,10.6
1,All Students,2020-21,5735,234,5501,95.9,34,7,20.6
1,All Students,2021-22,6996,644,6352,90.8,40,17,42.5
1,All Students,2022-23,11293,1045,10248,90.7,69,28,40.6
2,All Students,2018-19,5618,343,5275,93.9,33,4,12.1
2,All Students,2019-20,3391,159,3232,95.3,31,5,16.1
2,All Students,2020-21,8325,406,7919,95.1,48,5,10.4
2,All Students,2021-22,4527,364,4163,92.0,28,6,21.4
2,All Students,2022-23,8036,808,7228,89.9,48,15,31.3
3,All Students,2018-19,8431,322,8109,96.2,53,3,5.7
3,All Students,2019-20,3608,227,3381,93.7,32,6,18.8
3,All Students,2020-21,4811,247,4564,94.9,29,5,17.2
3,All Students,2021-22,8367,732,7635,91.3,51,17,33.3
3,All Students,2022-23,4691,339,4352,92.8,32,9,28.1
4,All Students,2018-19,7227,406,6821,94.4,42,8,19.0
4,All Students,2019-20,5198,198,5000,96.2,47,5,10.6
4,All Students,2020-21,5457,248,5209,95.5,32,5,15.6
4,All Students,2021-22,5309,316,4993,94.0,32,6,18.8
4,All Students,2022-23,9544,822,8722,91.4,55,14,25.5
5,All Students,2018-19,7311,473,6838,93.5,43,8,18.6
5,All Students,2019-20,4820,193,4627,96.0,43,3,7.0
5,All Students,2020-21,7881,267,7614,96.6,47,3,6.4
5,All Students,2021-22,5678,424,5254,92.5,33,9,27.3
5,All Students,2022-23,5620,404,5216,92.8,33,8,24.2
All Grades,All Students,2018-19,113634,6680,106954,94.1,664,120,18.1
All Grades,All Students,2019-20,74718,4230,70488,94.3,671,109,16.2
All Grades,All Students,2020-21,101855,4093,97762,96.0,601,59,9.8
All Grades,All Students,2021-22,101704,7846,93858,92.3,596,172,28.9
All Grades,All Students,2022-23,99227,7886,91341,92.1,593,163,27.5
PK in K-12 Schools,All Students,2018-19,11296,1055,10241,90.7,71,23,32.4
PK in K-12 Schools,All Students,2019-20,7367,769,6598,89.6,71,27,38.0
PK in K-12 Schools,All Students,2020-21,6013,s,s,s,s,s,s
PK in K-12 Schools,All Students,2021-22,6214,726,5488,88.3,37,17,45.9
PK in K-12 Schools,All Students,2022-23,5802,711,5091,87.7,39,20,51.3
0K,All Students,2018-19,16919,1036,15883,93.9,98,17,17.3
0K,All Students,2019-20,12291,822,11469,93.3,111,25,22.5
0K,All Students,2020-21,14103,546,13557,96.1,85,7,8.2
0K,All Students,2021-22,14483,1301,13182,91.0,88,34,38.6
0K,All Students,2022-23,14121,1430,12691,89.9,85,28,32.9
1,All Students,2018-19,17413,1057,16356,93.9,100,20,20.0
1,All Students,2019-20,11635,683,10952,94.1,105,19,18.1
1,All Students,2020-21,16832,666,16166,96.0,100,11,11.0
1,All Students,2021-22,15425,1349,14076,91.3,90,27,30.0
1,All Students,2022-23,14879,1148,13731,92.3,89,27,30.3
2,All Students,2018-19,18973,993,17980,94.8,110,16,14.5
2,All Students,2019-20,11520,567,10953,95.1,101,14,13.9
2,All Students,2020-21,15883,677,15206,95.7,94,11,11.7
2,All Students,2021-22,17119,1287,15832,92.5,99,32,32.3
2,All Students,2022-23,17061,1351,15710,92.1,100,30,30.0
3,All Students,2018-19,18096,931,17165,94.9,105,15,14.3
3,All Students,2019-20,11976,510,11466,95.7,106,7,6.6
3,All Students,2020-21,15208,482,14726,96.8,90,3,3.3
3,All Students,2021-22,16136,997,15139,93.8,94,18,19.1
3,All Students,2022-23,16533,1262,15271,92.4,96,25,26.0
4,All Students,2018-19,15256,773,14483,94.9,89,12,13.5
4,All Students,2019-20,10767,434,10333,96.0,95,8,8.4
4,All Students,2020-21,17978,703,17275,96.1,104,12,11.5
4,All Students,2021-22,15500,1014,14486,93.5,90,20,22.2
4,All Students,2022-23,16009,995,15014,93.8,94,16,17.0
5,All Students,2018-19,15681,835,14846,94.7,91,17,18.7
5,All Students,2019-20,9162,445,8717,95.1,82,9,11.0
5,All Students,2020-21,15830,706,15124,95.5,92,11,12.0
5,All Students,2021-22,16827,1172,15655,93.0,98,24,24.5
5,All Students,2022-23,14822,989,13833,93.3,90,17,18.9
6,All Students,2020-21,8,s,s,s,s,s,s
All Grades,All Students,2018-19,161997,7133,154864,95.6,933,100,10.7
All Grades,All Students,2019-20,103257,4647,98610,95.5,919,97,10.6
All Grades,All Students,2020-21,148023,10997,137026,92.6,875,221,25.3
All Grades,All Students,2021-22,147575,10505,137070,92.9,878,218,24.8
All Grades,All Students,2022-23,149694,10828,138866,92.8,906,231,25.5
PK in K-12 Schools,All Students,2018-19,15362,1064,14298,93.1,91,23,25.3
PK in K-12 Schools,All Students,2019-20,10066,785,9281,92.2,91,27,29.7
PK in K-12 Schools,All Students,2020-21,13995,1491,12504,89.3,82,36,43.9
PK in K-12 Schools,All Students,2021-22,17785,1725,16060,90.3,112,48,42.9
PK in K-12 Schools,All Students,2022-23,20405,2337,18068,88.5,123,59,48.0
0K,All Students,2018-19,24498,1313,23185,94.6,141,19,13.5
0K,All Students,2019-20,14899,863,14036,94.2,131,18,13.7
0K,All Students,2020-21,21118,1764,19354,91.6,129,35,27.1
0K,All Students,2021-22,16929,1354,15575,92.0,100,29,29.0
0K,All Students,2022-23,18040,1255,16785,93.0,112,28,25.0
1,All Students,2018-19,24608,1167,23441,95.3,141,18,12.8
1,All Students,2019-20,15491,619,14872,96.0,138,11,8.0
1,All Students,2020-21,21568,1794,19774,91.7,132,38,28.8
1,All Students,2021-22,22189,1807,20382,91.9,133,36,27.1
1,All Students,2022-23,17786,1327,16459,92.5,110,27,24.5
2,All Students,2018-19,25503,1006,24497,96.1,147,12,8.2
2,All Students,2019-20,15476,589,14887,96.2,139,10,7.2
2,All Students,2020-21,22682,1729,20953,92.4,132,34,25.8
2,All Students,2021-22,22724,1498,21226,93.4,135,29,21.5
2,All Students,2022-23,23129,1561,21568,93.3,140,36,25.7
3,All Students,2018-19,23708,845,22863,96.4,136,9,6.6
3,All Students,2019-20,16599,724,15875,95.6,147,17,11.6
3,All Students,2020-21,22838,1470,21368,93.6,135,23,17.0
3,All Students,2021-22,23186,1512,21674,93.5,135,31,23.0
3,All Students,2022-23,25590,1667,23923,93.5,156,30,19.2
4,All Students,2018-19,26253,908,25345,96.5,151,8,5.3
4,All Students,2019-20,15789,542,15247,96.6,139,8,5.8
4,All Students,2020-21,24358,1455,22903,94.0,140,29,20.7
4,All Students,2021-22,23493,1311,22182,94.4,138,21,15.2
4,All Students,2022-23,22370,1422,20948,93.6,132,25,18.9
5,All Students,2018-19,22065,830,21235,96.2,126,11,8.7
5,All Students,2019-20,14937,525,14412,96.5,134,6,4.5
5,All Students,2020-21,21464,1294,20170,94.0,125,26,20.8
5,All Students,2021-22,21269,1298,19971,93.9,125,24,19.2
5,All Students,2022-23,22374,1259,21115,94.4,133,26,19.5
All Grades,All Students,2018-19,58780,6201,52579,89.5,395,185,46.8
All Grades,All Students,2019-20,38045,3922,34123,89.7,378,144,38.1
All Grades,All Students,2020-21,57700,7377,50323,87.2,356,164,46.1
All Grades,All Students,2021-22,51721,8489,43232,83.6,320,202,63.1
All Grades,All Students,2022-23,73961,9732,64229,86.8,556,320,57.6
PK in K-12 Schools,All Students,2018-19,4122,645,3477,84.4,26,18,69.2
PK in K-12 Schools,All Students,2019-20,2893,517,2376,82.1,32,23,71.9
PK in K-12 Schools,All Students,2020-21,1615,310,1305,80.8,12,8,66.7
PK in K-12 Schools,All Students,2021-22,3628,763,2865,79.0,23,21,91.3
PK in K-12 Schools,All Students,2022-23,6216,1142,5074,81.6,40,32,80.0
0K,All Students,2018-19,7860,1188,6672,84.9,58,42,72.4
0K,All Students,2019-20,3851,508,3343,86.8,40,21,52.5
0K,All Students,2020-21,6456,899,5557,86.1,42,22,52.4
0K,All Students,2021-22,4584,1062,3522,76.8,29,22,75.9
0K,All Students,2022-23,9228,1443,7785,84.4,79,48,60.8
1,All Students,2018-19,7966,895,7071,88.8,54,28,51.9
1,All Students,2019-20,4440,408,4032,90.8,47,18,38.3
1,All Students,2020-21,5561,1086,4475,80.5,33,23,69.7
1,All Students,2021-22,6124,1115,5009,81.8,36,24,66.7
1,All Students,2022-23,8813,1198,7615,86.4,79,47,59.5
2,All Students,2018-19,8217,847,7370,89.7,55,23,41.8
2,All Students,2019-20,5151,531,4620,89.7,51,19,37.3
2,All Students,2020-21,6507,1015,5492,84.4,39,22,56.4
2,All Students,2021-22,4144,690,3454,83.3,26,20,76.9
2,All Students,2022-23,8881,1154,7727,87.0,76,49,64.5
3,All Students,2018-19,6557,591,5966,91.0,47,20,42.6
3,All Students,2019-20,4943,513,4430,89.6,48,18,37.5
3,All Students,2020-21,7564,974,6590,87.1,45,21,46.7
3,All Students,2021-22,5258,769,4489,85.4,32,21,65.6
3,All Students,2022-23,5651,629,5022,88.9,39,20,51.3
4,All Students,2018-19,5105,436,4669,91.5,33,12,36.4
4,All Students,2019-20,3782,231,3551,93.9,35,7,20.0
4,All Students,2020-21,8031,1223,6808,84.8,50,27,54.0
4,All Students,2021-22,7424,1097,6327,85.2,48,26,54.2
4,All Students,2022-23,5659,677,4982,88.0,43,22,51.2
5,All Students,2018-19,4138,441,3697,89.3,28,13,46.4
5,All Students,2019-20,3115,278,2837,91.1,33,15,45.5
5,All Students,2020-21,4919,339,4580,93.1,31,6,19.4
5,All Students,2021-22,6528,883,5645,86.5,39,18,46.2
5,All Students,2022-23,7138,718,6420,89.9,45,20,44.4
6,All Students,2018-19,6298,389,5909,93.8,41,10,24.4
6,All Students,2019-20,3135,371,2764,88.2,29,10,34.5
6,All Students,2020-21,6165,635,5530,89.7,38,15,39.5
6,All Students,2021-22,5062,594,4468,88.3,33,16,48.5
6,All Students,2022-23,10922,1347,9575,87.7,78,41,52.6
7,All Students,2018-19,4848,362,4486,92.5,31,9,29.0
7,All Students,2019-20,3773,271,3502,92.8,37,7,18.9
7,All Students,2020-21,5069,489,4580,90.4,30,10,33.3
7,All Students,2021-22,4162,650,3512,84.4,25,13,52.0
7,All Students,2022-23,5572,s,s,s,s,s,s
8,All Students,2018-19,3669,407,3262,88.9,22,10,45.5
8,All Students,2019-20,2962,294,2668,90.1,26,7,26.9
8,All Students,2020-21,5813,407,5406,93.0,36,10,27.8
8,All Students,2021-22,4807,866,3941,82.0,29,21,72.4
8,All Students,2022-23,5793,620,5173,89.3,38,18,47.4
9,All Students,2022-23,88,s,s,s,s,s,s
All Grades,All Students,2018-19,79001,7437,71564,90.6,485,178,36.7
All Grades,All Students,2019-20,47716,4221,43495,91.2,434,143,32.9
All Grades,All Students,2020-21,68923,6397,62526,90.7,414,120,29.0
All Grades,All Students,2021-22,70076,10210,59866,85.4,437,230,52.6
All Grades,All Students,2022-23,83921,11184,72737,86.7,626,352,56.2
PK in K-12 Schools,All Students,2018-19,10562,1612,8950,84.7,65,40,61.5
PK in K-12 Schools,All Students,2019-20,5455,652,4803,88.0,53,28,52.8
PK in K-12 Schools,All Students,2020-21,8410,630,7780,92.5,52,12,23.1
PK in K-12 Schools,All Students,2021-22,13988,2749,11239,80.3,91,60,65.9
PK in K-12 Schools,All Students,2022-23,15171,2579,12592,83.0,120,79,65.8
0K,All Students,2018-19,9119,826,8293,90.9,59,19,32.2
0K,All Students,2019-20,7381,866,6515,88.3,67,31,46.3
0K,All Students,2020-21,8777,1374,7403,84.3,54,24,44.4
0K,All Students,2021-22,10851,1321,9530,87.8,68,34,50.0
0K,All Students,2022-23,12533,1892,10641,84.9,89,55,61.8
1,All Students,2018-19,11546,1160,10386,90.0,70,27,38.6
1,All Students,2019-20,6172,567,5605,90.8,56,15,26.8
1,All Students,2020-21,10547,1381,9166,86.9,62,23,37.1
1,All Students,2021-22,9311,1599,7712,82.8,57,31,54.4
1,All Students,2022-23,13527,1717,11810,87.3,99,56,56.6
2,All Students,2018-19,11766,947,10819,92.0,72,18,25.0
2,All Students,2019-20,6323,556,5767,91.2,57,18,31.6
2,All Students,2020-21,9006,683,8323,92.4,55,14,25.5
2,All Students,2021-22,8848,1257,7591,85.8,55,26,47.3
2,All Students,2022-23,8801,1157,7644,86.9,66,39,59.1
3,All Students,2018-19,13375,1110,12265,91.7,84,29,34.5
3,All Students,2019-20,7277,562,6715,92.3,65,19,29.2
3,All Students,2020-21,9515,777,8738,91.8,57,16,28.1
3,All Students,2021-22,9040,1091,7949,87.9,56,28,50.0
3,All Students,2022-23,12516,1446,11070,88.4,96,47,49.0
4,All Students,2018-19,11139,864,10275,92.2,66,20,30.3
4,All Students,2019-20,8419,567,7852,93.3,76,18,23.7
4,All Students,2020-21,10489,760,9729,92.8,63,12,19.0
4,All Students,2021-22,9025,1267,7758,86.0,54,30,55.6
4,All Students,2022-23,9899,1135,8764,88.5,80,39,48.8
5,All Students,2018-19,11494,918,10576,92.0,69,25,36.2
5,All Students,2019-20,6689,451,6238,93.3,60,14,23.3
5,All Students,2020-21,12179,792,11387,93.5,71,19,26.8
5,All Students,2021-22,9013,926,8087,89.7,56,21,37.5
5,All Students,2022-23,11474,1258,10216,89.0,76,37,48.7
All Grades,All Students,2018-19,241348,11447,229901,95.3,1400,165,11.8
All Grades,All Students,2019-20,156410,6976,149434,95.5,1393,160,11.5
All Grades,All Students,2020-21,219582,7306,212276,96.7,1288,109,8.5
All Grades,All Students,2021-22,206011,13330,192681,93.5,1212,232,19.1
All Grades,All Students,2022-23,203663,13949,189714,93.2,1184,282,23.8
7,All Students,2019-20,23966,1499,22467,93.7,215,42,19.5
PK in K-12 Schools,All Students,2018-19,6219,465,5754,92.5,40,10,25.0
PK in K-12 Schools,All Students,2019-20,4038,387,3651,90.4,39,16,41.0
PK in K-12 Schools,All Students,2020-21,5754,554,5200,90.4,33,16,48.5
PK in K-12 Schools,All Students,2021-22,6123,791,5332,87.1,36,18,50.0
PK in K-12 Schools,All Students,2022-23,5384,815,4569,84.9,31,23,74.2
0K,All Students,2018-19,29706,2005,27701,93.3,173,37,21.4
0K,All Students,2019-20,19454,1045,18409,94.6,174,24,13.8
0K,All Students,2020-21,25118,1351,23767,94.6,153,23,15.0
0K,All Students,2021-22,22347,2043,20304,90.9,135,47,34.8
0K,All Students,2022-23,22573,2265,20308,90.0,134,62,46.3
1,All Students,2018-19,26890,1408,25482,94.8,161,21,13.0
1,All Students,2019-20,19509,1051,18458,94.6,176,30,17.0
1,All Students,2020-21,27792,1098,26694,96.0,162,18,11.1
1,All Students,2021-22,21978,1644,20334,92.5,132,34,25.8
1,All Students,2022-23,21690,1752,19938,91.9,126,42,33.3
2,All Students,2018-19,31025,1554,29471,95.0,179,21,11.7
2,All Students,2019-20,16729,835,15894,95.0,149,16,10.7
2,All Students,2020-21,27848,835,27013,97.0,162,9,5.6
2,All Students,2021-22,27781,1874,25907,93.3,163,30,18.4
2,All Students,2022-23,22693,1651,21042,92.7,132,40,30.3
3,All Students,2018-19,29535,1375,28160,95.3,171,15,8.8
3,All Students,2019-20,20224,938,19286,95.4,181,22,12.2
3,All Students,2020-21,23630,695,22935,97.1,143,9,6.3
3,All Students,2021-22,27354,1695,25659,93.8,165,31,18.8
3,All Students,2022-23,27314,1864,25450,93.2,162,32,19.8
4,All Students,2018-19,33274,1453,31821,95.6,194,19,9.8
4,All Students,2019-20,18645,840,17805,95.5,166,19,11.4
4,All Students,2020-21,27528,880,26648,96.8,161,12,7.5
4,All Students,2021-22,22626,1406,21220,93.8,135,24,17.8
4,All Students,2022-23,27604,1485,26119,94.6,160,17,10.6
5,All Students,2018-19,28849,1553,27296,94.6,165,32,19.4
5,All Students,2019-20,20499,917,19582,95.5,182,23,12.6
5,All Students,2020-21,26599,885,25714,96.7,156,11,7.1
5,All Students,2021-22,24751,1739,23012,93.0,142,27,19.0
5,All Students,2022-23,22024,1469,20555,93.3,128,28,21.9
6,All Students,2018-19,21642,588,21054,97.3,124,1,0.8
6,All Students,2019-20,14263,433,13830,97.0,125,6,4.8
6,All Students,2020-21,20445,395,20050,98.1,118,5,4.2
6,All Students,2021-22,18714,981,17733,94.8,109,13,11.9
6,All Students,2022-23,20477,1027,19450,95.0,117,15,12.8
7,All Students,2018-19,18018,513,17505,97.2,102,3,2.9
7,All Students,2019-20,11799,195,11604,98.3,103,1,1.0
7,All Students,2020-21,17736,278,17458,98.4,102,2,2.0
7,All Students,2021-22,17717,514,17203,97.1,101,4,4.0
7,All Students,2022-23,16893,885,16008,94.8,97,15,15.5
8,All Students,2018-19,16190,533,15657,96.7,91,6,6.6
8,All Students,2019-20,11250,335,10915,97.0,98,3,3.1
8,All Students,2020-21,17132,335,16797,98.0,98,4,4.1
8,All Students,2021-22,16620,643,15977,96.1,94,4,4.3
8,All Students,2022-23,17011,736,16275,95.7,97,8,8.2
All Grades,All Students,2018-19,121178,8250,112928,93.2,702,156,22.2
All Grades,All Students,2019-20,72235,4731,67504,93.5,652,135,20.7
All Grades,All Students,2020-21,101191,9203,91988,90.9,592,150,25.3
All Grades,All Students,2021-22,82824,7661,75163,90.8,488,167,34.2
All Grades,All Students,2022-23,72457,5900,66557,91.9,458,150,32.8
6,All Students,2018-19,38384,2277,36107,94.1,227,51,22.5
6,All Students,2019-20,23184,1387,21797,94.0,210,37,17.6
6,All Students,2020-21,31404,2755,28649,91.2,186,46,24.7
6,All Students,2021-22,26189,2397,23792,90.8,154,47,30.5
6,All Students,2022-23,19235,1680,17555,91.3,122,48,39.3
7,All Students,2018-19,41372,2734,38638,93.4,239,50,20.9
7,All Students,2020-21,33137,2763,30374,91.7,194,57,29.4
7,All Students,2021-22,26279,2269,24010,91.4,154,53,34.4
7,All Students,2022-23,26345,2110,24235,92.0,169,52,30.8
8,All Students,2018-19,41422,3239,38183,92.2,236,55,23.3
8,All Students,2019-20,25085,1845,23240,92.6,227,56,24.7
8,All Students,2020-21,36650,3685,32965,89.9,212,47,22.2
8,All Students,2021-22,30356,2995,27361,90.1,180,67,37.2
8,All Students,2022-23,26877,2110,24767,92.1,167,50,29.9
All Grades,All Students,2018-19,223306,15567,207739,93.0,1361,348,25.6
All Grades,All Students,2019-20,138994,9041,129953,93.5,1265,275,21.7
All Grades,All Students,2020-21,187875,15002,172873,92.0,1134,299,26.4
All Grades,All Students,2021-22,189300,19770,169530,89.6,1173,501,42.7
All Grades,All Students,2022-23,192105,16868,175237,91.2,1266,453,35.8
PK in K-12 Schools,All Students,2018-19,7031,s,s,s,s,s,s
PK in K-12 Schools,All Students,2019-20,4543,400,4143,91.2,41,13,31.7
PK in K-12 Schools,All Students,2020-21,5723,628,5095,89.0,34,15,44.1
PK in K-12 Schools,All Students,2021-22,8483,1291,7192,84.8,54,35,64.8
PK in K-12 Schools,All Students,2022-23,8820,996,7824,88.7,54,23,42.6
0K,All Students,2018-19,21128,2030,19098,90.4,134,49,36.6
0K,All Students,2019-20,15267,1364,13903,91.1,145,48,33.1
0K,All Students,2020-21,15248,1490,13758,90.2,98,32,32.7
0K,All Students,2021-22,17514,2186,15328,87.5,110,59,53.6
0K,All Students,2022-23,14367,1840,12527,87.2,102,60,58.8
1,All Students,2018-19,21397,1802,19595,91.6,135,44,32.6
1,All Students,2019-20,11643,915,10728,92.1,106,29,27.4
1,All Students,2020-21,19358,1176,18182,93.9,119,29,24.4
1,All Students,2021-22,15480,1847,13633,88.1,99,49,49.5
1,All Students,2022-23,17847,1770,16077,90.1,124,55,44.4
2,All Students,2018-19,19311,1376,17935,92.9,116,30,25.9
2,All Students,2019-20,14646,859,13787,94.1,133,26,19.5
2,All Students,2020-21,16404,870,15534,94.7,98,22,22.4
2,All Students,2021-22,19310,2055,17255,89.4,116,52,44.8
2,All Students,2022-23,16748,1521,15227,90.9,118,47,39.8
3,All Students,2018-19,25998,1590,24408,93.9,161,40,24.8
3,All Students,2019-20,12610,639,11971,94.9,113,19,16.8
3,All Students,2020-21,21640,1158,20482,94.6,132,26,19.7
3,All Students,2021-22,17279,1708,15571,90.1,106,46,43.4
3,All Students,2022-23,19642,1506,18136,92.3,130,44,33.8
4,All Students,2018-19,20941,1213,19728,94.2,129,25,19.4
4,All Students,2019-20,16295,987,15308,93.9,149,31,20.8
4,All Students,2020-21,18705,690,18015,96.3,111,9,8.1
4,All Students,2021-22,23848,1998,21850,91.6,143,50,35.0
4,All Students,2022-23,18595,1540,17055,91.7,133,45,33.8
5,All Students,2018-19,21917,1311,20606,94.0,135,28,20.7
5,All Students,2019-20,13132,803,12329,93.9,120,19,15.8
5,All Students,2020-21,22827,1551,21276,93.2,136,33,24.3
5,All Students,2021-22,19274,1737,17537,91.0,117,44,37.6
5,All Students,2022-23,24538,1713,22825,93.0,155,36,23.2
6,All Students,2018-19,31414,1869,29545,94.1,186,38,20.4
6,All Students,2019-20,14278,756,13522,94.7,130,18,13.8
6,All Students,2020-21,20535,2241,18294,89.1,123,35,28.5
6,All Students,2021-22,26308,2520,23788,90.4,162,65,40.1
6,All Students,2022-23,22195,1716,20479,92.3,142,44,31.0
7,All Students,2018-19,26844,1530,25314,94.3,162,33,20.4
7,All Students,2019-20,19409,1194,18215,93.8,173,33,19.1
7,All Students,2020-21,19795,1981,17814,90.0,118,32,27.1
7,All Students,2021-22,20454,2021,18433,90.1,131,44,33.6
7,All Students,2022-23,26765,2210,24555,91.7,169,51,30.2
8,All Students,2018-19,27324,1960,25364,92.8,161,40,24.8
8,All Students,2019-20,17171,1124,16047,93.5,155,39,25.2
8,All Students,2020-21,27640,3217,24423,88.4,165,66,40.0
8,All Students,2021-22,21350,2407,18943,88.7,135,57,42.2
8,All Students,2022-23,22588,2056,20532,90.9,139,48,34.5
9,All Students,2018-19,1,s,s,s,s,s,s
All Grades,All Students,2018-19,209719,10404,199315,95.0,1217,181,14.9
All Grades,All Students,2019-20,135994,6394,129600,95.3,1209,142,11.7
All Grades,All Students,2020-21,201477,8715,192762,95.7,1189,133,11.2
All Grades,All Students,2021-22,194240,15355,178885,92.1,1138,305,26.8
All Grades,All Students,2022-23,185691,13958,171733,92.5,1089,285,26.2
6,All Students,2018-19,74540,3576,70964,95.2,436,57,13.1
6,All Students,2019-20,44771,1943,42828,95.7,400,39,9.8
6,All Students,2020-21,64352,2743,61609,95.7,384,39,10.2
6,All Students,2021-22,64045,4531,59514,92.9,381,87,22.8
6,All Students,2022-23,61749,3918,57831,93.7,361,70,19.4
7,All Students,2018-19,67262,2989,64273,95.6,391,53,13.6
7,All Students,2019-20,46338,2136,44202,95.4,412,50,12.1
7,All Students,2020-21,66796,2579,64217,96.1,392,35,8.9
7,All Students,2021-22,62309,5307,57002,91.5,367,105,28.6
7,All Students,2022-23,61531,s,s,s,s,s,s
8,All Students,2018-19,67917,3839,64078,94.3,390,71,18.2
8,All Students,2019-20,44885,2315,42570,94.8,398,53,13.3
8,All Students,2020-21,70329,3393,66936,95.2,413,59,14.3
8,All Students,2021-22,67886,5517,62369,91.9,390,113,29.0
8,All Students,2022-23,62410,5544,56866,91.1,365,125,34.2
9,All Students,2022-23,1,s,s,s,s,s,s
All Grades,All Students,2018-19,303272,14650,288622,95.2,1763,216,12.3
All Grades,All Students,2019-20,191536,7732,183804,96.0,1714,179,10.4
All Grades,All Students,2020-21,280196,16718,263478,94.0,1647,299,18.2
All Grades,All Students,2021-22,275372,18893,256479,93.1,1619,380,23.5
All Grades,All Students,2022-23,268794,16617,252177,93.8,1582,295,18.6
6,All Students,2018-19,107668,5051,102617,95.3,628,69,11.0
6,All Students,2019-20,63653,2489,61164,96.1,569,57,10.0
6,All Students,2020-21,84601,5144,79457,93.9,502,100,19.9
6,All Students,2021-22,93142,5905,87237,93.7,551,115,20.9
6,All Students,2022-23,85139,4700,80439,94.5,503,77,15.3
7,All Students,2018-19,94075,s,s,s,s,s,s
7,All Students,2019-20,67977,2814,65163,95.9,609,66,10.8
7,All Students,2020-21,93957,5649,88308,94.0,549,95,17.3
7,All Students,2021-22,85303,6137,79166,92.8,504,131,26.0
7,All Students,2022-23,95098,6022,89076,93.7,563,115,20.4
8,All Students,2018-19,101528,5513,96015,94.6,590,91,15.4
8,All Students,2019-20,59906,2429,57477,95.9,536,56,10.4
8,All Students,2020-21,101638,5925,95713,94.2,596,104,17.4
8,All Students,2021-22,96927,6851,90076,92.9,564,134,23.8
8,All Students,2022-23,88557,5895,82662,93.3,516,103,20.0
9,All Students,2018-19,1,s,s,s,s,s,s
All Grades,All Students,2018-19,142496,7842,134654,94.5,851,141,16.6
All Grades,All Students,2019-20,88978,5017,83961,94.4,807,131,16.2
All Grades,All Students,2020-21,126754,9125,117629,92.8,762,175,23.0
All Grades,All Students,2021-22,124218,11497,112721,90.7,765,294,38.4
All Grades,All Students,2022-23,120175,10468,109707,91.3,742,245,33.0
PK in K-12 Schools,All Students,2018-19,12939,1133,11806,91.2,78,22,28.2
PK in K-12 Schools,All Students,2019-20,8211,718,7493,91.3,72,28,38.9
PK in K-12 Schools,All Students,2020-21,11167,1246,9921,88.8,66,24,36.4
PK in K-12 Schools,All Students,2021-22,9572,1058,8514,88.9,59,24,40.7
PK in K-12 Schools,All Students,2022-23,9790,1163,8627,88.1,64,24,37.5
0K,All Students,2018-19,17566,1102,16464,93.7,106,29,27.4
0K,All Students,2019-20,14036,1099,12937,92.2,128,32,25.0
0K,All Students,2020-21,19252,1269,17983,93.4,118,27,22.9
0K,All Students,2021-22,18593,1948,16645,89.5,117,58,49.6
0K,All Students,2022-23,17955,1728,16227,90.4,114,43,37.7
1,All Students,2018-19,21624,1345,20279,93.8,131,25,19.1
1,All Students,2019-20,11840,607,11233,94.9,111,16,14.4
1,All Students,2020-21,20330,1763,18567,91.3,123,35,28.5
1,All Students,2021-22,20522,2045,18477,90.0,128,51,39.8
1,All Students,2022-23,18424,1710,16714,90.7,119,39,32.8
2,All Students,2018-19,20939,961,19978,95.4,126,11,8.7
2,All Students,2019-20,13621,719,12902,94.7,121,15,12.4
2,All Students,2020-21,18012,1138,16874,93.7,110,21,19.1
2,All Students,2021-22,19312,1951,17361,89.9,121,50,41.3
2,All Students,2022-23,20668,1902,18766,90.8,125,47,37.6
3,All Students,2018-19,23163,1092,22071,95.3,136,18,13.2
3,All Students,2019-20,13822,596,13226,95.7,126,10,7.9
3,All Students,2020-21,18829,1255,17574,93.3,115,26,22.6
3,All Students,2021-22,18544,1476,17068,92.0,111,35,31.5
3,All Students,2022-23,17402,1342,16060,92.3,104,28,26.9
4,All Students,2018-19,24435,1268,23167,94.8,146,16,11.0
4,All Students,2019-20,14022,516,13506,96.3,128,11,8.6
4,All Students,2020-21,19266,1237,18029,93.6,114,25,21.9
4,All Students,2021-22,20656,1750,18906,91.5,127,47,37.0
4,All Students,2022-23,18168,1233,16935,93.2,110,29,26.4
5,All Students,2018-19,21830,941,20889,95.7,128,20,15.6
5,All Students,2019-20,13426,762,12664,94.3,121,19,15.7
5,All Students,2020-21,19898,1217,18681,93.9,116,17,14.7
5,All Students,2021-22,17019,1269,15750,92.5,102,29,28.4
5,All Students,2022-23,17768,1390,16378,92.2,106,35,33.0
All Grades,All Students,2018-19,173851,8260,165591,95.2,1022,133,13.0
All Grades,All Students,2019-20,107840,5625,102215,94.8,963,142,14.7
All Grades,All Students,2020-21,148845,12812,136033,91.4,873,253,29.0
All Grades,All Students,2021-22,143167,11491,131676,92.0,856,258,30.1
All Grades,All Students,2022-23,138670,10449,128221,92.5,835,229,27.4
PK in K-12 Schools,All Students,2021-22,2655,436,2219,83.6,15,11,73.3
PK in K-12 Schools,All Students,2022-23,5793,601,5192,89.6,36,18,50.0
0K,All Students,2018-19,19932,1306,18626,93.4,119,26,21.8
0K,All Students,2019-20,12805,786,12019,93.9,115,27,23.5
0K,All Students,2020-21,16951,1917,15034,88.7,99,34,34.3
0K,All Students,2021-22,16580,1513,15067,90.9,107,34,31.8
0K,All Students,2022-23,14623,1410,13213,90.4,89,36,40.4
1,All Students,2018-19,21635,1237,20398,94.3,130,28,21.5
1,All Students,2019-20,12538,780,11758,93.8,114,22,19.3
1,All Students,2020-21,17733,1392,16341,92.2,105,27,25.7
1,All Students,2021-22,16721,1604,15117,90.4,101,36,35.6
1,All Students,2022-23,16496,1268,15228,92.3,99,25,25.3
2,All Students,2018-19,24537,965,23572,96.1,143,11,7.7
2,All Students,2019-20,14212,828,13384,94.2,127,20,15.7
2,All Students,2020-21,18903,1666,17237,91.2,110,37,33.6
2,All Students,2021-22,19574,1296,18278,93.4,118,27,22.9
2,All Students,2022-23,18376,1496,16880,91.9,113,34,30.1
3,All Students,2018-19,36552,1739,34813,95.2,216,25,11.6
3,All Students,2019-20,23275,1039,22236,95.5,207,16,7.7
3,All Students,2020-21,32240,2909,29331,91.0,188,58,30.9
3,All Students,2021-22,29209,2359,26850,91.9,172,57,33.1
3,All Students,2022-23,28353,1857,26496,93.5,168,36,21.4
4,All Students,2018-19,39307,1643,37664,95.8,227,19,8.4
4,All Students,2019-20,23082,1156,21926,95.0,204,34,16.7
4,All Students,2020-21,32961,2579,30382,92.2,195,48,24.6
4,All Students,2021-22,30016,2350,27666,92.2,177,55,31.1
4,All Students,2022-23,28806,1885,26921,93.5,171,40,23.4
5,All Students,2018-19,31888,1370,30518,95.7,187,24,12.8
5,All Students,2019-20,21928,1036,20892,95.3,196,23,11.7
5,All Students,2020-21,30057,2349,27708,92.2,176,49,27.8
5,All Students,2021-22,28412,1933,26479,93.2,166,38,22.9
5,All Students,2022-23,26223,1932,24291,92.6,159,40,25.2
All Grades,All Students,2018-19,182462,9973,172489,94.5,1056,167,15.8
All Grades,All Students,2019-20,116698,6159,110539,94.7,1033,154,14.9
All Grades,All Students,2020-21,159947,5274,154673,96.7,936,75,8.0
All Grades,All Students,2021-22,146510,10194,136316,93.0,860,200,23.3
All Grades,All Students,2022-23,135086,10401,124685,92.3,814,218,26.8
PK in K-12 Schools,All Students,2018-19,9194,738,8456,92.0,55,13,23.6
PK in K-12 Schools,All Students,2019-20,5523,443,5080,92.0,50,14,28.0
PK in K-12 Schools,All Students,2020-21,7236,402,6834,94.4,46,10,21.7
PK in K-12 Schools,All Students,2021-22,7669,915,6754,88.1,47,24,51.1
PK in K-12 Schools,All Students,2022-23,8559,1135,7424,86.7,52,26,50.0
0K,All Students,2018-19,24068,1824,22244,92.4,142,38,26.8
0K,All Students,2019-20,18575,1143,17432,93.8,166,27,16.3
0K,All Students,2020-21,21957,1268,20689,94.2,130,22,16.9
0K,All Students,2021-22,19533,1678,17855,91.4,115,38,33.0
0K,All Students,2022-23,17743,1879,15864,89.4,110,41,37.3
1,All Students,2018-19,24504,1577,22927,93.6,145,30,20.7
1,All Students,2019-20,15701,883,14818,94.4,140,22,15.7
1,All Students,2020-21,25403,737,24666,97.1,149,8,5.4
1,All Students,2021-22,20041,1553,18488,92.3,117,32,27.4
1,All Students,2022-23,18459,1409,17050,92.4,114,30,26.3
2,All Students,2018-19,27339,1576,25763,94.2,155,26,16.8
2,All Students,2019-20,15956,888,15068,94.4,140,21,15.0
2,All Students,2020-21,21793,319,21474,98.5,127,3,2.4
2,All Students,2021-22,23654,1644,22010,93.0,140,30,21.4
2,All Students,2022-23,19437,1406,18031,92.8,113,31,27.4
3,All Students,2018-19,27748,1287,26461,95.4,161,16,9.9
3,All Students,2019-20,17106,839,16267,95.1,151,21,13.9
3,All Students,2020-21,22027,411,21616,98.1,127,4,3.1
3,All Students,2021-22,18808,873,17935,95.4,110,10,9.1
3,All Students,2022-23,23286,1673,21613,92.8,137,30,21.9
4,All Students,2018-19,29606,1312,28294,95.6,168,14,8.3
4,All Students,2019-20,17122,750,16372,95.6,152,19,12.5
4,All Students,2020-21,24752,854,23898,96.5,145,9,6.2
4,All Students,2021-22,22305,1220,21085,94.5,132,22,16.7
4,All Students,2022-23,18455,1042,17413,94.4,110,21,19.1
5,All Students,2018-19,26416,1104,25312,95.8,151,20,13.2
5,All Students,2019-20,18365,791,17574,95.7,160,18,11.3
5,All Students,2020-21,22949,672,22277,97.1,133,9,6.8
5,All Students,2021-22,24378,1640,22738,93.3,141,32,22.7
5,All Students,2022-23,20406,1163,19243,94.3,122,20,16.4
6,All Students,2018-19,13587,555,13032,95.9,79,10,12.7
6,All Students,2019-20,8350,422,7928,94.9,74,12,16.2
6,All Students,2020-21,13830,611,13219,95.6,79,10,12.7
6,All Students,2021-22,10122,671,9451,93.4,58,12,20.7
6,All Students,2022-23,8741,694,8047,92.1,56,19,33.9
All Grades,All Students,2018-19,64073,4290,59783,93.3,395,89,22.5
All Grades,All Students,2019-20,36186,2432,33754,93.3,338,76,22.5
All Grades,All Students,2020-21,52074,4786,47288,90.8,314,109,34.7
All Grades,All Students,2021-22,52533,7586,44947,85.6,344,203,59.0
All Grades,All Students,2022-23,57116,6872,50244,88.0,390,200,51.3
PK in K-12 Schools,All Students,2018-19,5718,635,5083,88.9,37,17,45.9
PK in K-12 Schools,All Students,2019-20,2697,343,2354,87.3,30,17,56.7
PK in K-12 Schools,All Students,2020-21,4999,764,4235,84.7,33,19,57.6
PK in K-12 Schools,All Students,2021-22,9608,2035,7573,78.8,66,60,90.9
PK in K-12 Schools,All Students,2022-23,10823,1620,9203,85.0,72,49,68.1
0K,All Students,2018-19,8392,634,7758,92.4,55,18,32.7
0K,All Students,2019-20,4412,376,4036,91.5,42,17,40.5
0K,All Students,2020-21,7491,956,6535,87.2,49,25,51.0
0K,All Students,2021-22,8854,1368,7486,84.5,57,34,59.6
0K,All Students,2022-23,7530,1054,6476,86.0,54,34,63.0
1,All Students,2018-19,10310,690,9620,93.3,62,15,24.2
1,All Students,2019-20,5089,310,4779,93.9,47,6,12.8
1,All Students,2020-21,6706,610,6096,90.9,41,16,39.0
1,All Students,2021-22,6443,1123,5320,82.6,46,32,69.6
1,All Students,2022-23,8486,1145,7341,86.5,58,32,55.2
2,All Students,2018-19,8520,609,7911,92.9,53,12,22.6
2,All Students,2019-20,5623,371,5252,93.4,51,11,21.6
2,All Students,2020-21,7684,650,7034,91.5,44,14,31.8
2,All Students,2021-22,6394,702,5692,89.0,39,18,46.2
2,All Students,2022-23,6197,720,5477,88.4,41,18,43.9
3,All Students,2018-19,10928,680,10248,93.8,66,10,15.2
3,All Students,2019-20,4910,287,4623,94.2,46,5,10.9
3,All Students,2020-21,8016,662,7354,91.7,48,14,29.2
3,All Students,2021-22,8579,1005,7574,88.3,53,23,43.4
3,All Students,2022-23,8408,770,7638,90.8,58,24,41.4
4,All Students,2018-19,10430,552,9878,94.7,64,7,10.9
4,All Students,2019-20,6487,397,6090,93.9,59,10,16.9
4,All Students,2020-21,7261,455,6806,93.7,42,8,19.0
4,All Students,2021-22,6330,708,5622,88.8,42,18,42.9
4,All Students,2022-23,8122,794,7328,90.2,57,21,36.8
5,All Students,2018-19,9775,490,9285,95.0,58,10,17.2
5,All Students,2019-20,6968,348,6620,95.0,63,10,15.9
5,All Students,2020-21,9917,689,9228,93.1,57,13,22.8
5,All Students,2021-22,6325,645,5680,89.8,41,18,43.9
5,All Students,2022-23,7550,769,6781,89.8,50,22,44.0
All Grades,All Students,2018-19,180009,8278,171731,95.4,1051,126,12.0
All Grades,All Students,2019-20,107584,5374,102210,95.0,975,131,13.4
All Grades,All Students,2020-21,144353,8002,136351,94.5,855,146,17.1
All Grades,All Students,2021-22,130332,10624,119708,91.8,786,241,30.7
All Grades,All Students,2022-23,120782,9416,111366,92.2,738,208,28.2
PK in K-12 Schools,All Students,2018-19,12536,1416,11120,88.7,73,38,52.1
PK in K-12 Schools,All Students,2019-20,7528,759,6769,89.9,69,27,39.1
PK in K-12 Schools,All Students,2020-21,11159,1149,10010,89.7,65,24,36.9
PK in K-12 Schools,All Students,2021-22,10774,1380,9394,87.2,67,38,56.7
PK in K-12 Schools,All Students,2022-23,10255,1254,9001,87.8,64,35,54.7
0K,All Students,2018-19,24550,1399,23151,94.3,147,25,17.0
0K,All Students,2019-20,15140,992,14148,93.4,139,29,20.9
0K,All Students,2020-21,18614,2188,16426,88.2,115,47,40.9
0K,All Students,2021-22,18490,1912,16578,89.7,114,45,39.5
0K,All Students,2022-23,15545,1338,14207,91.4,98,29,29.6
1,All Students,2018-19,26937,1329,25608,95.1,156,19,12.2
1,All Students,2019-20,15074,769,14305,94.9,136,18,13.2
1,All Students,2020-21,22203,1217,20986,94.5,131,20,15.3
1,All Students,2021-22,16981,1573,15408,90.7,101,37,36.6
1,All Students,2022-23,18080,1424,16656,92.1,111,30,27.0
2,All Students,2018-19,27484,1278,26206,95.4,161,17,10.6
2,All Students,2019-20,16314,883,15431,94.6,151,23,15.2
2,All Students,2020-21,22460,829,21631,96.3,134,18,13.4
2,All Students,2021-22,20351,1395,18956,93.1,119,27,22.7
2,All Students,2022-23,16965,1544,15421,90.9,103,38,36.9
3,All Students,2018-19,24795,857,23938,96.5,145,6,4.1
3,All Students,2019-20,17548,719,16829,95.9,160,15,9.4
3,All Students,2020-21,23313,904,22409,96.1,140,15,10.7
3,All Students,2021-22,20693,1478,19215,92.9,130,41,31.5
3,All Students,2022-23,19487,1151,18336,94.1,119,23,19.3
4,All Students,2018-19,32290,1019,31271,96.8,187,12,6.4
4,All Students,2019-20,15475,559,14916,96.4,138,9,6.5
4,All Students,2020-21,23735,1075,22660,95.5,138,14,10.1
4,All Students,2021-22,21610,1488,20122,93.1,129,27,20.9
4,All Students,2022-23,20433,1364,19069,93.3,123,29,23.6
5,All Students,2018-19,31417,980,30437,96.9,182,9,4.9
5,All Students,2019-20,20505,693,19812,96.6,182,10,5.5
5,All Students,2020-21,22869,640,22229,97.2,132,8,6.1
5,All Students,2021-22,21433,1398,20035,93.5,126,26,20.6
5,All Students,2022-23,20017,1341,18676,93.3,120,24,20.0
All Grades,All Students,2018-19,176639,8548,168091,95.2,1034,123,11.9
All Grades,All Students,2019-20,109144,5526,103618,94.9,977,136,13.9
All Grades,All Students,2020-21,155057,8120,146937,94.8,917,152,16.6
All Grades,All Students,2021-22,138677,10707,127970,92.3,820,210,25.6
All Grades,All Students,2022-23,139327,9885,129442,92.9,864,225,26.0
PK in K-12 Schools,All Students,2018-19,6047,439,5608,92.7,39,12,30.8
PK in K-12 Schools,All Students,2019-20,3899,326,3573,91.6,36,11,30.6
PK in K-12 Schools,All Students,2020-21,6274,411,5863,93.4,38,6,15.8
PK in K-12 Schools,All Students,2021-22,5594,705,4889,87.4,37,18,48.6
PK in K-12 Schools,All Students,2022-23,8642,784,7858,90.9,52,17,32.7
0K,All Students,2018-19,28756,1611,27145,94.4,170,20,11.8
0K,All Students,2019-20,17901,1136,16765,93.7,162,35,21.6
0K,All Students,2020-21,25249,1837,23412,92.7,151,38,25.2
0K,All Students,2021-22,17822,1572,16250,91.2,110,34,30.9
0K,All Students,2022-23,21373,2018,19355,90.6,139,52,37.4
1,All Students,2018-19,26700,1277,25423,95.2,157,24,15.3
1,All Students,2019-20,18914,895,18019,95.3,167,19,11.4
1,All Students,2020-21,24464,1133,23331,95.4,146,19,13.0
1,All Students,2021-22,24603,2171,22432,91.2,148,48,32.4
1,All Students,2022-23,17639,1359,16280,92.3,109,31,28.4
2,All Students,2018-19,27046,1207,25839,95.5,159,17,10.7
2,All Students,2019-20,16754,791,15963,95.3,152,22,14.5
2,All Students,2020-21,26741,1098,25643,95.9,156,19,12.2
2,All Students,2021-22,22032,1700,20332,92.3,128,37,28.9
2,All Students,2022-23,24169,1853,22316,92.3,150,46,30.7
3,All Students,2018-19,26890,1294,25596,95.2,156,18,11.5
3,All Students,2019-20,17214,769,16445,95.5,151,14,9.3
3,All Students,2020-21,24191,1262,22929,94.8,143,24,16.8
3,All Students,2021-22,25104,1736,23368,93.1,144,25,17.4
3,All Students,2022-23,22076,1236,20840,94.4,135,26,19.3
4,All Students,2018-19,28818,1233,27585,95.7,166,16,9.6
4,All Students,2019-20,16826,854,15972,94.9,150,24,16.0
4,All Students,2020-21,24277,989,23288,95.9,143,20,14.0
4,All Students,2021-22,22311,1432,20879,93.6,129,26,20.2
4,All Students,2022-23,23987,1454,22533,93.9,148,30,20.3
5,All Students,2018-19,32382,1487,30895,95.4,187,16,8.6
5,All Students,2019-20,17636,755,16881,95.7,159,11,6.9
5,All Students,2020-21,23861,1390,22471,94.2,140,26,18.6
5,All Students,2021-22,21211,1391,19820,93.4,124,22,17.7
5,All Students,2022-23,21441,1181,20260,94.5,131,23,17.6
All Grades,All Students,2018-19,82542,8023,74519,90.3,505,196,38.8
All Grades,All Students,2019-20,49034,4198,44836,91.4,457,147,32.2
All Grades,All Students,2020-21,69319,8616,60703,87.6,415,161,38.8
All Grades,All Students,2021-22,70801,9457,61344,86.6,432,228,52.8
All Grades,All Students,2022-23,72931,9709,63222,86.7,497,272,54.7
PK in K-12 Schools,All Students,2018-19,8847,1049,7798,88.1,54,24,44.4
PK in K-12 Schools,All Students,2019-20,5423,726,4697,86.6,56,30,53.6
PK in K-12 Schools,All Students,2020-21,6883,969,5914,85.9,42,13,31.0
PK in K-12 Schools,All Students,2021-22,12306,2154,10152,82.5,81,61,75.3
PK in K-12 Schools,All Students,2022-23,13879,2493,11386,82.0,84,55,65.5
0K,All Students,2018-19,12245,1445,10800,88.2,77,36,46.8
0K,All Students,2019-20,7150,717,6433,90.0,68,25,36.8
0K,All Students,2020-21,8526,1494,7032,82.5,55,31,56.4
0K,All Students,2021-22,9290,1409,7881,84.8,55,32,58.2
0K,All Students,2022-23,9645,1609,8036,83.3,74,53,71.6
1,All Students,2018-19,11639,1198,10441,89.7,75,32,42.7
1,All Students,2019-20,7743,649,7094,91.6,73,23,31.5
1,All Students,2020-21,10942,1106,9836,89.9,64,21,32.8
1,All Students,2021-22,9125,1325,7800,85.5,54,27,50.0
1,All Students,2022-23,8361,1033,7328,87.6,63,37,58.7
2,All Students,2018-19,11273,1089,10184,90.3,68,26,38.2
2,All Students,2019-20,6687,498,6189,92.6,62,19,30.6
2,All Students,2020-21,11682,1776,9906,84.8,70,31,44.3
2,All Students,2021-22,11135,1228,9907,89.0,66,23,34.8
2,All Students,2022-23,10204,1361,8843,86.7,67,38,56.7
3,All Students,2018-19,12400,1065,11335,91.4,72,24,33.3
3,All Students,2019-20,6942,545,6397,92.1,61,17,27.9
3,All Students,2020-21,9831,1039,8792,89.4,57,19,33.3
3,All Students,2021-22,12141,1368,10773,88.7,74,32,43.2
3,All Students,2022-23,10365,1071,9294,89.7,66,29,43.9
4,All Students,2018-19,11541,886,10655,92.3,72,22,30.6
4,All Students,2019-20,7944,583,7361,92.7,72,18,25.0
4,All Students,2020-21,9446,908,8538,90.4,56,22,39.3
4,All Students,2021-22,8509,924,7585,89.1,52,22,42.3
4,All Students,2022-23,11723,1163,10560,90.1,79,30,38.0
5,All Students,2018-19,14597,1291,13306,91.2,87,32,36.8
5,All Students,2019-20,7145,480,6665,93.3,65,15,23.1
5,All Students,2020-21,12009,1324,10685,89.0,71,24,33.8
5,All Students,2021-22,8294,s,s,s,s,s,s
5,All Students,2022-23,8754,979,7775,88.8,64,30,46.9
6,All Students,2021-22,1,s,s,s,s,s,s
All Grades,All Students,2018-19,81225,6055,75170,92.5,487,135,27.7
All Grades,All Students,2019-20,51041,3152,47889,93.8,460,105,22.8
All Grades,All Students,2020-21,66316,4584,61732,93.1,392,72,18.4
All Grades,All Students,2021-22,67017,5929,61088,91.2,403,134,33.3
All Grades,All Students,2022-23,62352,5753,56599,90.8,450,171,38.0
6,All Students,2018-19,22441,1582,20859,93.0,136,35,25.7
6,All Students,2019-20,17681,1028,16653,94.2,163,35,21.5
6,All Students,2020-21,19214,1346,17868,93.0,116,20,17.2
6,All Students,2021-22,21847,2036,19811,90.7,134,46,34.3
6,All Students,2022-23,16386,s,s,s,s,s,s
7,All Students,2018-19,29156,2231,26925,92.3,173,47,27.2
7,All Students,2019-20,14179,870,13309,93.9,128,33,25.8
7,All Students,2020-21,25168,1555,23613,93.8,148,25,16.9
7,All Students,2021-22,21007,s,s,s,s,s,s
7,All Students,2022-23,22817,1749,21068,92.3,170,54,31.8
8,All Students,2018-19,29628,2242,27386,92.4,178,53,29.8
8,All Students,2019-20,19181,1254,17927,93.5,169,37,21.9
8,All Students,2020-21,21934,1683,20251,92.3,128,27,21.1
8,All Students,2021-22,24154,1877,22277,92.2,146,40,27.4
8,All Students,2022-23,23088,2308,20780,90.0,148,60,40.5
9,All Students,2021-22,9,s,s,s,s,s,s
9,All Students,2022-23,61,s,s,s,s,s,s
All Grades,All Students,2018-19,140193,7327,132866,94.8,828,109,13.2
All Grades,All Students,2019-20,87493,4315,83178,95.1,782,105,13.4
All Grades,All Students,2020-21,126446,4874,121572,96.1,740,80,10.8
All Grades,All Students,2021-22,121190,8919,112271,92.6,718,189,26.3
All Grades,All Students,2022-23,109480,8096,101384,92.6,661,183,27.7
PK in K-12 Schools,All Students,2018-19,6702,638,6064,90.5,41,18,43.9
PK in K-12 Schools,All Students,2019-20,4029,254,3775,93.7,38,8,21.1
PK in K-12 Schools,All Students,2020-21,6230,241,5989,96.1,36,4,11.1
PK in K-12 Schools,All Students,2021-22,6110,570,5540,90.7,37,18,48.6
PK in K-12 Schools,All Students,2022-23,6276,832,5444,86.7,39,25,64.1
0K,All Students,2018-19,21499,1422,20077,93.4,126,27,21.4
0K,All Students,2019-20,11336,791,10545,93.0,102,27,26.5
0K,All Students,2020-21,16817,835,15982,95.0,101,18,17.8
0K,All Students,2021-22,17690,1525,16165,91.4,106,35,33.0
0K,All Students,2022-23,13559,1010,12549,92.6,81,24,29.6
1,All Students,2018-19,22228,1053,21175,95.3,129,8,6.2
1,All Students,2019-20,12800,704,12096,94.5,113,19,16.8
1,All Students,2020-21,15629,960,14669,93.9,92,16,17.4
1,All Students,2021-22,15931,1182,14749,92.6,92,29,31.5
1,All Students,2022-23,18247,1389,16858,92.4,106,34,32.1
2,All Students,2018-19,21414,1100,20314,94.9,125,14,11.2
2,All Students,2019-20,14221,663,13558,95.3,129,17,13.2
2,All Students,2020-21,18546,613,17933,96.7,110,9,8.2
2,All Students,2021-22,15653,1303,14350,91.7,94,34,36.2
2,All Students,2022-23,15237,1216,14021,92.0,96,30,31.3
3,All Students,2018-19,26585,1233,25352,95.4,157,17,10.8
3,All Students,2019-20,15660,706,14954,95.5,139,15,10.8
3,All Students,2020-21,23846,760,23086,96.8,138,13,9.4
3,All Students,2021-22,22981,1522,21459,93.4,135,26,19.3
3,All Students,2022-23,15745,1095,14650,93.0,94,26,27.7
4,All Students,2018-19,21813,959,20854,95.6,130,13,10.0
4,All Students,2019-20,17122,666,16456,96.1,150,11,7.3
4,All Students,2020-21,22954,731,22223,96.8,133,10,7.5
4,All Students,2021-22,22451,1407,21044,93.7,132,21,15.9
4,All Students,2022-23,21883,1275,20608,94.2,131,23,17.6
5,All Students,2018-19,19952,922,19030,95.4,120,12,10.0
5,All Students,2019-20,12325,531,11794,95.7,111,8,7.2
5,All Students,2020-21,22424,734,21690,96.7,130,10,7.7
5,All Students,2021-22,20374,1410,18964,93.1,122,26,21.3
5,All Students,2022-23,18533,1279,17254,93.1,114,21,18.4
All Grades,All Students,2018-19,48806,3524,45282,92.8,284,74,26.1
All Grades,All Students,2019-20,31506,2252,29254,92.9,282,67,23.8
All Grades,All Students,2020-21,39879,3110,36769,92.2,241,64,26.6
All Grades,All Students,2021-22,37342,4139,33203,88.9,221,108,48.9
All Grades,All Students,2022-23,37291,3647,33644,90.2,236,96,40.7
PK in K-12 Schools,All Students,2018-19,6909,611,6298,91.2,41,14,34.1
PK in K-12 Schools,All Students,2019-20,4127,453,3674,89.0,37,15,40.5
PK in K-12 Schools,All Students,2020-21,2312,286,2026,87.6,17,8,47.1
PK in K-12 Schools,All Students,2021-22,3186,542,2644,83.0,18,17,94.4
PK in K-12 Schools,All Students,2022-23,3166,368,2798,88.4,19,11,57.9
0K,All Students,2018-19,14931,1167,13764,92.2,86,29,33.7
0K,All Students,2019-20,9384,716,8668,92.4,86,23,26.7
0K,All Students,2020-21,13734,1231,12503,91.0,81,22,27.2
0K,All Students,2021-22,13925,1763,12162,87.3,86,47,54.7
0K,All Students,2022-23,13198,1353,11845,89.7,88,40,45.5
1,All Students,2018-19,14735,870,13865,94.1,86,15,17.4
1,All Students,2019-20,9778,668,9110,93.2,86,21,24.4
1,All Students,2020-21,10916,601,10315,94.5,65,13,20.0
1,All Students,2021-22,11196,1119,10077,90.0,65,28,43.1
1,All Students,2022-23,11882,1113,10769,90.6,76,26,34.2
2,All Students,2018-19,12231,876,11355,92.8,71,16,22.5
2,All Students,2019-20,8217,415,7802,94.9,73,8,11.0
2,All Students,2020-21,12917,992,11925,92.3,78,21,26.9
2,All Students,2021-22,9035,715,8320,92.1,52,16,30.8
2,All Students,2022-23,9045,813,8232,91.0,53,19,35.8
All Grades,All Students,2018-19,280597,11127,269470,96.0,1598,145,9.1
All Grades,All Students,2019-20,180127,5870,174257,96.7,1577,96,6.1
All Grades,All Students,2020-21,269391,17143,252248,93.6,1565,295,18.8
All Grades,All Students,2021-22,264728,18938,245790,92.8,1529,342,22.4
All Grades,All Students,2022-23,267784,14699,253085,94.5,1541,237,15.4
5,All Students,2018-19,30883,s,s,s,s,s,s
5,All Students,2019-20,20486,593,19893,97.1,181,11,6.1
5,All Students,2020-21,30977,1756,29221,94.3,182,35,19.2
5,All Students,2021-22,30167,1886,28281,93.7,171,29,17.0
5,All Students,2022-23,31348,1359,29989,95.7,178,15,8.4
6,All Students,2018-19,84059,3147,80912,96.3,476,40,8.4
6,All Students,2019-20,53921,1732,52189,96.8,471,24,5.1
6,All Students,2020-21,79633,4943,74690,93.8,464,83,17.9
6,All Students,2021-22,78572,5662,72910,92.8,458,102,22.3
6,All Students,2022-23,80737,4492,76245,94.4,467,74,15.8
7,All Students,2018-19,82681,2881,79800,96.5,472,38,8.1
7,All Students,2019-20,53317,1669,51648,96.9,467,33,7.1
7,All Students,2020-21,79577,5175,74402,93.5,460,89,19.3
7,All Students,2021-22,79169,5842,73327,92.6,457,110,24.1
7,All Students,2022-23,80873,4287,76586,94.7,462,72,15.6
8,All Students,2018-19,82964,4156,78808,95.0,472,58,12.3
8,All Students,2019-20,52403,1876,50527,96.4,458,28,6.1
8,All Students,2020-21,79128,5234,73894,93.4,458,87,19.0
8,All Students,2021-22,76820,5548,71272,92.8,443,101,22.8
8,All Students,2022-23,74826,4561,70265,93.9,434,76,17.5
9,All Students,2018-19,10,s,s,s,s,s,s
All Grades,All Students,2018-19,54237,3207,51030,94.1,320,59,18.4
All Grades,All Students,2019-20,33305,2048,31257,93.9,301,59,19.6
All Grades,All Students,2020-21,43296,1822,41474,95.8,258,29,11.2
All Grades,All Students,2021-22,38761,3225,35536,91.7,230,76,33.0
All Grades,All Students,2022-23,37713,3266,34447,91.3,225,72,32.0
PK in K-12 Schools,All Students,2018-19,6362,567,5795,91.1,38,12,31.6
PK in K-12 Schools,All Students,2019-20,3953,394,3559,90.0,37,16,43.2
PK in K-12 Schools,All Students,2020-21,5861,s,s,s,s,s,s
PK in K-12 Schools,All Students,2021-22,6092,639,5453,89.5,37,17,45.9
PK in K-12 Schools,All Students,2022-23,6264,723,5541,88.5,36,16,44.4
0K,All Students,2018-19,18114,1016,17098,94.4,108,19,17.6
0K,All Students,2019-20,9221,622,8599,93.3,85,20,23.5
0K,All Students,2020-21,11001,530,10471,95.2,66,9,13.6
0K,All Students,2021-22,12171,1105,11066,90.9,71,29,40.8
0K,All Students,2022-23,12845,1212,11633,90.6,77,29,37.7
1,All Students,2018-19,15678,910,14768,94.2,95,17,17.9
1,All Students,2019-20,11230,646,10584,94.2,100,17,17.0
1,All Students,2020-21,12264,433,11831,96.5,72,7,9.7
1,All Students,2021-22,10198,752,9446,92.6,62,13,21.0
1,All Students,2022-23,10410,754,9656,92.8,63,17,27.0
2,All Students,2018-19,14083,714,13369,94.9,79,11,13.9
2,All Students,2019-20,8901,386,8515,95.7,79,6,7.6
2,All Students,2020-21,14003,433,13570,96.9,84,5,6.0
2,All Students,2021-22,10300,729,9571,92.9,60,17,28.3
2,All Students,2022-23,8194,577,7617,93.0,49,10,20.4
3,All Students,2020-21,167,s,s,s,s,s,s
All Grades,All Students,2018-19,225591,10905,214686,95.2,1302,156,12.0
All Grades,All Students,2019-20,137118,5183,131935,96.2,1217,113,9.3
All Grades,All Students,2020-21,198291,15488,182803,92.2,1160,317,27.3
All Grades,All Students,2021-22,191416,12220,179196,93.6,1129,243,21.5
All Grades,All Students,2022-23,181150,12130,169020,93.3,1081,231,21.4
6,All Students,2018-19,69439,2395,67044,96.6,400,29,7.3
6,All Students,2019-20,41905,1535,40370,96.3,376,33,8.8
6,All Students,2020-21,64997,4406,60591,93.2,381,86,22.6
6,All Students,2021-22,60536,4423,56113,92.7,363,95,26.2
6,All Students,2022-23,55469,s,s,s,s,s,s
7,All Students,2018-19,75553,2960,72593,96.1,438,42,9.6
7,All Students,2019-20,45833,1776,44057,96.1,407,38,9.3
7,All Students,2020-21,63906,4254,59652,93.3,373,80,21.4
7,All Students,2021-22,64901,3558,61343,94.5,383,62,16.2
7,All Students,2022-23,60879,4073,56806,93.3,362,73,20.2
8,All Students,2018-19,80599,5550,75049,93.1,464,85,18.3
8,All Students,2019-20,49380,1872,47508,96.2,434,42,9.7
8,All Students,2020-21,69388,6828,62560,90.2,406,151,37.2
8,All Students,2021-22,65979,4239,61740,93.6,383,86,22.5
8,All Students,2022-23,64800,4546,60254,93.0,383,88,23.0
9,All Students,2022-23,2,s,s,s,s,s,s
All Grades,All Students,2018-19,85939,5288,80651,93.8,505,96,19.0
All Grades,All Students,2019-20,52681,3166,49515,94.0,470,76,16.2
All Grades,All Students,2020-21,70688,2798,67890,96.0,425,58,13.6
All Grades,All Students,2021-22,69386,6270,63116,91.0,415,151,36.4
All Grades,All Students,2022-23,69458,6738,62720,90.3,428,168,39.3
PK in K-12 Schools,All Students,2018-19,6192,522,5670,91.6,38,13,34.2
PK in K-12 Schools,All Students,2019-20,4137,362,3775,91.2,37,10,27.0
PK in K-12 Schools,All Students,2020-21,5218,222,4996,95.7,32,6,18.8
PK in K-12 Schools,All Students,2021-22,6170,610,5560,90.1,37,16,43.2
PK in K-12 Schools,All Students,2022-23,6239,896,5343,85.6,36,22,61.1
0K,All Students,2018-19,12424,920,11504,92.6,73,20,27.4
0K,All Students,2019-20,7261,542,6719,92.5,65,14,21.5
0K,All Students,2020-21,9531,352,9179,96.3,60,9,15.0
0K,All Students,2021-22,10177,1155,9022,88.7,62,32,51.6
0K,All Students,2022-23,10733,1273,9460,88.1,72,38,52.8
1,All Students,2018-19,10938,779,10159,92.9,66,14,21.2
1,All Students,2019-20,7796,551,7245,92.9,70,13,18.6
1,All Students,2020-21,10584,451,10133,95.7,62,9,14.5
1,All Students,2021-22,11069,1028,10041,90.7,69,26,37.7
1,All Students,2022-23,9458,998,8460,89.4,58,27,46.6
2,All Students,2018-19,12847,688,12159,94.6,75,10,13.3
2,All Students,2019-20,6891,386,6505,94.4,61,12,19.7
2,All Students,2020-21,11043,502,10541,95.5,70,10,14.3
2,All Students,2021-22,10322,883,9439,91.4,60,17,28.3
2,All Students,2022-23,11284,1074,10210,90.5,70,29,41.4
3,All Students,2018-19,14621,830,13791,94.3,86,15,17.4
3,All Students,2019-20,8001,412,7589,94.9,70,7,10.0
3,All Students,2020-21,10329,421,9908,95.9,60,6,10.0
3,All Students,2021-22,11343,970,10373,91.4,66,21,31.8
3,All Students,2022-23,10737,754,9983,93.0,64,16,25.0
4,All Students,2018-19,15155,731,14424,95.2,88,10,11.4
4,All Students,2019-20,9145,426,8719,95.3,81,9,11.1
4,All Students,2020-21,11205,393,10812,96.5,65,8,12.3
4,All Students,2021-22,9749,738,9011,92.4,59,16,27.1
4,All Students,2022-23,11141,933,10208,91.6,69,20,29.0
5,All Students,2018-19,13762,818,12944,94.1,79,14,17.7
5,All Students,2019-20,9450,487,8963,94.8,86,11,12.8
5,All Students,2020-21,12778,457,12321,96.4,76,10,13.2
5,All Students,2021-22,10556,886,9670,91.6,62,23,37.1
5,All Students,2022-23,9866,810,9056,91.8,59,16,27.1
All Grades,All Students,2018-19,22127,1089,21038,95.1,156,27,17.3
All Grades,All Students,2019-20,10461,409,10052,96.1,109,11,10.1
All Grades,All Students,2020-21,13520,690,12830,94.9,95,12,12.6
All Grades,All Students,2021-22,22694,1604,21090,92.9,158,38,24.1
All Grades,All Students,2022-23,25406,2186,23220,91.4,182,70,38.5
6,All Students,2018-19,4001,236,3765,94.1,39,9,23.1
6,All Students,2019-20,2333,78,2255,96.7,26,1,3.8
6,All Students,2020-21,1636,70,1566,95.7,17,3,17.6
6,All Students,2021-22,6172,493,5679,92.0,49,17,34.7
6,All Students,2022-23,6558,652,5906,90.1,58,23,39.7
7,All Students,2018-19,6941,330,6611,95.2,51,10,19.6
7,All Students,2019-20,3959,160,3799,96.0,39,5,12.8
7,All Students,2020-21,5558,192,5366,96.5,38,3,7.9
7,All Students,2021-22,7009,435,6574,93.8,46,6,13.0
7,All Students,2022-23,9944,871,9073,91.2,64,26,40.6
8,All Students,2018-19,11185,523,10662,95.3,66,8,12.1
8,All Students,2019-20,4169,171,3998,95.9,44,5,11.4
8,All Students,2020-21,6326,428,5898,93.2,40,6,15.0
8,All Students,2021-22,9513,676,8837,92.9,63,15,23.8
8,All Students,2022-23,8904,663,8241,92.6,60,21,35.0
All Grades,All Students,2018-19,88124,7737,80387,91.2,551,146,26.5
All Grades,All Students,2019-20,52171,3744,48427,92.8,529,114,21.6
All Grades,All Students,2020-21,89796,7416,82380,91.7,532,122,22.9
All Grades,All Students,2021-22,79951,9548,70403,88.1,534,187,35.0
All Grades,All Students,2022-23,73809,7546,66263,89.8,467,155,33.2
9,All Students,2018-19,19763,1549,18214,92.2,124,27,21.8
9,All Students,2019-20,12510,793,11717,93.7,121,23,19.0
9,All Students,2020-21,20533,835,19698,95.9,121,11,9.1
9,All Students,2021-22,19448,1843,17605,90.5,117,39,33.3
9,All Students,2022-23,19713,1600,18113,91.9,125,34,27.2
10,All Students,2018-19,20060,1716,18344,91.4,127,28,22.0
10,All Students,2019-20,12907,1024,11883,92.1,122,31,25.4
10,All Students,2020-21,19043,1977,17066,89.6,113,31,27.4
10,All Students,2021-22,20579,1893,18686,90.8,125,42,33.6
10,All Students,2022-23,18428,1397,17031,92.4,119,28,23.5
11,All Students,2018-19,18207,1645,16562,91.0,111,34,30.6
11,All Students,2019-20,12240,724,11516,94.1,116,23,19.8
11,All Students,2020-21,19203,1831,17372,90.5,111,33,29.7
11,All Students,2021-22,17786,2338,15448,86.9,105,46,43.8
11,All Students,2022-23,18410,1786,16624,90.3,115,35,30.4
12,All Students,2018-19,30094,2827,27267,90.6,189,57,30.2
12,All Students,2019-20,14514,1203,13311,91.7,170,37,21.8
12,All Students,2020-21,31017,2773,28244,91.1,187,47,25.1
12,All Students,2021-22,22138,3474,18664,84.3,187,60,32.1
12,All Students,2022-23,17258,2763,14495,84.0,108,58,53.7
All Grades,All Students,2018-19,110530,5647,104883,94.9,650,90,13.8
All Grades,All Students,2019-20,66296,3473,62823,94.8,591,89,15.1
All Grades,All Students,2020-21,93067,5034,88033,94.6,564,95,16.8
All Grades,All Students,2021-22,92603,7628,84975,91.8,554,164,29.6
All Grades,All Students,2022-23,86232,6497,79735,92.5,528,141,26.7
0K,All Students,2018-19,15390,1153,14237,92.5,94,23,24.5
0K,All Students,2019-20,7622,529,7093,93.1,69,20,29.0
0K,All Students,2020-21,10466,629,9837,94.0,70,15,21.4
0K,All Students,2021-22,15823,1491,14332,90.6,95,38,40.0
0K,All Students,2022-23,10459,921,9538,91.2,64,20,31.3
1,All Students,2018-19,16486,949,15537,94.2,98,12,12.2
1,All Students,2019-20,9830,583,9247,94.1,87,13,14.9
1,All Students,2020-21,11070,822,10248,92.6,68,19,27.9
1,All Students,2021-22,12019,1057,10962,91.2,72,20,27.8
1,All Students,2022-23,16776,1391,15385,91.7,104,31,29.8
2,All Students,2018-19,19893,855,19038,95.7,116,14,12.1
2,All Students,2019-20,10723,551,10172,94.9,95,11,11.6
2,All Students,2020-21,14676,940,13736,93.6,87,19,21.8
2,All Students,2021-22,11755,978,10777,91.7,72,23,31.9
2,All Students,2022-23,12805,994,11811,92.2,79,27,34.2
3,All Students,2018-19,21995,1008,20987,95.4,127,13,10.2
3,All Students,2019-20,13504,646,12858,95.2,125,20,16.0
3,All Students,2020-21,16572,788,15784,95.2,98,11,11.2
3,All Students,2021-22,16105,1372,14733,91.5,97,35,36.1
3,All Students,2022-23,12885,872,12013,93.2,78,21,26.9
4,All Students,2018-19,18130,871,17259,95.2,107,12,11.2
4,All Students,2019-20,13832,652,13180,95.3,121,13,10.7
4,All Students,2020-21,21131,1087,20044,94.9,128,18,14.1
4,All Students,2021-22,18814,1420,17394,92.5,111,25,22.5
4,All Students,2022-23,15626,1133,14493,92.7,96,18,18.8
5,All Students,2018-19,18636,811,17825,95.6,108,16,14.8
5,All Students,2019-20,10785,512,10273,95.3,94,12,12.8
5,All Students,2020-21,19152,768,18384,96.0,113,13,11.5
5,All Students,2021-22,18087,1310,16777,92.8,107,23,21.5
5,All Students,2022-23,17681,1186,16495,93.3,107,24,22.4
All Grades,All Students,2018-19,100473,5344,95129,94.7,589,75,12.7
All Grades,All Students,2019-20,64353,3107,61246,95.2,585,75,12.8
All Grades,All Students,2020-21,104385,11943,92442,88.6,600,238,39.7
All Grades,All Students,2021-22,99612,8459,91153,91.5,587,166,28.3
All Grades,All Students,2022-23,96025,8020,88005,91.6,572,165,28.8
6,All Students,2018-19,18012,812,17200,95.5,103,6,5.8
6,All Students,2019-20,11053,383,10670,96.5,97,6,6.2
6,All Students,2020-21,18123,1986,16137,89.0,105,39,37.1
6,All Students,2021-22,16945,1146,15799,93.2,101,24,23.8
6,All Students,2022-23,14835,1173,13662,92.1,87,22,25.3
7,All Students,2018-19,13883,621,13262,95.5,80,9,11.3
7,All Students,2019-20,10344,381,9963,96.3,93,6,6.5
7,All Students,2020-21,16116,1871,14245,88.4,93,40,43.0
7,All Students,2021-22,15502,880,14622,94.3,90,14,15.6
7,All Students,2022-23,15474,1145,14329,92.6,90,19,21.1
8,All Students,2018-19,14856,535,14321,96.4,86,3,3.5
8,All Students,2019-20,8492,378,8114,95.5,75,7,9.3
8,All Students,2020-21,15382,1834,13548,88.1,88,40,45.5
8,All Students,2021-22,14920,1000,13920,93.3,85,21,24.7
8,All Students,2022-23,14633,780,13853,94.7,85,9,10.6
9,All Students,2018-19,14924,932,13992,93.8,89,12,13.5
9,All Students,2019-20,8979,330,8649,96.3,84,7,8.3
9,All Students,2020-21,14261,1815,12446,87.3,82,39,47.6
9,All Students,2021-22,14538,1180,13358,91.9,87,24,27.6
9,All Students,2022-23,14568,985,13583,93.2,88,26,29.5
10,All Students,2018-19,13086,664,12422,94.9,78,8,10.3
10,All Students,2019-20,8783,515,8268,94.1,83,16,19.3
10,All Students,2020-21,13722,1352,12370,90.1,79,21,26.6
10,All Students,2021-22,12377,1394,10983,88.7,75,34,45.3
10,All Students,2022-23,12404,1353,11051,89.1,76,25,32.9
11,All Students,2018-19,13454,667,12787,95.0,80,12,15.0
11,All Students,2019-20,8424,588,7836,93.0,77,16,20.8
11,All Students,2020-21,13306,966,12340,92.7,76,17,22.4
11,All Students,2021-22,12580,914,11666,92.7,74,13,17.6
11,All Students,2022-23,11993,1141,10852,90.5,73,26,35.6
12,All Students,2018-19,12258,1113,11145,90.9,73,25,34.2
12,All Students,2019-20,8278,532,7746,93.6,76,17,22.4
12,All Students,2020-21,13475,2119,11356,84.3,77,42,54.5
12,All Students,2021-22,12750,1945,10805,84.7,75,36,48.0
12,All Students,2022-23,12118,1443,10675,88.1,73,38,52.1
All Grades,All Students,2018-19,74839,3385,71454,95.5,437,58,13.3
All Grades,All Students,2019-20,48124,2573,45551,94.7,425,61,14.4
All Grades,All Students,2020-21,72675,4748,67927,93.5,422,88,20.9
All Grades,All Students,2021-22,66663,4806,61857,92.8,383,89,23.2
All Grades,All Students,2022-23,65492,4991,60501,92.4,388,83,21.4
6,All Students,2018-19,22591,1091,21500,95.2,132,15,11.4
6,All Students,2019-20,14813,796,14017,94.6,134,24,17.9
6,All Students,2020-21,21370,1549,19821,92.8,124,32,25.8
6,All Students,2021-22,20517,1580,18937,92.3,119,30,25.2
6,All Students,2022-23,19339,s,s,s,s,s,s
7,All Students,2018-19,25690,1038,24652,96.0,149,18,12.1
7,All Students,2019-20,17161,965,16196,94.4,150,23,15.3
7,All Students,2020-21,25574,1590,23984,93.8,151,32,21.2
7,All Students,2021-22,22190,1633,20557,92.6,128,29,22.7
7,All Students,2022-23,24330,1775,22555,92.7,144,29,20.1
8,All Students,2018-19,26558,1256,25302,95.3,156,25,16.0
8,All Students,2019-20,16150,812,15338,95.0,141,14,9.9
8,All Students,2020-21,25731,1609,24122,93.7,147,24,16.3
8,All Students,2021-22,23956,1593,22363,93.4,136,30,22.1
8,All Students,2022-23,21764,1692,20072,92.2,128,29,22.7
9,All Students,2022-23,59,s,s,s,s,s,s
All Grades,All Students,2018-19,92300,3051,89249,96.7,527,30,5.7
All Grades,All Students,2019-20,62538,2184,60354,96.5,548,28,5.1
All Grades,All Students,2020-21,92635,1398,91237,98.5,541,12,2.2
All Grades,All Students,2021-22,85105,3026,82079,96.4,492,32,6.5
All Grades,All Students,2022-23,84675,3758,80917,95.6,490,42,8.6
0K,All Students,2018-19,8733,375,8358,95.7,50,4,8.0
0K,All Students,2019-20,5591,309,5282,94.5,49,6,12.2
0K,All Students,2020-21,8342,176,8166,97.9,50,3,6.0
0K,All Students,2021-22,8042,515,7527,93.6,46,8,17.4
0K,All Students,2022-23,8366,649,7717,92.2,49,15,30.6
1,All Students,2018-19,11062,476,10586,95.7,63,4,6.3
1,All Students,2019-20,7015,303,6712,95.7,61,5,8.2
1,All Students,2020-21,10176,122,10054,98.8,60,0,0.0
1,All Students,2021-22,8362,295,8067,96.5,51,3,5.9
1,All Students,2022-23,9971,623,9348,93.8,62,9,14.5
2,All Students,2018-19,11070,354,10716,96.8,64,5,7.8
2,All Students,2019-20,7245,262,6983,96.4,63,5,7.9
2,All Students,2020-21,10659,77,10582,99.3,61,0,0.0
2,All Students,2021-22,9506,333,9173,96.5,56,3,5.4
2,All Students,2022-23,10446,450,9996,95.7,59,4,6.8
3,All Students,2018-19,11212,408,10804,96.4,64,1,1.6
3,All Students,2019-20,7124,238,6886,96.7,63,2,3.2
3,All Students,2020-21,10050,101,9949,99.0,58,0,0.0
3,All Students,2021-22,9883,280,9603,97.2,56,1,1.8
3,All Students,2022-23,11022,453,10569,95.9,64,3,4.7
4,All Students,2018-19,10803,388,10415,96.4,62,6,9.7
4,All Students,2019-20,7130,276,6854,96.1,62,1,1.6
4,All Students,2020-21,10222,178,10044,98.3,60,0,0.0
4,All Students,2021-22,9212,263,8949,97.1,52,1,1.9
4,All Students,2022-23,9485,296,9189,96.9,54,2,3.7
5,All Students,2018-19,10138,287,9851,97.2,58,2,3.4
5,All Students,2019-20,7129,221,6908,96.9,63,2,3.2
5,All Students,2020-21,10339,90,10249,99.1,60,0,0.0
5,All Students,2021-22,10089,230,9859,97.7,57,2,3.5
5,All Students,2022-23,9419,301,9118,96.8,54,1,1.9
6,All Students,2018-19,10822,301,10521,97.2,61,2,3.3
6,All Students,2019-20,10793,306,10487,97.2,94,5,5.3
6,All Students,2020-21,10808,280,10528,97.4,63,4,6.3
6,All Students,2021-22,9602,392,9210,95.9,56,6,10.7
6,All Students,2022-23,9736,362,9374,96.3,55,4,7.3
7,All Students,2018-19,7298,84,7214,98.8,41,0,0.0
7,All Students,2019-20,5360,159,5201,97.0,48,2,4.2
7,All Students,2020-21,14012,248,13764,98.2,83,3,3.6
7,All Students,2021-22,8269,248,8021,97.0,47,1,2.1
7,All Students,2022-23,8119,244,7875,97.0,47,1,2.1
8,All Students,2018-19,11162,378,10784,96.6,64,6,9.4
8,All Students,2019-20,5151,110,5041,97.9,45,0,0.0
8,All Students,2020-21,8027,126,7901,98.4,46,2,4.3
8,All Students,2021-22,12140,470,11670,96.1,71,7,9.9
8,All Students,2022-23,8111,380,7731,95.3,46,3,6.5
All Grades,All Students,2018-19,93911,6241,87670,93.4,569,108,19.0
All Grades,All Students,2019-20,60072,3661,56411,93.9,556,101,18.2
All Grades,All Students,2020-21,98934,9110,89824,90.8,573,155,27.1
All Grades,All Students,2021-22,89867,10242,79625,88.6,563,224,39.8
All Grades,All Students,2022-23,88920,9483,79437,89.3,556,170,30.6
9,All Students,2018-19,24452,993,23459,95.9,150,12,8.0
9,All Students,2019-20,14851,907,13944,93.9,141,31,22.0
9,All Students,2020-21,24886,1153,23733,95.4,144,14,9.7
9,All Students,2021-22,23848,2722,21126,88.6,147,64,43.5
9,All Students,2022-23,22726,1948,20778,91.4,147,41,27.9
10,All Students,2018-19,24126,1365,22761,94.3,147,23,15.6
10,All Students,2019-20,15814,832,14982,94.7,144,16,11.1
10,All Students,2020-21,24425,1563,22862,93.6,141,27,19.1
10,All Students,2021-22,23255,1704,21551,92.7,140,32,22.9
10,All Students,2022-23,23069,2770,20299,88.0,147,53,36.1
11,All Students,2018-19,22477,1315,21162,94.1,135,22,16.3
11,All Students,2019-20,15721,717,15004,95.4,145,17,11.7
11,All Students,2020-21,24886,1913,22973,92.3,143,36,25.2
11,All Students,2021-22,23146,2779,20367,88.0,139,45,32.4
11,All Students,2022-23,21836,1581,20255,92.8,134,24,17.9
12,All Students,2018-19,22856,2568,20288,88.8,137,51,37.2
12,All Students,2019-20,13686,1205,12481,91.2,126,37,29.4
12,All Students,2020-21,24737,4481,20256,81.9,145,78,53.8
12,All Students,2021-22,19618,3037,16581,84.5,137,83,60.6
12,All Students,2022-23,21289,3184,18105,85.0,128,52,40.6
All Grades,All Students,2018-19,79934,4583,75351,94.3,473,78,16.5
All Grades,All Students,2019-20,50984,2810,48174,94.5,458,68,14.8
All Grades,All Students,2020-21,76899,4346,72553,94.3,459,70,15.3
All Grades,All Students,2021-22,77191,7578,69613,90.2,463,185,40.0
All Grades,All Students,2022-23,76359,6922,69437,90.9,479,188,39.2
0K,All Students,2018-19,13169,871,12298,93.4,82,16,19.5
0K,All Students,2019-20,8462,609,7853,92.8,76,20,26.3
0K,All Students,2020-21,13647,823,12824,94.0,81,14,17.3
0K,All Students,2021-22,13405,1844,11561,86.2,84,50,59.5
0K,All Students,2022-23,12753,1542,11211,87.9,80,41,51.3
1,All Students,2018-19,14932,977,13955,93.5,87,18,20.7
1,All Students,2019-20,9118,565,8553,93.8,83,16,19.3
1,All Students,2020-21,12377,572,11805,95.4,74,9,12.2
1,All Students,2021-22,14807,1532,13275,89.7,88,39,44.3
1,All Students,2022-23,13385,1464,11921,89.1,86,42,48.8
2,All Students,2018-19,13962,808,13154,94.2,83,17,20.5
2,All Students,2019-20,8757,450,8307,94.9,78,10,12.8
2,All Students,2020-21,13989,724,13265,94.8,83,11,13.3
2,All Students,2021-22,11734,1055,10679,91.0,69,28,40.6
2,All Students,2022-23,13509,1208,12301,91.1,87,38,43.7
3,All Students,2018-19,13016,596,12420,95.4,77,10,13.0
3,All Students,2019-20,10406,503,9903,95.2,94,11,11.7
3,All Students,2020-21,12600,786,11814,93.8,77,9,11.7
3,All Students,2021-22,14532,1295,13237,91.1,89,30,33.7
3,All Students,2022-23,12621,929,11692,92.6,74,23,31.1
4,All Students,2018-19,14920,751,14169,95.0,88,10,11.4
4,All Students,2019-20,6752,347,6405,94.9,60,6,10.0
4,All Students,2020-21,15644,855,14789,94.5,92,15,16.3
4,All Students,2021-22,12920,916,12004,92.9,76,19,25.0
4,All Students,2022-23,13742,976,12766,92.9,87,25,28.7
5,All Students,2018-19,9935,580,9355,94.2,56,7,12.5
5,All Students,2019-20,7489,336,7153,95.5,67,5,7.5
5,All Students,2020-21,8642,586,8056,93.2,52,12,23.1
5,All Students,2021-22,9793,936,8857,90.4,57,19,33.3
5,All Students,2022-23,10349,803,9546,92.2,65,19,29.2
All Grades,All Students,2018-19,60785,3154,57631,94.8,354,61,17.2
All Grades,All Students,2019-20,47907,2585,45322,94.6,429,67,15.6
All Grades,All Students,2020-21,83545,4050,79495,95.2,493,87,17.6
All Grades,All Students,2021-22,83186,6558,76628,92.1,489,142,29.0
All Grades,All Students,2022-23,86440,6217,80223,92.8,518,136,26.3
PK in K-12 Schools,All Students,2018-19,9357,630,8727,93.3,54,14,25.9
PK in K-12 Schools,All Students,2019-20,5867,501,5366,91.5,54,19,35.2
PK in K-12 Schools,All Students,2020-21,8823,785,8038,91.1,54,17,31.5
PK in K-12 Schools,All Students,2021-22,9158,959,8199,89.5,54,21,38.9
PK in K-12 Schools,All Students,2022-23,8995,873,8122,90.3,59,23,39.0
0K,All Students,2018-19,15528,843,14685,94.6,91,15,16.5
0K,All Students,2019-20,10049,736,9313,92.7,92,22,23.9
0K,All Students,2020-21,13872,840,13032,93.9,84,21,25.0
0K,All Students,2021-22,13749,1176,12573,91.4,84,26,31.0
0K,All Students,2022-23,14637,1268,13369,91.3,86,31,36.0
1,All Students,2018-19,12557,624,11933,95.0,73,12,16.4
1,All Students,2019-20,9143,416,8727,95.5,81,9,11.1
1,All Students,2020-21,14253,714,13539,95.0,83,15,18.1
1,All Students,2021-22,12349,1055,11294,91.5,74,23,31.1
1,All Students,2022-23,12973,873,12100,93.3,80,21,26.3
2,All Students,2018-19,11396,461,10935,96.0,66,8,12.1
2,All Students,2019-20,8221,356,7865,95.7,72,6,8.3
2,All Students,2020-21,13215,545,12670,95.9,76,10,13.2
2,All Students,2021-22,14389,1122,13267,92.2,82,27,32.9
2,All Students,2022-23,12246,939,11307,92.3,72,18,25.0
3,All Students,2018-19,11947,596,11351,95.0,70,12,17.1
3,All Students,2019-20,6748,264,6484,96.1,60,4,6.7
3,All Students,2020-21,11714,240,11474,98.0,70,6,8.6
3,All Students,2021-22,13176,870,12306,93.4,76,19,25.0
3,All Students,2022-23,14176,1005,13171,92.9,83,22,26.5
4,All Students,2019-20,7879,312,7567,96.0,70,7,10.0
4,All Students,2020-21,10199,361,9838,96.5,59,6,10.2
4,All Students,2021-22,10794,666,10128,93.8,63,14,22.2
4,All Students,2022-23,12743,785,11958,93.8,75,15,20.0
5,All Students,2020-21,11469,565,10904,95.1,67,12,17.9
5,All Students,2021-22,9571,710,8861,92.6,56,12,21.4
5,All Students,2022-23,10670,474,10196,95.6,63,6,9.5
All Grades,All Students,2018-19,5891,515,5376,91.3,43,16,37.2
All Grades,All Students,2019-20,11855,726,11129,93.9,109,16,14.7
All Grades,All Students,2020-21,23521,800,22721,96.6,144,11,7.6
All Grades,All Students,2021-22,42142,3050,39092,92.8,249,54,21.7
All Grades,All Students,2022-23,53345,4074,49271,92.4,332,82,24.7
PK in K-12 Schools,All Students,2021-22,2757,306,2451,88.9,16,8,50.0
PK in K-12 Schools,All Students,2022-23,3132,250,2882,92.0,19,4,21.1
0K,All Students,2018-19,5891,515,5376,91.3,43,16,37.2
0K,All Students,2019-20,8498,482,8016,94.3,77,10,13.0
0K,All Students,2020-21,10096,378,9718,96.3,61,7,11.5
0K,All Students,2021-22,17613,1461,16152,91.7,104,25,24.0
0K,All Students,2022-23,14154,1295,12859,90.9,94,35,37.2
1,All Students,2019-20,3357,244,3113,92.7,32,6,18.8
1,All Students,2020-21,9220,254,8966,97.2,58,1,1.7
1,All Students,2021-22,9546,545,9001,94.3,56,8,14.3
1,All Students,2022-23,16048,1141,14907,92.9,96,17,17.7
2,All Students,2020-21,4205,168,4037,96.0,25,3,12.0
2,All Students,2021-22,7833,381,7452,95.1,47,7,14.9
2,All Students,2022-23,8724,610,8114,93.0,53,11,20.8
3,All Students,2021-22,4393,357,4036,91.9,26,6,23.1
3,All Students,2022-23,6356,382,5974,94.0,39,7,17.9
4,All Students,2022-23,4931,396,4535,92.0,31,8,25.8
All Grades,All Students,2022-23,45018,9388,35630,79.1,325,239,73.5
PK in K-12 Schools,All Students,2022-23,45006,s,s,s,s,s,s
0K,All Students,2022-23,12,s,s,s,s,s,s
All Grades,All Students,2019-20,14315,1374,12941,90.4,135,47,34.8
All Grades,All Students,2020-21,31681,1846,29835,94.2,188,35,18.6
All Grades,All Students,2021-22,44305,4186,40119,90.6,266,101,38.0
All Grades,All Students,2022-23,59260,5403,53857,90.9,356,129,36.2
PK in K-12 Schools,All Students,2019-20,6780,740,6040,89.1,65,26,40.0
PK in K-12 Schools,All Students,2020-21,9198,583,8615,93.7,54,12,22.2
PK in K-12 Schools,All Students,2021-22,11793,1381,10412,88.3,73,32,43.8
PK in K-12 Schools,All Students,2022-23,11984,1453,10531,87.9,69,33,47.8
0K,All Students,2019-20,7535,634,6901,91.6,70,21,30.0
0K,All Students,2020-21,12634,600,12034,95.3,75,10,13.3
0K,All Students,2021-22,12493,1288,11205,89.7,75,37,49.3
0K,All Students,2022-23,13315,1451,11864,89.1,81,39,48.1
1,All Students,2020-21,9849,663,9186,93.3,59,13,22.0
1,All Students,2021-22,11450,914,10536,92.0,68,20,29.4
1,All Students,2022-23,11950,962,10988,91.9,75,22,29.3
2,All Students,2021-22,8569,603,7966,93.0,50,12,24.0
2,All Students,2022-23,11768,872,10896,92.6,70,21,30.0
3,All Students,2022-23,10243,665,9578,93.5,61,14,23.0
All Grades,All Students,2022-23,15335,1769,13566,88.5,97,43,44.3
9,All Students,2022-23,15335,1769,13566,88.5,97,43,44.3
All Grades,All Students,2018-19,382234,45944,336290,88.0,2469,775,31.4
All Grades,All Students,2019-20,250493,29636,220857,88.2,2370,698,29.5
All Grades,All Students,2020-21,369617,59660,309957,83.9,2155,733,34.0
All Grades,All Students,2021-22,339327,58732,280595,82.7,2114,1067,50.5
All Grades,All Students,2022-23,326429,53939,272490,83.5,2180,1058,48.5
9,All Students,2018-19,104464,14641,89823,86.0,686,223,32.5
9,All Students,2019-20,77680,8567,69113,89.0,746,205,27.5
9,All Students,2020-21,104526,19967,84559,80.9,618,249,40.3
9,All Students,2021-22,95395,15056,80339,84.2,608,255,41.9
9,All Students,2022-23,83904,14406,69498,82.8,602,290,48.2
10,All Students,2018-19,95531,11764,83767,87.7,622,205,33.0
10,All Students,2019-20,59569,7093,52476,88.1,569,177,31.1
10,All Students,2020-21,102183,15073,87110,85.2,595,174,29.2
10,All Students,2021-22,77415,13643,63772,82.4,501,250,49.9
10,All Students,2022-23,85412,13350,72062,84.4,580,248,42.8
11,All Students,2018-19,85892,6393,79499,92.6,546,120,22.0
11,All Students,2019-20,51089,5021,46068,90.2,479,126,26.3
11,All Students,2020-21,86455,13634,72821,84.2,497,158,31.8
11,All Students,2021-22,92295,15495,76800,83.2,563,285,50.6
11,All Students,2022-23,77122,12781,64341,83.4,504,245,48.6
12,All Students,2018-19,96347,13146,83201,86.4,615,227,36.9
12,All Students,2019-20,62155,8955,53200,85.6,576,190,33.0
12,All Students,2020-21,76453,10986,65467,85.6,445,152,34.2
12,All Students,2021-22,74222,14538,59684,80.4,442,277,62.7
12,All Students,2022-23,79991,13402,66589,83.2,494,275,55.7
All Grades,All Students,2018-19,366988,44732,322256,87.8,2332,835,35.8
All Grades,All Students,2019-20,240776,30543,210233,87.3,2283,849,37.2
All Grades,All Students,2020-21,366010,63020,302990,82.8,2176,924,42.5
All Grades,All Students,2021-22,337646,45825,291821,86.4,2098,900,42.9
All Grades,All Students,2022-23,309025,43386,265639,86.0,2048,866,42.3
7,All Students,2022-23,1,s,s,s,s,s,s
8,All Students,2019-20,7,s,s,s,s,s,s
8,All Students,2022-23,10,s,s,s,s,s,s
9,All Students,2018-19,137437,21596,115841,84.3,886,361,40.7
9,All Students,2019-20,86960,14425,72535,83.4,840,374,44.5
9,All Students,2020-21,128159,29968,98191,76.6,769,405,52.7
9,All Students,2021-22,108025,18406,89619,83.0,683,321,47.0
9,All Students,2022-23,98183,19154,79029,80.5,684,356,52.0
10,All Students,2018-19,90336,10089,80247,88.8,590,210,35.6
10,All Students,2019-20,59607,6965,52642,88.3,564,196,34.8
10,All Students,2020-21,96509,15223,81286,84.2,573,231,40.3
10,All Students,2021-22,88887,12283,76604,86.2,564,245,43.4
10,All Students,2022-23,77157,11238,65919,85.4,521,232,44.5
11,All Students,2018-19,66154,5073,61081,92.3,409,90,22.0
11,All Students,2019-20,40188,s,s,s,s,s,s
11,All Students,2020-21,64064,5992,58072,90.6,379,96,25.3
11,All Students,2021-22,69597,6737,62860,90.3,422,134,31.8
11,All Students,2022-23,61512,5946,55566,90.3,391,120,30.7
12,All Students,2018-19,73061,7974,65087,89.1,447,174,38.9
12,All Students,2019-20,54014,6197,47817,88.5,501,206,41.1
12,All Students,2020-21,77278,11837,65441,84.7,455,192,42.2
12,All Students,2021-22,71137,8399,62738,88.2,429,200,46.6
12,All Students,2022-23,72162,7038,65124,90.2,452,158,35.0
All Grades,All Students,2018-19,141762,10484,131278,92.6,852,170,20.0
All Grades,All Students,2019-20,93599,5441,88158,94.2,851,102,12.0
All Grades,All Students,2020-21,152794,7068,145726,95.4,875,94,10.7
All Grades,All Students,2021-22,146666,15731,130935,89.3,869,318,36.6
All Grades,All Students,2022-23,137863,12691,125172,90.8,839,243,29.0
8,All Students,2020-21,91,s,s,s,s,s,s
9,All Students,2018-19,42761,1770,40991,95.9,257,19,7.4
9,All Students,2019-20,22971,930,22041,96.0,209,11,5.3
9,All Students,2020-21,36692,818,35874,97.8,211,9,4.3
9,All Students,2021-22,35998,3083,32915,91.4,214,61,28.5
9,All Students,2022-23,34399,2356,32043,93.2,209,38,18.2
10,All Students,2018-19,36320,2465,33855,93.2,218,42,19.3
10,All Students,2019-20,26791,1219,25572,95.4,244,20,8.2
10,All Students,2020-21,37836,1365,36471,96.4,217,19,8.8
10,All Students,2021-22,35306,3094,32212,91.2,208,54,26.0
10,All Students,2022-23,36698,3294,33404,91.0,223,64,28.7
11,All Students,2018-19,31519,2163,29356,93.1,191,32,16.8
11,All Students,2019-20,23096,1290,21806,94.4,211,27,12.8
11,All Students,2020-21,41617,1919,39698,95.4,238,22,9.2
11,All Students,2021-22,35620,3868,31752,89.1,212,76,35.8
11,All Students,2022-23,33622,2618,31004,92.2,205,47,22.9
12,All Students,2018-19,31162,4086,27076,86.9,186,77,41.4
12,All Students,2019-20,20741,2002,18739,90.3,187,44,23.5
12,All Students,2020-21,36558,s,s,s,s,s,s
12,All Students,2021-22,39742,5686,34056,85.7,235,127,54.0
12,All Students,2022-23,33144,4423,28721,86.7,202,94,46.5
All Grades,All Students,2018-19,166810,19400,147410,88.4,1041,329,31.6
All Grades,All Students,2019-20,106550,10783,95767,89.9,1003,289,28.8
All Grades,All Students,2020-21,163650,27623,136027,83.1,949,406,42.8
All Grades,All Students,2021-22,148878,20816,128062,86.0,910,366,40.2
All Grades,All Students,2022-23,134125,11681,122444,91.3,878,244,27.8
9,All Students,2018-19,45798,6174,39624,86.5,295,82,27.8
9,All Students,2019-20,29448,3606,25842,87.8,280,88,31.4
9,All Students,2020-21,45607,7603,38004,83.3,263,105,39.9
9,All Students,2021-22,40870,5743,35127,85.9,256,95,37.1
9,All Students,2022-23,33323,3042,30281,90.9,247,82,33.2
10,All Students,2018-19,47941,5280,42661,89.0,300,92,30.7
10,All Students,2019-20,27644,2800,24844,89.9,259,72,27.8
10,All Students,2020-21,41240,7483,33757,81.9,240,101,42.1
10,All Students,2021-22,41482,5727,35755,86.2,252,91,36.1
10,All Students,2022-23,34146,3235,30911,90.5,216,56,25.9
11,All Students,2018-19,39779,4231,35548,89.4,243,73,30.0
11,All Students,2019-20,25185,1653,23532,93.4,240,52,21.7
11,All Students,2020-21,37758,7065,30693,81.3,217,103,47.5
11,All Students,2021-22,33206,4438,28768,86.6,201,80,39.8
11,All Students,2022-23,34705,2534,32171,92.7,214,45,21.0
12,All Students,2018-19,33292,3715,29577,88.8,203,82,40.4
12,All Students,2019-20,24273,2724,21549,88.8,226,79,35.0
12,All Students,2020-21,39045,5472,33573,86.0,229,97,42.4
12,All Students,2021-22,33320,4908,28412,85.3,201,100,49.8
12,All Students,2022-23,31951,2870,29081,91.0,201,61,30.3
All Grades,All Students,2018-19,138491,15385,123106,88.9,930,285,30.6
All Grades,All Students,2019-20,88572,12842,75730,85.5,859,293,34.1
All Grades,All Students,2020-21,120115,23921,96194,80.1,726,310,42.7
All Grades,All Students,2021-22,145823,28007,117816,80.8,1056,516,48.9
All Grades,All Students,2022-23,199945,37095,162850,81.4,1515,799,52.7
8,All Students,2022-23,22,s,s,s,s,s,s
9,All Students,2018-19,19275,2476,16799,87.2,145,51,35.2
9,All Students,2019-20,14972,1941,13031,87.0,157,60,38.2
9,All Students,2020-21,17535,5335,12200,69.6,112,69,61.6
9,All Students,2021-22,32829,7234,25595,78.0,270,138,51.1
9,All Students,2022-23,64297,15169,49128,76.4,554,342,61.7
10,All Students,2018-19,40918,4545,36373,88.9,302,89,29.5
10,All Students,2019-20,25043,3277,21766,86.9,266,85,32.0
10,All Students,2020-21,38727,8403,30324,78.3,249,120,48.2
10,All Students,2021-22,58963,10427,48536,82.3,463,214,46.2
10,All Students,2022-23,62012,11661,50351,81.2,475,248,52.2
11,All Students,2018-19,36823,3283,33540,91.1,223,47,21.1
11,All Students,2019-20,18992,2538,16454,86.6,171,47,27.5
11,All Students,2020-21,29900,3874,26026,87.0,174,50,28.7
11,All Students,2021-22,21609,4038,17571,81.3,129,55,42.6
11,All Students,2022-23,50877,5839,45038,88.5,345,131,38.0
12,All Students,2018-19,41475,5081,36394,87.7,260,98,37.7
12,All Students,2019-20,29565,5086,24479,82.8,266,102,38.3
12,All Students,2020-21,33953,6309,27644,81.4,191,71,37.2
12,All Students,2021-22,32422,6308,26114,80.5,194,109,56.2
12,All Students,2022-23,22737,s,s,s,s,s,s
All Grades,All Students,2018-19,167733,12211,155522,92.7,1024,225,22.0
All Grades,All Students,2019-20,112219,7206,105013,93.6,1035,201,19.4
All Grades,All Students,2020-21,194830,13539,181291,93.1,1125,194,17.2
All Grades,All Students,2021-22,202596,21009,181587,89.6,1219,386,31.7
All Grades,All Students,2022-23,223468,19948,203520,91.1,1389,366,26.3
9,All Students,2018-19,33959,2153,31806,93.7,207,39,18.8
9,All Students,2019-20,23960,1389,22571,94.2,224,32,14.3
9,All Students,2020-21,64874,4216,60658,93.5,375,60,16.0
9,All Students,2021-22,59843,5654,54189,90.6,365,96,26.3
9,All Students,2022-23,65123,5524,59599,91.5,409,98,24.0
10,All Students,2018-19,49409,3401,46008,93.1,302,54,17.9
10,All Students,2019-20,24954,1548,23406,93.8,230,43,18.7
10,All Students,2020-21,41397,2737,38660,93.4,239,33,13.8
10,All Students,2021-22,68539,7019,61520,89.8,411,131,31.9
10,All Students,2022-23,61183,5558,55625,90.9,382,95,24.9
11,All Students,2018-19,49055,3314,45741,93.2,301,56,18.6
11,All Students,2019-20,31808,1609,30199,94.9,294,41,13.9
11,All Students,2020-21,37207,2003,35204,94.6,215,25,11.6
11,All Students,2021-22,39091,3542,35549,90.9,234,57,24.4
11,All Students,2022-23,60615,4906,55709,91.9,374,95,25.4
12,All Students,2018-19,35310,3343,31967,90.5,214,76,35.5
12,All Students,2019-20,31497,2660,28837,91.6,288,86,29.9
12,All Students,2020-21,51352,4583,46769,91.1,296,76,25.7
12,All Students,2021-22,35123,4794,30329,86.4,209,102,48.8
12,All Students,2022-23,36547,3960,32587,89.2,224,78,34.8
All Grades,All Students,2018-19,92717,2946,89771,96.8,537,24,4.5
All Grades,All Students,2019-20,63627,2128,61499,96.7,562,29,5.2
All Grades,All Students,2020-21,100414,3784,96630,96.2,579,38,6.6
All Grades,All Students,2021-22,89490,6531,82959,92.7,530,128,24.2
All Grades,All Students,2022-23,85555,4895,80660,94.3,528,76,14.4
7,All Students,2018-19,10502,182,10320,98.3,59,0,0.0
7,All Students,2019-20,7068,129,6939,98.2,62,2,3.2
7,All Students,2020-21,9976,87,9889,99.1,58,0,0.0
7,All Students,2021-22,9690,265,9425,97.3,57,5,8.8
7,All Students,2022-23,8651,329,8322,96.2,54,5,9.3
8,All Students,2018-19,11108,147,10961,98.7,63,0,0.0
8,All Students,2019-20,6726,199,6527,97.0,59,1,1.7
8,All Students,2020-21,10266,143,10123,98.6,59,0,0.0
8,All Students,2021-22,8840,319,8521,96.4,52,3,5.8
8,All Students,2022-23,9014,411,8603,95.4,55,7,12.7
9,All Students,2018-19,25516,772,24744,97.0,149,9,6.0
9,All Students,2019-20,11381,293,11088,97.4,102,4,3.9
9,All Students,2020-21,19771,639,19132,96.8,113,5,4.4
9,All Students,2021-22,15718,970,14748,93.8,94,13,13.8
9,All Students,2022-23,23194,1330,21864,94.3,146,17,11.6
10,All Students,2018-19,22061,775,21286,96.5,130,7,5.4
10,All Students,2019-20,15904,593,15311,96.3,140,10,7.1
10,All Students,2020-21,16516,512,16004,96.9,96,7,7.3
10,All Students,2021-22,17101,781,16320,95.4,102,11,10.8
10,All Students,2022-23,14599,758,13841,94.8,89,14,15.7
11,All Students,2018-19,14184,329,13855,97.7,82,1,1.2
11,All Students,2019-20,13428,536,12892,96.0,119,5,4.2
11,All Students,2020-21,24012,1013,22999,95.8,138,8,5.8
11,All Students,2021-22,15905,923,14982,94.2,94,14,14.9
11,All Students,2022-23,15589,792,14797,94.9,95,6,6.3
12,All Students,2018-19,9346,741,8605,92.1,54,7,13.0
12,All Students,2019-20,9120,378,8742,95.9,80,7,8.8
12,All Students,2020-21,19873,1390,18483,93.0,115,18,15.7
12,All Students,2021-22,22236,3273,18963,85.3,131,82,62.6
12,All Students,2022-23,14508,1275,13233,91.2,89,27,30.3
All Grades,All Students,2018-19,78965,5329,73636,93.3,450,88,19.6
All Grades,All Students,2019-20,50319,3338,46981,93.4,446,98,22.0
All Grades,All Students,2020-21,68093,3477,64616,94.9,399,54,13.5
All Grades,All Students,2021-22,71377,5796,65581,91.9,415,127,30.6
All Grades,All Students,2022-23,75752,6294,69458,91.7,446,139,31.2
PK in K-12 Schools,All Students,2018-19,6352,612,5740,90.4,36,11,30.6
PK in K-12 Schools,All Students,2019-20,4087,369,3718,91.0,36,16,44.4
PK in K-12 Schools,All Students,2020-21,5729,622,5107,89.1,36,15,41.7
PK in K-12 Schools,All Students,2021-22,6370,623,5747,90.2,36,13,36.1
PK in K-12 Schools,All Students,2022-23,6332,697,5635,89.0,37,18,48.6
0K,All Students,2018-19,11984,915,11069,92.4,69,18,26.1
0K,All Students,2019-20,7744,608,7136,92.1,70,20,28.6
0K,All Students,2020-21,9197,507,8690,94.5,54,8,14.8
0K,All Students,2021-22,10510,976,9534,90.7,62,21,33.9
0K,All Students,2022-23,14183,1336,12847,90.6,84,32,38.1
1,All Students,2018-19,10704,688,10016,93.6,61,11,18.0
1,All Students,2019-20,7908,487,7421,93.8,69,9,13.0
1,All Students,2020-21,10928,489,10439,95.5,64,7,10.9
1,All Students,2021-22,9866,852,9014,91.4,59,21,35.6
1,All Students,2022-23,10094,836,9258,91.7,60,20,33.3
2,All Students,2018-19,11693,684,11009,94.2,68,8,11.8
2,All Students,2019-20,6742,461,6281,93.2,60,14,23.3
2,All Students,2020-21,10821,449,10372,95.9,63,5,7.9
2,All Students,2021-22,11769,812,10957,93.1,69,13,18.8
2,All Students,2022-23,10804,810,9994,92.5,65,20,30.8
3,All Students,2018-19,10852,664,10188,93.9,61,11,18.0
3,All Students,2019-20,7058,317,6741,95.5,62,4,6.5
3,All Students,2020-21,10150,393,9757,96.1,58,5,8.6
3,All Students,2021-22,11685,835,10850,92.9,67,20,29.9
3,All Students,2022-23,11305,877,10428,92.2,65,16,24.6
4,All Students,2018-19,14871,1002,13869,93.3,84,18,21.4
4,All Students,2019-20,7334,537,6797,92.7,66,18,27.3
4,All Students,2020-21,10212,490,9722,95.2,60,5,8.3
4,All Students,2021-22,10058,828,9230,91.8,58,19,32.8
4,All Students,2022-23,11743,728,11015,93.8,70,13,18.6
5,All Students,2018-19,12509,764,11745,93.9,71,11,15.5
5,All Students,2019-20,9446,559,8887,94.1,83,17,20.5
5,All Students,2020-21,11056,527,10529,95.2,64,9,14.1
5,All Students,2021-22,11119,870,10249,92.2,64,20,31.3
5,All Students,2022-23,11291,1010,10281,91.1,65,20,30.8
All Grades,All Students,2018-19,188319,13244,175075,93.0,1114,258,23.2
All Grades,All Students,2019-20,121811,8531,113280,93.0,1089,256,23.5
All Grades,All Students,2020-21,171748,14455,157293,91.6,1001,294,29.4
All Grades,All Students,2021-22,167245,15908,151337,90.5,997,360,36.1
All Grades,All Students,2022-23,165316,14807,150509,91.0,991,337,34.0
6,All Students,2018-19,62645,3989,58656,93.6,372,78,21.0
6,All Students,2019-20,38042,2411,35631,93.7,343,77,22.4
6,All Students,2020-21,50778,3489,47289,93.1,300,70,23.3
6,All Students,2021-22,52479,5001,47478,90.5,318,118,37.1
6,All Students,2022-23,56651,4940,51711,91.3,338,119,35.2
7,All Students,2018-19,68219,4891,63328,92.8,405,90,22.2
7,All Students,2019-20,41369,3074,38295,92.6,368,96,26.1
7,All Students,2020-21,58841,5178,53663,91.2,342,104,30.4
7,All Students,2021-22,52740,4581,48159,91.3,313,97,31.0
7,All Students,2022-23,54400,4904,49496,91.0,327,117,35.8
8,All Students,2018-19,57455,4364,53091,92.4,337,90,26.7
8,All Students,2019-20,42400,3046,39354,92.8,378,83,22.0
8,All Students,2020-21,62129,5788,56341,90.7,359,120,33.4
8,All Students,2021-22,62026,6326,55700,89.8,366,145,39.6
8,All Students,2022-23,54265,4963,49302,90.9,326,101,31.0
All Grades,All Students,2018-19,131972,6859,125113,94.8,754,96,12.7
All Grades,All Students,2019-20,77129,4422,72707,94.3,678,97,14.3
All Grades,All Students,2020-21,110915,4634,106281,95.8,647,66,10.2
All Grades,All Students,2021-22,112313,7489,104824,93.3,650,133,20.5
All Grades,All Students,2022-23,117025,8075,108950,93.1,678,148,21.8
PK in K-12 Schools,All Students,2018-19,6264,585,5679,90.7,36,10,27.8
PK in K-12 Schools,All Students,2019-20,4091,328,3763,92.0,36,12,33.3
PK in K-12 Schools,All Students,2020-21,5325,533,4792,90.0,32,12,37.5
PK in K-12 Schools,All Students,2021-22,6367,512,5855,92.0,36,11,30.6
PK in K-12 Schools,All Students,2022-23,6358,580,5778,90.9,37,14,37.8
0K,All Students,2018-19,15546,1018,14528,93.5,92,17,18.5
0K,All Students,2019-20,9712,664,9048,93.2,85,16,18.8
0K,All Students,2020-21,17731,757,16974,95.7,106,13,12.3
0K,All Students,2021-22,15090,1165,13925,92.3,88,22,25.0
0K,All Students,2022-23,16196,1248,14948,92.3,95,24,25.3
1,All Students,2018-19,22172,1162,21010,94.8,128,17,13.3
1,All Students,2019-20,10372,604,9768,94.2,92,13,14.1
1,All Students,2020-21,15191,562,14629,96.3,88,6,6.8
1,All Students,2021-22,18544,1154,17390,93.8,108,21,19.4
1,All Students,2022-23,16931,1186,15745,93.0,100,23,23.0
2,All Students,2018-19,16845,830,16015,95.1,96,10,10.4
2,All Students,2019-20,14466,721,13745,95.0,127,11,8.7
2,All Students,2020-21,16018,645,15373,96.0,93,7,7.5
2,All Students,2021-22,15950,970,14980,93.9,91,15,16.5
2,All Students,2022-23,19617,1346,18271,93.1,111,25,22.5
3,All Students,2018-19,18547,810,17737,95.6,106,11,10.4
3,All Students,2019-20,11342,700,10642,93.8,99,16,16.2
3,All Students,2020-21,22184,753,21431,96.6,129,8,6.2
3,All Students,2021-22,16520,1128,15392,93.2,95,22,23.2
3,All Students,2022-23,17418,1144,16274,93.4,101,23,22.8
4,All Students,2018-19,24211,1055,23156,95.6,136,11,8.1
4,All Students,2019-20,11802,575,11227,95.1,104,14,13.5
4,All Students,2020-21,16986,646,16340,96.2,99,9,9.1
4,All Students,2021-22,22547,1330,21217,94.1,130,21,16.2
4,All Students,2022-23,17025,1150,15875,93.2,98,21,21.4
5,All Students,2018-19,28387,1399,26988,95.1,160,20,12.5
5,All Students,2019-20,15344,830,14514,94.6,135,15,11.1
5,All Students,2020-21,17480,738,16742,95.8,100,11,11.0
5,All Students,2021-22,17295,1230,16065,92.9,102,21,20.6
5,All Students,2022-23,23480,1421,22059,93.9,136,18,13.2
All Grades,All Students,2018-19,120384,7055,113329,94.1,697,104,14.9
All Grades,All Students,2019-20,85868,5530,80338,93.6,779,176,22.6
All Grades,All Students,2020-21,128058,6765,121293,94.7,758,115,15.2
All Grades,All Students,2021-22,135269,13080,122189,90.3,812,299,36.8
All Grades,All Students,2022-23,144690,12324,132366,91.5,847,268,31.6
PK in K-12 Schools,All Students,2018-19,11891,923,10968,92.2,72,21,29.2
PK in K-12 Schools,All Students,2019-20,14993,1569,13424,89.5,139,61,43.9
PK in K-12 Schools,All Students,2020-21,21533,1654,19879,92.3,133,35,26.3
PK in K-12 Schools,All Students,2021-22,21968,3087,18881,85.9,131,79,60.3
PK in K-12 Schools,All Students,2022-23,24743,3362,21381,86.4,143,77,53.8
0K,All Students,2018-19,15739,1131,14608,92.8,92,20,21.7
0K,All Students,2019-20,11757,797,10960,93.2,108,17,15.7
0K,All Students,2020-21,19087,1024,18063,94.6,112,17,15.2
0K,All Students,2021-22,20053,2227,17826,88.9,118,48,40.7
0K,All Students,2022-23,20746,1947,18799,90.6,125,44,35.2
1,All Students,2018-19,17679,1019,16660,94.2,104,18,17.3
1,All Students,2019-20,10851,573,10278,94.7,97,17,17.5
1,All Students,2020-21,16691,783,15908,95.3,100,14,14.0
1,All Students,2021-22,19589,1806,17783,90.8,117,46,39.3
1,All Students,2022-23,21272,1726,19546,91.9,124,39,31.5
2,All Students,2018-19,19423,1134,18289,94.2,111,15,13.5
2,All Students,2019-20,11529,619,10910,94.6,105,20,19.0
2,All Students,2020-21,15810,748,15062,95.3,93,10,10.8
2,All Students,2021-22,18489,1629,16860,91.2,114,35,30.7
2,All Students,2022-23,19916,1465,18451,92.6,116,29,25.0
3,All Students,2018-19,16925,887,16038,94.8,96,12,12.5
3,All Students,2019-20,12351,553,11798,95.5,110,15,13.6
3,All Students,2020-21,18532,898,17634,95.2,108,14,13.0
3,All Students,2021-22,15230,1141,14089,92.5,92,23,25.0
3,All Students,2022-23,19864,1427,18437,92.8,117,31,26.5
4,All Students,2018-19,20580,1032,19548,95.0,118,10,8.5
4,All Students,2019-20,11015,719,10296,93.5,99,27,27.3
4,All Students,2020-21,19546,824,18722,95.8,113,11,9.7
4,All Students,2021-22,19678,1579,18099,92.0,119,33,27.7
4,All Students,2022-23,17133,1085,16048,93.7,100,22,22.0
5,All Students,2018-19,18147,929,17218,94.9,104,8,7.7
5,All Students,2019-20,13372,700,12672,94.8,121,19,15.7
5,All Students,2020-21,16859,834,16025,95.1,99,14,14.1
5,All Students,2021-22,20262,1611,18651,92.0,121,35,28.9
5,All Students,2022-23,21016,1312,19704,93.8,122,26,21.3
All Grades,All Students,2018-19,55584,2763,52821,95.0,317,30,9.5
All Grades,All Students,2019-20,36171,2066,34105,94.3,321,48,15.0
All Grades,All Students,2020-21,49304,1430,47874,97.1,285,13,4.6
All Grades,All Students,2021-22,53074,3329,49745,93.7,307,52,16.9
All Grades,All Students,2022-23,52411,3672,48739,93.0,300,72,24.0
0K,All Students,2018-19,8384,491,7893,94.1,48,5,10.4
0K,All Students,2019-20,5670,428,5242,92.5,52,12,23.1
0K,All Students,2020-21,7682,253,7429,96.7,44,1,2.3
0K,All Students,2021-22,11490,833,10657,92.8,66,14,21.2
0K,All Students,2022-23,8344,594,7750,92.9,48,11,22.9
1,All Students,2018-19,9612,461,9151,95.2,54,7,13.0
1,All Students,2019-20,5244,305,4939,94.2,46,3,6.5
1,All Students,2020-21,8152,290,7862,96.4,47,4,8.5
1,All Students,2021-22,8134,518,7616,93.6,47,6,12.8
1,All Students,2022-23,11459,860,10599,92.5,65,16,24.6
2,All Students,2018-19,8092,374,7718,95.4,46,2,4.3
2,All Students,2019-20,6256,340,5916,94.6,55,8,14.5
2,All Students,2020-21,7908,189,7719,97.6,46,2,4.3
2,All Students,2021-22,8551,638,7913,92.5,51,14,27.5
2,All Students,2022-23,8319,581,7738,93.0,47,14,29.8
3,All Students,2018-19,9833,474,9359,95.2,57,4,7.0
3,All Students,2019-20,5244,238,5006,95.5,46,5,10.9
3,All Students,2020-21,9463,308,9155,96.7,54,5,9.3
3,All Students,2021-22,8128,457,7671,94.4,46,7,15.2
3,All Students,2022-23,7474,608,6866,91.9,45,15,33.3
4,All Students,2018-19,12237,642,11595,94.8,70,8,11.4
4,All Students,2019-20,5891,266,5625,95.5,53,7,13.2
4,All Students,2020-21,7430,176,7254,97.6,44,0,0.0
4,All Students,2021-22,8673,434,8239,95.0,49,4,8.2
4,All Students,2022-23,8142,516,7626,93.7,46,9,19.6
5,All Students,2018-19,7426,321,7105,95.7,42,4,9.5
5,All Students,2019-20,7866,489,7377,93.8,69,13,18.8
5,All Students,2020-21,8669,214,8455,97.5,50,1,2.0
5,All Students,2021-22,8098,449,7649,94.5,48,7,14.6
5,All Students,2022-23,8673,513,8160,94.1,49,7,14.3
All Grades,All Students,2018-19,94801,5733,89068,94.0,542,96,17.7
All Grades,All Students,2019-20,61190,4144,57046,93.2,539,108,20.0
All Grades,All Students,2020-21,81875,4446,77429,94.6,495,81,16.4
All Grades,All Students,2021-22,83216,8914,74302,89.3,490,214,43.7
All Grades,All Students,2022-23,83939,7440,76499,91.1,491,153,31.2
PK in K-12 Schools,All Students,2018-19,8234,727,7507,91.2,51,16,31.4
PK in K-12 Schools,All Students,2019-20,4576,460,4116,89.9,41,17,41.5
PK in K-12 Schools,All Students,2020-21,4921,311,4610,93.7,34,8,23.5
PK in K-12 Schools,All Students,2021-22,7594,1425,6169,81.2,45,34,75.6
PK in K-12 Schools,All Students,2022-23,6436,776,5660,87.9,39,19,48.7
0K,All Students,2018-19,12646,827,11819,93.5,71,16,22.5
0K,All Students,2019-20,9285,629,8656,93.2,81,16,19.8
0K,All Students,2020-21,10063,586,9477,94.2,61,9,14.8
0K,All Students,2021-22,13705,1474,12231,89.2,83,36,43.4
0K,All Students,2022-23,12961,1259,11702,90.3,75,24,32.0
1,All Students,2018-19,14107,830,13277,94.1,81,15,18.5
1,All Students,2019-20,8446,558,7888,93.4,74,16,21.6
1,All Students,2020-21,13914,761,13153,94.5,83,13,15.7
1,All Students,2021-22,10173,965,9208,90.5,59,21,35.6
1,All Students,2022-23,13998,1185,12813,91.5,82,22,26.8
2,All Students,2018-19,11397,653,10744,94.3,65,10,15.4
2,All Students,2019-20,9424,606,8818,93.6,82,15,18.3
2,All Students,2020-21,12495,608,11887,95.1,75,12,16.0
2,All Students,2021-22,13093,1196,11897,90.9,78,28,35.9
2,All Students,2022-23,10819,884,9935,91.8,65,18,27.7
3,All Students,2018-19,16902,970,15932,94.3,96,14,14.6
3,All Students,2019-20,7549,592,6957,92.2,69,20,29.0
3,All Students,2020-21,13244,623,12621,95.3,80,12,15.0
3,All Students,2021-22,13105,1309,11796,90.0,76,34,44.7
3,All Students,2022-23,13475,1060,12415,92.1,78,23,29.5
4,All Students,2018-19,15706,867,14839,94.5,89,17,19.1
4,All Students,2019-20,10948,687,10261,93.7,96,14,14.6
4,All Students,2020-21,10921,608,10313,94.4,64,10,15.6
4,All Students,2021-22,13329,1329,12000,90.0,78,34,43.6
4,All Students,2022-23,12848,1063,11785,91.7,74,19,25.7
5,All Students,2018-19,15809,859,14950,94.6,89,8,9.0
5,All Students,2019-20,10962,612,10350,94.4,96,10,10.4
5,All Students,2020-21,16317,949,15368,94.2,98,17,17.3
5,All Students,2021-22,12217,1216,11001,90.0,71,27,38.0
5,All Students,2022-23,13402,1213,12189,90.9,78,28,35.9
All Grades,All Students,2018-19,207981,12654,195327,93.9,1184,211,17.8
All Grades,All Students,2019-20,136265,7287,128978,94.7,1192,167,14.0
All Grades,All Students,2020-21,208116,12150,195966,94.2,1203,233,19.4
All Grades,All Students,2021-22,205210,16398,188812,92.0,1192,329,27.6
All Grades,All Students,2022-23,212704,16042,196662,92.5,1229,315,25.6
6,All Students,2018-19,70132,3370,66762,95.2,400,45,11.3
6,All Students,2019-20,44538,1949,42589,95.6,389,40,10.3
6,All Students,2020-21,71202,3687,67515,94.8,412,64,15.5
6,All Students,2021-22,66303,4701,61602,92.9,387,85,22.0
6,All Students,2022-23,71995,4445,67550,93.8,415,81,19.5
7,All Students,2018-19,71155,4490,66665,93.7,407,79,19.4
7,All Students,2019-20,45698,2231,43467,95.1,400,48,12.0
7,All Students,2020-21,67111,3010,64101,95.5,389,60,15.4
7,All Students,2021-22,70794,5393,65401,92.4,413,106,25.7
7,All Students,2022-23,68457,5033,63424,92.6,397,96,24.2
8,All Students,2018-19,66694,4794,61900,92.8,377,87,23.1
8,All Students,2019-20,46029,3107,42922,93.2,403,79,19.6
8,All Students,2020-21,69803,5453,64350,92.2,402,109,27.1
8,All Students,2021-22,68113,6304,61809,90.7,392,138,35.2
8,All Students,2022-23,72252,6564,65688,90.9,417,138,33.1
All Grades,All Students,2018-19,106001,5951,100050,94.4,614,88,14.3
All Grades,All Students,2019-20,67569,3504,64065,94.8,604,77,12.7
All Grades,All Students,2020-21,96811,2581,94230,97.3,576,32,5.6
All Grades,All Students,2021-22,95878,6681,89197,93.0,564,145,25.7
All Grades,All Students,2022-23,95836,5686,90150,94.1,553,95,17.2
PK in K-12 Schools,All Students,2018-19,3123,248,2875,92.1,19,5,26.3
PK in K-12 Schools,All Students,2019-20,2069,162,1907,92.2,18,6,33.3
PK in K-12 Schools,All Students,2020-21,2978,115,2863,96.1,18,2,11.1
PK in K-12 Schools,All Students,2021-22,3072,358,2714,88.3,21,15,71.4
PK in K-12 Schools,All Students,2022-23,3182,251,2931,92.1,18,6,33.3
0K,All Students,2018-19,14454,876,13578,93.9,84,15,17.9
0K,All Students,2019-20,10532,676,9856,93.6,94,21,22.3
0K,All Students,2020-21,14202,374,13828,97.4,88,3,3.4
0K,All Students,2021-22,12800,1105,11695,91.4,76,27,35.5
0K,All Students,2022-23,12438,867,11571,93.0,72,20,27.8
1,All Students,2018-19,16729,933,15796,94.4,97,13,13.4
1,All Students,2019-20,9915,441,9474,95.6,89,8,9.0
1,All Students,2020-21,15495,520,14975,96.6,92,8,8.7
1,All Students,2021-22,15005,1033,13972,93.1,87,22,25.3
1,All Students,2022-23,13491,872,12619,93.5,78,17,21.8
2,All Students,2018-19,15741,835,14906,94.7,91,10,11.0
2,All Students,2019-20,11795,613,11182,94.8,108,12,11.1
2,All Students,2020-21,15704,337,15367,97.9,94,4,4.3
2,All Students,2021-22,15401,1010,14391,93.4,92,22,23.9
2,All Students,2022-23,17043,1020,16023,94.0,98,18,18.4
3,All Students,2018-19,16028,838,15190,94.8,94,11,11.7
3,All Students,2019-20,10814,522,10292,95.2,95,7,7.4
3,All Students,2020-21,17963,573,17390,96.8,107,10,9.3
3,All Students,2021-22,14899,962,13937,93.5,87,17,19.5
3,All Students,2022-23,15468,771,14697,95.0,88,10,11.4
4,All Students,2018-19,18867,904,17963,95.2,109,12,11.0
4,All Students,2019-20,10403,503,9900,95.2,93,8,8.6
4,All Students,2020-21,15483,305,15178,98.0,90,2,2.2
4,All Students,2021-22,18636,1144,17492,93.9,108,21,19.4
4,All Students,2022-23,15220,777,14443,94.9,87,8,9.2
5,All Students,2018-19,21059,1317,19742,93.7,120,22,18.3
5,All Students,2019-20,12041,587,11454,95.1,107,15,14.0
5,All Students,2020-21,14986,357,14629,97.6,87,3,3.4
5,All Students,2021-22,16065,1069,14996,93.3,93,21,22.6
5,All Students,2022-23,18994,1128,17866,94.1,112,16,14.3
All Grades,All Students,2018-19,58572,2448,56124,95.8,333,20,6.0
All Grades,All Students,2019-20,36557,1581,34976,95.7,324,29,9.0
All Grades,All Students,2020-21,52081,1587,50494,97.0,305,13,4.3
All Grades,All Students,2021-22,50049,3061,46988,93.9,292,51,17.5
All Grades,All Students,2022-23,53055,3484,49571,93.4,317,63,19.9
PK in K-12 Schools,All Students,2018-19,6348,398,5950,93.7,36,4,11.1
PK in K-12 Schools,All Students,2019-20,4031,226,3805,94.4,38,7,18.4
PK in K-12 Schools,All Students,2020-21,6053,252,5801,95.8,36,2,5.6
PK in K-12 Schools,All Students,2021-22,6064,544,5520,91.0,39,16,41.0
PK in K-12 Schools,All Students,2022-23,7207,572,6635,92.1,44,13,29.5
0K,All Students,2018-19,6329,284,6045,95.5,36,2,5.6
0K,All Students,2019-20,4609,231,4378,95.0,40,6,15.0
0K,All Students,2020-21,6369,210,6159,96.7,38,2,5.3
0K,All Students,2021-22,6554,444,6110,93.2,38,6,15.8
0K,All Students,2022-23,6491,416,6075,93.6,39,8,20.5
1,All Students,2018-19,7567,312,7255,95.9,43,2,4.7
1,All Students,2019-20,4700,226,4474,95.2,41,3,7.3
1,All Students,2020-21,7710,177,7533,97.7,45,2,4.4
1,All Students,2021-22,7079,453,6626,93.6,40,7,17.5
1,All Students,2022-23,8111,478,7633,94.1,48,6,12.5
2,All Students,2018-19,7313,248,7065,96.6,43,0,0.0
2,All Students,2019-20,5450,160,5290,97.1,48,1,2.1
2,All Students,2020-21,7335,209,7126,97.2,43,2,4.7
2,All Students,2021-22,8641,419,8222,95.2,50,4,8.0
2,All Students,2022-23,6976,519,6457,92.6,41,11,26.8
3,All Students,2018-19,10787,436,10351,96.0,61,6,9.8
3,All Students,2019-20,4337,203,4134,95.3,39,5,12.8
3,All Students,2020-21,8223,250,7973,97.0,47,2,4.3
3,All Students,2021-22,7504,426,7078,94.3,44,6,13.6
3,All Students,2022-23,9080,546,8534,94.0,54,10,18.5
4,All Students,2018-19,10832,462,10370,95.7,61,4,6.6
4,All Students,2019-20,6569,234,6335,96.4,58,2,3.4
4,All Students,2020-21,6764,191,6573,97.2,40,2,5.0
4,All Students,2021-22,8138,428,7710,94.7,46,7,15.2
4,All Students,2022-23,7260,470,6790,93.5,44,9,20.5
5,All Students,2018-19,9396,308,9088,96.7,53,2,3.8
5,All Students,2019-20,6861,301,6560,95.6,60,5,8.3
5,All Students,2020-21,9627,298,9329,96.9,56,1,1.8
5,All Students,2021-22,6069,347,5722,94.3,35,5,14.3
5,All Students,2022-23,7930,483,7447,93.9,47,6,12.8
All Grades,All Students,2018-19,31992,3219,28773,89.9,198,83,41.9
All Grades,All Students,2019-20,21710,2134,19576,90.2,210,79,37.6
All Grades,All Students,2020-21,35916,5809,30107,83.8,218,122,56.0
All Grades,All Students,2021-22,35533,6785,28748,80.9,218,154,70.6
All Grades,All Students,2022-23,32207,4107,28100,87.2,217,121,55.8
PK in K-12 Schools,All Students,2020-21,4602,1041,3561,77.4,30,20,66.7
PK in K-12 Schools,All Students,2021-22,5488,1296,4192,76.4,33,30,90.9
PK in K-12 Schools,All Students,2022-23,5470,775,4695,85.8,35,23,65.7
0K,All Students,2018-19,5619,552,5067,90.2,36,16,44.4
0K,All Students,2019-20,3167,375,2792,88.2,31,15,48.4
0K,All Students,2020-21,4442,528,3914,88.1,27,13,48.1
0K,All Students,2021-22,4881,1120,3761,77.1,32,25,78.1
0K,All Students,2022-23,4288,666,3622,84.5,34,23,67.6
1,All Students,2018-19,6061,653,5408,89.2,39,18,46.2
1,All Students,2019-20,3344,343,3001,89.7,33,13,39.4
1,All Students,2020-21,5340,849,4491,84.1,33,20,60.6
1,All Students,2021-22,4934,814,4120,83.5,30,20,66.7
1,All Students,2022-23,4253,572,3681,86.6,27,19,70.4
2,All Students,2018-19,6650,748,5902,88.8,39,19,48.7
2,All Students,2019-20,3422,312,3110,90.9,34,14,41.2
2,All Students,2020-21,5510,693,4817,87.4,32,13,40.6
2,All Students,2021-22,4806,783,4023,83.7,32,22,68.8
2,All Students,2022-23,5287,672,4615,87.3,33,15,45.5
3,All Students,2018-19,6859,818,6041,88.1,44,20,45.5
3,All Students,2019-20,4023,403,3620,90.0,37,15,40.5
3,All Students,2020-21,4717,690,4027,85.4,29,15,51.7
3,All Students,2021-22,5096,904,4192,82.3,30,21,70.0
3,All Students,2022-23,4054,s,s,s,s,s,s
4,All Students,2018-19,6803,448,6355,93.4,40,10,25.0
4,All Students,2019-20,3883,452,3431,88.4,39,17,43.6
4,All Students,2020-21,5965,764,5201,87.2,35,20,57.1
4,All Students,2021-22,5052,840,4212,83.4,29,15,51.7
4,All Students,2022-23,4740,447,4293,90.6,30,11,36.7
5,All Students,2019-20,3871,249,3622,93.6,36,5,13.9
5,All Students,2020-21,5340,1244,4096,76.7,32,21,65.6
5,All Students,2021-22,5276,1028,4248,80.5,32,21,65.6
5,All Students,2022-23,4093,519,3574,87.3,29,12,41.4
7,All Students,2022-23,22,s,s,s,s,s,s
All Grades,All Students,2018-19,55006,3657,51349,93.4,333,75,22.5
All Grades,All Students,2019-20,37253,3080,34173,91.7,344,110,32.0
All Grades,All Students,2020-21,54442,6670,47772,87.7,330,134,40.6
All Grades,All Students,2021-22,57971,7011,50960,87.9,352,165,46.9
All Grades,All Students,2022-23,56624,5047,51577,91.1,347,121,34.9
PK in K-12 Schools,All Students,2018-19,6086,654,5432,89.3,37,17,45.9
PK in K-12 Schools,All Students,2019-20,5404,683,4721,87.4,53,30,56.6
PK in K-12 Schools,All Students,2020-21,9158,1345,7813,85.3,58,29,50.0
PK in K-12 Schools,All Students,2021-22,10994,1720,9274,84.4,69,44,63.8
PK in K-12 Schools,All Students,2022-23,10750,1447,9303,86.5,64,38,59.4
0K,All Students,2018-19,9999,634,9365,93.7,62,12,19.4
0K,All Students,2019-20,6018,609,5409,89.9,55,23,41.8
0K,All Students,2020-21,6940,927,6013,86.6,44,21,47.7
0K,All Students,2021-22,8763,1114,7649,87.3,54,23,42.6
0K,All Students,2022-23,8603,874,7729,89.8,55,24,43.6
1,All Students,2018-19,7472,497,6975,93.3,45,12,26.7
1,All Students,2019-20,6003,436,5567,92.7,54,16,29.6
1,All Students,2020-21,8932,1260,7672,85.9,53,26,49.1
1,All Students,2021-22,7532,944,6588,87.5,44,26,59.1
1,All Students,2022-23,7415,630,6785,91.5,45,14,31.1
2,All Students,2018-19,7364,590,6774,92.0,47,14,29.8
2,All Students,2019-20,4701,290,4411,93.8,44,10,22.7
2,All Students,2020-21,8667,1017,7650,88.3,51,20,39.2
2,All Students,2021-22,8251,967,7284,88.3,50,22,44.0
2,All Students,2022-23,6798,547,6251,92.0,40,11,27.5
3,All Students,2018-19,7042,401,6641,94.3,42,5,11.9
3,All Students,2019-20,5054,428,4626,91.5,48,16,33.3
3,All Students,2020-21,6506,597,5909,90.8,39,10,25.6
3,All Students,2021-22,8322,886,7436,89.4,50,19,38.0
3,All Students,2022-23,7252,566,6686,92.2,45,13,28.9
4,All Students,2018-19,7928,342,7586,95.7,46,4,8.7
4,All Students,2019-20,4352,318,4034,92.7,39,7,17.9
4,All Students,2020-21,7257,735,6522,89.9,44,14,31.8
4,All Students,2021-22,7804,606,7198,92.2,48,12,25.0
4,All Students,2022-23,7117,435,6682,93.9,45,8,17.8
5,All Students,2018-19,9115,539,8576,94.1,54,11,20.4
5,All Students,2019-20,5721,316,5405,94.5,51,8,15.7
5,All Students,2020-21,6982,789,6193,88.7,41,14,34.1
5,All Students,2021-22,6305,774,5531,87.7,37,19,51.4
5,All Students,2022-23,8689,548,8141,93.7,53,13,24.5
All Grades,All Students,2018-19,152761,9967,142794,93.5,896,222,24.8
All Grades,All Students,2019-20,98969,5869,93100,94.1,878,163,18.6
All Grades,All Students,2020-21,144049,13548,130501,90.6,852,255,29.9
All Grades,All Students,2021-22,140083,13532,126551,90.3,843,311,36.9
All Grades,All Students,2022-23,135804,12335,123469,90.9,816,281,34.4
PK in K-12 Schools,All Students,2018-19,3178,248,2930,92.2,18,6,33.3
PK in K-12 Schools,All Students,2019-20,2050,142,1908,93.1,18,6,33.3
PK in K-12 Schools,All Students,2020-21,2825,207,2618,92.7,20,5,25.0
PK in K-12 Schools,All Students,2021-22,2977,303,2674,89.8,19,10,52.6
PK in K-12 Schools,All Students,2022-23,3164,279,2885,91.2,18,5,27.8
0K,All Students,2018-19,23729,1850,21879,92.2,141,44,31.2
0K,All Students,2019-20,15291,1109,14182,92.7,139,35,25.2
0K,All Students,2020-21,22799,2386,20413,89.5,138,45,32.6
0K,All Students,2021-22,23802,2819,20983,88.2,144,64,44.4
0K,All Students,2022-23,21247,2398,18849,88.7,130,59,45.4
1,All Students,2018-19,26507,1900,24607,92.8,155,45,29.0
1,All Students,2019-20,15129,964,14165,93.6,134,25,18.7
1,All Students,2020-21,21394,2940,18454,86.3,128,51,39.8
1,All Students,2021-22,22632,2287,20345,89.9,141,52,36.9
1,All Students,2022-23,24184,2527,21657,89.6,146,59,40.4
2,All Students,2018-19,23358,1434,21924,93.9,137,32,23.4
2,All Students,2019-20,16700,1025,15675,93.9,146,29,19.9
2,All Students,2020-21,22620,2053,20567,90.9,130,39,30.0
2,All Students,2021-22,21000,1927,19073,90.8,127,42,33.1
2,All Students,2022-23,21369,1746,19623,91.8,130,40,30.8
3,All Students,2018-19,26632,1377,25255,94.8,155,27,17.4
3,All Students,2019-20,15200,877,14323,94.2,135,23,17.0
3,All Students,2020-21,24887,2238,22649,91.0,146,44,30.1
3,All Students,2021-22,23052,2248,20804,90.2,136,53,39.0
3,All Students,2022-23,19997,1753,18244,91.2,122,39,32.0
4,All Students,2018-19,25868,1521,24347,94.1,151,30,19.9
4,All Students,2019-20,17735,870,16865,95.1,157,23,14.6
4,All Students,2020-21,24047,1942,22105,91.9,139,37,26.6
4,All Students,2021-22,23721,1909,21812,92.0,142,46,32.4
4,All Students,2022-23,21731,1830,19901,91.6,131,38,29.0
5,All Students,2018-19,23489,1637,21852,93.0,139,38,27.3
5,All Students,2019-20,16864,882,15982,94.8,149,22,14.8
5,All Students,2020-21,25477,1782,23695,93.0,151,34,22.5
5,All Students,2021-22,22899,2039,20860,91.1,134,44,32.8
5,All Students,2022-23,24112,1802,22310,92.5,139,41,29.5
All Grades,All Students,2018-19,87199,8476,78723,90.3,542,200,36.9
All Grades,All Students,2019-20,50906,5187,45719,89.8,484,198,40.9
All Grades,All Students,2020-21,73944,12113,61831,83.6,456,266,58.3
All Grades,All Students,2021-22,75703,12091,63612,84.0,484,320,66.1
All Grades,All Students,2022-23,69988,8223,61765,88.3,439,209,47.6
PK in K-12 Schools,All Students,2018-19,8795,1337,7458,84.8,62,37,59.7
PK in K-12 Schools,All Students,2019-20,5677,853,4824,85.0,56,32,57.1
PK in K-12 Schools,All Students,2020-21,5317,783,4534,85.3,36,19,52.8
PK in K-12 Schools,All Students,2021-22,8477,1685,6792,80.1,60,50,83.3
PK in K-12 Schools,All Students,2022-23,7547,1149,6398,84.8,52,32,61.5
0K,All Students,2018-19,13358,1507,11851,88.7,85,37,43.5
0K,All Students,2019-20,7195,936,6259,87.0,71,36,50.7
0K,All Students,2020-21,10997,1919,9078,82.5,70,43,61.4
0K,All Students,2021-22,10581,1886,8695,82.2,74,56,75.7
0K,All Students,2022-23,10178,1493,8685,85.3,69,43,62.3
1,All Students,2018-19,11717,1112,10605,90.5,71,23,32.4
1,All Students,2019-20,8654,904,7750,89.6,82,35,42.7
1,All Students,2020-21,11722,2286,9436,80.5,69,46,66.7
1,All Students,2021-22,11077,1777,9300,84.0,69,45,65.2
1,All Students,2022-23,9317,1062,8255,88.6,56,27,48.2
2,All Students,2018-19,10947,971,9976,91.1,65,20,30.8
2,All Students,2019-20,7538,694,6844,90.8,71,26,36.6
2,All Students,2020-21,12834,1916,10918,85.1,78,39,50.0
2,All Students,2021-22,11781,1938,9843,83.5,74,46,62.2
2,All Students,2022-23,9599,968,8631,89.9,59,23,39.0
3,All Students,2018-19,12269,1124,11145,90.8,79,31,39.2
3,All Students,2019-20,6727,572,6155,91.5,61,19,31.1
3,All Students,2020-21,11722,1916,9806,83.7,71,44,62.0
3,All Students,2021-22,11929,1674,10255,86.0,72,38,52.8
3,All Students,2022-23,9737,945,8792,90.3,58,18,31.0
4,All Students,2018-19,13336,1282,12054,90.4,83,28,33.7
4,All Students,2019-20,7484,642,6842,91.4,74,27,36.5
4,All Students,2020-21,9924,1529,8395,84.6,63,40,63.5
4,All Students,2021-22,10832,1870,8962,82.7,66,46,69.7
4,All Students,2022-23,11719,1113,10606,90.5,70,25,35.7
5,All Students,2018-19,16777,1143,15634,93.2,97,24,24.7
5,All Students,2019-20,7631,586,7045,92.3,69,23,33.3
5,All Students,2020-21,11428,1764,9664,84.6,69,35,50.7
5,All Students,2021-22,11026,1261,9765,88.6,69,39,56.5
5,All Students,2022-23,11891,1493,10398,87.4,75,41,54.7
All Grades,All Students,2018-19,87965,9169,78796,89.6,550,243,44.2
All Grades,All Students,2019-20,53852,5731,48121,89.4,512,217,42.4
All Grades,All Students,2020-21,75572,14406,61166,80.9,462,288,62.3
All Grades,All Students,2021-22,73278,11857,61421,83.8,462,294,63.6
All Grades,All Students,2022-23,65128,9286,55842,85.7,413,231,55.9
PK in K-12 Schools,All Students,2018-19,5753,1010,4743,82.4,39,28,71.8
PK in K-12 Schools,All Students,2019-20,5329,927,4402,82.6,53,31,58.5
PK in K-12 Schools,All Students,2020-21,6808,1954,4854,71.3,44,34,77.3
PK in K-12 Schools,All Students,2021-22,9666,2069,7597,78.6,65,46,70.8
PK in K-12 Schools,All Students,2022-23,9791,1992,7799,79.7,64,51,79.7
0K,All Students,2018-19,13725,1804,11921,86.9,87,44,50.6
0K,All Students,2019-20,7188,1111,6077,84.5,69,41,59.4
0K,All Students,2020-21,11827,2470,9357,79.1,74,53,71.6
0K,All Students,2021-22,7754,1458,6296,81.2,51,41,80.4
0K,All Students,2022-23,8392,1267,7125,84.9,52,31,59.6
1,All Students,2018-19,15506,1698,13808,89.0,96,47,49.0
1,All Students,2019-20,7983,757,7226,90.5,77,26,33.8
1,All Students,2020-21,10443,3079,7364,70.5,65,55,84.6
1,All Students,2021-22,12583,2249,10334,82.1,77,54,70.1
1,All Students,2022-23,7533,1094,6439,85.5,49,33,67.3
2,All Students,2018-19,12549,1131,11418,91.0,79,31,39.2
2,All Students,2019-20,8224,770,7454,90.6,77,32,41.6
2,All Students,2020-21,10655,1801,8854,83.1,64,39,60.9
2,All Students,2021-22,9624,1627,7997,83.1,61,40,65.6
2,All Students,2022-23,12214,1869,10345,84.7,77,43,55.8
3,All Students,2018-19,12567,1318,11249,89.5,79,38,48.1
3,All Students,2019-20,8140,719,7421,91.2,74,23,31.1
3,All Students,2020-21,11702,2028,9674,82.7,72,44,61.1
3,All Students,2021-22,10215,1462,8753,85.7,66,40,60.6
3,All Students,2022-23,8535,1078,7457,87.4,58,26,44.8
4,All Students,2018-19,15248,1198,14050,92.1,95,33,34.7
4,All Students,2019-20,8051,685,7366,91.5,76,29,38.2
4,All Students,2020-21,12972,1843,11129,85.8,77,33,42.9
4,All Students,2021-22,10646,1285,9361,87.9,66,33,50.0
4,All Students,2022-23,9067,1165,7902,87.2,54,30,55.6
5,All Students,2018-19,12617,1010,11607,92.0,75,22,29.3
5,All Students,2019-20,8937,762,8175,91.5,86,35,40.7
5,All Students,2020-21,11165,1231,9934,89.0,66,30,45.5
5,All Students,2021-22,12790,1707,11083,86.7,76,40,52.6
5,All Students,2022-23,9596,821,8775,91.4,59,17,28.8
All Grades,All Students,2018-19,98985,8105,90880,91.8,588,174,29.6
All Grades,All Students,2019-20,63915,4599,59316,92.8,576,136,23.6
All Grades,All Students,2020-21,92422,6977,85445,92.5,544,131,24.1
All Grades,All Students,2021-22,81086,9176,71910,88.7,485,212,43.7
All Grades,All Students,2022-23,84944,9602,75342,88.7,528,227,43.0
PK in K-12 Schools,All Students,2018-19,6272,712,5560,88.6,39,18,46.2
PK in K-12 Schools,All Students,2019-20,7481,668,6813,91.1,67,24,35.8
PK in K-12 Schools,All Students,2020-21,9804,707,9097,92.8,58,12,20.7
PK in K-12 Schools,All Students,2021-22,9782,1152,8630,88.2,59,29,49.2
PK in K-12 Schools,All Students,2022-23,11217,1567,9650,86.0,66,39,59.1
0K,All Students,2018-19,12632,1205,11427,90.5,75,27,36.0
0K,All Students,2019-20,7416,628,6788,91.5,65,20,30.8
0K,All Students,2020-21,11477,1376,10101,88.0,67,25,37.3
0K,All Students,2021-22,11619,1577,10042,86.4,68,33,48.5
0K,All Students,2022-23,12216,1644,10572,86.5,77,42,54.5
1,All Students,2018-19,15792,1412,14380,91.1,96,30,31.3
1,All Students,2019-20,9057,610,8447,93.3,80,14,17.5
1,All Students,2020-21,11851,1017,10834,91.4,71,17,23.9
1,All Students,2021-22,11541,1414,10127,87.7,69,35,50.7
1,All Students,2022-23,12479,1519,10960,87.8,74,31,41.9
2,All Students,2018-19,17292,1530,15762,91.2,101,33,32.7
2,All Students,2019-20,8824,605,8219,93.1,80,17,21.3
2,All Students,2020-21,13533,665,12868,95.1,79,12,15.2
2,All Students,2021-22,10895,1331,9564,87.8,65,26,40.0
2,All Students,2022-23,10952,s,s,s,s,s,s
3,All Students,2018-19,16452,1143,15309,93.1,96,26,27.1
3,All Students,2019-20,10557,835,9722,92.1,96,25,26.0
3,All Students,2020-21,13589,791,12798,94.2,79,14,17.7
3,All Students,2021-22,11034,977,10057,91.1,67,21,31.3
3,All Students,2022-23,13007,1421,11586,89.1,81,33,40.7
4,All Students,2018-19,15845,1161,14684,92.7,94,22,23.4
4,All Students,2019-20,10928,691,10237,93.7,101,20,19.8
4,All Students,2020-21,15032,1062,13970,92.9,88,21,23.9
4,All Students,2021-22,13613,1367,12246,90.0,81,34,42.0
4,All Students,2022-23,11311,1053,10258,90.7,73,26,35.6
5,All Students,2018-19,14700,942,13758,93.6,87,18,20.7
5,All Students,2019-20,9652,562,9090,94.2,87,16,18.4
5,All Students,2020-21,17136,1359,15777,92.1,102,30,29.4
5,All Students,2021-22,12602,1358,11244,89.2,76,34,44.7
5,All Students,2022-23,13761,1279,12482,90.7,85,28,32.9
6,All Students,2022-23,1,s,s,s,s,s,s
All Grades,All Students,2018-19,80736,5806,74930,92.8,483,140,29.0
All Grades,All Students,2019-20,48303,3979,44324,91.8,437,132,30.2
All Grades,All Students,2020-21,70996,13620,57376,80.8,424,269,63.4
All Grades,All Students,2021-22,66883,9879,57004,85.2,408,232,56.9
All Grades,All Students,2022-23,61315,7504,53811,87.8,393,196,49.9
0K,All Students,2018-19,10976,924,10052,91.6,68,27,39.7
0K,All Students,2019-20,7223,918,6305,87.3,66,33,50.0
0K,All Students,2020-21,9378,2280,7098,75.7,55,38,69.1
0K,All Students,2021-22,10209,1821,8388,82.2,63,41,65.1
0K,All Students,2022-23,7907,s,s,s,s,s,s
1,All Students,2018-19,14064,1119,12945,92.0,84,26,31.0
1,All Students,2019-20,7683,703,6980,90.8,72,27,37.5
1,All Students,2020-21,10761,2234,8527,79.2,64,42,65.6
1,All Students,2021-22,8932,1533,7399,82.8,60,44,73.3
1,All Students,2022-23,10294,1460,8834,85.8,69,43,62.3
2,All Students,2018-19,13372,1130,12242,91.5,83,29,34.9
2,All Students,2019-20,9341,634,8707,93.2,82,20,24.4
2,All Students,2020-21,12311,2573,9738,79.1,75,57,76.0
2,All Students,2021-22,10196,1542,8654,84.9,62,39,62.9
2,All Students,2022-23,9462,1092,8370,88.5,58,29,50.0
3,All Students,2018-19,12488,928,11560,92.6,77,24,31.2
3,All Students,2019-20,7935,604,7331,92.4,72,18,25.0
3,All Students,2020-21,13907,1923,11984,86.2,82,39,47.6
3,All Students,2021-22,11194,1553,9641,86.1,68,36,52.9
3,All Students,2022-23,9740,1214,8526,87.5,65,29,44.6
4,All Students,2018-19,13831,860,12971,93.8,79,17,21.5
4,All Students,2019-20,8600,641,7959,92.5,77,18,23.4
4,All Students,2020-21,12552,2148,10404,82.9,76,45,59.2
4,All Students,2021-22,14669,1661,13008,88.7,86,33,38.4
4,All Students,2022-23,10446,1176,9270,88.7,64,30,46.9
5,All Students,2018-19,16005,845,15160,94.7,92,17,18.5
5,All Students,2019-20,7521,479,7042,93.6,68,16,23.5
5,All Students,2020-21,12087,2462,9625,79.6,72,48,66.7
5,All Students,2021-22,11683,1769,9914,84.9,69,39,56.5
5,All Students,2022-23,13464,1197,12267,91.1,81,26,32.1
6,All Students,2022-23,2,s,s,s,s,s,s
All Grades,All Students,2018-19,61654,5914,55740,90.4,371,141,38.0
All Grades,All Students,2019-20,45007,4641,40366,89.7,416,166,39.9
All Grades,All Students,2020-21,68981,13362,55619,80.6,412,241,58.5
All Grades,All Students,2021-22,66563,10585,55978,84.1,404,258,63.9
All Grades,All Students,2022-23,69396,8730,60666,87.4,413,185,44.8
PK in K-12 Schools,All Students,2019-20,5450,712,4738,86.9,51,29,56.9
PK in K-12 Schools,All Students,2020-21,8772,2917,5855,66.7,51,47,92.2
PK in K-12 Schools,All Students,2021-22,8917,1900,7017,78.7,55,50,90.9
PK in K-12 Schools,All Students,2022-23,8858,1224,7634,86.2,52,27,51.9
0K,All Students,2018-19,8873,1124,7749,87.3,55,28,50.9
0K,All Students,2019-20,6122,715,5407,88.3,58,29,50.0
0K,All Students,2020-21,9529,1471,8058,84.6,58,33,56.9
0K,All Students,2021-22,10941,1946,8995,82.2,66,44,66.7
0K,All Students,2022-23,9914,1312,8602,86.8,58,24,41.4
1,All Students,2018-19,9254,881,8373,90.5,57,22,38.6
1,All Students,2019-20,6374,838,5536,86.9,61,34,55.7
1,All Students,2020-21,9373,2164,7209,76.9,57,39,68.4
1,All Students,2021-22,9747,1407,8340,85.6,58,34,58.6
1,All Students,2022-23,10675,1489,9186,86.1,64,31,48.4
2,All Students,2018-19,9259,911,8348,90.2,57,24,42.1
2,All Students,2019-20,6726,555,6171,91.7,62,19,30.6
2,All Students,2020-21,8685,1759,6926,79.7,52,34,65.4
2,All Students,2021-22,7975,s,s,s,s,s,s
2,All Students,2022-23,10053,1172,8881,88.3,61,24,39.3
3,All Students,2018-19,11373,1024,10349,91.0,66,20,30.3
3,All Students,2019-20,6211,595,5616,90.4,56,17,30.4
3,All Students,2020-21,10917,1850,9067,83.1,64,30,46.9
3,All Students,2021-22,9946,1532,8414,84.6,62,44,71.0
3,All Students,2022-23,8935,1118,7817,87.5,53,27,50.9
4,All Students,2018-19,11078,925,10153,91.7,66,22,33.3
4,All Students,2019-20,7886,660,7226,91.6,71,20,28.2
4,All Students,2020-21,9100,853,8247,90.6,56,16,28.6
4,All Students,2021-22,10498,1402,9096,86.6,61,28,45.9
4,All Students,2022-23,9314,1134,8180,87.8,57,27,47.4
5,All Students,2018-19,11817,1049,10768,91.1,70,25,35.7
5,All Students,2019-20,6238,566,5672,90.9,57,18,31.6
5,All Students,2020-21,12605,2348,10257,81.4,74,42,56.8
5,All Students,2021-22,8372,981,7391,88.3,50,21,42.0
5,All Students,2022-23,11647,1281,10366,89.0,68,25,36.8
6,All Students,2021-22,167,s,s,s,s,s,s
All Grades,All Students,2018-19,167240,13552,153688,91.9,988,291,29.5
All Grades,All Students,2019-20,106491,8630,97861,91.9,970,299,30.8
All Grades,All Students,2020-21,149110,18279,130831,87.7,882,362,41.0
All Grades,All Students,2021-22,142542,19299,123243,86.5,858,447,52.1
All Grades,All Students,2022-23,142697,16119,126578,88.7,894,415,46.4
PK in K-12 Schools,All Students,2018-19,6337,583,5754,90.8,37,12,32.4
PK in K-12 Schools,All Students,2019-20,7516,804,6712,89.3,67,31,46.3
PK in K-12 Schools,All Students,2020-21,11217,1677,9540,85.0,67,35,52.2
PK in K-12 Schools,All Students,2021-22,11060,2126,8934,80.8,68,54,79.4
PK in K-12 Schools,All Students,2022-23,10694,1390,9304,87.0,68,38,55.9
0K,All Students,2018-19,25209,2267,22942,91.0,149,54,36.2
0K,All Students,2019-20,13996,1238,12758,91.2,130,46,35.4
0K,All Students,2020-21,22273,2561,19712,88.5,138,63,45.7
0K,All Students,2021-22,21495,3331,18164,84.5,131,76,58.0
0K,All Students,2022-23,19898,2931,16967,85.3,132,85,64.4
1,All Students,2018-19,25826,2265,23561,91.2,157,51,32.5
1,All Students,2019-20,15219,1196,14023,92.1,139,37,26.6
1,All Students,2020-21,20677,2365,18312,88.6,122,44,36.1
1,All Students,2021-22,22792,2670,20122,88.3,135,59,43.7
1,All Students,2022-23,21364,2637,18727,87.7,136,69,50.7
2,All Students,2018-19,22342,1837,20505,91.8,134,40,29.9
2,All Students,2019-20,17349,1388,15961,92.0,156,46,29.5
2,All Students,2020-21,22293,2915,19378,86.9,131,55,42.0
2,All Students,2021-22,17791,2379,15412,86.6,107,54,50.5
2,All Students,2022-23,21442,2113,19329,90.1,137,52,38.0
3,All Students,2018-19,27896,2215,25681,92.1,165,46,27.9
3,All Students,2019-20,12787,974,11813,92.4,120,37,30.8
3,All Students,2020-21,26483,3060,23423,88.4,154,55,35.7
3,All Students,2021-22,23144,2807,20337,87.9,136,68,50.0
3,All Students,2022-23,21611,2416,19195,88.8,135,59,43.7
4,All Students,2018-19,32589,2624,29965,91.9,188,58,30.9
4,All Students,2019-20,19315,1429,17886,92.6,173,48,27.7
4,All Students,2020-21,18936,2371,16565,87.5,113,52,46.0
4,All Students,2021-22,26253,3408,22845,87.0,158,68,43.0
4,All Students,2022-23,22874,2401,20473,89.5,139,62,44.6
5,All Students,2018-19,27041,1761,25280,93.5,158,30,19.0
5,All Students,2019-20,20309,1601,18708,92.1,185,54,29.2
5,All Students,2020-21,27231,3330,23901,87.8,157,58,36.9
5,All Students,2021-22,20007,2578,17429,87.1,123,68,55.3
5,All Students,2022-23,24814,2231,22583,91.0,147,50,34.0
All Grades,All Students,2018-19,96673,4846,91827,95.0,556,63,11.3
All Grades,All Students,2019-20,64876,3388,61488,94.8,577,76,13.2
All Grades,All Students,2020-21,98838,3542,95296,96.4,571,46,8.1
All Grades,All Students,2021-22,102088,6814,95274,93.3,594,124,20.9
All Grades,All Students,2022-23,105121,6727,98394,93.6,603,117,19.4
PK in K-12 Schools,All Students,2018-19,6310,445,5865,92.9,36,8,22.2
PK in K-12 Schools,All Students,2019-20,4097,295,3802,92.8,37,8,21.6
PK in K-12 Schools,All Students,2020-21,6300,183,6117,97.1,36,3,8.3
PK in K-12 Schools,All Students,2021-22,6313,465,5848,92.6,36,7,19.4
PK in K-12 Schools,All Students,2022-23,6370,694,5676,89.1,36,17,47.2
0K,All Students,2018-19,12921,704,12217,94.6,75,9,12.0
0K,All Students,2019-20,9531,603,8928,93.7,86,11,12.8
0K,All Students,2020-21,14765,532,14233,96.4,85,6,7.1
0K,All Students,2021-22,18281,1280,17001,93.0,104,21,20.2
0K,All Students,2022-23,16058,1173,14885,92.7,93,25,26.9
1,All Students,2018-19,16260,824,15436,94.9,94,7,7.4
1,All Students,2019-20,8783,450,8333,94.9,77,7,9.1
1,All Students,2020-21,15165,847,14318,94.4,88,10,11.4
1,All Students,2021-22,15650,985,14665,93.7,92,16,17.4
1,All Students,2022-23,19334,1131,18203,94.2,110,14,12.7
2,All Students,2018-19,13985,723,13262,94.8,81,11,13.6
2,All Students,2019-20,11444,565,10879,95.1,101,17,16.8
2,All Students,2020-21,13187,401,12786,97.0,78,7,9.0
2,All Students,2021-22,14749,1022,13727,93.1,86,18,20.9
2,All Students,2022-23,15159,958,14201,93.7,87,17,19.5
3,All Students,2018-19,17092,809,16283,95.3,98,10,10.2
3,All Students,2019-20,10000,525,9475,94.8,90,12,13.3
3,All Students,2020-21,16849,534,16315,96.8,97,8,8.2
3,All Students,2021-22,13713,827,12886,94.0,80,17,21.3
3,All Students,2022-23,15602,938,14664,94.0,89,15,16.9
4,All Students,2018-19,15087,670,14417,95.6,87,9,10.3
4,All Students,2019-20,11545,552,10993,95.2,102,12,11.8
4,All Students,2020-21,15072,635,14437,95.8,87,8,9.2
4,All Students,2021-22,17289,992,16297,94.3,102,17,16.7
4,All Students,2022-23,14697,873,13824,94.1,84,14,16.7
5,All Students,2018-19,15018,671,14347,95.5,85,9,10.6
5,All Students,2019-20,9476,398,9078,95.8,84,9,10.7
5,All Students,2020-21,17500,410,17090,97.7,100,4,4.0
5,All Students,2021-22,16093,1243,14850,92.3,94,28,29.8
5,All Students,2022-23,17901,960,16941,94.6,104,15,14.4
All Grades,All Students,2018-19,234463,12895,221568,94.5,1346,207,15.4
All Grades,All Students,2019-20,157267,8851,148416,94.4,1397,238,17.0
All Grades,All Students,2020-21,227770,25230,202540,88.9,1322,491,37.1
All Grades,All Students,2021-22,228467,19319,209148,91.5,1328,398,30.0
All Grades,All Students,2022-23,226856,16127,210729,92.9,1311,321,24.5
6,All Students,2018-19,77173,3961,73212,94.9,446,61,13.7
6,All Students,2019-20,55447,2717,52730,95.1,495,70,14.1
6,All Students,2020-21,67622,4446,63176,93.4,394,92,23.4
6,All Students,2021-22,73317,5773,67544,92.1,429,122,28.4
6,All Students,2022-23,75145,4688,70457,93.8,436,94,21.6
7,All Students,2018-19,76817,4820,71997,93.7,444,90,20.3
7,All Students,2019-20,51279,2604,48675,94.9,456,70,15.4
7,All Students,2020-21,82688,10367,72321,87.5,479,203,42.4
7,All Students,2021-22,70821,5504,65317,92.2,414,109,26.3
7,All Students,2022-23,75878,5335,70543,93.0,435,100,23.0
8,All Students,2018-19,80473,4114,76359,94.9,456,56,12.3
8,All Students,2019-20,50541,3530,47011,93.0,446,98,22.0
8,All Students,2020-21,77460,10417,67043,86.6,449,196,43.7
8,All Students,2021-22,84329,8042,76287,90.5,485,167,34.4
8,All Students,2022-23,75833,6104,69729,92.0,440,127,28.9
All Grades,All Students,2018-19,52840,3177,49663,94.0,305,52,17.0
All Grades,All Students,2019-20,33665,1925,31740,94.3,298,52,17.4
All Grades,All Students,2020-21,49861,2281,47580,95.4,290,37,12.8
All Grades,All Students,2021-22,49580,3047,46533,93.9,291,54,18.6
All Grades,All Students,2022-23,48223,3030,45193,93.7,284,56,19.7
PK in K-12 Schools,All Students,2018-19,3179,303,2876,90.5,20,8,40.0
PK in K-12 Schools,All Students,2019-20,2052,147,1905,92.8,18,2,11.1
PK in K-12 Schools,All Students,2020-21,3143,285,2858,90.9,18,7,38.9
PK in K-12 Schools,All Students,2021-22,3172,350,2822,89.0,18,8,44.4
PK in K-12 Schools,All Students,2022-23,3053,280,2773,90.8,18,7,38.9
0K,All Students,2018-19,8132,554,7578,93.2,48,9,18.8
0K,All Students,2019-20,5253,342,4911,93.5,46,12,26.1
0K,All Students,2020-21,6382,412,5970,93.5,39,10,25.6
0K,All Students,2021-22,6109,446,5663,92.7,36,9,25.0
0K,All Students,2022-23,7167,413,6754,94.2,45,9,20.0
1,All Students,2018-19,9195,501,8694,94.6,53,7,13.2
1,All Students,2019-20,5178,276,4902,94.7,46,8,17.4
1,All Students,2020-21,7342,304,7038,95.9,43,5,11.6
1,All Students,2021-22,6389,374,6015,94.1,38,6,15.8
1,All Students,2022-23,6671,504,6167,92.4,39,10,25.6
2,All Students,2018-19,9297,544,8753,94.1,53,10,18.9
2,All Students,2019-20,6215,405,5810,93.5,55,14,25.5
2,All Students,2020-21,7535,387,7148,94.9,43,7,16.3
2,All Students,2021-22,8427,577,7850,93.2,51,12,23.5
2,All Students,2022-23,6072,332,5740,94.5,35,4,11.4
3,All Students,2018-19,7453,372,7081,95.0,43,4,9.3
3,All Students,2019-20,5723,229,5494,96.0,51,5,9.8
3,All Students,2020-21,9450,295,9155,96.9,54,3,5.6
3,All Students,2021-22,7167,381,6786,94.7,42,6,14.3
3,All Students,2022-23,8904,582,8322,93.5,51,10,19.6
4,All Students,2018-19,7574,368,7206,95.1,43,5,11.6
4,All Students,2019-20,4629,260,4369,94.4,41,5,12.2
4,All Students,2020-21,9133,361,8772,96.0,53,2,3.8
4,All Students,2021-22,8975,468,8507,94.8,52,7,13.5
4,All Students,2022-23,6978,413,6565,94.1,42,8,19.0
5,All Students,2018-19,8010,535,7475,93.3,45,9,20.0
5,All Students,2019-20,4615,266,4349,94.2,41,6,14.6
5,All Students,2020-21,6876,237,6639,96.6,40,3,7.5
5,All Students,2021-22,9341,451,8890,95.2,54,6,11.1
5,All Students,2022-23,9378,506,8872,94.6,54,8,14.8
All Grades,All Students,2018-19,187283,16395,170888,91.2,1104,351,31.8
All Grades,All Students,2019-20,122106,10196,111910,91.6,1108,292,26.4
All Grades,All Students,2020-21,182617,27729,154888,84.8,1074,470,43.8
All Grades,All Students,2021-22,174359,22424,151935,87.1,1053,480,45.6
All Grades,All Students,2022-23,166457,18882,147575,88.7,1005,406,40.4
6,All Students,2018-19,64294,4969,59325,92.3,379,100,26.4
6,All Students,2019-20,38803,2835,35968,92.7,355,94,26.5
6,All Students,2020-21,60857,8536,52321,86.0,367,159,43.3
6,All Students,2021-22,58449,7115,51334,87.8,350,151,43.1
6,All Students,2022-23,49272,s,s,s,s,s,s
7,All Students,2018-19,63274,5333,57941,91.6,374,120,32.1
7,All Students,2019-20,41711,3602,38109,91.4,381,95,24.9
7,All Students,2020-21,58683,8197,50486,86.0,343,124,36.2
7,All Students,2021-22,59651,7640,52011,87.2,363,165,45.5
7,All Students,2022-23,58353,6201,52152,89.4,349,136,39.0
8,All Students,2018-19,59715,6093,53622,89.8,351,131,37.3
8,All Students,2019-20,41592,3759,37833,91.0,372,103,27.7
8,All Students,2020-21,63077,10996,52081,82.6,364,187,51.4
8,All Students,2021-22,56259,7669,48590,86.4,340,164,48.2
8,All Students,2022-23,58741,7176,51565,87.8,348,144,41.4
9,All Students,2022-23,91,s,s,s,s,s,s
All Grades,All Students,2018-19,47450,4498,42952,90.5,285,109,38.2
All Grades,All Students,2019-20,34414,3432,30982,90.0,317,122,38.5
All Grades,All Students,2020-21,59556,9652,49904,83.8,346,155,44.8
All Grades,All Students,2021-22,54721,9119,45602,83.3,335,206,61.5
All Grades,All Students,2022-23,48941,6842,42099,86.0,299,146,48.8
6,All Students,2018-19,14561,1331,13230,90.9,89,33,37.1
6,All Students,2019-20,9358,890,8468,90.5,87,33,37.9
6,All Students,2020-21,13637,1568,12069,88.5,79,29,36.7
6,All Students,2021-22,10171,1526,8645,85.0,65,37,56.9
6,All Students,2022-23,11103,1040,10063,90.6,65,23,35.4
7,All Students,2018-19,13536,1072,12464,92.1,79,24,30.4
7,All Students,2019-20,8873,878,7995,90.1,79,31,39.2
7,All Students,2020-21,13191,1161,12030,91.2,76,21,27.6
7,All Students,2021-22,12606,1547,11059,87.7,77,35,45.5
7,All Students,2022-23,9726,1142,8584,88.3,58,21,36.2
8,All Students,2018-19,10156,1106,9050,89.1,58,27,46.6
8,All Students,2019-20,8197,671,7526,91.8,73,22,30.1
8,All Students,2020-21,13170,2695,10475,79.5,77,39,50.6
8,All Students,2021-22,13174,2157,11017,83.6,77,51,66.2
8,All Students,2022-23,11530,1303,10227,88.7,68,26,38.2
9,All Students,2018-19,4796,523,4273,89.1,31,12,38.7
9,All Students,2019-20,3387,486,2901,85.7,34,15,44.1
9,All Students,2020-21,8876,2603,6273,70.7,53,35,66.0
9,All Students,2021-22,6065,1453,4612,76.0,39,32,82.1
9,All Students,2022-23,4477,732,3745,83.6,29,17,58.6
10,All Students,2018-19,4401,466,3935,89.4,28,13,46.4
10,All Students,2019-20,2521,276,2245,89.1,23,10,43.5
10,All Students,2020-21,4208,807,3401,80.8,24,12,50.0
10,All Students,2021-22,6284,1219,5065,80.6,39,26,66.7
10,All Students,2022-23,4172,1020,3152,75.6,27,25,92.6
11,All Students,2019-20,2078,231,1847,88.9,21,11,52.4
11,All Students,2020-21,3324,499,2825,85.0,19,9,47.4
11,All Students,2021-22,3415,781,2634,77.1,20,15,75.0
11,All Students,2022-23,5096,993,4103,80.5,34,21,61.8
12,All Students,2020-21,3150,319,2831,89.9,18,10,55.6
12,All Students,2021-22,3006,436,2570,85.5,18,10,55.6
12,All Students,2022-23,2837,612,2225,78.4,18,13,72.2
All Grades,All Students,2018-19,108035,5630,102405,94.8,635,93,14.6
All Grades,All Students,2019-20,72827,4419,68408,93.9,657,127,19.3
All Grades,All Students,2020-21,111257,5680,105577,94.9,650,102,15.7
All Grades,All Students,2021-22,106714,9241,97473,91.3,619,180,29.1
All Grades,All Students,2022-23,106753,8560,98193,92.0,624,187,30.0
PK in K-12 Schools,All Students,2018-19,3139,187,2952,94.0,18,2,11.1
PK in K-12 Schools,All Students,2019-20,3728,373,3355,90.0,33,14,42.4
PK in K-12 Schools,All Students,2020-21,5713,429,5284,92.5,34,7,20.6
PK in K-12 Schools,All Students,2021-22,5456,661,4795,87.9,32,12,37.5
PK in K-12 Schools,All Students,2022-23,5796,705,5091,87.8,35,18,51.4
0K,All Students,2018-19,17992,1185,16807,93.4,109,26,23.9
0K,All Students,2019-20,11609,819,10790,92.9,104,26,25.0
0K,All Students,2020-21,16049,824,15225,94.9,96,17,17.7
0K,All Students,2021-22,17513,1835,15678,89.5,103,36,35.0
0K,All Students,2022-23,15347,1401,13946,90.9,91,31,34.1
1,All Students,2018-19,17106,779,16327,95.4,100,7,7.0
1,All Students,2019-20,10951,701,10250,93.6,101,21,20.8
1,All Students,2020-21,17457,1165,16292,93.3,101,20,19.8
1,All Students,2021-22,17311,1700,15611,90.2,98,31,31.6
1,All Students,2022-23,17525,1491,16034,91.5,101,35,34.7
2,All Students,2018-19,17292,894,16398,94.8,101,14,13.9
2,All Students,2019-20,11183,588,10595,94.7,101,15,14.9
2,All Students,2020-21,16327,748,15579,95.4,96,14,14.6
2,All Students,2021-22,16200,1279,14921,92.1,97,27,27.8
2,All Students,2022-23,17564,1448,16116,91.8,102,28,27.5
3,All Students,2018-19,20784,950,19834,95.4,124,19,15.3
3,All Students,2019-20,11464,649,10815,94.3,104,19,18.3
3,All Students,2020-21,16778,778,16000,95.4,97,15,15.5
3,All Students,2021-22,16898,1314,15584,92.2,98,28,28.6
3,All Students,2022-23,15890,1093,14797,93.1,96,25,26.0
4,All Students,2018-19,15115,751,14364,95.0,88,9,10.2
4,All Students,2019-20,14160,766,13394,94.6,128,22,17.2
4,All Students,2020-21,16526,609,15917,96.3,96,10,10.4
4,All Students,2021-22,16998,1219,15779,92.8,97,25,25.8
4,All Students,2022-23,18152,1384,16768,92.4,104,30,28.8
5,All Students,2018-19,16607,884,15723,94.7,95,16,16.8
5,All Students,2019-20,9732,523,9209,94.6,86,10,11.6
5,All Students,2020-21,22407,1127,21280,95.0,130,19,14.6
5,All Students,2021-22,16338,1233,15105,92.5,94,21,22.3
5,All Students,2022-23,16479,1038,15441,93.7,95,20,21.1
All Grades,All Students,2018-19,147828,8516,139312,94.2,851,141,16.6
All Grades,All Students,2019-20,94125,5992,88133,93.6,836,152,18.2
All Grades,All Students,2020-21,133165,6437,126728,95.2,786,96,12.2
All Grades,All Students,2021-22,122889,9957,112932,91.9,716,184,25.7
All Grades,All Students,2022-23,117122,8904,108218,92.4,677,171,25.3
PK in K-12 Schools,All Students,2018-19,3134,216,2918,93.1,20,5,25.0
PK in K-12 Schools,All Students,2019-20,2052,150,1902,92.7,18,5,27.8
PK in K-12 Schools,All Students,2020-21,3062,527,2535,82.8,19,7,36.8
PK in K-12 Schools,All Students,2021-22,3167,319,2848,89.9,19,8,42.1
PK in K-12 Schools,All Students,2022-23,3186,s,s,s,s,s,s
0K,All Students,2018-19,23280,1580,21700,93.2,135,28,20.7
0K,All Students,2019-20,14720,1000,13720,93.2,132,26,19.7
0K,All Students,2020-21,21965,925,21040,95.8,129,15,11.6
0K,All Students,2021-22,19668,1842,17826,90.6,116,36,31.0
0K,All Students,2022-23,19926,1696,18230,91.5,117,40,34.2
1,All Students,2018-19,22171,1381,20790,93.8,127,19,15.0
1,All Students,2019-20,14353,982,13371,93.2,128,24,18.8
1,All Students,2020-21,19201,877,18324,95.4,114,13,11.4
1,All Students,2021-22,20005,1664,18341,91.7,114,33,28.9
1,All Students,2022-23,18229,1567,16662,91.4,106,28,26.4
2,All Students,2018-19,26595,1397,25198,94.7,154,17,11.0
2,All Students,2019-20,13390,887,12503,93.4,121,21,17.4
2,All Students,2020-21,21410,812,20598,96.2,125,9,7.2
2,All Students,2021-22,18449,1414,17035,92.3,108,23,21.3
2,All Students,2022-23,19188,1510,17678,92.1,112,27,24.1
3,All Students,2018-19,25833,1245,24588,95.2,147,19,12.9
3,All Students,2019-20,17513,1120,16393,93.6,154,25,16.2
3,All Students,2020-21,18298,692,17606,96.2,109,11,10.1
3,All Students,2021-22,20777,1423,19354,93.2,123,23,18.7
3,All Students,2022-23,18833,1296,17537,93.1,109,27,24.8
4,All Students,2018-19,23579,1382,22197,94.1,136,25,18.4
4,All Students,2019-20,16631,916,15715,94.5,148,23,15.5
4,All Students,2020-21,24955,1065,23890,95.7,147,17,11.6
4,All Students,2021-22,17708,1418,16290,92.0,102,28,27.5
4,All Students,2022-23,20040,1310,18730,93.5,114,22,19.3
5,All Students,2018-19,23236,1315,21921,94.3,132,28,21.2
5,All Students,2019-20,15466,937,14529,93.9,135,28,20.7
5,All Students,2020-21,24274,1539,22735,93.7,143,24,16.8
5,All Students,2021-22,23115,1877,21238,91.9,134,33,24.6
5,All Students,2022-23,17716,1305,16411,92.6,101,23,22.8
6,All Students,2022-23,4,s,s,s,s,s,s
All Grades,All Students,2018-19,68867,7117,61750,89.7,421,178,42.3
All Grades,All Students,2019-20,45043,4556,40487,89.9,428,173,40.4
All Grades,All Students,2020-21,64298,13728,50570,78.6,387,249,64.3
All Grades,All Students,2021-22,61623,9386,52237,84.8,384,231,60.2
All Grades,All Students,2022-23,62763,8268,54495,86.8,393,211,53.7
PK in K-12 Schools,All Students,2018-19,4508,523,3985,88.4,32,17,53.1
PK in K-12 Schools,All Students,2019-20,6223,934,5289,85.0,66,42,63.6
PK in K-12 Schools,All Students,2020-21,7603,2156,5447,71.6,49,38,77.6
PK in K-12 Schools,All Students,2021-22,9099,1662,7437,81.7,63,48,76.2
PK in K-12 Schools,All Students,2022-23,9788,1554,8234,84.1,65,41,63.1
0K,All Students,2018-19,9591,1247,8344,87.0,59,30,50.8
0K,All Students,2019-20,4933,693,4240,86.0,48,25,52.1
0K,All Students,2020-21,9057,2427,6630,73.2,56,41,73.2
0K,All Students,2021-22,8837,1212,7625,86.3,55,29,52.7
0K,All Students,2022-23,7147,948,6199,86.7,47,28,59.6
1,All Students,2018-19,10040,1026,9014,89.8,60,29,48.3
1,All Students,2019-20,5215,509,4706,90.2,49,22,44.9
1,All Students,2020-21,7500,1756,5744,76.6,45,31,68.9
1,All Students,2021-22,9306,1568,7738,83.2,57,39,68.4
1,All Students,2022-23,10320,1295,9025,87.5,65,37,56.9
2,All Students,2018-19,13163,1265,11898,90.4,81,29,35.8
2,All Students,2019-20,7558,835,6723,89.0,73,31,42.5
2,All Students,2020-21,8147,1838,6309,77.4,50,36,72.0
2,All Students,2021-22,7280,1332,5948,81.7,47,33,70.2
2,All Students,2022-23,9668,1452,8216,85.0,60,33,55.0
3,All Students,2018-19,9786,901,8885,90.8,58,16,27.6
3,All Students,2019-20,8018,616,7402,92.3,74,20,27.0
3,All Students,2020-21,11454,2389,9065,79.1,66,41,62.1
3,All Students,2021-22,7892,1113,6779,85.9,47,29,61.7
3,All Students,2022-23,7927,1051,6876,86.7,50,25,50.0
4,All Students,2018-19,10649,980,9669,90.8,64,26,40.6
4,All Students,2019-20,6627,442,6185,93.3,59,12,20.3
4,All Students,2020-21,11340,1643,9697,85.5,67,32,47.8
4,All Students,2021-22,9039,1281,7758,85.8,55,30,54.5
4,All Students,2022-23,8654,1012,7642,88.3,53,26,49.1
5,All Students,2018-19,11130,1175,9955,89.4,67,31,46.3
5,All Students,2019-20,6469,527,5942,91.9,59,21,35.6
5,All Students,2020-21,9197,1519,7678,83.5,54,30,55.6
5,All Students,2021-22,10170,1218,8952,88.0,60,23,38.3
5,All Students,2022-23,9259,956,8303,89.7,53,21,39.6
All Grades,All Students,2018-19,120277,7574,112703,93.7,691,128,18.5
All Grades,All Students,2019-20,76216,5063,71153,93.4,686,147,21.4
All Grades,All Students,2020-21,112068,5405,106663,95.2,651,84,12.9
All Grades,All Students,2021-22,116206,9939,106267,91.4,683,210,30.7
All Grades,All Students,2022-23,117846,9701,108145,91.8,691,219,31.7
PK in K-12 Schools,All Students,2018-19,9475,910,8565,90.4,54,22,40.7
PK in K-12 Schools,All Students,2019-20,7442,745,6697,90.0,69,27,39.1
PK in K-12 Schools,All Students,2020-21,10523,762,9761,92.8,63,14,22.2
PK in K-12 Schools,All Students,2021-22,11849,1737,10112,85.3,72,48,66.7
PK in K-12 Schools,All Students,2022-23,11939,1502,10437,87.4,69,37,53.6
0K,All Students,2018-19,17031,1465,15566,91.4,99,36,36.4
0K,All Students,2019-20,11239,839,10400,92.5,100,25,25.0
0K,All Students,2020-21,16437,750,15687,95.4,95,10,10.5
0K,All Students,2021-22,15898,1372,14526,91.4,96,29,30.2
0K,All Students,2022-23,16742,1661,15081,90.1,101,43,42.6
1,All Students,2018-19,18710,1160,17550,93.8,108,17,15.7
1,All Students,2019-20,10739,782,9957,92.7,98,26,26.5
1,All Students,2020-21,17028,982,16046,94.2,99,15,15.2
1,All Students,2021-22,17081,1282,15799,92.5,99,27,27.3
1,All Students,2022-23,16106,1224,14882,92.4,96,30,31.3
2,All Students,2018-19,19578,1057,18521,94.6,112,12,10.7
2,All Students,2019-20,11362,588,10774,94.8,101,12,11.9
2,All Students,2020-21,15300,925,14375,94.0,88,16,18.2
2,All Students,2021-22,17947,1586,16361,91.2,106,33,31.1
2,All Students,2022-23,18674,1315,17359,93.0,108,26,24.1
3,All Students,2018-19,17695,941,16754,94.7,104,13,12.5
3,All Students,2019-20,12624,708,11916,94.4,112,15,13.4
3,All Students,2020-21,17435,676,16759,96.1,100,10,10.0
3,All Students,2021-22,14808,1174,13634,92.1,86,25,29.1
3,All Students,2022-23,18086,1401,16685,92.3,106,33,31.1
4,All Students,2018-19,17779,1024,16755,94.2,101,16,15.8
4,All Students,2019-20,11430,684,10746,94.0,101,18,17.8
4,All Students,2020-21,18240,539,17701,97.0,107,6,5.6
4,All Students,2021-22,19853,1505,18348,92.4,116,28,24.1
4,All Students,2022-23,14855,1012,13843,93.2,87,21,24.1
5,All Students,2018-19,20009,1017,18992,94.9,113,12,10.6
5,All Students,2019-20,11380,717,10663,93.7,105,24,22.9
5,All Students,2020-21,17105,771,16334,95.5,99,13,13.1
5,All Students,2021-22,18770,1283,17487,93.2,108,20,18.5
5,All Students,2022-23,21444,1586,19858,92.6,124,29,23.4
All Grades,All Students,2018-19,188520,12499,176021,93.4,1073,209,19.5
All Grades,All Students,2019-20,118632,7800,110832,93.4,1051,191,18.2
All Grades,All Students,2020-21,175903,6581,169322,96.3,1016,94,9.3
All Grades,All Students,2021-22,175465,15685,159780,91.1,1014,345,34.0
All Grades,All Students,2022-23,187154,15476,171678,91.7,1075,330,30.7
6,All Students,2018-19,62774,3570,59204,94.3,357,47,13.2
6,All Students,2019-20,36607,2279,34328,93.8,325,58,17.8
6,All Students,2020-21,60788,1772,59016,97.1,351,19,5.4
6,All Students,2021-22,57573,4283,53290,92.6,333,84,25.2
6,All Students,2022-23,64206,4331,59875,93.3,368,70,19.0
7,All Students,2018-19,64640,4018,60622,93.8,369,71,19.2
7,All Students,2019-20,40036,2637,37399,93.4,357,67,18.8
7,All Students,2020-21,55461,2701,52760,95.1,322,46,14.3
7,All Students,2021-22,62453,5295,57158,91.5,360,115,31.9
7,All Students,2022-23,59375,4511,54864,92.4,345,96,27.8
8,All Students,2018-19,61106,4911,56195,92.0,347,91,26.2
8,All Students,2019-20,41989,2884,39105,93.1,369,66,17.9
8,All Students,2020-21,59654,2108,57546,96.5,343,29,8.5
8,All Students,2021-22,55439,6107,49332,89.0,321,146,45.5
8,All Students,2022-23,63573,6634,56939,89.6,362,164,45.3
All Grades,All Students,2018-19,72948,3498,69450,95.2,420,43,10.2
All Grades,All Students,2019-20,48536,2472,46064,94.9,430,41,9.5
All Grades,All Students,2020-21,73876,2985,70891,96.0,435,41,9.4
All Grades,All Students,2021-22,68034,5047,62987,92.6,393,88,22.4
All Grades,All Students,2022-23,66840,4237,62603,93.7,388,70,18.0
0K,All Students,2018-19,13303,721,12582,94.6,77,9,11.7
0K,All Students,2019-20,5764,331,5433,94.3,51,6,11.8
0K,All Students,2020-21,12759,603,12156,95.3,74,8,10.8
0K,All Students,2021-22,8854,764,8090,91.4,51,14,27.5
0K,All Students,2022-23,12718,1062,11656,91.6,73,21,28.8
1,All Students,2018-19,11351,595,10756,94.8,64,6,9.4
1,All Students,2019-20,9463,490,8973,94.8,85,8,9.4
1,All Students,2020-21,10291,440,9851,95.7,62,8,12.9
1,All Students,2021-22,12742,996,11746,92.2,75,21,28.0
1,All Students,2022-23,10611,724,9887,93.2,62,12,19.4
2,All Students,2018-19,14577,733,13844,95.0,86,7,8.1
2,All Students,2019-20,7395,376,7019,94.9,66,8,12.1
2,All Students,2020-21,13500,503,12997,96.3,82,9,11.0
2,All Students,2021-22,9458,687,8771,92.7,55,10,18.2
2,All Students,2022-23,12222,771,11451,93.7,72,13,18.1
3,All Students,2018-19,11216,495,10721,95.6,63,7,11.1
3,All Students,2019-20,9889,489,9400,95.1,87,7,8.0
3,All Students,2020-21,11386,441,10945,96.1,66,6,9.1
3,All Students,2021-22,11564,814,10750,93.0,66,13,19.7
3,All Students,2022-23,9315,479,8836,94.9,54,7,13.0
4,All Students,2018-19,13028,546,12482,95.8,76,9,11.8
4,All Students,2019-20,7311,340,6971,95.3,64,6,9.4
4,All Students,2020-21,14627,669,13958,95.4,86,7,8.1
4,All Students,2021-22,10685,746,9939,93.0,61,11,18.0
4,All Students,2022-23,10935,568,10367,94.8,64,7,10.9
5,All Students,2018-19,9473,408,9065,95.7,54,5,9.3
5,All Students,2019-20,8714,446,8268,94.9,77,6,7.8
5,All Students,2020-21,11313,329,10984,97.1,65,3,4.6
5,All Students,2021-22,14731,1040,13691,92.9,85,19,22.4
5,All Students,2022-23,11039,633,10406,94.3,63,10,15.9
All Grades,All Students,2018-19,153810,7846,145964,94.9,882,104,11.8
All Grades,All Students,2019-20,101519,6540,94979,93.6,894,181,20.2
All Grades,All Students,2020-21,143203,7615,135588,94.7,847,122,14.4
All Grades,All Students,2021-22,144568,11240,133328,92.2,844,225,26.7
All Grades,All Students,2022-23,150911,11458,139453,92.4,877,229,26.1
PK in K-12 Schools,All Students,2018-19,15613,1229,14384,92.1,90,25,27.8
PK in K-12 Schools,All Students,2019-20,11679,1230,10449,89.5,106,55,51.9
PK in K-12 Schools,All Students,2020-21,13600,900,12700,93.4,85,20,23.5
PK in K-12 Schools,All Students,2021-22,16009,1664,14345,89.6,96,39,40.6
PK in K-12 Schools,All Students,2022-23,19867,2026,17841,89.8,118,50,42.4
0K,All Students,2018-19,23071,1361,21710,94.1,133,17,12.8
0K,All Students,2019-20,15276,1201,14075,92.1,134,35,26.1
0K,All Students,2020-21,21486,1303,20183,93.9,127,20,15.7
0K,All Students,2021-22,19947,1751,18196,91.2,118,42,35.6
0K,All Students,2022-23,20914,1968,18946,90.6,122,44,36.1
1,All Students,2018-19,23000,1148,21852,95.0,135,13,9.6
1,All Students,2019-20,14437,925,13512,93.6,128,29,22.7
1,All Students,2020-21,21681,1122,20559,94.8,126,18,14.3
1,All Students,2021-22,22135,1764,20371,92.0,128,39,30.5
1,All Students,2022-23,21616,1628,19988,92.5,125,32,25.6
2,All Students,2018-19,24358,1209,23149,95.0,140,18,12.9
2,All Students,2019-20,14759,813,13946,94.5,129,14,10.9
2,All Students,2020-21,19800,969,18831,95.1,116,14,12.1
2,All Students,2021-22,21940,1670,20270,92.4,127,30,23.6
2,All Students,2022-23,22429,1569,20860,93.0,133,32,24.1
3,All Students,2018-19,23098,971,22127,95.8,132,11,8.3
3,All Students,2019-20,15807,860,14947,94.6,138,18,13.0
3,All Students,2020-21,21509,799,20710,96.3,126,10,7.9
3,All Students,2021-22,20625,1447,19178,93.0,121,28,23.1
3,All Students,2022-23,23554,1663,21891,92.9,135,30,22.2
4,All Students,2018-19,22242,975,21267,95.6,126,13,10.3
4,All Students,2019-20,14957,647,14310,95.7,131,11,8.4
4,All Students,2020-21,23843,1470,22373,93.8,139,25,18.0
4,All Students,2021-22,21035,1434,19601,93.2,121,24,19.8
4,All Students,2022-23,21880,1291,20589,94.1,126,21,16.7
5,All Students,2018-19,22428,953,21475,95.8,126,7,5.6
5,All Students,2019-20,14604,864,13740,94.1,128,19,14.8
5,All Students,2020-21,21284,1052,20232,95.1,128,15,11.7
5,All Students,2021-22,22877,1510,21367,93.4,133,23,17.3
5,All Students,2022-23,20651,1313,19338,93.6,118,20,16.9
All Grades,All Students,2018-19,64123,4051,60072,93.7,393,90,22.9
All Grades,All Students,2019-20,44397,2860,41537,93.6,415,94,22.7
All Grades,All Students,2020-21,68534,6285,62249,90.8,403,112,27.8
All Grades,All Students,2021-22,66099,5726,60373,91.3,395,124,31.4
All Grades,All Students,2022-23,62588,4806,57782,92.3,380,106,27.9
PK in K-12 Schools,All Students,2018-19,5972,604,5368,89.9,35,18,51.4
PK in K-12 Schools,All Students,2019-20,4123,357,3766,91.3,37,14,37.8
PK in K-12 Schools,All Students,2020-21,5570,462,5108,91.7,33,9,27.3
PK in K-12 Schools,All Students,2021-22,5099,994,4105,80.5,33,21,63.6
PK in K-12 Schools,All Students,2022-23,4806,620,4186,87.1,30,18,60.0
0K,All Students,2018-19,11570,839,10731,92.7,68,15,22.1
0K,All Students,2019-20,8096,631,7465,92.2,78,25,32.1
0K,All Students,2020-21,10019,784,9235,92.2,59,14,23.7
0K,All Students,2021-22,10673,1048,9625,90.2,65,30,46.2
0K,All Students,2022-23,9028,839,8189,90.7,59,22,37.3
1,All Students,2018-19,9361,524,8837,94.4,59,12,20.3
1,All Students,2019-20,7566,487,7079,93.6,69,16,23.2
1,All Students,2020-21,12791,1568,11223,87.7,74,27,36.5
1,All Students,2021-22,9984,809,9175,91.9,58,18,31.0
1,All Students,2022-23,9020,740,8280,91.8,54,16,29.6
2,All Students,2018-19,7061,425,6636,94.0,46,11,23.9
2,All Students,2019-20,6070,388,5682,93.6,59,15,25.4
2,All Students,2020-21,11382,1029,10353,91.0,67,21,31.3
2,All Students,2021-22,11754,881,10873,92.5,71,17,23.9
2,All Students,2022-23,10260,714,9546,93.0,60,16,26.7
3,All Students,2018-19,11905,543,11362,95.4,74,8,10.8
3,All Students,2019-20,5177,281,4896,94.6,52,8,15.4
3,All Students,2020-21,9258,880,8378,90.5,54,16,29.6
3,All Students,2021-22,10162,751,9411,92.6,61,15,24.6
3,All Students,2022-23,10957,733,10224,93.3,66,14,21.2
4,All Students,2018-19,7592,453,7139,94.0,47,9,19.1
4,All Students,2019-20,7850,348,7502,95.6,70,6,8.6
4,All Students,2020-21,8469,636,7833,92.5,50,12,24.0
4,All Students,2021-22,8996,590,8406,93.4,52,11,21.2
4,All Students,2022-23,9548,637,8911,93.3,59,12,20.3
5,All Students,2018-19,10662,663,9999,93.8,64,17,26.6
5,All Students,2019-20,5515,368,5147,93.3,50,10,20.0
5,All Students,2020-21,11045,926,10119,91.6,66,13,19.7
5,All Students,2021-22,9431,653,8778,93.1,55,12,21.8
5,All Students,2022-23,8969,523,8446,94.2,52,8,15.4
All Grades,All Students,2018-19,94272,7241,87031,92.3,566,179,31.6
All Grades,All Students,2019-20,59158,4379,54779,92.6,541,149,27.5
All Grades,All Students,2020-21,86337,8340,77997,90.3,515,153,29.7
All Grades,All Students,2021-22,83793,7760,76033,90.7,505,190,37.6
All Grades,All Students,2022-23,84733,8016,76717,90.5,516,196,38.0
0K,All Students,2018-19,14296,1646,12650,88.5,87,41,47.1
0K,All Students,2019-20,9875,845,9030,91.4,93,33,35.5
0K,All Students,2020-21,13699,1401,12298,89.8,80,23,28.8
0K,All Students,2021-22,15809,1892,13917,88.0,99,50,50.5
0K,All Students,2022-23,14765,1652,13113,88.8,94,42,44.7
1,All Students,2018-19,15072,1173,13899,92.2,91,28,30.8
1,All Students,2019-20,8568,794,7774,90.7,79,30,38.0
1,All Students,2020-21,14294,1052,13242,92.6,87,19,21.8
1,All Students,2021-22,12452,1191,11261,90.4,75,33,44.0
1,All Students,2022-23,15573,1629,13944,89.5,95,43,45.3
2,All Students,2018-19,17900,1216,16684,93.2,106,33,31.1
2,All Students,2019-20,9041,604,8437,93.3,84,19,22.6
2,All Students,2020-21,11942,1252,10690,89.5,73,25,34.2
2,All Students,2021-22,14523,1251,13272,91.4,87,27,31.0
2,All Students,2022-23,12455,1112,11343,91.1,74,28,37.8
3,All Students,2018-19,17595,1421,16174,91.9,109,36,33.0
3,All Students,2019-20,11337,674,10663,94.1,101,21,20.8
3,All Students,2020-21,13258,1123,12135,91.5,79,18,22.8
3,All Students,2021-22,11495,1196,10299,89.6,72,31,43.1
3,All Students,2022-23,16356,1441,14915,91.2,101,36,35.6
4,All Students,2018-19,14197,766,13431,94.6,84,18,21.4
4,All Students,2019-20,11507,986,10521,91.4,104,31,29.8
4,All Students,2020-21,16509,1503,15006,90.9,96,30,31.3
4,All Students,2021-22,13752,1084,12668,92.1,80,24,30.0
4,All Students,2022-23,11912,1102,10810,90.7,72,27,37.5
5,All Students,2018-19,15212,1019,14193,93.3,89,23,25.8
5,All Students,2019-20,8830,476,8354,94.6,80,15,18.8
5,All Students,2020-21,16635,2009,14626,87.9,100,38,38.0
5,All Students,2021-22,15762,1146,14616,92.7,92,25,27.2
5,All Students,2022-23,13672,1080,12592,92.1,80,20,25.0
All Grades,All Students,2018-19,125249,7368,117881,94.1,735,136,18.5
All Grades,All Students,2019-20,79319,5018,74301,93.7,721,140,19.4
All Grades,All Students,2020-21,116089,6796,109293,94.1,687,133,19.4
All Grades,All Students,2021-22,115341,10154,105187,91.2,695,231,33.2
All Grades,All Students,2022-23,118531,8955,109576,92.4,723,209,28.9
PK in K-12 Schools,All Students,2018-19,6352,588,5764,90.7,36,13,36.1
PK in K-12 Schools,All Students,2019-20,5792,531,5261,90.8,51,20,39.2
PK in K-12 Schools,All Students,2020-21,8704,855,7849,90.2,52,21,40.4
PK in K-12 Schools,All Students,2021-22,8809,1073,7736,87.8,52,26,50.0
PK in K-12 Schools,All Students,2022-23,8893,936,7957,89.5,54,20,37.0
0K,All Students,2018-19,16619,1167,15452,93.0,102,24,23.5
0K,All Students,2019-20,10793,1043,9750,90.3,101,36,35.6
0K,All Students,2020-21,14809,1028,13781,93.1,90,23,25.6
0K,All Students,2021-22,18847,1958,16889,89.6,114,48,42.1
0K,All Students,2022-23,17604,1641,15963,90.7,112,42,37.5
1,All Students,2018-19,16140,1014,15126,93.7,98,21,21.4
1,All Students,2019-20,12233,799,11434,93.5,114,21,18.4
1,All Students,2020-21,16330,960,15370,94.1,97,19,19.6
1,All Students,2021-22,14728,1280,13448,91.3,93,34,36.6
1,All Students,2022-23,20930,1530,19400,92.7,128,37,28.9
2,All Students,2018-19,20930,1222,19708,94.2,124,25,20.2
2,All Students,2019-20,10725,575,10150,94.6,100,12,12.0
2,All Students,2020-21,17171,777,16394,95.5,101,11,10.9
2,All Students,2021-22,17110,1526,15584,91.1,103,31,30.1
2,All Students,2022-23,15445,1207,14238,92.2,92,23,25.0
3,All Students,2018-19,22103,1218,20885,94.5,127,21,16.5
3,All Students,2019-20,13542,808,12734,94.0,121,21,17.4
3,All Students,2020-21,17027,707,16320,95.8,101,11,10.9
3,All Students,2021-22,17708,1581,16127,91.1,107,39,36.4
3,All Students,2022-23,17647,1230,16417,93.0,109,35,32.1
4,All Students,2018-19,19431,986,18445,94.9,111,18,16.2
4,All Students,2019-20,13824,713,13111,94.8,124,17,13.7
4,All Students,2020-21,21167,1048,20119,95.0,123,20,16.3
4,All Students,2021-22,16924,1151,15773,93.2,104,24,23.1
4,All Students,2022-23,20212,1358,18854,93.3,122,35,28.7
5,All Students,2018-19,23674,1173,22501,95.0,137,14,10.2
5,All Students,2019-20,12410,549,11861,95.6,110,13,11.8
5,All Students,2020-21,20881,1421,19460,93.2,123,28,22.8
5,All Students,2021-22,21215,1585,19630,92.5,122,29,23.8
5,All Students,2022-23,17800,1053,16747,94.1,106,17,16.0
All Grades,All Students,2018-19,188265,10262,178003,94.5,1080,157,14.5
All Grades,All Students,2019-20,125056,6991,118065,94.4,1106,154,13.9
All Grades,All Students,2020-21,182267,13727,168540,92.5,1075,249,23.2
All Grades,All Students,2021-22,177314,12631,164683,92.9,1034,248,24.0
All Grades,All Students,2022-23,180367,13017,167350,92.8,1039,257,24.7
PK in K-12 Schools,All Students,2018-19,9491,614,8877,93.5,54,10,18.5
PK in K-12 Schools,All Students,2019-20,6127,383,5744,93.7,54,9,16.7
PK in K-12 Schools,All Students,2020-21,9215,584,8631,93.7,59,10,16.9
PK in K-12 Schools,All Students,2021-22,9178,915,8263,90.0,55,24,43.6
PK in K-12 Schools,All Students,2022-23,9558,962,8596,89.9,54,26,48.1
0K,All Students,2018-19,25938,1531,24407,94.1,150,25,16.7
0K,All Students,2019-20,17892,1093,16799,93.9,157,22,14.0
0K,All Students,2020-21,24115,1580,22535,93.4,145,31,21.4
0K,All Students,2021-22,28483,2278,26205,92.0,168,45,26.8
0K,All Students,2022-23,25642,2385,23257,90.7,150,55,36.7
1,All Students,2018-19,29488,1685,27803,94.3,170,24,14.1
1,All Students,2019-20,16912,1058,15854,93.7,152,28,18.4
1,All Students,2020-21,26943,1985,24958,92.6,158,29,18.4
1,All Students,2021-22,24288,1825,22463,92.5,145,35,24.1
1,All Students,2022-23,29366,2086,27280,92.9,167,41,24.6
2,All Students,2018-19,30329,1632,28697,94.6,174,24,13.8
2,All Students,2019-20,19896,1110,18786,94.4,179,27,15.1
2,All Students,2020-21,26940,1918,25022,92.9,157,34,21.7
2,All Students,2021-22,26871,1917,24954,92.9,156,36,23.1
2,All Students,2022-23,24900,1840,23060,92.6,146,35,24.0
3,All Students,2018-19,34726,2033,32693,94.1,200,30,15.0
3,All Students,2019-20,20685,1110,19575,94.6,181,25,13.8
3,All Students,2020-21,29534,2460,27074,91.7,174,47,27.0
3,All Students,2021-22,27288,1648,25640,94.0,159,26,16.4
3,All Students,2022-23,29893,1800,28093,94.0,171,30,17.5
4,All Students,2018-19,31140,1343,29797,95.7,178,17,9.6
4,All Students,2019-20,22945,1242,21703,94.6,203,25,12.3
4,All Students,2020-21,30925,2015,28910,93.5,181,34,18.8
4,All Students,2021-22,29319,2029,27290,93.1,168,41,24.4
4,All Students,2022-23,29443,1773,27670,94.0,170,25,14.7
5,All Students,2018-19,27153,1424,25729,94.8,154,27,17.5
5,All Students,2019-20,20599,995,19604,95.2,180,18,10.0
5,All Students,2020-21,34595,3185,31410,90.8,201,64,31.8
5,All Students,2021-22,31887,2019,29868,93.7,183,41,22.4
5,All Students,2022-23,31565,2171,29394,93.1,181,45,24.9
All Grades,All Students,2018-19,137773,15169,122604,89.0,848,384,45.3
All Grades,All Students,2019-20,80972,9226,71746,88.6,776,345,44.5
All Grades,All Students,2020-21,113194,19923,93271,82.4,690,389,56.4
All Grades,All Students,2021-22,106096,19315,86781,81.8,651,448,68.8
All Grades,All Students,2022-23,99795,16669,83126,83.3,622,403,64.8
PK in K-12 Schools,All Students,2018-19,12056,s,s,s,s,s,s
PK in K-12 Schools,All Students,2019-20,8374,1384,6990,83.5,84,46,54.8
PK in K-12 Schools,All Students,2020-21,11243,2084,9159,81.5,71,49,69.0
PK in K-12 Schools,All Students,2021-22,12493,2708,9785,78.3,85,69,81.2
PK in K-12 Schools,All Students,2022-23,13257,3008,10249,77.3,85,69,81.2
0K,All Students,2018-19,18369,2419,15950,86.8,114,59,51.8
0K,All Students,2019-20,11371,1542,9829,86.4,109,57,52.3
0K,All Students,2020-21,14875,3408,11467,77.1,97,65,67.0
0K,All Students,2021-22,12489,2421,10068,80.6,77,57,74.0
0K,All Students,2022-23,14403,2480,11923,82.8,92,67,72.8
1,All Students,2018-19,21736,2594,19142,88.1,137,74,54.0
1,All Students,2019-20,10818,1346,9472,87.6,109,58,53.2
1,All Students,2020-21,15836,2779,13057,82.5,96,49,51.0
1,All Students,2021-22,16492,3196,13296,80.6,98,68,69.4
1,All Students,2022-23,11243,1980,9263,82.4,73,47,64.4
2,All Students,2018-19,22041,2149,19892,90.2,133,57,42.9
2,All Students,2019-20,12459,1271,11188,89.8,116,43,37.1
2,All Students,2020-21,14988,3034,11954,79.8,93,58,62.4
2,All Students,2021-22,16434,3017,13417,81.6,104,69,66.3
2,All Students,2022-23,16517,2616,13901,84.2,105,63,60.0
3,All Students,2018-19,21060,2100,18960,90.0,127,48,37.8
3,All Students,2019-20,12403,1103,11300,91.1,119,40,33.6
3,All Students,2020-21,17699,2787,14912,84.3,106,57,53.8
3,All Students,2021-22,14491,2593,11898,82.1,89,65,73.0
3,All Students,2022-23,16115,2680,13435,83.4,99,65,65.7
4,All Students,2018-19,21165,2072,19093,90.2,131,51,38.9
4,All Students,2019-20,12945,1386,11559,89.3,124,55,44.4
4,All Students,2020-21,19477,2715,16762,86.1,114,52,45.6
4,All Students,2021-22,15898,2694,13204,83.1,93,59,63.4
4,All Students,2022-23,14486,2062,12424,85.8,86,49,57.0
5,All Students,2018-19,21255,2105,19150,90.1,128,52,40.6
5,All Students,2019-20,12602,1194,11408,90.5,115,46,40.0
5,All Students,2020-21,19076,3116,15960,83.7,113,59,52.2
5,All Students,2021-22,17799,2686,15113,84.9,105,61,58.1
5,All Students,2022-23,13774,1843,11931,86.6,82,43,52.4
6,All Students,2018-19,91,s,s,s,s,s,s
All Grades,All Students,2018-19,152551,10694,141857,93.0,906,227,25.1
All Grades,All Students,2019-20,97136,6769,90367,93.0,881,210,23.8
All Grades,All Students,2020-21,145149,13999,131150,90.4,864,236,27.3
All Grades,All Students,2021-22,145004,16039,128965,88.9,861,347,40.3
All Grades,All Students,2022-23,141027,13820,127207,90.2,841,308,36.6
PK in K-12 Schools,All Students,2018-19,6354,462,5892,92.7,36,8,22.2
PK in K-12 Schools,All Students,2019-20,4024,420,3604,89.6,36,16,44.4
PK in K-12 Schools,All Students,2020-21,5998,s,s,s,s,s,s
PK in K-12 Schools,All Students,2021-22,6019,907,5112,84.9,35,18,51.4
PK in K-12 Schools,All Students,2022-23,6214,654,5560,89.5,36,16,44.4
0K,All Students,2018-19,24882,2259,22623,90.9,147,53,36.1
0K,All Students,2019-20,14768,1262,13506,91.5,134,39,29.1
0K,All Students,2020-21,21906,2132,19774,90.3,133,44,33.1
0K,All Students,2021-22,20997,2416,18581,88.5,127,60,47.2
0K,All Students,2022-23,20500,2451,18049,88.0,125,55,44.0
1,All Students,2018-19,26893,1817,25076,93.2,162,40,24.7
1,All Students,2019-20,15227,1153,14074,92.4,140,40,28.6
1,All Students,2020-21,23764,2380,21384,90.0,143,35,24.5
1,All Students,2021-22,23275,2741,20534,88.2,136,65,47.8
1,All Students,2022-23,21615,1964,19651,90.9,128,47,36.7
2,All Students,2018-19,24297,1598,22699,93.4,146,35,24.0
2,All Students,2019-20,17322,1122,16200,93.5,159,37,23.3
2,All Students,2020-21,22312,2512,19800,88.7,131,40,30.5
2,All Students,2021-22,22948,2587,20361,88.7,136,58,42.6
2,All Students,2022-23,24662,2718,21944,89.0,147,64,43.5
3,All Students,2018-19,23656,1549,22107,93.5,143,37,25.9
3,All Students,2019-20,15248,906,14342,94.1,136,24,17.6
3,All Students,2020-21,26036,2115,23921,91.9,154,30,19.5
3,All Students,2021-22,21893,2417,19476,89.0,132,49,37.1
3,All Students,2022-23,23532,2290,21242,90.3,140,47,33.6
4,All Students,2018-19,23979,1537,22442,93.6,140,26,18.6
4,All Students,2019-20,15634,1064,14570,93.2,140,28,20.0
4,All Students,2020-21,22685,2046,20639,91.0,134,35,26.1
4,All Students,2021-22,26209,2541,23668,90.3,156,50,32.1
4,All Students,2022-23,19196,1646,17550,91.4,116,34,29.3
5,All Students,2018-19,22490,1472,21018,93.5,132,28,21.2
5,All Students,2019-20,14913,842,14071,94.4,136,26,19.1
5,All Students,2020-21,22445,1762,20683,92.1,133,35,26.3
5,All Students,2021-22,23663,2430,21233,89.7,139,47,33.8
5,All Students,2022-23,25308,2097,23211,91.7,149,45,30.2
6,All Students,2020-21,3,s,s,s,s,s,s
All Grades,All Students,2018-19,43788,3544,40244,91.9,269,79,29.4
All Grades,All Students,2019-20,29030,2396,26634,91.7,265,77,29.1
All Grades,All Students,2020-21,41680,5993,35687,85.6,250,117,46.8
All Grades,All Students,2021-22,36226,4945,31281,86.3,234,119,50.9
All Grades,All Students,2022-23,33840,4369,29471,87.1,211,100,47.4
PK in K-12 Schools,All Students,2018-19,3179,256,2923,91.9,19,7,36.8
PK in K-12 Schools,All Students,2019-20,3595,353,3242,90.2,34,15,44.1
PK in K-12 Schools,All Students,2020-21,4647,903,3744,80.6,30,22,73.3
PK in K-12 Schools,All Students,2021-22,4733,973,3760,79.4,30,21,70.0
PK in K-12 Schools,All Students,2022-23,5307,984,4323,81.5,37,26,70.3
0K,All Students,2018-19,5611,477,5134,91.5,37,11,29.7
0K,All Students,2019-20,5209,523,4686,90.0,48,17,35.4
0K,All Students,2020-21,6509,1104,5405,83.0,39,22,56.4
0K,All Students,2021-22,4104,773,3331,81.2,29,20,69.0
0K,All Students,2022-23,4012,563,3449,86.0,26,15,57.7
1,All Students,2018-19,6447,682,5765,89.4,38,15,39.5
1,All Students,2019-20,3452,244,3208,92.9,32,7,21.9
1,All Students,2020-21,7454,1088,6366,85.4,44,19,43.2
1,All Students,2021-22,4789,721,4068,84.9,31,16,51.6
1,All Students,2022-23,3618,378,3240,89.6,22,8,36.4
2,All Students,2018-19,5853,359,5494,93.9,39,9,23.1
2,All Students,2019-20,4064,373,3691,90.8,36,11,30.6
2,All Students,2020-21,5503,603,4900,89.0,32,11,34.4
2,All Students,2021-22,6352,690,5662,89.1,40,19,47.5
2,All Students,2022-23,4085,603,3482,85.2,25,12,48.0
3,All Students,2018-19,6823,630,6193,90.8,41,15,36.6
3,All Students,2019-20,3609,195,3414,94.6,32,4,12.5
3,All Students,2020-21,5793,796,4997,86.3,35,12,34.3
3,All Students,2021-22,6010,838,5172,86.1,38,16,42.1
3,All Students,2022-23,5411,609,4802,88.7,33,13,39.4
4,All Students,2018-19,6906,433,6473,93.7,40,7,17.5
4,All Students,2019-20,4605,380,4225,91.7,42,15,35.7
4,All Students,2020-21,5124,537,4587,89.5,32,12,37.5
4,All Students,2021-22,5148,558,4590,89.2,33,16,48.5
4,All Students,2022-23,5800,629,5171,89.2,35,15,42.9
5,All Students,2018-19,8969,707,8262,92.1,55,15,27.3
5,All Students,2019-20,4496,328,4168,92.7,41,8,19.5
5,All Students,2020-21,6650,962,5688,85.5,38,19,50.0
5,All Students,2021-22,5090,392,4698,92.3,33,11,33.3
5,All Students,2022-23,5607,603,5004,89.2,33,11,33.3
All Grades,All Students,2018-19,82105,4022,78083,95.1,497,73,14.7
All Grades,All Students,2019-20,53542,2562,50980,95.2,497,59,11.9
All Grades,All Students,2020-21,85356,4323,81033,94.9,511,75,14.7
All Grades,All Students,2021-22,88585,6483,82102,92.7,530,123,23.2
All Grades,All Students,2022-23,83064,5707,77357,93.1,514,104,20.2
9,All Students,2018-19,21886,705,21181,96.8,133,7,5.3
9,All Students,2019-20,10521,565,9956,94.6,102,14,13.7
9,All Students,2020-21,24985,1603,23382,93.6,150,29,19.3
9,All Students,2021-22,27489,1909,25580,93.1,165,34,20.6
9,All Students,2022-23,20762,1198,19564,94.2,131,22,16.8
10,All Students,2018-19,21897,884,21013,96.0,133,13,9.8
10,All Students,2019-20,15111,555,14556,96.3,139,7,5.0
10,All Students,2020-21,16287,777,15510,95.2,98,15,15.3
10,All Students,2021-22,24018,1733,22285,92.8,145,34,23.4
10,All Students,2022-23,25967,1593,24374,93.9,161,27,16.8
11,All Students,2018-19,20782,1069,19713,94.9,125,18,14.4
11,All Students,2019-20,14146,574,13572,95.9,130,11,8.5
11,All Students,2020-21,22776,848,21928,96.3,136,14,10.3
11,All Students,2021-22,14978,1091,13887,92.7,90,22,24.4
11,All Students,2022-23,22620,1703,20917,92.5,138,30,21.7
12,All Students,2018-19,17540,1364,16176,92.2,106,35,33.0
12,All Students,2019-20,13764,868,12896,93.7,126,27,21.4
12,All Students,2020-21,21308,1095,20213,94.9,127,17,13.4
12,All Students,2021-22,22100,1750,20350,92.1,130,33,25.4
12,All Students,2022-23,13715,1213,12502,91.2,84,25,29.8
All Grades,All Students,2018-19,178585,8851,169734,95.0,1014,121,11.9
All Grades,All Students,2019-20,115206,5901,109305,94.9,1013,122,12.0
All Grades,All Students,2020-21,169439,10288,159151,93.9,993,186,18.7
All Grades,All Students,2021-22,168007,12973,155034,92.3,981,241,24.6
All Grades,All Students,2022-23,174910,11343,163567,93.5,1006,189,18.8
PK in K-12 Schools,All Students,2018-19,3186,262,2924,91.8,18,7,38.9
PK in K-12 Schools,All Students,2019-20,2032,113,1919,94.4,19,3,15.8
PK in K-12 Schools,All Students,2020-21,3146,213,2933,93.2,19,4,21.1
PK in K-12 Schools,All Students,2021-22,3168,306,2862,90.3,18,5,27.8
PK in K-12 Schools,All Students,2022-23,3135,314,2821,90.0,19,10,52.6
0K,All Students,2018-19,18898,1148,17750,93.9,107,19,17.8
0K,All Students,2019-20,11590,812,10778,93.0,103,22,21.4
0K,All Students,2020-21,17422,990,16432,94.3,104,23,22.1
0K,All Students,2021-22,16971,1645,15326,90.3,99,35,35.4
0K,All Students,2022-23,15566,1111,14455,92.9,90,17,18.9
1,All Students,2018-19,17482,871,16611,95.0,99,10,10.1
1,All Students,2019-20,12305,715,11590,94.2,107,17,15.9
1,All Students,2020-21,17527,939,16588,94.6,106,18,17.0
1,All Students,2021-22,19222,1380,17842,92.8,114,22,19.3
1,All Students,2022-23,17535,1400,16135,92.0,99,26,26.3
2,All Students,2018-19,21806,1271,20535,94.2,125,19,15.2
2,All Students,2019-20,11572,475,11097,95.9,102,7,6.9
2,All Students,2020-21,17753,1575,16178,91.1,104,28,26.9
2,All Students,2021-22,17459,1349,16110,92.3,102,25,24.5
2,All Students,2022-23,19591,1139,18452,94.2,114,16,14.0
3,All Students,2018-19,22280,1036,21244,95.4,127,13,10.2
3,All Students,2019-20,14192,751,13441,94.7,125,13,10.4
3,All Students,2020-21,17704,466,17238,97.4,105,5,4.8
3,All Students,2021-22,18649,1223,17426,93.4,106,16,15.1
3,All Students,2022-23,17862,993,16869,94.4,103,12,11.7
4,All Students,2018-19,18023,769,17254,95.7,102,8,7.8
4,All Students,2019-20,14768,711,14057,95.2,129,17,13.2
4,All Students,2020-21,20400,936,19464,95.4,118,10,8.5
4,All Students,2021-22,18003,1258,16745,93.0,106,22,20.8
4,All Students,2022-23,18782,1091,17691,94.2,107,19,17.8
5,All Students,2018-19,19108,847,18261,95.6,108,9,8.3
5,All Students,2019-20,11678,523,11155,95.5,103,6,5.8
5,All Students,2020-21,22832,2018,20814,91.2,135,43,31.9
5,All Students,2021-22,19409,1702,17707,91.2,113,36,31.9
5,All Students,2022-23,18420,893,17527,95.2,104,12,11.5
6,All Students,2018-19,18575,925,17650,95.0,105,13,12.4
6,All Students,2019-20,11004,504,10500,95.4,97,9,9.3
6,All Students,2020-21,17838,1031,16807,94.2,102,18,17.6
6,All Students,2021-22,21791,1613,20178,92.6,129,31,24.0
6,All Students,2022-23,23374,1656,21718,92.9,135,26,19.3
7,All Students,2018-19,22614,741,21873,96.7,128,11,8.6
7,All Students,2019-20,11996,597,11399,95.0,105,14,13.3
7,All Students,2020-21,16617,1206,15411,92.7,96,20,20.8
7,All Students,2021-22,17475,1178,16297,93.3,102,20,19.6
7,All Students,2022-23,22453,1477,20976,93.4,132,27,20.5
8,All Students,2018-19,16613,981,15632,94.1,95,12,12.6
8,All Students,2019-20,14069,700,13369,95.0,123,14,11.4
8,All Students,2020-21,18200,914,17286,95.0,104,17,16.3
8,All Students,2021-22,15860,1319,14541,91.7,92,29,31.5
8,All Students,2022-23,18192,1269,16923,93.0,103,24,23.3
All Grades,All Students,2018-19,94701,8450,86251,91.1,583,199,34.1
All Grades,All Students,2019-20,63972,6344,57628,90.1,596,217,36.4
All Grades,All Students,2020-21,109915,28038,81877,74.5,644,412,64.0
All Grades,All Students,2021-22,102228,16544,85684,83.8,655,396,60.5
All Grades,All Students,2022-23,87912,12106,75806,86.2,565,271,48.0
5,All Students,2019-20,43,s,s,s,s,s,s
6,All Students,2018-19,29130,2464,26666,91.5,182,62,34.1
6,All Students,2019-20,24506,2269,22237,90.7,228,82,36.0
6,All Students,2020-21,42599,10216,32383,76.0,250,166,66.4
6,All Students,2021-22,33752,6001,27751,82.2,223,139,62.3
6,All Students,2022-23,25510,3564,21946,86.0,164,80,48.8
7,All Students,2018-19,28354,s,s,s,s,s,s
7,All Students,2019-20,19382,s,s,s,s,s,s
7,All Students,2020-21,37635,10000,27635,73.4,220,136,61.8
7,All Students,2021-22,35151,5218,29933,85.2,226,135,59.7
7,All Students,2022-23,30901,4522,26379,85.4,202,103,51.0
8,All Students,2018-19,37214,3417,33797,90.8,224,72,32.1
8,All Students,2019-20,20041,2099,17942,89.5,187,65,34.8
8,All Students,2020-21,29680,s,s,s,s,s,s
8,All Students,2021-22,33311,s,s,s,s,s,s
8,All Students,2022-23,31501,4020,27481,87.2,199,88,44.2
9,All Students,2018-19,3,s,s,s,s,s,s
9,All Students,2020-21,1,s,s,s,s,s,s
9,All Students,2021-22,14,s,s,s,s,s,s
All Grades,All Students,2018-19,128502,7396,121106,94.2,739,131,17.7
All Grades,All Students,2019-20,82892,4804,78088,94.2,745,121,16.2
All Grades,All Students,2020-21,124799,4478,120321,96.4,733,83,11.3
All Grades,All Students,2021-22,125576,9288,116288,92.6,744,203,27.3
All Grades,All Students,2022-23,132209,9842,122367,92.6,766,190,24.8
PK in K-12 Schools,All Students,2018-19,6343,538,5805,91.5,36,12,33.3
PK in K-12 Schools,All Students,2019-20,5471,486,4985,91.1,53,22,41.5
PK in K-12 Schools,All Students,2020-21,8909,581,8328,93.5,59,14,23.7
PK in K-12 Schools,All Students,2021-22,9266,1321,7945,85.7,55,38,69.1
PK in K-12 Schools,All Students,2022-23,9626,1249,8377,87.0,58,33,56.9
0K,All Students,2018-19,16373,1057,15316,93.5,95,17,17.9
0K,All Students,2019-20,13179,872,12307,93.4,119,25,21.0
0K,All Students,2020-21,19860,584,19276,97.1,118,12,10.2
0K,All Students,2021-22,18436,1589,16847,91.4,112,34,30.4
0K,All Students,2022-23,17485,1642,15843,90.6,101,30,29.7
1,All Students,2018-19,21555,1134,20421,94.7,126,18,14.3
1,All Students,2019-20,10457,621,9836,94.1,93,13,14.0
1,All Students,2020-21,20090,830,19260,95.9,116,10,8.6
1,All Students,2021-22,22251,1674,20577,92.5,133,34,25.6
1,All Students,2022-23,21136,1731,19405,91.8,124,35,28.2
2,All Students,2018-19,17788,1077,16711,93.9,102,16,15.7
2,All Students,2019-20,14429,752,13677,94.8,130,18,13.8
2,All Students,2020-21,16019,383,15636,97.6,93,5,5.4
2,All Students,2021-22,20384,1312,19072,93.6,119,25,21.0
2,All Students,2022-23,23927,1625,22302,93.2,137,26,19.0
3,All Students,2018-19,20625,1129,19496,94.5,119,20,16.8
3,All Students,2019-20,11643,581,11062,95.0,103,15,14.6
3,All Students,2020-21,21706,712,20994,96.7,125,12,9.6
3,All Students,2021-22,16335,999,15336,93.9,99,21,21.2
3,All Students,2022-23,20127,1136,18991,94.4,116,21,18.1
4,All Students,2018-19,21993,1316,20677,94.0,126,25,19.8
4,All Students,2019-20,13326,673,12653,94.9,119,12,10.1
4,All Students,2020-21,17284,459,16825,97.3,102,10,9.8
4,All Students,2021-22,21007,1299,19708,93.8,121,28,23.1
4,All Students,2022-23,17135,1021,16114,94.0,99,17,17.2
5,All Students,2018-19,23825,1145,22680,95.2,135,23,17.0
5,All Students,2019-20,14387,819,13568,94.3,128,16,12.5
5,All Students,2020-21,20931,929,20002,95.6,120,20,16.7
5,All Students,2021-22,17897,1094,16803,93.9,105,23,21.9
5,All Students,2022-23,22773,1438,21335,93.7,131,28,21.4
All Grades,All Students,2018-19,238121,23112,215009,90.3,1418,478,33.7
All Grades,All Students,2019-20,151574,13846,137728,90.9,1375,412,30.0
All Grades,All Students,2020-21,242334,44826,197508,81.5,1416,753,53.2
All Grades,All Students,2021-22,237105,36265,200840,84.7,1420,746,52.5
All Grades,All Students,2022-23,217070,28199,188871,87.0,1329,604,45.4
6,All Students,2018-19,78963,6784,72179,91.4,474,135,28.5
6,All Students,2019-20,52390,4267,48123,91.9,474,127,26.8
6,All Students,2020-21,81735,15407,66328,81.2,479,261,54.5
6,All Students,2021-22,73906,11532,62374,84.4,449,240,53.5
6,All Students,2022-23,66247,7617,58630,88.5,406,163,40.1
7,All Students,2018-19,74358,6654,67704,91.1,445,152,34.2
7,All Students,2019-20,51314,4759,46555,90.7,470,137,29.1
7,All Students,2020-21,79696,14094,65602,82.3,468,228,48.7
7,All Students,2021-22,82303,12741,69562,84.5,494,248,50.2
7,All Students,2022-23,72196,9705,62491,86.6,444,211,47.5
8,All Students,2018-19,84800,9674,75126,88.6,499,191,38.3
8,All Students,2019-20,47870,4820,43050,89.9,431,148,34.3
8,All Students,2020-21,80903,15325,65578,81.1,469,264,56.3
8,All Students,2021-22,80869,11966,68903,85.2,477,258,54.1
8,All Students,2022-23,78627,10877,67750,86.2,479,230,48.0
9,All Students,2021-22,5,s,s,s,s,s,s
10,All Students,2021-22,22,s,s,s,s,s,s
All Grades,All Students,2018-19,103842,5679,98163,94.5,620,104,16.8
All Grades,All Students,2019-20,68300,3975,64325,94.2,613,116,18.9
All Grades,All Students,2020-21,103357,4259,99098,95.9,610,71,11.6
All Grades,All Students,2021-22,106513,7538,98975,92.9,639,158,24.7
All Grades,All Students,2022-23,107766,8598,99168,92.0,632,173,27.4
PK in K-12 Schools,All Students,2018-19,11626,910,10716,92.2,74,23,31.1
PK in K-12 Schools,All Students,2019-20,7978,775,7203,90.3,71,31,43.7
PK in K-12 Schools,All Students,2020-21,11636,688,10948,94.1,70,16,22.9
PK in K-12 Schools,All Students,2021-22,10470,1083,9387,89.7,65,32,49.2
PK in K-12 Schools,All Students,2022-23,10909,1459,9450,86.6,64,42,65.6
0K,All Students,2018-19,17230,1081,16149,93.7,101,20,19.8
0K,All Students,2019-20,10653,693,9960,93.5,96,21,21.9
0K,All Students,2020-21,16077,737,15340,95.4,95,13,13.7
0K,All Students,2021-22,18090,1426,16664,92.1,108,27,25.0
0K,All Students,2022-23,14956,1574,13382,89.5,91,36,39.6
1,All Students,2018-19,18013,931,17082,94.8,105,19,18.1
1,All Students,2019-20,11502,639,10863,94.4,103,17,16.5
1,All Students,2020-21,16031,606,15425,96.2,94,6,6.4
1,All Students,2021-22,15567,1160,14407,92.5,95,23,24.2
1,All Students,2022-23,19124,1429,17695,92.5,111,25,22.5
2,All Students,2018-19,13707,677,13030,95.1,84,10,11.9
2,All Students,2019-20,10940,556,10384,94.9,99,12,12.1
2,All Students,2020-21,17458,797,16661,95.4,102,16,15.7
2,All Students,2021-22,15536,1023,14513,93.4,93,16,17.2
2,All Students,2022-23,15438,1034,14404,93.3,91,20,22.0
3,All Students,2018-19,14475,722,13753,95.0,84,9,10.7
3,All Students,2019-20,9520,506,9014,94.7,84,13,15.5
3,All Students,2020-21,15123,513,14610,96.6,90,6,6.7
3,All Students,2021-22,16528,976,15552,94.1,97,19,19.6
3,All Students,2022-23,15226,958,14268,93.7,88,15,17.0
4,All Students,2018-19,14883,630,14253,95.8,90,10,11.1
4,All Students,2019-20,8305,398,7907,95.2,75,10,13.3
4,All Students,2020-21,14690,428,14262,97.1,87,6,6.9
4,All Students,2021-22,16043,1071,14972,93.3,96,23,24.0
4,All Students,2022-23,17311,1122,16189,93.5,101,21,20.8
5,All Students,2018-19,13908,728,13180,94.8,82,13,15.9
5,All Students,2019-20,9402,408,8994,95.7,85,12,14.1
5,All Students,2020-21,12342,490,11852,96.0,72,8,11.1
5,All Students,2021-22,14279,799,13480,94.4,85,18,21.2
5,All Students,2022-23,14802,1022,13780,93.1,86,14,16.3
All Grades,All Students,2018-19,148683,8402,140281,94.3,862,135,15.7
All Grades,All Students,2019-20,97869,5582,92287,94.3,876,151,17.2
All Grades,All Students,2020-21,141381,5036,136345,96.4,835,72,8.6
All Grades,All Students,2021-22,141330,10378,130952,92.7,834,205,24.6
All Grades,All Students,2022-23,141989,9928,132061,93.0,835,195,23.4
PK in K-12 Schools,All Students,2018-19,15628,1483,14145,90.5,92,39,42.4
PK in K-12 Schools,All Students,2019-20,10004,917,9087,90.8,92,35,38.0
PK in K-12 Schools,All Students,2020-21,12501,762,11739,93.9,79,16,20.3
PK in K-12 Schools,All Students,2021-22,13236,1443,11793,89.1,82,35,42.7
PK in K-12 Schools,All Students,2022-23,14678,1377,13301,90.6,87,32,36.8
0K,All Students,2018-19,20019,1281,18738,93.6,118,17,14.4
0K,All Students,2019-20,14843,971,13872,93.5,134,31,23.1
0K,All Students,2020-21,19226,786,18440,95.9,113,14,12.4
0K,All Students,2021-22,18588,1690,16898,90.9,113,35,31.0
0K,All Students,2022-23,19296,1567,17729,91.9,115,34,29.6
1,All Students,2018-19,23249,1195,22054,94.9,135,19,14.1
1,All Students,2019-20,13503,727,12776,94.6,120,13,10.8
1,All Students,2020-21,21872,735,21137,96.6,131,9,6.9
1,All Students,2021-22,21182,1586,19596,92.5,124,31,25.0
1,All Students,2022-23,21016,1424,19592,93.2,124,25,20.2
2,All Students,2018-19,23905,1220,22685,94.9,139,16,11.5
2,All Students,2019-20,15321,875,14446,94.3,138,28,20.3
2,All Students,2020-21,19849,618,19231,96.9,117,7,6.0
2,All Students,2021-22,23140,1696,21444,92.7,134,33,24.6
2,All Students,2022-23,22889,1671,21218,92.7,133,34,25.6
3,All Students,2018-19,23905,1396,22509,94.2,138,23,16.7
3,All Students,2019-20,15418,721,14697,95.3,137,13,9.5
3,All Students,2020-21,22200,566,21634,97.5,129,5,3.9
3,All Students,2021-22,18735,1115,17620,94.0,108,15,13.9
3,All Students,2022-23,22400,1506,20894,93.3,131,32,24.4
4,All Students,2018-19,19994,847,19147,95.8,115,10,8.7
4,All Students,2019-20,15700,775,14925,95.1,139,19,13.7
4,All Students,2020-21,22704,734,21970,96.8,132,10,7.6
4,All Students,2021-22,22373,1279,21094,94.3,135,27,20.0
4,All Students,2022-23,18885,1155,17730,93.9,111,13,11.7
5,All Students,2018-19,21983,980,21003,95.5,125,11,8.8
5,All Students,2019-20,13080,596,12484,95.4,116,12,10.3
5,All Students,2020-21,23029,835,22194,96.4,134,11,8.2
5,All Students,2021-22,24076,1569,22507,93.5,138,29,21.0
5,All Students,2022-23,22825,1228,21597,94.6,134,25,18.7
All Grades,All Students,2018-19,141175,8401,132774,94.0,823,134,16.3
All Grades,All Students,2019-20,93797,6111,87686,93.5,833,189,22.7
All Grades,All Students,2020-21,137900,7905,129995,94.3,829,147,17.7
All Grades,All Students,2021-22,143410,13668,129742,90.5,848,329,38.8
All Grades,All Students,2022-23,140677,11488,129189,91.8,842,254,30.2
PK in K-12 Schools,All Students,2018-19,11787,1221,10566,89.6,69,26,37.7
PK in K-12 Schools,All Students,2019-20,12338,1363,10975,89.0,110,53,48.2
PK in K-12 Schools,All Students,2020-21,16783,2513,14270,85.0,110,55,50.0
PK in K-12 Schools,All Students,2021-22,17889,2984,14905,83.3,109,80,73.4
PK in K-12 Schools,All Students,2022-23,17799,2677,15122,85.0,109,73,67.0
0K,All Students,2018-19,20126,1477,18649,92.7,117,28,23.9
0K,All Students,2019-20,12728,1019,11709,92.0,112,31,27.7
0K,All Students,2020-21,20740,998,19742,95.2,125,16,12.8
0K,All Students,2021-22,19609,2120,17489,89.2,117,54,46.2
0K,All Students,2022-23,17413,1502,15911,91.4,108,40,37.0
1,All Students,2018-19,24779,1546,23233,93.8,144,27,18.8
1,All Students,2019-20,12184,692,11492,94.3,109,20,18.3
1,All Students,2020-21,20110,1098,19012,94.5,120,25,20.8
1,All Students,2021-22,21349,1905,19444,91.1,124,42,33.9
1,All Students,2022-23,19240,1355,17885,93.0,118,28,23.7
2,All Students,2018-19,22055,1082,20973,95.1,127,12,9.4
2,All Students,2019-20,15954,913,15041,94.3,141,26,18.4
2,All Students,2020-21,18391,715,17676,96.1,109,10,9.2
2,All Students,2021-22,20355,1841,18514,91.0,123,47,38.2
2,All Students,2022-23,20996,1382,19614,93.4,124,23,18.5
3,All Students,2018-19,19463,1029,18434,94.7,119,15,12.6
3,All Students,2019-20,14121,738,13383,94.8,125,21,16.8
3,All Students,2020-21,22951,873,22078,96.2,136,14,10.3
3,All Students,2021-22,19814,1697,18117,91.4,116,39,33.6
3,All Students,2022-23,20609,1440,19169,93.0,123,29,23.6
4,All Students,2018-19,19890,1110,18780,94.4,114,16,14.0
4,All Students,2019-20,13084,652,12432,95.0,117,18,15.4
4,All Students,2020-21,19571,671,18900,96.6,117,12,10.3
4,All Students,2021-22,22561,1738,20823,92.3,133,39,29.3
4,All Students,2022-23,21542,1588,19954,92.6,128,32,25.0
5,All Students,2018-19,23075,936,22139,95.9,133,10,7.5
5,All Students,2019-20,13388,734,12654,94.5,119,20,16.8
5,All Students,2020-21,19354,1037,18317,94.6,112,15,13.4
5,All Students,2021-22,21833,1383,20450,93.7,126,28,22.2
5,All Students,2022-23,23078,1544,21534,93.3,132,29,22.0
All Grades,All Students,2018-19,103598,6163,97435,94.1,592,88,14.9
All Grades,All Students,2019-20,66850,4349,62501,93.5,589,112,19.0
All Grades,All Students,2020-21,94486,5940,88546,93.7,557,97,17.4
All Grades,All Students,2021-22,93303,7429,85874,92.0,546,140,25.6
All Grades,All Students,2022-23,91164,7154,84010,92.2,524,136,26.0
PK in K-12 Schools,All Students,2018-19,6359,374,5985,94.1,36,4,11.1
PK in K-12 Schools,All Students,2019-20,4134,310,3824,92.5,36,10,27.8
PK in K-12 Schools,All Students,2020-21,6290,650,5640,89.7,36,10,27.8
PK in K-12 Schools,All Students,2021-22,5920,650,5270,89.0,36,17,47.2
PK in K-12 Schools,All Students,2022-23,6366,686,5680,89.2,37,13,35.1
0K,All Students,2018-19,15540,1234,14306,92.1,90,23,25.6
0K,All Students,2019-20,10863,1010,9853,90.7,96,34,35.4
0K,All Students,2020-21,13523,684,12839,94.9,80,11,13.8
0K,All Students,2021-22,14744,1112,13632,92.5,85,21,24.7
0K,All Students,2022-23,12538,1184,11354,90.6,72,26,36.1
1,All Students,2018-19,14987,1061,13926,92.9,86,17,19.8
1,All Students,2019-20,10386,640,9746,93.8,92,18,19.6
1,All Students,2020-21,14967,972,13995,93.5,91,19,20.9
1,All Students,2021-22,13433,1046,12387,92.2,80,17,21.3
1,All Students,2022-23,14692,1103,13589,92.5,85,20,23.5
2,All Students,2018-19,17004,857,16147,95.0,98,9,9.2
2,All Students,2019-20,9469,609,8860,93.6,83,15,18.1
2,All Students,2020-21,15023,851,14172,94.3,87,12,13.8
2,All Students,2021-22,14711,1081,13630,92.7,86,17,19.8
2,All Students,2022-23,13777,967,12810,93.0,80,18,22.5
3,All Students,2018-19,14354,784,13570,94.5,82,10,12.2
3,All Students,2019-20,11337,643,10694,94.3,100,12,12.0
3,All Students,2020-21,13849,863,12986,93.8,83,15,18.1
3,All Students,2021-22,14435,1220,13215,91.5,85,21,24.7
3,All Students,2022-23,14915,1105,13810,92.6,85,20,23.5
4,All Students,2018-19,17651,946,16705,94.6,100,15,15.0
4,All Students,2019-20,9130,524,8606,94.3,81,13,16.0
4,All Students,2020-21,16841,730,16111,95.7,98,10,10.2
4,All Students,2021-22,13875,1167,12708,91.6,81,26,32.1
4,All Students,2022-23,13789,979,12810,92.9,79,16,20.3
5,All Students,2018-19,17703,907,16796,94.9,100,10,10.0
5,All Students,2019-20,11531,613,10918,94.7,101,10,9.9
5,All Students,2020-21,13993,1190,12803,91.5,82,20,24.4
5,All Students,2021-22,16185,1153,15032,92.9,93,21,22.6
5,All Students,2022-23,15087,1130,13957,92.5,86,23,26.7
All Grades,All Students,2018-19,103492,5477,98015,94.7,596,78,13.1
All Grades,All Students,2019-20,69036,4338,64698,93.7,616,107,17.4
All Grades,All Students,2020-21,101146,3190,97956,96.8,589,52,8.8
All Grades,All Students,2021-22,110184,9383,100801,91.5,641,193,30.1
All Grades,All Students,2022-23,113088,8369,104719,92.6,659,150,22.8
PK in K-12 Schools,All Students,2018-19,11677,907,10770,92.2,69,20,29.0
PK in K-12 Schools,All Students,2019-20,7914,799,7115,89.9,69,21,30.4
PK in K-12 Schools,All Students,2020-21,10633,664,9969,93.8,63,16,25.4
PK in K-12 Schools,All Students,2021-22,11891,1417,10474,88.1,70,37,52.9
PK in K-12 Schools,All Students,2022-23,11529,1252,10277,89.1,68,33,48.5
0K,All Students,2018-19,17091,894,16197,94.8,100,11,11.0
0K,All Students,2019-20,11630,741,10889,93.6,103,23,22.3
0K,All Students,2020-21,14611,650,13961,95.6,86,13,15.1
0K,All Students,2021-22,15766,1426,14340,91.0,91,26,28.6
0K,All Students,2022-23,17148,1438,15710,91.6,101,24,23.8
1,All Students,2018-19,15030,785,14245,94.8,85,8,9.4
1,All Students,2019-20,11062,637,10425,94.2,99,19,19.2
1,All Students,2020-21,17229,394,16835,97.7,100,3,3.0
1,All Students,2021-22,14361,1186,13175,91.7,85,28,32.9
1,All Students,2022-23,16301,1168,15133,92.8,96,23,24.0
2,All Students,2018-19,15898,782,15116,95.1,91,10,11.0
2,All Students,2019-20,9738,568,9170,94.2,88,10,11.4
2,All Students,2020-21,16040,464,15576,97.1,94,8,8.5
2,All Students,2021-22,18612,1408,17204,92.4,107,29,27.1
2,All Students,2022-23,15094,1089,14005,92.8,88,15,17.0
3,All Students,2018-19,11801,475,11326,96.0,70,4,5.7
3,All Students,2019-20,9689,608,9081,93.7,87,12,13.8
3,All Students,2020-21,14659,365,14294,97.5,86,4,4.7
3,All Students,2021-22,16339,1180,15159,92.8,93,21,22.6
3,All Students,2022-23,18525,1166,17359,93.7,108,19,17.6
4,All Students,2018-19,17101,906,16195,94.7,97,16,16.5
4,All Students,2019-20,7838,339,7499,95.7,72,7,9.7
4,All Students,2020-21,15226,346,14880,97.7,87,5,5.7
4,All Students,2021-22,16404,1281,15123,92.2,99,27,27.3
4,All Students,2022-23,17134,1137,15997,93.4,98,17,17.3
5,All Students,2018-19,14894,728,14166,95.1,84,9,10.7
5,All Students,2019-20,11165,646,10519,94.2,98,15,15.3
5,All Students,2020-21,12748,307,12441,97.6,73,3,4.1
5,All Students,2021-22,16811,1485,15326,91.2,96,25,26.0
5,All Students,2022-23,17357,1119,16238,93.6,100,19,19.0
All Grades,All Students,2018-19,115156,10530,104626,90.9,693,236,34.1
All Grades,All Students,2019-20,74407,6557,67850,91.2,688,230,33.4
All Grades,All Students,2020-21,101301,17106,84195,83.1,621,325,52.3
All Grades,All Students,2021-22,92183,13982,78201,84.8,566,322,56.9
All Grades,All Students,2022-23,85616,9839,75777,88.5,548,247,45.1
PK in K-12 Schools,All Students,2018-19,12181,1527,10654,87.5,73,34,46.6
PK in K-12 Schools,All Students,2019-20,10455,1251,9204,88.0,101,52,51.5
PK in K-12 Schools,All Students,2020-21,12447,3125,9322,74.9,83,61,73.5
PK in K-12 Schools,All Students,2021-22,10397,2398,7999,76.9,71,58,81.7
PK in K-12 Schools,All Students,2022-23,12397,2073,10324,83.3,89,59,66.3
0K,All Students,2018-19,16024,1592,14432,90.1,98,36,36.7
0K,All Students,2019-20,12461,1286,11175,89.7,115,43,37.4
0K,All Students,2020-21,14583,2996,11587,79.5,89,57,64.0
0K,All Students,2021-22,13180,2464,10716,81.3,82,61,74.4
0K,All Students,2022-23,9382,1351,8031,85.6,59,31,52.5
1,All Students,2018-19,18833,1703,17130,91.0,113,40,35.4
1,All Students,2019-20,10466,828,9638,92.1,95,30,31.6
1,All Students,2020-21,15841,2843,12998,82.1,96,53,55.2
1,All Students,2021-22,13873,1906,11967,86.3,83,40,48.2
1,All Students,2022-23,11874,1538,10336,87.0,76,40,52.6
2,All Students,2018-19,17697,1518,16179,91.4,104,31,29.8
2,All Students,2019-20,10709,846,9863,92.1,98,23,23.5
2,All Students,2020-21,14730,1505,13225,89.8,90,32,35.6
2,All Students,2021-22,14319,1871,12448,86.9,88,46,52.3
2,All Students,2022-23,13022,1259,11763,90.3,83,31,37.3
3,All Students,2018-19,17365,1617,15748,90.7,110,38,34.5
3,All Students,2019-20,8924,707,8217,92.1,83,22,26.5
3,All Students,2020-21,15425,2620,12805,83.0,91,44,48.4
3,All Students,2021-22,12284,1499,10785,87.8,72,32,44.4
3,All Students,2022-23,14574,1379,13195,90.5,88,33,37.5
4,All Students,2018-19,16631,1405,15226,91.6,97,34,35.1
4,All Students,2019-20,11361,900,10461,92.1,103,34,33.0
4,All Students,2020-21,12708,1881,10827,85.2,79,38,48.1
4,All Students,2021-22,14735,2008,12727,86.4,88,48,54.5
4,All Students,2022-23,11408,989,10419,91.3,72,24,33.3
5,All Students,2018-19,16425,1168,15257,92.9,98,23,23.5
5,All Students,2019-20,10031,739,9292,92.6,93,26,28.0
5,All Students,2020-21,15567,2136,13431,86.3,93,40,43.0
5,All Students,2021-22,13395,1836,11559,86.3,82,37,45.1
5,All Students,2022-23,12959,1250,11709,90.4,81,29,35.8
All Grades,All Students,2018-19,123219,7893,115326,93.6,717,150,20.9
All Grades,All Students,2019-20,79065,5198,73867,93.4,703,136,19.3
All Grades,All Students,2020-21,115032,5071,109961,95.6,674,80,11.9
All Grades,All Students,2021-22,122141,9553,112588,92.2,729,218,29.9
All Grades,All Students,2022-23,123491,9585,113906,92.2,722,201,27.8
PK in K-12 Schools,All Students,2018-19,11118,1097,10021,90.1,67,29,43.3
PK in K-12 Schools,All Students,2019-20,7305,822,6483,88.7,64,26,40.6
PK in K-12 Schools,All Students,2020-21,9710,891,8819,90.8,59,18,30.5
PK in K-12 Schools,All Students,2021-22,10440,1334,9106,87.2,66,32,48.5
PK in K-12 Schools,All Students,2022-23,11147,1293,9854,88.4,65,31,47.7
0K,All Students,2018-19,17930,1371,16559,92.4,103,25,24.3
0K,All Students,2019-20,12497,862,11635,93.1,112,26,23.2
0K,All Students,2020-21,17028,1015,16013,94.0,101,16,15.8
0K,All Students,2021-22,17400,1501,15899,91.4,103,32,31.1
0K,All Students,2022-23,20959,1947,19012,90.7,123,52,42.3
1,All Students,2018-19,17502,930,16572,94.7,105,17,16.2
1,All Students,2019-20,11913,714,11199,94.0,106,19,17.9
1,All Students,2020-21,18538,542,17996,97.1,108,7,6.5
1,All Students,2021-22,18498,1484,17014,92.0,112,40,35.7
1,All Students,2022-23,18124,1326,16798,92.7,107,22,20.6
2,All Students,2018-19,19548,1042,18506,94.7,114,15,13.2
2,All Students,2019-20,10662,593,10069,94.4,94,16,17.0
2,All Students,2020-21,18554,651,17903,96.5,108,8,7.4
2,All Students,2021-22,17715,1134,16581,93.6,109,26,23.9
2,All Students,2022-23,19065,1470,17595,92.3,113,32,28.3
3,All Students,2018-19,15733,884,14849,94.4,90,13,14.4
3,All Students,2019-20,13150,720,12430,94.5,117,14,12.0
3,All Students,2020-21,16055,511,15544,96.8,93,6,6.5
3,All Students,2021-22,20025,1459,18566,92.7,116,33,28.4
3,All Students,2022-23,16291,994,15297,93.9,95,15,15.8
4,All Students,2018-19,19728,1266,18462,93.6,114,22,19.3
4,All Students,2019-20,10813,637,10176,94.1,97,15,15.5
4,All Students,2020-21,20074,621,19453,96.9,117,9,7.7
4,All Students,2021-22,17600,1160,16440,93.4,104,23,22.1
4,All Students,2022-23,20010,1468,18542,92.7,116,28,24.1
5,All Students,2018-19,21660,1303,20357,94.0,124,29,23.4
5,All Students,2019-20,12725,850,11875,93.3,113,20,17.7
5,All Students,2020-21,15073,840,14233,94.4,88,16,18.2
5,All Students,2021-22,20463,1481,18982,92.8,119,32,26.9
5,All Students,2022-23,17895,1087,16808,93.9,103,21,20.4
All Grades,All Students,2018-19,52538,3360,49178,93.6,304,63,20.7
All Grades,All Students,2019-20,34650,2408,32242,93.1,310,64,20.6
All Grades,All Students,2020-21,53301,5898,47403,88.9,313,112,35.8
All Grades,All Students,2021-22,49308,6692,42616,86.4,287,132,46.0
All Grades,All Students,2022-23,50717,5865,44852,88.4,299,119,39.8
PK in K-12 Schools,All Students,2018-19,6091,555,5536,90.9,37,15,40.5
PK in K-12 Schools,All Students,2019-20,5647,584,5063,89.7,50,19,38.0
PK in K-12 Schools,All Students,2020-21,7791,1565,6226,79.9,46,28,60.9
PK in K-12 Schools,All Students,2021-22,8086,1387,6699,82.8,49,33,67.3
PK in K-12 Schools,All Students,2022-23,7676,1235,6441,83.9,47,28,59.6
0K,All Students,2018-19,8360,642,7718,92.3,48,15,31.3
0K,All Students,2019-20,5173,339,4834,93.4,45,9,20.0
0K,All Students,2020-21,7254,623,6631,91.4,44,14,31.8
0K,All Students,2021-22,7228,1216,6012,83.2,41,22,53.7
0K,All Students,2022-23,7753,1048,6705,86.5,49,25,51.0
1,All Students,2018-19,8096,444,7652,94.5,46,7,15.2
1,All Students,2019-20,4894,400,4494,91.8,46,15,32.6
1,All Students,2020-21,8219,972,7247,88.2,47,17,36.2
1,All Students,2021-22,6843,873,5970,87.2,40,19,47.5
1,All Students,2022-23,6269,903,5366,85.6,36,17,47.2
2,All Students,2018-19,8238,483,7755,94.1,48,6,12.5
2,All Students,2019-20,5124,292,4832,94.3,46,6,13.0
2,All Students,2020-21,6922,691,6231,90.0,40,13,32.5
2,All Students,2021-22,8277,952,7325,88.5,48,18,37.5
2,All Students,2022-23,7498,753,6745,90.0,43,13,30.2
3,All Students,2018-19,7757,478,7279,93.8,45,7,15.6
3,All Students,2019-20,4445,254,4191,94.3,41,6,14.6
3,All Students,2020-21,6932,377,6555,94.6,42,6,14.3
3,All Students,2021-22,5901,834,5067,85.9,34,15,44.1
3,All Students,2022-23,8166,745,7421,90.9,48,15,31.3
4,All Students,2018-19,6979,342,6637,95.1,40,4,10.0
4,All Students,2019-20,5375,328,5047,93.9,47,5,10.6
4,All Students,2020-21,7613,786,6827,89.7,45,15,33.3
4,All Students,2021-22,6801,752,6049,88.9,39,14,35.9
4,All Students,2022-23,6193,534,5659,91.4,35,9,25.7
5,All Students,2018-19,7017,416,6601,94.1,40,9,22.5
5,All Students,2019-20,3992,211,3781,94.7,35,4,11.4
5,All Students,2020-21,8570,884,7686,89.7,49,19,38.8
5,All Students,2021-22,6172,678,5494,89.0,36,11,30.6
5,All Students,2022-23,7162,647,6515,91.0,41,12,29.3
All Grades,All Students,2018-19,153036,9587,143449,93.7,896,181,20.2
All Grades,All Students,2019-20,92156,6404,85752,93.1,829,187,22.6
All Grades,All Students,2020-21,131674,13052,118622,90.1,787,247,31.4
All Grades,All Students,2021-22,125076,14956,110120,88.0,747,350,46.9
All Grades,All Students,2022-23,112552,10474,102078,90.7,660,219,33.2
PK in K-12 Schools,All Students,2018-19,6278,597,5681,90.5,37,19,51.4
PK in K-12 Schools,All Students,2019-20,4099,s,s,s,s,s,s
PK in K-12 Schools,All Students,2020-21,4348,955,3393,78.0,30,19,63.3
PK in K-12 Schools,All Students,2021-22,5731,1031,4700,82.0,35,27,77.1
PK in K-12 Schools,All Students,2022-23,6201,641,5560,89.7,36,12,33.3
0K,All Students,2018-19,23584,1785,21799,92.4,141,33,23.4
0K,All Students,2019-20,14349,1204,13145,91.6,131,39,29.8
0K,All Students,2020-21,19398,2434,16964,87.5,118,46,39.0
0K,All Students,2021-22,16500,1992,14508,87.9,104,48,46.2
0K,All Students,2022-23,13349,1514,11835,88.7,80,38,47.5
1,All Students,2018-19,21178,1366,19812,93.5,123,22,17.9
1,All Students,2019-20,13447,1022,12425,92.4,121,25,20.7
1,All Students,2020-21,21091,2046,19045,90.3,128,37,28.9
1,All Students,2021-22,19520,2289,17231,88.3,115,50,43.5
1,All Students,2022-23,16779,1552,15227,90.8,98,30,30.6
2,All Students,2018-19,21130,1300,19830,93.8,125,25,20.0
2,All Students,2019-20,13200,925,12275,93.0,118,25,21.2
2,All Students,2020-21,18912,1375,17537,92.7,115,28,24.3
2,All Students,2021-22,19835,2139,17696,89.2,117,55,47.0
2,All Students,2022-23,18386,1645,16741,91.1,109,39,35.8
3,All Students,2018-19,25558,1476,24082,94.2,150,25,16.7
3,All Students,2019-20,13891,937,12954,93.3,125,33,26.4
3,All Students,2020-21,20435,1727,18708,91.5,122,34,27.9
3,All Students,2021-22,20652,2346,18306,88.6,121,53,43.8
3,All Students,2022-23,17658,1607,16051,90.9,105,37,35.2
4,All Students,2018-19,24779,1340,23439,94.6,142,20,14.1
4,All Students,2019-20,16785,1033,15752,93.8,151,26,17.2
4,All Students,2020-21,21595,2254,19341,89.6,125,42,33.6
4,All Students,2021-22,20883,2371,18512,88.6,123,52,42.3
4,All Students,2022-23,18817,1564,17253,91.7,108,27,25.0
5,All Students,2018-19,30529,1723,28806,94.4,178,37,20.8
5,All Students,2019-20,16379,813,15566,95.0,147,23,15.6
5,All Students,2020-21,25895,2261,23634,91.3,149,41,27.5
5,All Students,2021-22,21955,2788,19167,87.3,132,65,49.2
5,All Students,2022-23,21362,1951,19411,90.9,124,36,29.0
6,All Students,2019-20,6,s,s,s,s,s,s
All Grades,All Students,2018-19,168704,15942,152762,90.6,1015,347,34.2
All Grades,All Students,2019-20,112305,11029,101276,90.2,1019,362,35.5
All Grades,All Students,2020-21,175571,38357,137214,78.2,1021,652,63.9
All Grades,All Students,2021-22,175037,27488,147549,84.3,1054,645,61.2
All Grades,All Students,2022-23,165217,20980,144237,87.3,1001,476,47.6
5,All Students,2022-23,3,s,s,s,s,s,s
6,All Students,2018-19,59174,5830,53344,90.1,360,129,35.8
6,All Students,2019-20,38525,3469,35056,91.0,351,118,33.6
6,All Students,2020-21,57743,s,s,s,s,s,s
6,All Students,2021-22,56607,8408,48199,85.1,347,195,56.2
6,All Students,2022-23,51152,s,s,s,s,s,s
7,All Students,2018-19,56865,4978,51887,91.2,336,110,32.7
7,All Students,2019-20,37776,3793,33983,90.0,347,125,36.0
7,All Students,2020-21,58780,12498,46282,78.7,341,214,62.8
7,All Students,2021-22,58388,9196,49192,84.3,347,210,60.5
7,All Students,2022-23,56620,7378,49242,87.0,345,162,47.0
8,All Students,2018-19,52606,s,s,s,s,s,s
8,All Students,2019-20,36004,3767,32237,89.5,321,119,37.1
8,All Students,2020-21,59044,14982,44062,74.6,342,235,68.7
8,All Students,2021-22,60042,9884,50158,83.5,360,240,66.7
8,All Students,2022-23,57442,8209,49233,85.7,343,184,53.6
9,All Students,2018-19,59,s,s,s,s,s,s
9,All Students,2020-21,4,s,s,s,s,s,s
All Grades,All Students,2018-19,50277,2873,47404,94.3,290,45,15.5
All Grades,All Students,2019-20,43723,2767,40956,93.7,384,68,17.7
All Grades,All Students,2020-21,75968,4490,71478,94.1,445,69,15.5
All Grades,All Students,2021-22,81666,6529,75137,92.0,477,118,24.7
All Grades,All Students,2022-23,81416,6305,75111,92.3,475,122,25.7
PK in K-12 Schools,All Students,2018-19,3182,206,2976,93.5,18,3,16.7
PK in K-12 Schools,All Students,2019-20,2049,148,1901,92.8,18,4,22.2
PK in K-12 Schools,All Students,2020-21,3150,45,3105,98.6,18,0,0.0
PK in K-12 Schools,All Students,2021-22,3127,447,2680,85.7,18,11,61.1
PK in K-12 Schools,All Students,2022-23,3182,271,2911,91.5,18,5,27.8
0K,All Students,2018-19,12651,815,11836,93.6,73,17,23.3
0K,All Students,2019-20,11374,868,10506,92.4,100,28,28.0
0K,All Students,2020-21,10576,685,9891,93.5,65,10,15.4
0K,All Students,2021-22,11627,968,10659,91.7,71,16,22.5
0K,All Students,2022-23,13804,1191,12613,91.4,81,28,34.6
1,All Students,2018-19,11619,673,10946,94.2,68,9,13.2
1,All Students,2019-20,8269,517,7752,93.7,73,13,17.8
1,All Students,2020-21,17065,891,16174,94.8,99,13,13.1
1,All Students,2021-22,10338,914,9424,91.2,61,17,27.9
1,All Students,2022-23,12072,915,11157,92.4,71,17,23.9
2,All Students,2018-19,13090,686,12404,94.8,74,8,10.8
2,All Students,2019-20,7392,426,6966,94.2,65,10,15.4
2,All Students,2020-21,12454,913,11541,92.7,72,16,22.2
2,All Students,2021-22,17105,1317,15788,92.3,98,21,21.4
2,All Students,2022-23,10789,912,9877,91.5,64,19,29.7
3,All Students,2018-19,9735,493,9242,94.9,57,8,14.0
3,All Students,2019-20,8588,468,8120,94.6,75,7,9.3
3,All Students,2020-21,10908,633,10275,94.2,64,8,12.5
3,All Students,2021-22,13483,1074,12409,92.0,80,22,27.5
3,All Students,2022-23,16094,1144,14950,92.9,93,20,21.5
4,All Students,2019-20,6051,340,5711,94.4,53,6,11.3
4,All Students,2020-21,12900,822,12078,93.6,75,15,20.0
4,All Students,2021-22,11971,776,11195,93.5,68,10,14.7
4,All Students,2022-23,13828,1116,12712,91.9,80,21,26.3
5,All Students,2020-21,8915,501,8414,94.4,52,7,13.5
5,All Students,2021-22,14015,1033,12982,92.6,81,21,25.9
5,All Students,2022-23,11647,756,10891,93.5,68,12,17.6
All Grades,All Students,2018-19,79582,3875,75707,95.1,452,51,11.3
All Grades,All Students,2019-20,52103,2616,49487,95.0,457,58,12.7
All Grades,All Students,2020-21,80486,4617,75869,94.3,463,91,19.7
All Grades,All Students,2021-22,79124,5927,73197,92.5,454,122,26.9
All Grades,All Students,2022-23,73996,5486,68510,92.6,431,121,28.1
6,All Students,2018-19,26938,1125,25813,95.8,155,14,9.0
6,All Students,2019-20,17715,706,17009,96.0,156,15,9.6
6,All Students,2020-21,28434,1360,27074,95.2,165,25,15.2
6,All Students,2021-22,26683,1952,24731,92.7,155,42,27.1
6,All Students,2022-23,21406,1476,19930,93.1,128,34,26.6
7,All Students,2018-19,26704,1363,25341,94.9,151,17,11.3
7,All Students,2019-20,17499,879,16620,95.0,153,21,13.7
7,All Students,2020-21,26001,1599,24402,93.9,149,34,22.8
7,All Students,2021-22,26899,1861,25038,93.1,154,34,22.1
7,All Students,2022-23,26319,1878,24441,92.9,152,35,23.0
8,All Students,2018-19,25940,1387,24553,94.7,146,20,13.7
8,All Students,2019-20,16889,1031,15858,93.9,148,22,14.9
8,All Students,2020-21,26051,1658,24393,93.6,149,32,21.5
8,All Students,2021-22,25542,2114,23428,91.7,145,46,31.7
8,All Students,2022-23,26271,2132,24139,91.9,151,52,34.4
All Grades,All Students,2018-19,70734,5742,64992,91.9,444,111,25.0
All Grades,All Students,2019-20,45867,4353,41514,90.5,431,119,27.6
All Grades,All Students,2020-21,74397,19516,54881,73.8,432,278,64.4
All Grades,All Students,2021-22,73551,9346,64205,87.3,445,170,38.2
All Grades,All Students,2022-23,77929,9159,68770,88.2,480,185,38.5
9,All Students,2018-19,22603,1660,20943,92.7,143,28,19.6
9,All Students,2019-20,12249,1375,10874,88.8,116,31,26.7
9,All Students,2020-21,21123,5203,15920,75.4,122,75,61.5
9,All Students,2021-22,23239,2463,20776,89.4,140,41,29.3
9,All Students,2022-23,23862,2379,21483,90.0,147,45,30.6
10,All Students,2018-19,18671,1473,17198,92.1,119,33,27.7
10,All Students,2019-20,12906,1012,11894,92.2,122,32,26.2
10,All Students,2020-21,16163,4625,11538,71.4,95,67,70.5
10,All Students,2021-22,19789,1781,18008,91.0,120,31,25.8
10,All Students,2022-23,22743,2659,20084,88.3,141,52,36.9
11,All Students,2018-19,15566,1201,14365,92.3,96,17,17.7
11,All Students,2019-20,10694,853,9841,92.0,100,20,20.0
11,All Students,2020-21,18169,4103,14066,77.4,105,56,53.3
11,All Students,2021-22,13735,2148,11587,84.4,85,43,50.6
11,All Students,2022-23,19012,2110,16902,88.9,118,46,39.0
12,All Students,2018-19,13894,1408,12486,89.9,86,33,38.4
12,All Students,2019-20,10018,1113,8905,88.9,93,36,38.7
12,All Students,2020-21,18942,5585,13357,70.5,110,80,72.7
12,All Students,2021-22,16788,2954,13834,82.4,100,55,55.0
12,All Students,2022-23,12312,2011,10301,83.7,74,42,56.8
All Grades,All Students,2018-19,77435,4232,73203,94.5,445,64,14.4
All Grades,All Students,2019-20,49219,2262,46957,95.4,439,49,11.2
All Grades,All Students,2020-21,70706,4743,65963,93.3,410,79,19.3
All Grades,All Students,2021-22,67404,6517,60887,90.3,396,150,37.9
All Grades,All Students,2022-23,67615,5746,61869,91.5,394,115,29.2
PK in K-12 Schools,All Students,2018-19,6208,360,5848,94.2,37,6,16.2
PK in K-12 Schools,All Students,2019-20,4098,209,3889,94.9,38,5,13.2
PK in K-12 Schools,All Students,2020-21,6288,904,5384,85.6,36,15,41.7
PK in K-12 Schools,All Students,2021-22,6272,996,5276,84.1,37,25,67.6
PK in K-12 Schools,All Students,2022-23,6302,828,5474,86.9,36,20,55.6
0K,All Students,2018-19,10782,808,9974,92.5,63,19,30.2
0K,All Students,2019-20,7112,329,6783,95.4,63,8,12.7
0K,All Students,2020-21,8273,674,7599,91.9,48,13,27.1
0K,All Students,2021-22,8264,922,7342,88.8,51,27,52.9
0K,All Students,2022-23,9441,951,8490,89.9,56,21,37.5
1,All Students,2018-19,11514,651,10863,94.3,66,12,18.2
1,All Students,2019-20,7210,337,6873,95.3,67,6,9.0
1,All Students,2020-21,10510,711,9799,93.2,62,14,22.6
1,All Students,2021-22,9644,876,8768,90.9,59,21,35.6
1,All Students,2022-23,8746,681,8065,92.2,51,12,23.5
2,All Students,2018-19,12991,706,12285,94.6,74,12,16.2
2,All Students,2019-20,7512,357,7155,95.2,67,9,13.4
2,All Students,2020-21,11449,685,10764,94.0,66,11,16.7
2,All Students,2021-22,9915,808,9107,91.9,56,15,26.8
2,All Students,2022-23,10758,855,9903,92.1,63,18,28.6
3,All Students,2018-19,12018,588,11430,95.1,69,7,10.1
3,All Students,2019-20,8472,381,8091,95.5,74,8,10.8
3,All Students,2020-21,10401,541,9860,94.8,61,10,16.4
3,All Students,2021-22,10299,1018,9281,90.1,61,22,36.1
3,All Students,2022-23,10702,884,9818,91.7,62,16,25.8
4,All Students,2018-19,11462,526,10936,95.4,66,4,6.1
4,All Students,2019-20,7534,374,7160,95.0,66,9,13.6
4,All Students,2020-21,12425,702,11723,94.4,71,10,14.1
4,All Students,2021-22,11557,971,10586,91.6,66,19,28.8
4,All Students,2022-23,9821,699,9122,92.9,58,13,22.4
5,All Students,2018-19,12460,593,11867,95.2,70,4,5.7
5,All Students,2019-20,7281,275,7006,96.2,64,4,6.3
5,All Students,2020-21,11360,526,10834,95.4,66,6,9.1
5,All Students,2021-22,11453,926,10527,91.9,66,21,31.8
5,All Students,2022-23,11845,848,10997,92.8,68,15,22.1
All Grades,All Students,2022-23,177146,35376,141770,80.0,1170,872,74.5
PK in K-12 Schools,All Students,2022-23,177080,s,s,s,s,s,s
0K,All Students,2022-23,66,s,s,s,s,s,s
All Grades,All Students,2018-19,42247,3544,38703,91.6,249,77,30.9
All Grades,All Students,2019-20,33421,2713,30708,91.9,302,94,31.1
All Grades,All Students,2020-21,65201,5788,59413,91.1,387,120,31.0
All Grades,All Students,2021-22,73650,8120,65530,89.0,445,187,42.0
All Grades,All Students,2022-23,72436,7497,64939,89.7,431,173,40.1
PK in K-12 Schools,All Students,2018-19,6068,570,5498,90.6,38,9,23.7
PK in K-12 Schools,All Students,2019-20,4163,421,3742,89.9,37,13,35.1
PK in K-12 Schools,All Students,2020-21,9039,1017,8022,88.7,57,22,38.6
PK in K-12 Schools,All Students,2021-22,8909,1171,7738,86.9,55,32,58.2
PK in K-12 Schools,All Students,2022-23,8933,1253,7680,86.0,51,34,66.7
0K,All Students,2018-19,13965,1327,12638,90.5,83,35,42.2
0K,All Students,2019-20,6411,599,5812,90.7,60,25,41.7
0K,All Students,2020-21,10209,1099,9110,89.2,60,25,41.7
0K,All Students,2021-22,8777,914,7863,89.6,54,22,40.7
0K,All Students,2022-23,8380,821,7559,90.2,50,20,40.0
1,All Students,2018-19,11304,765,10539,93.2,65,13,20.0
1,All Students,2019-20,8977,667,8310,92.6,80,22,27.5
1,All Students,2020-21,10149,677,9472,93.3,58,10,17.2
1,All Students,2021-22,10291,1237,9054,88.0,60,27,45.0
1,All Students,2022-23,9857,1160,8697,88.2,62,29,46.8
2,All Students,2018-19,10910,882,10028,91.9,63,20,31.7
2,All Students,2019-20,7173,562,6611,92.2,64,19,29.7
2,All Students,2020-21,14090,1133,12957,92.0,82,24,29.3
2,All Students,2021-22,9892,1077,8815,89.1,61,25,41.0
2,All Students,2022-23,9638,919,8719,90.5,57,20,35.1
3,All Students,2019-20,6697,464,6233,93.1,61,15,24.6
3,All Students,2020-21,11403,890,10513,92.2,67,17,25.4
3,All Students,2021-22,13869,1337,12532,90.4,82,29,35.4
3,All Students,2022-23,9335,1031,8304,89.0,56,24,42.9
4,All Students,2020-21,10311,972,9339,90.6,63,22,34.9
4,All Students,2021-22,11733,1276,10457,89.1,72,26,36.1
4,All Students,2022-23,13563,1290,12273,90.5,80,27,33.8
5,All Students,2021-22,10179,1108,9071,89.1,61,26,42.6
5,All Students,2022-23,12730,1023,11707,92.0,75,19,25.3
All Grades,All Students,2018-19,166007,8331,157676,95.0,955,129,13.5
All Grades,All Students,2019-20,102700,5922,96778,94.2,926,170,18.4
All Grades,All Students,2020-21,153699,8086,145613,94.7,899,143,15.9
All Grades,All Students,2021-22,151326,10399,140927,93.1,891,201,22.6
All Grades,All Students,2022-23,138354,10035,128319,92.7,822,201,24.5
PK in K-12 Schools,All Students,2018-19,4392,316,4076,92.8,27,7,25.9
PK in K-12 Schools,All Students,2019-20,4696,413,4283,91.2,44,17,38.6
PK in K-12 Schools,All Students,2020-21,7218,748,6470,89.6,44,16,36.4
PK in K-12 Schools,All Students,2021-22,6740,621,6119,90.8,40,14,35.0
PK in K-12 Schools,All Students,2022-23,5659,513,5146,90.9,34,12,35.3
0K,All Students,2018-19,25800,1394,24406,94.6,151,25,16.6
0K,All Students,2019-20,15551,1110,14441,92.9,141,39,27.7
0K,All Students,2020-21,24997,1658,23339,93.4,149,32,21.5
0K,All Students,2021-22,20378,1621,18757,92.0,121,34,28.1
0K,All Students,2022-23,19360,2011,17349,89.6,116,43,37.1
1,All Students,2018-19,23542,1271,22271,94.6,135,16,11.9
1,All Students,2019-20,15485,900,14585,94.2,138,27,19.6
1,All Students,2020-21,22094,1401,20693,93.7,128,25,19.5
1,All Students,2021-22,23993,2044,21949,91.5,142,42,29.6
1,All Students,2022-23,21726,1635,20091,92.5,131,33,25.2
2,All Students,2018-19,28721,1469,27252,94.9,166,19,11.4
2,All Students,2019-20,14662,801,13861,94.5,132,17,12.9
2,All Students,2020-21,23888,1156,22732,95.2,139,20,14.4
2,All Students,2021-22,22975,1414,21561,93.8,136,30,22.1
2,All Students,2022-23,23145,1760,21385,92.4,137,38,27.7
3,All Students,2018-19,26336,1257,25079,95.2,150,18,12.0
3,All Students,2019-20,20000,1139,18861,94.3,185,30,16.2
3,All Students,2020-21,21273,908,20365,95.7,122,12,9.8
3,All Students,2021-22,24958,1573,23385,93.7,148,29,19.6
3,All Students,2022-23,23555,1425,22130,94.0,140,27,19.3
4,All Students,2018-19,24399,1263,23136,94.8,140,24,17.1
4,All Students,2019-20,15693,663,15030,95.8,139,15,10.8
4,All Students,2020-21,30146,1424,28722,95.3,177,21,11.9
4,All Students,2021-22,22294,1311,20983,94.1,130,26,20.0
4,All Students,2022-23,23823,1485,22338,93.8,143,34,23.8
5,All Students,2018-19,32817,1361,31456,95.9,186,20,10.8
5,All Students,2019-20,16613,896,15717,94.6,147,25,17.0
5,All Students,2020-21,24083,791,23292,96.7,140,17,12.1
5,All Students,2021-22,29988,1815,28173,93.9,174,26,14.9
5,All Students,2022-23,21086,1206,19880,94.3,121,14,11.6
All Grades,All Students,2018-19,258973,15709,243264,93.9,1499,294,19.6
All Grades,All Students,2019-20,182220,10919,171301,94.0,1626,312,19.2
All Grades,All Students,2020-21,265113,41415,223698,84.4,1541,721,46.8
All Grades,All Students,2021-22,263876,26329,237547,90.0,1562,582,37.3
All Grades,All Students,2022-23,260940,22521,238419,91.4,1542,486,31.5
6,All Students,2018-19,89271,4539,84732,94.9,520,87,16.7
6,All Students,2019-20,62538,3424,59114,94.5,560,92,16.4
6,All Students,2020-21,80375,11525,68850,85.7,470,208,44.3
6,All Students,2021-22,79416,6541,72875,91.8,472,154,32.6
6,All Students,2022-23,87977,6654,81323,92.4,525,145,27.6
7,All Students,2018-19,92483,5133,87350,94.4,534,84,15.7
7,All Students,2019-20,58973,3398,55575,94.2,524,103,19.7
7,All Students,2020-21,93667,15426,78241,83.5,546,259,47.4
7,All Students,2021-22,87639,8912,78727,89.8,522,183,35.1
7,All Students,2022-23,83001,6696,76305,91.9,489,153,31.3
8,All Students,2018-19,77219,6037,71182,92.2,445,123,27.6
8,All Students,2019-20,60709,4097,56612,93.3,542,117,21.6
8,All Students,2020-21,91071,14464,76607,84.1,525,254,48.4
8,All Students,2021-22,96821,10876,85945,88.8,568,245,43.1
8,All Students,2022-23,89962,9171,80791,89.8,528,188,35.6
All Grades,All Students,2018-19,53016,6104,46912,88.5,329,158,48.0
All Grades,All Students,2019-20,31954,3402,28552,89.4,297,125,42.1
All Grades,All Students,2020-21,47111,10278,36833,78.2,282,181,64.2
All Grades,All Students,2021-22,48795,9138,39657,81.3,314,215,68.5
All Grades,All Students,2022-23,44949,7536,37413,83.2,285,172,60.4
PK in K-12 Schools,All Students,2019-20,2060,301,1759,85.4,18,12,66.7
PK in K-12 Schools,All Students,2020-21,3021,990,2031,67.2,20,16,80.0
PK in K-12 Schools,All Students,2021-22,3133,562,2571,82.1,19,12,63.2
PK in K-12 Schools,All Students,2022-23,3020,610,2410,79.8,21,15,71.4
0K,All Students,2018-19,6597,975,5622,85.2,42,26,61.9
0K,All Students,2019-20,4993,502,4491,89.9,48,21,43.8
0K,All Students,2020-21,7062,1727,5335,75.5,43,31,72.1
0K,All Students,2021-22,6425,1658,4767,74.2,44,34,77.3
0K,All Students,2022-23,7547,1466,6081,80.6,47,31,66.0
1,All Students,2018-19,8028,891,7137,88.9,52,23,44.2
1,All Students,2019-20,4129,475,3654,88.5,40,17,42.5
1,All Students,2020-21,7396,1532,5864,79.3,43,26,60.5
1,All Students,2021-22,6810,1175,5635,82.7,46,35,76.1
1,All Students,2022-23,6229,1084,5145,82.6,40,21,52.5
2,All Students,2018-19,9537,1153,8384,87.9,56,28,50.0
2,All Students,2019-20,4190,328,3862,92.2,39,14,35.9
2,All Students,2020-21,5877,1089,4788,81.5,34,19,55.9
2,All Students,2021-22,8195,1440,6755,82.4,52,35,67.3
2,All Students,2022-23,6562,1039,5523,84.2,42,30,71.4
3,All Students,2018-19,8982,997,7985,88.9,58,26,44.8
3,All Students,2019-20,5423,669,4754,87.7,50,25,50.0
3,All Students,2020-21,6503,1176,5327,81.9,39,25,64.1
3,All Students,2021-22,6585,1197,5388,81.8,43,30,69.8
3,All Students,2022-23,7322,1192,6130,83.7,46,24,52.2
4,All Students,2018-19,9577,941,8636,90.2,56,23,41.1
4,All Students,2019-20,5662,624,5038,89.0,52,19,36.5
4,All Students,2020-21,8816,2397,6419,72.8,54,38,70.4
4,All Students,2021-22,8557,1575,6982,81.6,56,34,60.7
4,All Students,2022-23,6894,1173,5721,83.0,45,31,68.9
5,All Students,2018-19,10295,1147,9148,88.9,65,32,49.2
5,All Students,2019-20,5497,503,4994,90.8,50,17,34.0
5,All Students,2020-21,8436,1367,7069,83.8,49,26,53.1
5,All Students,2021-22,9090,1531,7559,83.2,54,35,64.8
5,All Students,2022-23,7375,972,6403,86.8,44,20,45.5
All Grades,All Students,2018-19,258980,14077,244903,94.6,1477,221,15.0
All Grades,All Students,2019-20,166473,8329,158144,95.0,1465,181,12.4
All Grades,All Students,2020-21,251773,10776,240997,95.7,1455,162,11.1
All Grades,All Students,2021-22,239669,17097,222572,92.9,1387,312,22.5
All Grades,All Students,2022-23,258239,17396,240843,93.3,1491,310,20.8
6,All Students,2018-19,91484,4180,87304,95.4,523,54,10.3
6,All Students,2019-20,51876,2361,49515,95.4,458,51,11.1
6,All Students,2020-21,83204,2320,80884,97.2,481,24,5.0
6,All Students,2021-22,75798,5228,70570,93.1,443,88,19.9
6,All Students,2022-23,89124,4976,84148,94.4,516,80,15.5
7,All Students,2018-19,85441,4632,80809,94.6,486,82,16.9
7,All Students,2019-20,60061,2901,57160,95.2,530,60,11.3
7,All Students,2020-21,77204,3485,73719,95.5,448,63,14.1
7,All Students,2021-22,85177,5937,79240,93.0,493,111,22.5
7,All Students,2022-23,80944,5845,75099,92.8,471,119,25.3
8,All Students,2018-19,82055,5265,76790,93.6,468,85,18.2
8,All Students,2019-20,54536,3067,51469,94.4,477,70,14.7
8,All Students,2020-21,91365,4971,86394,94.6,526,75,14.3
8,All Students,2021-22,78694,5932,72762,92.5,451,113,25.1
8,All Students,2022-23,88171,6575,81596,92.5,504,111,22.0
All Grades,All Students,2018-19,138889,14016,124873,89.9,864,378,43.8
All Grades,All Students,2019-20,82896,7767,75129,90.6,772,294,38.1
All Grades,All Students,2020-21,118087,25897,92190,78.1,698,452,64.8
All Grades,All Students,2021-22,105603,17149,88454,83.8,653,394,60.3
All Grades,All Students,2022-23,93889,12394,81495,86.8,581,301,51.8
PK in K-12 Schools,All Students,2018-19,6245,884,5361,85.8,44,27,61.4
PK in K-12 Schools,All Students,2019-20,3964,524,3440,86.8,38,23,60.5
PK in K-12 Schools,All Students,2020-21,6181,1862,4319,69.9,36,27,75.0
PK in K-12 Schools,All Students,2021-22,6326,1075,5251,83.0,37,25,67.6
PK in K-12 Schools,All Students,2022-23,6056,993,5063,83.6,42,26,61.9
0K,All Students,2018-19,17849,1931,15918,89.2,113,53,46.9
0K,All Students,2019-20,10144,1135,9009,88.8,102,49,48.0
0K,All Students,2020-21,14245,3130,11115,78.0,87,57,65.5
0K,All Students,2021-22,14241,2630,11611,81.5,90,53,58.9
0K,All Students,2022-23,11128,1419,9709,87.2,73,38,52.1
1,All Students,2018-19,22407,2659,19748,88.1,143,80,55.9
1,All Students,2019-20,10822,1106,9716,89.8,99,37,37.4
1,All Students,2020-21,16252,3799,12453,76.6,94,57,60.6
1,All Students,2021-22,13985,2646,11339,81.1,89,58,65.2
1,All Students,2022-23,16001,2291,13710,85.7,98,56,57.1
2,All Students,2018-19,23979,2400,21579,90.0,147,61,41.5
2,All Students,2019-20,14860,1370,13490,90.8,138,58,42.0
2,All Students,2020-21,16241,3658,12583,77.5,97,64,66.0
2,All Students,2021-22,15448,2292,13156,85.2,96,54,56.3
2,All Students,2022-23,13532,1807,11725,86.6,82,41,50.0
3,All Students,2018-19,24158,2398,21760,90.1,151,63,41.7
3,All Students,2019-20,14130,1202,12928,91.5,131,46,35.1
3,All Students,2020-21,20327,4289,16038,78.9,120,82,68.3
3,All Students,2021-22,14693,2200,12493,85.0,93,58,62.4
3,All Students,2022-23,14337,1929,12408,86.5,86,43,50.0
4,All Students,2018-19,22659,1857,20802,91.8,139,50,36.0
4,All Students,2019-20,15327,1361,13966,91.1,142,46,32.4
4,All Students,2020-21,22215,4887,17328,78.0,132,87,65.9
4,All Students,2021-22,18384,3049,15335,83.4,114,68,59.6
4,All Students,2022-23,14938,1753,13185,88.3,92,42,45.7
5,All Students,2018-19,21592,1887,19705,91.3,127,44,34.6
5,All Students,2019-20,13649,1069,12580,92.2,122,35,28.7
5,All Students,2020-21,22626,4272,18354,81.1,132,78,59.1
5,All Students,2021-22,22526,3257,19269,85.5,134,78,58.2
5,All Students,2022-23,17897,2202,15695,87.7,108,55,50.9
All Grades,All Students,2018-19,230927,15055,215872,93.5,1341,248,18.5
All Grades,All Students,2019-20,150575,10364,140211,93.1,1344,286,21.3
All Grades,All Students,2020-21,241366,37239,204127,84.6,1393,580,41.6
All Grades,All Students,2021-22,242254,27814,214440,88.5,1420,608,42.8
All Grades,All Students,2022-23,252056,28598,223458,88.7,1484,574,38.7
PK in K-12 Schools,All Students,2018-19,6372,825,5547,87.1,36,14,38.9
PK in K-12 Schools,All Students,2019-20,4091,401,3690,90.2,36,11,30.6
PK in K-12 Schools,All Students,2020-21,6228,960,5268,84.6,37,19,51.4
PK in K-12 Schools,All Students,2021-22,6203,884,5319,85.7,36,22,61.1
PK in K-12 Schools,All Students,2022-23,6349,834,5515,86.9,36,14,38.9
0K,All Students,2018-19,12986,921,12065,92.9,75,17,22.7
0K,All Students,2019-20,8362,825,7537,90.1,74,31,41.9
0K,All Students,2020-21,13124,1369,11755,89.6,75,23,30.7
0K,All Students,2021-22,12503,1456,11047,88.4,74,35,47.3
0K,All Students,2022-23,13053,1475,11578,88.7,75,37,49.3
1,All Students,2018-19,15439,923,14516,94.0,88,12,13.6
1,All Students,2019-20,9834,674,9160,93.1,87,18,20.7
1,All Students,2020-21,14993,1436,13557,90.4,87,24,27.6
1,All Students,2021-22,14496,1572,12924,89.2,84,40,47.6
1,All Students,2022-23,16336,1867,14469,88.6,94,36,38.3
2,All Students,2018-19,16126,938,15188,94.2,93,16,17.2
2,All Students,2019-20,10158,555,9603,94.5,90,14,15.6
2,All Students,2020-21,16603,1821,14782,89.0,95,27,28.4
2,All Students,2021-22,16138,1734,14404,89.3,92,41,44.6
2,All Students,2022-23,15615,1455,14160,90.7,89,29,32.6
3,All Students,2018-19,15925,919,15006,94.2,90,16,17.8
3,All Students,2019-20,10585,694,9891,93.4,92,21,22.8
3,All Students,2020-21,16879,1640,15239,90.3,97,24,24.7
3,All Students,2021-22,15633,1361,14272,91.3,90,28,31.1
3,All Students,2022-23,16568,1590,14978,90.4,95,35,36.8
4,All Students,2018-19,18149,940,17209,94.8,102,12,11.8
4,All Students,2019-20,11690,718,10972,93.9,103,19,18.4
4,All Students,2020-21,18426,2039,16387,88.9,109,32,29.4
4,All Students,2021-22,16690,1385,15305,91.7,95,31,32.6
4,All Students,2022-23,16655,1223,15432,92.7,95,32,33.7
5,All Students,2018-19,18100,911,17189,95.0,104,14,13.5
5,All Students,2019-20,11730,532,11198,95.5,102,10,9.8
5,All Students,2020-21,17319,2459,14860,85.8,100,37,37.0
5,All Students,2021-22,17419,1731,15688,90.1,100,39,39.0
5,All Students,2022-23,17297,1322,15975,92.4,99,25,25.3
6,All Students,2018-19,17466,763,16703,95.6,99,10,10.1
6,All Students,2019-20,11237,592,10645,94.7,100,16,16.0
6,All Students,2020-21,16872,2322,14550,86.2,97,37,38.1
6,All Students,2021-22,22576,2056,20520,90.9,130,47,36.2
6,All Students,2022-23,22710,2066,20644,90.9,131,40,30.5
7,All Students,2018-19,17087,880,16207,94.8,96,11,11.5
7,All Students,2019-20,10778,547,10231,94.9,94,13,13.8
7,All Students,2020-21,17324,4462,12862,74.2,99,81,81.8
7,All Students,2021-22,17005,1497,15508,91.2,99,30,30.3
7,All Students,2022-23,22747,1956,20791,91.4,131,41,31.3
8,All Students,2018-19,16739,828,15911,95.1,94,9,9.6
8,All Students,2019-20,10594,685,9909,93.5,93,18,19.4
8,All Students,2020-21,16025,2123,13902,86.8,91,38,41.8
8,All Students,2021-22,16783,1815,14968,89.2,97,41,42.3
8,All Students,2022-23,16805,1284,15521,92.4,95,30,31.6
9,All Students,2018-19,20054,1235,18819,93.8,123,24,19.5
9,All Students,2019-20,14580,801,13779,94.5,134,22,16.4
9,All Students,2020-21,25408,4336,21072,82.9,149,68,45.6
9,All Students,2021-22,25179,3123,22056,87.6,152,66,43.4
9,All Students,2022-23,23268,2947,20321,87.3,144,62,43.1
10,All Students,2018-19,19417,1438,17979,92.6,117,25,21.4
10,All Students,2019-20,12271,932,11339,92.4,114,27,23.7
10,All Students,2020-21,22870,3391,19479,85.2,131,51,38.9
10,All Students,2021-22,21786,3627,18159,83.4,133,68,51.1
10,All Students,2022-23,23012,2953,20059,87.2,144,56,38.9
11,All Students,2018-19,18427,1517,16910,91.8,111,27,24.3
11,All Students,2019-20,12039,860,11179,92.9,110,24,21.8
11,All Students,2020-21,18960,3712,15248,80.4,108,48,44.4
11,All Students,2021-22,21893,2725,19168,87.6,131,52,39.7
11,All Students,2022-23,19212,3910,15302,79.6,117,62,53.0
12,All Students,2018-19,18640,2017,16623,89.2,113,41,36.3
12,All Students,2019-20,12626,1548,11078,87.7,115,42,36.5
12,All Students,2020-21,20335,5169,15166,74.6,118,71,60.2
12,All Students,2021-22,17950,2848,15102,84.1,107,68,63.6
12,All Students,2022-23,22429,3716,18713,83.4,139,75,54.0
All Grades,All Students,2022-23,7937,825,7112,89.6,51,22,43.1
0K,All Students,2022-23,7937,825,7112,89.6,51,22,43.1
All Grades,All Students,2022-23,11178,1252,9926,88.8,67,22,32.8
6,All Students,2022-23,11178,1252,9926,88.8,67,22,32.8
All Grades,All Students,2018-19,499291,43231,456060,91.3,3082,513,16.6
All Grades,All Students,2019-20,339960,25897,314063,92.4,3172,592,18.7
All Grades,All Students,2020-21,540426,51100,489326,90.5,3169,695,21.9
All Grades,All Students,2021-22,530050,55106,474944,89.6,3241,937,28.9
All Grades,All Students,2022-23,516914,44622,472292,91.4,3286,843,25.7
9,All Students,2018-19,150433,23995,126438,84.0,903,195,21.6
9,All Students,2019-20,99740,10475,89265,89.5,933,200,21.4
9,All Students,2020-21,153706,22677,131029,85.2,904,270,29.9
9,All Students,2021-22,151864,22408,129456,85.2,928,301,32.4
9,All Students,2022-23,146928,14682,132246,90.0,952,253,26.6
10,All Students,2018-19,128221,7759,120462,93.9,815,136,16.7
10,All Students,2019-20,87031,6148,80883,92.9,819,153,18.7
10,All Students,2020-21,141535,11148,130387,92.1,829,151,18.2
10,All Students,2021-22,131278,12498,118780,90.5,815,241,29.6
10,All Students,2022-23,128759,9156,119603,92.9,826,185,22.4
11,All Students,2018-19,149794,7695,142099,94.9,933,120,12.9
11,All Students,2019-20,99401,6621,92780,93.3,930,178,19.1
11,All Students,2020-21,160044,12908,147136,91.9,941,199,21.1
11,All Students,2021-22,166425,14202,152223,91.5,1016,273,26.9
11,All Students,2022-23,120634,9066,111568,92.5,762,171,22.4
12,All Students,2018-19,70843,3782,67061,94.7,431,62,14.4
12,All Students,2019-20,53788,2653,51135,95.1,491,62,12.6
12,All Students,2020-21,85141,4367,80774,94.9,495,75,15.2
12,All Students,2021-22,80483,5998,74485,92.5,482,122,25.3
12,All Students,2022-23,120593,11718,108875,90.3,746,234,31.4
All Grades,All Students,2018-19,252259,39623,212636,84.3,1615,643,39.8
All Grades,All Students,2019-20,170387,27333,143054,84.0,1613,622,38.6
All Grades,All Students,2020-21,263788,58452,205336,77.8,1526,661,43.3
All Grades,All Students,2021-22,273633,53545,220088,80.4,1692,910,53.8
All Grades,All Students,2022-23,285512,40041,245471,86.0,1857,750,40.4
PK in K-12 Schools,All Students,2022-23,1,s,s,s,s,s,s
8,All Students,2022-23,2,s,s,s,s,s,s
9,All Students,2018-19,52924,5578,47346,89.5,348,121,34.8
9,All Students,2019-20,38371,3539,34832,90.8,369,102,27.6
9,All Students,2020-21,64435,10139,54296,84.3,379,140,36.9
9,All Students,2021-22,70190,10291,59899,85.3,445,202,45.4
9,All Students,2022-23,71897,7992,63905,88.9,469,175,37.3
10,All Students,2018-19,66704,9891,56813,85.2,440,167,38.0
10,All Students,2019-20,37933,5633,32300,85.2,377,146,38.7
10,All Students,2020-21,63277,12510,50767,80.2,368,152,41.3
10,All Students,2021-22,72021,13483,58538,81.3,448,234,52.2
10,All Students,2022-23,73593,8917,64676,87.9,486,182,37.4
11,All Students,2018-19,69272,11031,58241,84.1,430,160,37.2
11,All Students,2019-20,43172,6498,36674,84.9,409,147,35.9
11,All Students,2020-21,61180,13564,47616,77.8,354,150,42.4
11,All Students,2021-22,65177,12182,52995,81.3,411,228,55.5
11,All Students,2022-23,73398,10464,62934,85.7,479,196,40.9
12,All Students,2018-19,63359,13123,50236,79.3,397,195,49.1
12,All Students,2019-20,50911,11663,39248,77.1,458,227,49.6
12,All Students,2020-21,74896,22239,52657,70.3,425,219,51.5
12,All Students,2021-22,66245,17589,48656,73.4,388,246,63.4
12,All Students,2022-23,66621,12665,53956,81.0,423,197,46.6
All Grades,All Students,2018-19,417466,56549,360917,86.5,2699,975,36.1
All Grades,All Students,2019-20,269501,33284,236217,87.6,2578,937,36.3
All Grades,All Students,2020-21,423538,127476,296062,69.9,2508,1628,64.9
All Grades,All Students,2021-22,370763,39281,331482,89.4,2379,737,31.0
All Grades,All Students,2022-23,349586,49921,299665,85.7,2282,960,42.1
8,All Students,2018-19,3,s,s,s,s,s,s
9,All Students,2018-19,119783,15057,104726,87.4,781,268,34.3
9,All Students,2019-20,84549,10917,73632,87.1,813,314,38.6
9,All Students,2020-21,115789,40220,75569,65.3,691,476,68.9
9,All Students,2021-22,108489,14463,94026,86.7,695,270,38.8
9,All Students,2022-23,109011,18781,90230,82.8,721,337,46.7
10,All Students,2018-19,126493,21884,104609,82.7,838,373,44.5
10,All Students,2019-20,82016,11896,70120,85.5,804,343,42.7
10,All Students,2020-21,122701,38360,84341,68.7,731,475,65.0
10,All Students,2021-22,95363,10495,84868,89.0,639,224,35.1
10,All Students,2022-23,94255,14338,79917,84.8,633,288,45.5
11,All Students,2018-19,85984,9434,76550,89.0,547,172,31.4
11,All Students,2019-20,50722,5589,45133,89.0,480,134,27.9
11,All Students,2020-21,99342,25379,73963,74.5,584,330,56.5
11,All Students,2021-22,85241,8228,77013,90.3,547,140,25.6
11,All Students,2022-23,72946,8561,64385,88.3,474,171,36.1
12,All Students,2018-19,85203,s,s,s,s,s,s
12,All Students,2019-20,52214,4882,47332,90.7,481,146,30.4
12,All Students,2020-21,85706,23517,62189,72.6,502,347,69.1
12,All Students,2021-22,81670,6095,75575,92.5,498,103,20.7
12,All Students,2022-23,73374,8241,65133,88.8,454,164,36.1
All Grades,All Students,2018-19,607538,49306,558232,91.9,3735,895,24.0
All Grades,All Students,2019-20,406446,35301,371145,91.3,3760,1043,27.7
All Grades,All Students,2020-21,643942,58101,585841,91.0,3735,826,22.1
All Grades,All Students,2021-22,626933,82733,544200,86.8,3802,1734,45.6
All Grades,All Students,2022-23,622362,55576,566786,91.1,3913,1163,29.7
9,All Students,2018-19,146341,9605,136736,93.4,910,166,18.2
9,All Students,2019-20,105450,8331,97119,92.1,996,234,23.5
9,All Students,2020-21,169508,9472,160036,94.4,990,137,13.8
9,All Students,2021-22,160654,17990,142664,88.8,980,384,39.2
9,All Students,2022-23,153672,10795,142877,93.0,987,230,23.3
10,All Students,2018-19,169002,13826,155176,91.8,1051,238,22.6
10,All Students,2019-20,97517,8632,88885,91.1,903,235,26.0
10,All Students,2020-21,171054,15711,155343,90.8,993,206,20.7
10,All Students,2021-22,167736,19265,148471,88.5,1024,387,37.8
10,All Students,2022-23,154122,11974,142148,92.2,975,248,25.4
11,All Students,2018-19,149157,10627,138530,92.9,904,162,17.9
11,All Students,2019-20,99365,7752,91613,92.2,908,208,22.9
11,All Students,2020-21,146261,12297,133964,91.6,844,169,20.0
11,All Students,2021-22,153278,19651,133627,87.2,932,412,44.2
11,All Students,2022-23,164536,13641,150895,91.7,1027,249,24.2
12,All Students,2018-19,143038,15248,127790,89.3,870,329,37.8
12,All Students,2019-20,104114,10586,93528,89.8,953,366,38.4
12,All Students,2020-21,157102,20615,136487,86.9,907,313,34.5
12,All Students,2021-22,145265,25827,119438,82.2,866,551,63.6
12,All Students,2022-23,150032,19166,130866,87.2,924,436,47.2
All Grades,All Students,2018-19,556164,48793,507371,91.2,3450,808,23.4
All Grades,All Students,2019-20,374377,24574,349803,93.4,3483,510,14.6
All Grades,All Students,2020-21,569086,68038,501048,88.0,3340,1011,30.3
All Grades,All Students,2021-22,537649,67965,469684,87.4,3323,1383,41.6
All Grades,All Students,2022-23,483216,33658,449558,93.0,3076,604,19.6
8,All Students,2021-22,6,s,s,s,s,s,s
9,All Students,2018-19,151421,11851,139570,92.2,950,194,20.4
9,All Students,2019-20,95028,5149,89879,94.6,894,119,13.3
9,All Students,2020-21,136393,12665,123728,90.7,805,211,26.2
9,All Students,2021-22,120908,s,s,s,s,s,s
9,All Students,2022-23,97179,5454,91725,94.4,632,103,16.3
10,All Students,2018-19,134353,10423,123930,92.2,840,160,19.0
10,All Students,2019-20,96536,6044,90492,93.7,905,134,14.8
10,All Students,2020-21,142477,15574,126903,89.1,830,208,25.1
10,All Students,2021-22,135986,14561,121425,89.3,840,298,35.5
10,All Students,2022-23,120995,8712,112283,92.8,783,146,18.6
11,All Students,2018-19,138451,10899,127552,92.1,856,185,21.6
11,All Students,2019-20,86320,4628,81692,94.6,798,76,9.5
11,All Students,2020-21,144595,16423,128172,88.6,848,239,28.2
11,All Students,2021-22,135864,16910,118954,87.6,838,348,41.5
11,All Students,2022-23,130421,8050,122371,93.8,823,134,16.3
12,All Students,2018-19,131939,15620,116319,88.2,804,269,33.5
12,All Students,2019-20,96493,8753,87740,90.9,887,182,20.5
12,All Students,2020-21,145621,23376,122245,83.9,857,353,41.2
12,All Students,2021-22,144885,22896,121989,84.2,891,459,51.5
12,All Students,2022-23,134621,11442,123179,91.5,838,221,26.4
All Grades,All Students,2018-19,129143,20217,108926,84.3,797,357,44.8
All Grades,All Students,2019-20,90454,10625,79829,88.3,837,288,34.4
All Grades,All Students,2020-21,143177,39158,104019,72.7,846,500,59.1
All Grades,All Students,2021-22,125073,23678,101395,81.1,769,471,61.2
All Grades,All Students,2022-23,119421,20139,99282,83.1,753,413,54.8
9,All Students,2018-19,41762,7038,34724,83.1,260,123,47.3
9,All Students,2019-20,30523,3979,26544,87.0,287,104,36.2
9,All Students,2020-21,39431,10706,28725,72.8,231,124,53.7
9,All Students,2021-22,32991,6353,26638,80.7,205,118,57.6
9,All Students,2022-23,36978,6272,30706,83.0,244,126,51.6
10,All Students,2018-19,37452,5317,32135,85.8,237,93,39.2
10,All Students,2019-20,21491,2116,19375,90.2,201,58,28.9
10,All Students,2020-21,43985,13514,30471,69.3,263,171,65.0
10,All Students,2021-22,33853,6758,27095,80.0,208,127,61.1
10,All Students,2022-23,31152,5699,25453,81.7,194,108,55.7
11,All Students,2018-19,28490,3595,24895,87.4,168,45,26.8
11,All Students,2019-20,19514,2380,17134,87.8,176,56,31.8
11,All Students,2020-21,27984,6610,21374,76.4,164,83,50.6
11,All Students,2021-22,30501,4863,25638,84.1,187,100,53.5
11,All Students,2022-23,22898,3241,19657,85.8,140,68,48.6
12,All Students,2018-19,21439,4267,17172,80.1,132,96,72.7
12,All Students,2019-20,18926,2150,16776,88.6,173,70,40.5
12,All Students,2020-21,31777,8328,23449,73.8,188,122,64.9
12,All Students,2021-22,27728,5704,22024,79.4,169,126,74.6
12,All Students,2022-23,28393,4927,23466,82.6,175,111,63.4
All Grades,All Students,2018-19,222079,8048,214031,96.4,1333,105,7.9
All Grades,All Students,2019-20,146800,4866,141934,96.7,1337,96,7.2
All Grades,All Students,2020-21,230417,5374,225043,97.7,1337,42,3.1
All Grades,All Students,2021-22,229932,10775,219157,95.3,1357,183,13.5
All Grades,All Students,2022-23,226430,7913,218517,96.5,1375,112,8.1
9,All Students,2018-19,55468,1125,54343,98.0,334,5,1.5
9,All Students,2019-20,36181,729,35452,98.0,330,3,0.9
9,All Students,2020-21,58788,665,58123,98.9,343,1,0.3
9,All Students,2021-22,57789,1226,56563,97.9,340,8,2.4
9,All Students,2022-23,55640,1181,54459,97.9,338,9,2.7
10,All Students,2018-19,55599,1496,54103,97.3,333,18,5.4
10,All Students,2019-20,36687,859,35828,97.7,334,11,3.3
10,All Students,2020-21,56932,1490,55442,97.4,331,9,2.7
10,All Students,2021-22,60746,2084,58662,96.6,360,31,8.6
10,All Students,2022-23,59598,1450,58148,97.6,362,14,3.9
11,All Students,2018-19,57085,1938,55147,96.6,343,19,5.5
11,All Students,2019-20,36312,1287,35025,96.5,331,22,6.6
11,All Students,2020-21,56932,1420,55512,97.5,331,11,3.3
11,All Students,2021-22,55297,2995,52302,94.6,327,48,14.7
11,All Students,2022-23,58080,1733,56347,97.0,352,23,6.5
12,All Students,2018-19,53927,3489,50438,93.5,323,63,19.5
12,All Students,2019-20,37620,1991,35629,94.7,342,60,17.5
12,All Students,2020-21,57765,1799,55966,96.9,332,21,6.3
12,All Students,2021-22,56100,4470,51630,92.0,330,96,29.1
12,All Students,2022-23,53112,3549,49563,93.3,323,66,20.4
All Grades,All Students,2018-19,160661,11066,149595,93.1,920,208,22.6
All Grades,All Students,2019-20,100379,6784,93595,93.2,902,207,22.9
All Grades,All Students,2020-21,152591,14583,138008,90.4,889,246,27.7
All Grades,All Students,2021-22,152659,16412,136247,89.2,896,368,41.1
All Grades,All Students,2022-23,147659,13688,133971,90.7,873,304,34.8
PK in K-12 Schools,All Students,2018-19,3185,224,2961,93.0,18,4,22.2
PK in K-12 Schools,All Students,2019-20,2066,246,1820,88.1,19,10,52.6
PK in K-12 Schools,All Students,2020-21,3145,382,2763,87.9,18,5,27.8
PK in K-12 Schools,All Students,2021-22,3144,577,2567,81.6,19,13,68.4
PK in K-12 Schools,All Students,2022-23,3126,338,2788,89.2,20,10,50.0
0K,All Students,2018-19,16881,1305,15576,92.3,97,25,25.8
0K,All Students,2019-20,10002,714,9288,92.9,92,28,30.4
0K,All Students,2020-21,16709,1963,14746,88.3,99,32,32.3
0K,All Students,2021-22,17486,2190,15296,87.5,101,56,55.4
0K,All Students,2022-23,16484,1947,14537,88.2,100,49,49.0
1,All Students,2018-19,17652,1150,16502,93.5,104,23,22.1
1,All Students,2019-20,10690,738,9952,93.1,98,25,25.5
1,All Students,2020-21,15539,1459,14080,90.6,91,21,23.1
1,All Students,2021-22,17027,1915,15112,88.8,102,50,49.0
1,All Students,2022-23,15862,1478,14384,90.7,94,34,36.2
2,All Students,2018-19,17870,1178,16692,93.4,101,24,23.8
2,All Students,2019-20,11556,777,10779,93.3,104,28,26.9
2,All Students,2020-21,14831,1068,13763,92.8,87,16,18.4
2,All Students,2021-22,16558,1728,14830,89.6,95,41,43.2
2,All Students,2022-23,16389,1587,14802,90.3,97,36,37.1
3,All Students,2018-19,18513,1272,17241,93.1,104,24,23.1
3,All Students,2019-20,11643,780,10863,93.3,104,22,21.2
3,All Students,2020-21,18285,1670,16615,90.9,107,32,29.9
3,All Students,2021-22,16123,1379,14744,91.4,96,27,28.1
3,All Students,2022-23,16044,1275,14769,92.1,96,28,29.2
4,All Students,2018-19,18643,1080,17563,94.2,106,20,18.9
4,All Students,2019-20,11426,749,10677,93.4,101,18,17.8
4,All Students,2020-21,18313,1562,16751,91.5,108,27,25.0
4,All Students,2021-22,17009,1659,15350,90.2,99,34,34.3
4,All Students,2022-23,16023,1165,14858,92.7,94,21,22.3
5,All Students,2018-19,18552,1177,17375,93.7,108,21,19.4
5,All Students,2019-20,11933,772,11161,93.5,106,18,17.0
5,All Students,2020-21,17757,1414,16343,92.0,103,26,25.2
5,All Students,2021-22,18082,1719,16363,90.5,109,38,34.9
5,All Students,2022-23,16364,1297,15067,92.1,98,32,32.7
6,All Students,2018-19,16233,1122,15111,93.1,93,17,18.3
6,All Students,2019-20,10409,643,9766,93.8,95,18,18.9
6,All Students,2020-21,17366,2013,15353,88.4,100,37,37.0
6,All Students,2021-22,16385,1827,14558,88.8,95,38,40.0
6,All Students,2022-23,16733,1375,15358,91.8,96,22,22.9
7,All Students,2018-19,16793,1295,15498,92.3,95,26,27.4
7,All Students,2019-20,10174,642,9532,93.7,90,16,17.8
7,All Students,2020-21,15283,1060,14223,93.1,88,17,19.3
7,All Students,2021-22,16481,1794,14687,89.1,95,37,38.9
7,All Students,2022-23,15546,1671,13875,89.3,91,35,38.5
8,All Students,2018-19,16339,1263,15076,92.3,94,24,25.5
8,All Students,2019-20,10480,723,9757,93.1,93,24,25.8
8,All Students,2020-21,15363,1992,13371,87.0,88,33,37.5
8,All Students,2021-22,14364,1624,12740,88.7,85,34,40.0
8,All Students,2022-23,15088,1555,13533,89.7,87,37,42.5
All Grades,All Students,2018-19,112837,9074,103763,92.0,682,209,30.6
All Grades,All Students,2019-20,68249,5577,62672,91.8,639,197,30.8
All Grades,All Students,2020-21,99089,12746,86343,87.1,594,251,42.3
All Grades,All Students,2021-22,93609,12507,81102,86.6,579,317,54.7
All Grades,All Students,2022-23,88551,7795,80756,91.2,549,181,33.0
PK in K-12 Schools,All Students,2018-19,6506,430,6076,93.4,41,11,26.8
PK in K-12 Schools,All Students,2019-20,4132,384,3748,90.7,39,12,30.8
PK in K-12 Schools,All Students,2020-21,6427,s,s,s,s,s,s
PK in K-12 Schools,All Students,2021-22,7011,1042,5969,85.1,47,32,68.1
PK in K-12 Schools,All Students,2022-23,7303,815,6488,88.8,45,19,42.2
0K,All Students,2018-19,9254,1190,8064,87.1,60,30,50.0
0K,All Students,2019-20,5999,634,5365,89.4,58,25,43.1
0K,All Students,2020-21,6963,1195,5768,82.8,43,23,53.5
0K,All Students,2021-22,6984,1207,5777,82.7,42,33,78.6
0K,All Students,2022-23,7251,762,6489,89.5,48,22,45.8
1,All Students,2018-19,10000,1139,8861,88.6,59,25,42.4
1,All Students,2019-20,5274,489,4785,90.7,49,20,40.8
1,All Students,2020-21,9695,1537,8158,84.1,61,35,57.4
1,All Students,2021-22,9450,1847,7603,80.5,62,48,77.4
1,All Students,2022-23,6680,620,6060,90.7,43,16,37.2
2,All Students,2018-19,11682,963,10719,91.8,69,22,31.9
2,All Students,2019-20,6866,627,6239,90.9,66,24,36.4
2,All Students,2020-21,8645,1444,7201,83.3,53,29,54.7
2,All Students,2021-22,8476,1127,7349,86.7,50,28,56.0
2,All Students,2022-23,8582,860,7722,90.0,57,21,36.8
3,All Students,2018-19,10921,801,10120,92.7,69,17,24.6
3,All Students,2019-20,6879,538,6341,92.2,67,18,26.9
3,All Students,2020-21,10518,1329,9189,87.4,63,30,47.6
3,All Students,2021-22,7397,921,6476,87.5,48,24,50.0
3,All Students,2022-23,8173,721,7452,91.2,50,19,38.0
4,All Students,2018-19,11399,891,10508,92.2,69,20,29.0
4,All Students,2019-20,6979,432,6547,93.8,65,11,16.9
4,All Students,2020-21,10706,943,9763,91.2,63,18,28.6
4,All Students,2021-22,9300,1122,8178,87.9,56,31,55.4
4,All Students,2022-23,7824,677,7147,91.3,47,17,36.2
5,All Students,2018-19,13841,901,12940,93.5,83,20,24.1
5,All Students,2019-20,6847,563,6284,91.8,63,24,38.1
5,All Students,2020-21,9959,836,9123,91.6,58,15,25.9
5,All Students,2021-22,10475,1324,9151,87.4,65,33,50.8
5,All Students,2022-23,10478,802,9676,92.3,64,15,23.4
6,All Students,2018-19,12985,872,12113,93.3,78,20,25.6
6,All Students,2019-20,8721,703,8018,91.9,82,25,30.5
6,All Students,2020-21,10808,1761,9047,83.7,64,32,50.0
6,All Students,2021-22,10363,1081,9282,89.6,64,25,39.1
6,All Students,2022-23,11649,1157,10492,90.1,71,26,36.6
7,All Students,2018-19,13398,746,12652,94.4,79,17,21.5
7,All Students,2019-20,7753,491,7262,93.7,70,17,24.3
7,All Students,2020-21,13015,1921,11094,85.2,76,38,50.0
7,All Students,2021-22,10816,1278,9538,88.2,65,29,44.6
7,All Students,2022-23,10227,544,9683,94.7,62,8,12.9
8,All Students,2018-19,12851,1141,11710,91.1,75,27,36.0
8,All Students,2019-20,8799,716,8083,91.9,80,21,26.3
8,All Students,2020-21,12330,828,11502,93.3,71,11,15.5
8,All Students,2021-22,13337,1558,11779,88.3,80,34,42.5
8,All Students,2022-23,10384,837,9547,91.9,62,18,29.0
9,All Students,2020-21,23,s,s,s,s,s,s
All Grades,All Students,2018-19,55042,5986,49056,89.1,333,140,42.0
All Grades,All Students,2019-20,32601,3439,29162,89.5,292,134,45.9
All Grades,All Students,2020-21,43130,6753,36377,84.3,271,157,57.9
All Grades,All Students,2021-22,43972,6647,37325,84.9,265,155,58.5
All Grades,All Students,2022-23,40820,6052,34768,85.2,254,140,55.1
PK in K-12 Schools,All Students,2018-19,3103,441,2662,85.8,19,11,57.9
PK in K-12 Schools,All Students,2019-20,3616,484,3132,86.6,33,21,63.6
PK in K-12 Schools,All Students,2020-21,3083,693,2390,77.5,24,17,70.8
PK in K-12 Schools,All Students,2021-22,4388,858,3530,80.4,28,20,71.4
PK in K-12 Schools,All Students,2022-23,5442,1217,4225,77.6,36,29,80.6
0K,All Students,2018-19,7991,892,7099,88.8,47,18,38.3
0K,All Students,2019-20,2728,341,2387,87.5,25,13,52.0
0K,All Students,2020-21,4543,907,3636,80.0,32,24,75.0
0K,All Students,2021-22,3094,625,2469,79.8,20,14,70.0
0K,All Students,2022-23,4343,710,3633,83.7,26,15,57.7
1,All Students,2018-19,7312,788,6524,89.2,44,19,43.2
1,All Students,2019-20,5134,592,4542,88.5,48,23,47.9
1,All Students,2020-21,4346,699,3647,83.9,27,15,55.6
1,All Students,2021-22,5358,787,4571,85.3,35,21,60.0
1,All Students,2022-23,3545,631,2914,82.2,23,12,52.2
2,All Students,2018-19,8936,1133,7803,87.3,54,28,51.9
2,All Students,2019-20,4655,466,4189,90.0,41,17,41.5
2,All Students,2020-21,7875,1407,6468,82.1,49,32,65.3
2,All Students,2021-22,7043,1035,6008,85.3,41,22,53.7
2,All Students,2022-23,6337,826,5511,87.0,38,19,50.0
3,All Students,2018-19,8989,863,8126,90.4,56,22,39.3
3,All Students,2019-20,5309,556,4753,89.5,47,22,46.8
3,All Students,2020-21,7372,810,6562,89.0,43,17,39.5
3,All Students,2021-22,8128,1116,7012,86.3,49,26,53.1
3,All Students,2022-23,5611,856,4755,84.7,35,16,45.7
4,All Students,2018-19,8750,887,7863,89.9,52,22,42.3
4,All Students,2019-20,5539,462,5077,91.7,49,18,36.7
4,All Students,2020-21,7933,1368,6565,82.8,48,32,66.7
4,All Students,2021-22,7579,850,6729,88.8,44,23,52.3
4,All Students,2022-23,8741,1115,7626,87.2,53,29,54.7
5,All Students,2018-19,9961,982,8979,90.1,61,20,32.8
5,All Students,2019-20,5620,538,5082,90.4,49,20,40.8
5,All Students,2020-21,7978,869,7109,89.1,48,20,41.7
5,All Students,2021-22,8382,1376,7006,83.6,48,29,60.4
5,All Students,2022-23,6801,697,6104,89.8,43,20,46.5
All Grades,All Students,2018-19,64509,3784,60725,94.1,413,71,17.2
All Grades,All Students,2019-20,48099,2566,45533,94.7,429,68,15.9
All Grades,All Students,2020-21,67072,8449,58623,87.4,415,180,43.4
All Grades,All Students,2021-22,66538,6543,59995,90.2,398,140,35.2
All Grades,All Students,2022-23,65885,5265,60620,92.0,400,126,31.5
0K,All Students,2018-19,9256,661,8595,92.9,66,16,24.2
0K,All Students,2019-20,8129,590,7539,92.7,74,16,21.6
0K,All Students,2020-21,7826,1245,6581,84.1,52,30,57.7
0K,All Students,2021-22,10590,1294,9296,87.8,62,29,46.8
0K,All Students,2022-23,12222,1027,11195,91.6,74,27,36.5
1,All Students,2018-19,10303,597,9706,94.2,68,13,19.1
1,All Students,2019-20,7280,408,6872,94.4,65,11,16.9
1,All Students,2020-21,11780,1790,9990,84.8,74,33,44.6
1,All Students,2021-22,8799,s,s,s,s,s,s
1,All Students,2022-23,9647,812,8835,91.6,59,21,35.6
2,All Students,2018-19,11410,587,10823,94.9,69,10,14.5
2,All Students,2019-20,6985,s,s,s,s,s,s
2,All Students,2020-21,11095,1589,9506,85.7,69,43,62.3
2,All Students,2021-22,12444,1081,11363,91.3,75,22,29.3
2,All Students,2022-23,9801,967,8834,90.1,60,21,35.0
3,All Students,2018-19,13072,748,12324,94.3,82,13,15.9
3,All Students,2019-20,8110,388,7722,95.2,72,10,13.9
3,All Students,2020-21,10496,1115,9381,89.4,63,20,31.7
3,All Students,2021-22,11030,970,10060,91.2,67,19,28.4
3,All Students,2022-23,11385,762,10623,93.3,70,17,24.3
4,All Students,2018-19,10957,568,10389,94.8,69,7,10.1
4,All Students,2019-20,9557,471,9086,95.1,85,14,16.5
4,All Students,2020-21,12512,1466,11046,88.3,76,28,36.8
4,All Students,2021-22,11099,982,10117,91.2,66,19,28.8
4,All Students,2022-23,11118,848,10270,92.4,67,21,31.3
5,All Students,2018-19,9511,623,8888,93.4,59,12,20.3
5,All Students,2019-20,8027,374,7653,95.3,71,8,11.3
5,All Students,2020-21,13363,1244,12119,90.7,81,26,32.1
5,All Students,2021-22,12546,1106,11440,91.2,73,25,34.2
5,All Students,2022-23,11712,849,10863,92.8,70,19,27.1
6,All Students,2019-20,11,s,s,s,s,s,s
6,All Students,2021-22,30,s,s,s,s,s,s
All Grades,All Students,2018-19,71526,6684,64842,90.7,425,156,36.7
All Grades,All Students,2019-20,45645,4473,41172,90.2,410,151,36.8
All Grades,All Students,2020-21,60335,9744,50591,83.9,367,186,50.7
All Grades,All Students,2021-22,61774,7855,53919,87.3,374,194,51.9
All Grades,All Students,2022-23,63862,7586,56276,88.1,394,194,49.2
PK in K-12 Schools,All Students,2018-19,4908,492,4416,90.0,32,14,43.8
PK in K-12 Schools,All Students,2019-20,5430,661,4769,87.8,49,26,53.1
PK in K-12 Schools,All Students,2020-21,7101,s,s,s,s,s,s
PK in K-12 Schools,All Students,2021-22,8564,1587,6977,81.5,50,37,74.0
PK in K-12 Schools,All Students,2022-23,7412,s,s,s,s,s,s
0K,All Students,2018-19,6995,728,6267,89.6,44,18,40.9
0K,All Students,2019-20,5119,583,4536,88.6,47,23,48.9
0K,All Students,2020-21,7130,1939,5191,72.8,42,30,71.4
0K,All Students,2021-22,7629,1134,6495,85.1,47,26,55.3
0K,All Students,2022-23,9127,1513,7614,83.4,59,39,66.1
1,All Students,2018-19,10954,1066,9888,90.3,64,23,35.9
1,All Students,2019-20,5236,554,4682,89.4,46,19,41.3
1,All Students,2020-21,8248,1381,6867,83.3,51,31,60.8
1,All Students,2021-22,8155,1104,7051,86.5,50,30,60.0
1,All Students,2022-23,9207,1099,8108,88.1,58,26,44.8
2,All Students,2018-19,11131,1062,10069,90.5,67,24,35.8
2,All Students,2019-20,7141,682,6459,90.4,64,21,32.8
2,All Students,2020-21,7448,1127,6321,84.9,46,18,39.1
2,All Students,2021-22,7604,809,6795,89.4,46,20,43.5
2,All Students,2022-23,7974,831,7143,89.6,50,21,42.0
3,All Students,2018-19,12747,1119,11628,91.2,75,25,33.3
3,All Students,2019-20,7010,578,6432,91.8,63,17,27.0
3,All Students,2020-21,9503,1362,8141,85.7,56,28,50.0
3,All Students,2021-22,8624,915,7709,89.4,51,24,47.1
3,All Students,2022-23,9335,972,8363,89.6,58,27,46.6
4,All Students,2018-19,12230,1247,10983,89.8,70,28,40.0
4,All Students,2019-20,8027,712,7315,91.1,71,25,35.2
4,All Students,2020-21,9490,1407,8083,85.2,61,29,47.5
4,All Students,2021-22,10543,1216,9327,88.5,67,34,50.7
4,All Students,2022-23,9162,830,8332,90.9,53,20,37.7
5,All Students,2018-19,12561,970,11591,92.3,73,24,32.9
5,All Students,2019-20,7682,703,6979,90.8,70,20,28.6
5,All Students,2020-21,11402,1682,9720,85.2,68,29,42.6
5,All Students,2021-22,10655,1090,9565,89.8,63,23,36.5
5,All Students,2022-23,11628,1115,10513,90.4,69,26,37.7
6,All Students,2020-21,13,s,s,s,s,s,s
6,All Students,2022-23,17,s,s,s,s,s,s
All Grades,All Students,2018-19,62519,4705,57814,92.5,382,97,25.4
All Grades,All Students,2019-20,39351,2789,36562,92.9,357,91,25.5
All Grades,All Students,2020-21,58308,5230,53078,91.0,377,108,28.6
All Grades,All Students,2021-22,64093,6640,57453,89.6,395,156,39.5
All Grades,All Students,2022-23,64018,5631,58387,91.2,388,129,33.2
PK in K-12 Schools,All Students,2019-20,1643,217,1426,86.8,15,9,60.0
PK in K-12 Schools,All Students,2020-21,5635,325,5310,94.2,34,4,11.8
PK in K-12 Schools,All Students,2021-22,5288,778,4510,85.3,32,19,59.4
PK in K-12 Schools,All Students,2022-23,5403,759,4644,86.0,34,14,41.2
0K,All Students,2018-19,8682,736,7946,91.5,52,17,32.7
0K,All Students,2019-20,4815,379,4436,92.1,45,14,31.1
0K,All Students,2020-21,5894,513,5381,91.3,38,9,23.7
0K,All Students,2021-22,9472,1208,8264,87.2,58,26,44.8
0K,All Students,2022-23,7177,713,6464,90.1,46,15,32.6
1,All Students,2018-19,8930,578,8352,93.5,59,13,22.0
1,All Students,2019-20,6265,539,5726,91.4,57,16,28.1
1,All Students,2020-21,7781,651,7130,91.6,52,14,26.9
1,All Students,2021-22,7831,792,7039,89.9,49,21,42.9
1,All Students,2022-23,9781,895,8886,90.8,60,20,33.3
2,All Students,2018-19,6550,s,s,s,s,s,s
2,All Students,2019-20,5837,313,5524,94.6,52,8,15.4
2,All Students,2020-21,10182,1138,9044,88.8,68,24,35.3
2,All Students,2021-22,8936,798,8138,91.1,54,18,33.3
2,All Students,2022-23,8160,755,7405,90.7,49,22,44.9
3,All Students,2018-19,12267,878,11389,92.8,73,15,20.5
3,All Students,2019-20,5407,363,5044,93.3,50,11,22.0
3,All Students,2020-21,9401,769,8632,91.8,60,16,26.7
3,All Students,2021-22,12259,1349,10910,89.0,75,33,44.0
3,All Students,2022-23,9176,684,8492,92.5,55,15,27.3
4,All Students,2018-19,12077,881,11196,92.7,74,16,21.6
4,All Students,2019-20,7113,465,6648,93.5,64,15,23.4
4,All Students,2020-21,8566,823,7743,90.4,56,17,30.4
4,All Students,2021-22,10943,781,10162,92.9,68,18,26.5
4,All Students,2022-23,13186,1111,12075,91.6,78,26,33.3
5,All Students,2018-19,14006,1085,12921,92.3,82,23,28.0
5,All Students,2019-20,8271,513,7758,93.8,74,18,24.3
5,All Students,2020-21,10849,1011,9838,90.7,69,24,34.8
5,All Students,2021-22,9364,934,8430,90.0,59,21,35.6
5,All Students,2022-23,11135,714,10421,93.6,66,17,25.8
6,All Students,2018-19,7,s,s,s,s,s,s
All Grades,All Students,2018-19,104163,6197,97966,94.1,620,124,20.0
All Grades,All Students,2019-20,68386,4121,64265,94.0,620,114,18.4
All Grades,All Students,2020-21,93375,7997,85378,91.4,590,188,31.9
All Grades,All Students,2021-22,94216,8249,85967,91.2,583,192,32.9
All Grades,All Students,2022-23,92771,8654,84117,90.7,568,220,38.7
PK in K-12 Schools,All Students,2018-19,6197,668,5529,89.2,39,19,48.7
PK in K-12 Schools,All Students,2019-20,5359,663,4696,87.6,48,22,45.8
PK in K-12 Schools,All Students,2020-21,6920,886,6034,87.2,48,26,54.2
PK in K-12 Schools,All Students,2021-22,7933,904,7029,88.6,53,26,49.1
PK in K-12 Schools,All Students,2022-23,8612,s,s,s,s,s,s
0K,All Students,2018-19,13114,956,12158,92.7,78,21,26.9
0K,All Students,2019-20,7593,623,6970,91.8,69,20,29.0
0K,All Students,2020-21,11674,1384,10290,88.1,76,33,43.4
0K,All Students,2021-22,12107,1375,10732,88.6,74,33,44.6
0K,All Students,2022-23,10818,1149,9669,89.4,70,36,51.4
1,All Students,2018-19,13963,922,13041,93.4,83,18,21.7
1,All Students,2019-20,10009,662,9347,93.4,91,21,23.1
1,All Students,2020-21,13287,1420,11867,89.3,84,31,36.9
1,All Students,2021-22,14446,1462,12984,89.9,92,37,40.2
1,All Students,2022-23,11850,1398,10452,88.2,71,35,49.3
2,All Students,2018-19,14278,952,13326,93.3,87,17,19.5
2,All Students,2019-20,9323,569,8754,93.9,84,19,22.6
2,All Students,2020-21,14805,1097,13708,92.6,94,25,26.6
2,All Students,2021-22,15022,1234,13788,91.8,96,28,29.2
2,All Students,2022-23,15021,1546,13475,89.7,97,40,41.2
3,All Students,2018-19,18892,985,17907,94.8,111,18,16.2
3,All Students,2019-20,8927,444,8483,95.0,84,8,9.5
3,All Students,2020-21,14971,979,13992,93.5,91,24,26.4
3,All Students,2021-22,14991,1059,13932,92.9,90,22,24.4
3,All Students,2022-23,14956,1434,13522,90.4,90,36,40.0
4,All Students,2018-19,21500,904,20596,95.8,128,16,12.5
4,All Students,2019-20,12913,553,12360,95.7,117,10,8.5
4,All Students,2020-21,12982,921,12061,92.9,83,24,28.9
4,All Students,2021-22,15817,1170,14647,92.6,93,23,24.7
4,All Students,2022-23,15116,1030,14086,93.2,90,23,25.6
5,All Students,2018-19,16219,810,15409,95.0,94,15,16.0
5,All Students,2019-20,14262,607,13655,95.7,127,14,11.0
5,All Students,2020-21,18720,1294,17426,93.1,114,25,21.9
5,All Students,2021-22,13900,1045,12855,92.5,85,23,27.1
5,All Students,2022-23,16395,1162,15233,92.9,98,27,27.6
6,All Students,2022-23,3,s,s,s,s,s,s
All Grades,All Students,2018-19,92256,6364,85892,93.1,579,154,26.6
All Grades,All Students,2019-20,57784,4152,53632,92.8,527,149,28.3
All Grades,All Students,2020-21,82871,10617,72254,87.2,500,207,41.4
All Grades,All Students,2021-22,83582,8645,74937,89.7,499,205,41.1
All Grades,All Students,2022-23,82077,8846,73231,89.2,505,212,42.0
PK in K-12 Schools,All Students,2018-19,6387,878,5509,86.3,49,29,59.2
PK in K-12 Schools,All Students,2019-20,5572,586,4986,89.5,51,24,47.1
PK in K-12 Schools,All Students,2020-21,10417,884,9533,91.5,66,20,30.3
PK in K-12 Schools,All Students,2021-22,10307,1157,9150,88.8,61,28,45.9
PK in K-12 Schools,All Students,2022-23,9854,s,s,s,s,s,s
0K,All Students,2018-19,13319,1033,12286,92.2,84,23,27.4
0K,All Students,2019-20,7893,839,7054,89.4,79,35,44.3
0K,All Students,2020-21,10477,1603,8874,84.7,64,28,43.8
0K,All Students,2021-22,12845,1437,11408,88.8,77,37,48.1
0K,All Students,2022-23,11416,1500,9916,86.9,71,35,49.3
1,All Students,2018-19,15120,1158,13962,92.3,96,31,32.3
1,All Students,2019-20,8557,688,7869,92.0,78,29,37.2
1,All Students,2020-21,11805,1895,9910,83.9,71,34,47.9
1,All Students,2021-22,10603,1339,9264,87.4,64,30,46.9
1,All Students,2022-23,11874,1440,10434,87.9,70,31,44.3
2,All Students,2018-19,12310,774,11536,93.7,82,22,26.8
2,All Students,2019-20,9857,626,9231,93.6,87,19,21.8
2,All Students,2020-21,11915,1495,10420,87.5,73,34,46.6
2,All Students,2021-22,10836,1241,9595,88.5,67,32,47.8
2,All Students,2022-23,11308,1400,9908,87.6,68,37,54.4
3,All Students,2018-19,12703,737,11966,94.2,76,15,19.7
3,All Students,2019-20,7644,437,7207,94.3,70,15,21.4
3,All Students,2020-21,14371,2248,12123,84.4,86,45,52.3
3,All Students,2021-22,11579,1126,10453,90.3,70,25,35.7
3,All Students,2022-23,10485,1016,9469,90.3,65,24,36.9
4,All Students,2018-19,14775,859,13916,94.2,91,17,18.7
4,All Students,2019-20,8310,424,7886,94.9,74,9,12.2
4,All Students,2020-21,11672,1236,10436,89.4,69,25,36.2
4,All Students,2021-22,14945,1298,13647,91.3,88,25,28.4
4,All Students,2022-23,12181,1091,11090,91.0,76,22,28.9
5,All Students,2018-19,17642,925,16717,94.8,101,17,16.8
5,All Students,2019-20,9951,552,9399,94.5,88,18,20.5
5,All Students,2020-21,12214,1256,10958,89.7,71,21,29.6
5,All Students,2021-22,12467,1047,11420,91.6,72,28,38.9
5,All Students,2022-23,14956,1115,13841,92.5,87,26,29.9
6,All Students,2022-23,3,s,s,s,s,s,s
All Grades,All Students,2018-19,52635,3016,49619,94.3,315,55,17.5
All Grades,All Students,2019-20,37190,2812,34378,92.4,341,91,26.7
All Grades,All Students,2020-21,53874,5593,48281,89.6,340,136,40.0
All Grades,All Students,2021-22,55688,5297,50391,90.5,344,133,38.7
All Grades,All Students,2022-23,50082,4386,45696,91.2,301,94,31.2
PK in K-12 Schools,All Students,2018-19,6073,408,5665,93.3,36,9,25.0
PK in K-12 Schools,All Students,2019-20,5953,640,5313,89.2,58,23,39.7
PK in K-12 Schools,All Students,2020-21,9228,1465,7763,84.1,60,37,61.7
PK in K-12 Schools,All Students,2021-22,9094,1074,8020,88.2,58,34,58.6
PK in K-12 Schools,All Students,2022-23,8272,1191,7081,85.6,52,29,55.8
0K,All Students,2018-19,6298,460,5838,92.7,38,12,31.6
0K,All Students,2019-20,5569,448,5121,92.0,49,15,30.6
0K,All Students,2020-21,6789,928,5861,86.3,44,21,47.7
0K,All Students,2021-22,8301,863,7438,89.6,52,23,44.2
0K,All Students,2022-23,6438,498,5940,92.3,38,11,28.9
1,All Students,2018-19,6232,404,5828,93.5,38,12,31.6
1,All Students,2019-20,4994,357,4637,92.9,47,12,25.5
1,All Students,2020-21,8233,1207,7026,85.3,51,32,62.7
1,All Students,2021-22,6560,650,5910,90.1,41,18,43.9
1,All Students,2022-23,8209,665,7544,91.9,48,15,31.3
2,All Students,2018-19,8637,532,8105,93.8,51,6,11.8
2,All Students,2019-20,4110,310,3800,92.5,37,8,21.6
2,All Students,2020-21,6429,424,6005,93.4,40,8,20.0
2,All Students,2021-22,9122,816,8306,91.1,54,19,35.2
2,All Students,2022-23,6763,583,6180,91.4,41,10,24.4
3,All Students,2018-19,9095,454,8641,95.0,54,6,11.1
3,All Students,2019-20,5635,328,5307,94.2,50,9,18.0
3,All Students,2020-21,7478,733,6745,90.2,48,20,41.7
3,All Students,2021-22,6187,634,5553,89.8,40,17,42.5
3,All Students,2022-23,7379,504,6875,93.2,44,7,15.9
4,All Students,2018-19,7014,287,6727,95.9,42,3,7.1
4,All Students,2019-20,5305,439,4866,91.7,49,16,32.7
4,All Students,2020-21,7980,281,7699,96.5,49,5,10.2
4,All Students,2021-22,8360,730,7630,91.3,51,14,27.5
4,All Students,2022-23,5661,446,5215,92.1,33,9,27.3
5,All Students,2018-19,9286,471,8815,94.9,56,7,12.5
5,All Students,2019-20,5624,290,5334,94.8,51,8,15.7
5,All Students,2020-21,7737,555,7182,92.8,48,13,27.1
5,All Students,2021-22,8064,530,7534,93.4,48,8,16.7
5,All Students,2022-23,7360,499,6861,93.2,45,13,28.9
All Grades,All Students,2018-19,58258,4363,53895,92.5,353,89,25.2
All Grades,All Students,2019-20,36373,2590,33783,92.9,328,73,22.3
All Grades,All Students,2020-21,57847,3671,54176,93.7,351,64,18.2
All Grades,All Students,2021-22,53578,3192,50386,94.0,324,58,17.9
All Grades,All Students,2022-23,52226,3330,48896,93.6,320,60,18.8
5,All Students,2020-21,1,s,s,s,s,s,s
5,All Students,2021-22,9,s,s,s,s,s,s
6,All Students,2018-19,21959,1300,20659,94.1,134,28,20.9
6,All Students,2019-20,11204,670,10534,94.0,101,16,15.8
6,All Students,2020-21,17752,913,16839,94.9,109,17,15.6
6,All Students,2021-22,17491,877,16614,95.0,107,14,13.1
6,All Students,2022-23,15565,934,14631,94.0,97,19,19.6
7,All Students,2018-19,14270,944,13326,93.4,88,22,25.0
7,All Students,2019-20,14798,989,13809,93.3,136,37,27.2
7,All Students,2020-21,17390,s,s,s,s,s,s
7,All Students,2021-22,17090,s,s,s,s,s,s
7,All Students,2022-23,19243,1124,18119,94.2,115,18,15.7
8,All Students,2018-19,22029,2119,19910,90.4,131,39,29.8
8,All Students,2019-20,10371,931,9440,91.0,91,20,22.0
8,All Students,2020-21,22704,1705,20999,92.5,134,29,21.6
8,All Students,2021-22,18988,1324,17664,93.0,112,27,24.1
8,All Students,2022-23,17418,1272,16146,92.7,108,23,21.3
All Grades,All Students,2018-19,46396,4512,41884,90.3,295,101,34.2
All Grades,All Students,2019-20,33418,2575,30843,92.3,315,74,23.5
All Grades,All Students,2020-21,64172,9517,54655,85.2,382,151,39.5
All Grades,All Students,2021-22,60956,6606,54350,89.2,379,129,34.0
All Grades,All Students,2022-23,55624,6276,49348,88.7,365,159,43.6
7,All Students,2018-19,3,s,s,s,s,s,s
8,All Students,2021-22,18,s,s,s,s,s,s
9,All Students,2018-19,14553,1602,12951,89.0,101,33,32.7
9,All Students,2019-20,11706,936,10770,92.0,114,27,23.7
9,All Students,2020-21,26108,3905,22203,85.0,156,63,40.4
9,All Students,2021-22,22348,2962,19386,86.7,138,55,39.9
9,All Students,2022-23,15890,2189,13701,86.2,112,56,50.0
10,All Students,2018-19,12357,1041,11316,91.6,76,22,28.9
10,All Students,2019-20,8496,562,7934,93.4,80,19,23.8
10,All Students,2020-21,15558,2494,13064,84.0,93,37,39.8
10,All Students,2021-22,18847,1887,16960,90.0,118,39,33.1
10,All Students,2022-23,15744,1570,14174,90.0,104,41,39.4
11,All Students,2018-19,9981,910,9071,90.9,61,19,31.1
11,All Students,2019-20,6679,485,6194,92.7,61,12,19.7
11,All Students,2020-21,11885,1493,10392,87.4,71,23,32.4
11,All Students,2021-22,8580,s,s,s,s,s,s
11,All Students,2022-23,14417,1183,13234,91.8,91,29,31.9
12,All Students,2018-19,9502,s,s,s,s,s,s
12,All Students,2019-20,6537,592,5945,90.9,60,16,26.7
12,All Students,2020-21,10621,1625,8996,84.7,62,28,45.2
12,All Students,2021-22,11163,994,10169,91.1,68,19,27.9
12,All Students,2022-23,9573,1334,8239,86.1,58,33,56.9
All Grades,All Students,2018-19,64307,5327,58980,91.7,403,139,34.5
All Grades,All Students,2019-20,41755,3212,38543,92.3,389,123,31.6
All Grades,All Students,2020-21,61687,5920,55767,90.4,391,152,38.9
All Grades,All Students,2021-22,63121,7734,55387,87.7,390,193,49.5
All Grades,All Students,2022-23,56526,6182,50344,89.1,386,172,44.6
PK in K-12 Schools,All Students,2018-19,6302,634,5668,89.9,41,18,43.9
PK in K-12 Schools,All Students,2019-20,4064,457,3607,88.8,38,19,50.0
PK in K-12 Schools,All Students,2020-21,4046,411,3635,89.8,27,12,44.4
PK in K-12 Schools,All Students,2021-22,4024,612,3412,84.8,28,23,82.1
PK in K-12 Schools,All Students,2022-23,4727,655,4072,86.1,37,24,64.9
0K,All Students,2018-19,7573,815,6758,89.2,49,26,53.1
0K,All Students,2019-20,7450,591,6859,92.1,71,24,33.8
0K,All Students,2020-21,9544,1362,8182,85.7,62,38,61.3
0K,All Students,2021-22,8366,1092,7274,86.9,50,29,58.0
0K,All Students,2022-23,7112,809,6303,88.6,51,21,41.2
1,All Students,2018-19,8696,750,7946,91.4,56,18,32.1
1,All Students,2019-20,4403,393,4010,91.1,42,19,45.2
1,All Students,2020-21,11775,877,10898,92.6,72,20,27.8
1,All Students,2021-22,10855,1463,9392,86.5,66,36,54.5
1,All Students,2022-23,7502,800,6702,89.3,52,26,50.0
2,All Students,2018-19,9436,712,8724,92.5,58,21,36.2
2,All Students,2019-20,6009,414,5595,93.1,56,13,23.2
2,All Students,2020-21,7743,836,6907,89.2,54,25,46.3
2,All Students,2021-22,11448,1519,9929,86.7,71,36,50.7
2,All Students,2022-23,10515,1074,9441,89.8,72,33,45.8
3,All Students,2018-19,9828,752,9076,92.3,60,18,30.0
3,All Students,2019-20,6097,392,5705,93.6,57,16,28.1
3,All Students,2020-21,8351,795,7556,90.5,52,21,40.4
3,All Students,2021-22,8869,1062,7807,88.0,55,28,50.9
3,All Students,2022-23,9691,913,8778,90.6,59,24,40.7
4,All Students,2018-19,12851,979,11872,92.4,80,23,28.8
4,All Students,2019-20,6134,437,5697,92.9,57,16,28.1
4,All Students,2020-21,10179,754,9425,92.6,61,15,24.6
4,All Students,2021-22,8634,855,7779,90.1,55,18,32.7
4,All Students,2022-23,7931,922,7009,88.4,53,20,37.7
5,All Students,2018-19,9621,685,8936,92.9,59,15,25.4
5,All Students,2019-20,7598,528,7070,93.1,68,16,23.5
5,All Students,2020-21,10049,885,9164,91.2,63,21,33.3
5,All Students,2021-22,10925,1131,9794,89.6,65,23,35.4
5,All Students,2022-23,9048,1009,8039,88.8,62,24,38.7
All Grades,All Students,2018-19,52323,5452,46871,89.6,332,128,38.6
All Grades,All Students,2019-20,38079,3145,34934,91.7,352,101,28.7
All Grades,All Students,2020-21,54586,6255,48331,88.5,329,135,41.0
All Grades,All Students,2021-22,51340,5560,45780,89.2,316,131,41.5
All Grades,All Students,2022-23,48598,4900,43698,89.9,304,99,32.6
6,All Students,2018-19,18771,1646,17125,91.2,123,38,30.9
6,All Students,2019-20,12489,898,11591,92.8,116,25,21.6
6,All Students,2020-21,14851,1519,13332,89.8,92,31,33.7
6,All Students,2021-22,16036,1570,14466,90.2,102,34,33.3
6,All Students,2022-23,14938,1379,13559,90.8,95,23,24.2
7,All Students,2018-19,15917,s,s,s,s,s,s
7,All Students,2019-20,13955,1236,12719,91.1,127,39,30.7
7,All Students,2020-21,19298,2120,17178,89.0,115,46,40.0
7,All Students,2021-22,15021,s,s,s,s,s,s
7,All Students,2022-23,17716,1693,16023,90.4,111,45,40.5
8,All Students,2018-19,17629,2249,15380,87.2,110,48,43.6
8,All Students,2019-20,11622,s,s,s,s,s,s
8,All Students,2020-21,20437,2616,17821,87.2,122,58,47.5
8,All Students,2021-22,20209,2420,17789,88.0,122,60,49.2
8,All Students,2022-23,15944,1828,14116,88.5,98,31,31.6
9,All Students,2018-19,6,s,s,s,s,s,s
9,All Students,2019-20,13,s,s,s,s,s,s
9,All Students,2021-22,74,s,s,s,s,s,s
All Grades,All Students,2018-19,41549,3085,38464,92.6,269,81,30.1
All Grades,All Students,2019-20,20844,1545,19299,92.6,197,62,31.5
All Grades,All Students,2020-21,31404,2367,29037,92.5,203,43,21.2
All Grades,All Students,2021-22,37540,3890,33650,89.6,231,88,38.1
All Grades,All Students,2022-23,35469,3024,32445,91.5,226,79,35.0
PK in K-12 Schools,All Students,2018-19,3645,279,3366,92.3,22,7,31.8
PK in K-12 Schools,All Students,2019-20,1896,219,1677,88.4,20,10,50.0
PK in K-12 Schools,All Students,2020-21,4879,540,4339,88.9,36,13,36.1
PK in K-12 Schools,All Students,2021-22,7335,754,6581,89.7,45,18,40.0
PK in K-12 Schools,All Students,2022-23,4601,494,4107,89.3,32,14,43.8
0K,All Students,2018-19,4731,414,4317,91.2,31,11,35.5
0K,All Students,2019-20,3531,269,3262,92.4,32,11,34.4
0K,All Students,2020-21,4543,421,4122,90.7,30,7,23.3
0K,All Students,2021-22,4908,645,4263,86.9,32,16,50.0
0K,All Students,2022-23,5102,501,4601,90.2,33,12,36.4
1,All Students,2018-19,4726,346,4380,92.7,31,8,25.8
1,All Students,2019-20,2186,194,1992,91.1,25,12,48.0
1,All Students,2020-21,5146,340,4806,93.4,33,5,15.2
1,All Students,2021-22,6146,852,5294,86.1,39,19,48.7
1,All Students,2022-23,4575,540,4035,88.2,30,16,53.3
2,All Students,2018-19,6354,556,5798,91.2,44,16,36.4
2,All Students,2019-20,2484,119,2365,95.2,22,3,13.6
2,All Students,2020-21,3262,290,2972,91.1,20,3,15.0
2,All Students,2021-22,5977,462,5515,92.3,35,12,34.3
2,All Students,2022-23,6427,601,5826,90.6,38,14,36.8
3,All Students,2018-19,6934,555,6379,92.0,46,18,39.1
3,All Students,2019-20,3393,264,3129,92.2,33,10,30.3
3,All Students,2020-21,4032,200,3832,95.0,26,3,11.5
3,All Students,2021-22,3467,347,3120,90.0,22,8,36.4
3,All Students,2022-23,6099,349,5750,94.3,38,10,26.3
4,All Students,2018-19,6168,398,5770,93.5,40,10,25.0
4,All Students,2019-20,3121,232,2889,92.6,28,7,25.0
4,All Students,2020-21,5132,285,4847,94.4,32,6,18.8
4,All Students,2021-22,4410,310,4100,93.0,27,5,18.5
4,All Students,2022-23,3999,295,3704,92.6,25,7,28.0
5,All Students,2018-19,8991,537,8454,94.0,55,11,20.0
5,All Students,2019-20,4233,248,3985,94.1,37,9,24.3
5,All Students,2020-21,4410,291,4119,93.4,26,6,23.1
5,All Students,2021-22,5297,520,4777,90.2,31,10,32.3
5,All Students,2022-23,4666,244,4422,94.8,30,6,20.0
All Grades,All Students,2018-19,56274,4969,51305,91.2,342,105,30.7
All Grades,All Students,2019-20,33500,2655,30845,92.1,301,72,23.9
All Grades,All Students,2020-21,44009,4516,39493,89.7,272,81,29.8
All Grades,All Students,2021-22,50477,5061,45416,90.0,299,112,37.5
All Grades,All Students,2022-23,46211,4312,41899,90.7,279,92,33.0
5,All Students,2020-21,19,s,s,s,s,s,s
6,All Students,2018-19,16912,1150,15762,93.2,104,26,25.0
6,All Students,2019-20,9026,725,8301,92.0,81,18,22.2
6,All Students,2020-21,12453,s,s,s,s,s,s
6,All Students,2021-22,17668,1934,15734,89.1,106,41,38.7
6,All Students,2022-23,11226,1116,10110,90.1,72,26,36.1
7,All Students,2018-19,17852,1514,16338,91.5,109,31,28.4
7,All Students,2019-20,12021,785,11236,93.5,109,19,17.4
7,All Students,2020-21,13532,1485,12047,89.0,86,28,32.6
7,All Students,2021-22,15652,1616,14036,89.7,91,35,38.5
7,All Students,2022-23,18289,1674,16615,90.8,109,31,28.4
8,All Students,2018-19,21510,2305,19205,89.3,129,48,37.2
8,All Students,2019-20,12453,1145,11308,90.8,111,35,31.5
8,All Students,2020-21,18005,1876,16129,89.6,107,36,33.6
8,All Students,2021-22,17157,1511,15646,91.2,102,36,35.3
8,All Students,2022-23,16696,1522,15174,90.9,98,35,35.7
All Grades,All Students,2018-19,57952,4345,53607,92.5,338,81,24.0
All Grades,All Students,2019-20,34183,2289,31894,93.3,306,72,23.5
All Grades,All Students,2020-21,49143,4983,44160,89.9,291,92,31.6
All Grades,All Students,2021-22,44774,4732,40042,89.4,265,108,40.8
All Grades,All Students,2022-23,44542,4564,39978,89.8,268,102,38.1
6,All Students,2018-19,17278,1234,16044,92.9,101,26,25.7
6,All Students,2019-20,8492,s,s,s,s,s,s
6,All Students,2020-21,19119,2518,16601,86.8,113,45,39.8
6,All Students,2021-22,13834,1429,12405,89.7,84,31,36.9
6,All Students,2022-23,14184,1473,12711,89.6,86,33,38.4
7,All Students,2018-19,21826,1506,20320,93.1,127,24,18.9
7,All Students,2019-20,11332,742,10590,93.5,102,27,26.5
7,All Students,2020-21,12759,1228,11531,90.4,75,23,30.7
7,All Students,2021-22,17568,1892,15676,89.2,103,44,42.7
7,All Students,2022-23,12420,1111,11309,91.1,77,25,32.5
8,All Students,2018-19,18848,1605,17243,91.5,110,31,28.2
8,All Students,2019-20,14356,966,13390,93.3,126,26,20.6
8,All Students,2020-21,17265,1237,16028,92.8,103,24,23.3
8,All Students,2021-22,13372,1411,11961,89.4,78,33,42.3
8,All Students,2022-23,17938,1980,15958,89.0,105,44,41.9
9,All Students,2019-20,3,s,s,s,s,s,s
All Grades,All Students,2018-19,93811,5465,88346,94.2,549,87,15.8
All Grades,All Students,2019-20,60067,3206,56861,94.7,535,79,14.8
All Grades,All Students,2020-21,81875,4843,77032,94.1,493,95,19.3
All Grades,All Students,2021-22,83460,6598,76862,92.1,484,127,26.2
All Grades,All Students,2022-23,88084,8178,79906,90.7,520,183,35.2
0K,All Students,2018-19,16129,1034,15095,93.6,95,23,24.2
0K,All Students,2019-20,9072,474,8598,94.8,81,8,9.9
0K,All Students,2020-21,9351,s,s,s,s,s,s
0K,All Students,2021-22,15571,1635,13936,89.5,91,29,31.9
0K,All Students,2022-23,14854,1685,13169,88.7,88,38,43.2
1,All Students,2018-19,13287,962,12325,92.8,78,17,21.8
1,All Students,2019-20,10533,642,9891,93.9,93,15,16.1
1,All Students,2020-21,13644,762,12882,94.4,83,13,15.7
1,All Students,2021-22,10340,s,s,s,s,s,s
1,All Students,2022-23,15605,1752,13853,88.8,92,42,45.7
2,All Students,2018-19,13308,694,12614,94.8,78,8,10.3
2,All Students,2019-20,9365,557,8808,94.1,84,16,19.0
2,All Students,2020-21,15766,1069,14697,93.2,92,22,23.9
2,All Students,2021-22,14719,1039,13680,92.9,84,25,29.8
2,All Students,2022-23,11569,987,10582,91.5,69,18,26.1
3,All Students,2018-19,18077,987,17090,94.5,104,14,13.5
3,All Students,2019-20,8635,361,8274,95.8,77,10,13.0
3,All Students,2020-21,13522,742,12780,94.5,81,14,17.3
3,All Students,2021-22,15485,1084,14401,93.0,89,20,22.5
3,All Students,2022-23,15036,1188,13848,92.1,89,28,31.5
4,All Students,2018-19,16370,828,15542,94.9,97,12,12.4
4,All Students,2019-20,11534,687,10847,94.0,101,18,17.8
4,All Students,2020-21,12790,710,12080,94.4,78,14,17.9
4,All Students,2021-22,13914,1182,12732,91.5,82,25,30.5
4,All Students,2022-23,16204,1308,14896,91.9,94,29,30.9
5,All Students,2018-19,16640,960,15680,94.2,97,13,13.4
5,All Students,2019-20,10928,485,10443,95.6,99,12,12.1
5,All Students,2020-21,16799,897,15902,94.7,99,15,15.2
5,All Students,2021-22,13427,857,12570,93.6,77,15,19.5
5,All Students,2022-23,14816,1258,13558,91.5,88,28,31.8
6,All Students,2020-21,3,s,s,s,s,s,s
6,All Students,2021-22,4,s,s,s,s,s,s
All Grades,All Students,2018-19,28028,2427,25601,91.3,172,58,33.7
All Grades,All Students,2019-20,16193,1460,14733,91.0,154,53,34.4
All Grades,All Students,2020-21,24954,2828,22126,88.7,158,78,49.4
All Grades,All Students,2021-22,28530,4331,24199,84.8,178,112,62.9
All Grades,All Students,2022-23,33397,4356,29041,87.0,226,120,53.1
PK in K-12 Schools,All Students,2018-19,3657,428,3229,88.3,26,15,57.7
PK in K-12 Schools,All Students,2019-20,2994,328,2666,89.0,28,14,50.0
PK in K-12 Schools,All Students,2020-21,3924,440,3484,88.8,26,15,57.7
PK in K-12 Schools,All Students,2021-22,5080,823,4257,83.8,31,25,80.6
PK in K-12 Schools,All Students,2022-23,8032,1254,6778,84.4,56,37,66.1
0K,All Students,2018-19,3158,351,2807,88.9,19,9,47.4
0K,All Students,2019-20,1425,146,1279,89.8,15,8,53.3
0K,All Students,2020-21,4269,644,3625,84.9,28,17,60.7
0K,All Students,2021-22,4395,766,3629,82.6,29,17,58.6
0K,All Students,2022-23,4483,662,3821,85.2,33,18,54.5
1,All Students,2018-19,4133,398,3735,90.4,24,9,37.5
1,All Students,2019-20,1935,266,1669,86.3,20,12,60.0
1,All Students,2020-21,1735,s,s,s,s,s,s
1,All Students,2021-22,4107,745,3362,81.9,27,19,70.4
1,All Students,2022-23,5240,640,4600,87.8,35,15,42.9
2,All Students,2018-19,3688,352,3336,90.5,24,10,41.7
2,All Students,2019-20,2278,179,2099,92.1,21,6,28.6
2,All Students,2020-21,3226,448,2778,86.1,20,11,55.0
2,All Students,2021-22,2959,413,2546,86.0,19,10,52.6
2,All Students,2022-23,4583,650,3933,85.8,29,17,58.6
3,All Students,2018-19,4070,248,3822,93.9,24,3,12.5
3,All Students,2019-20,2795,214,2581,92.3,26,7,26.9
3,All Students,2020-21,3749,343,3406,90.9,22,9,40.9
3,All Students,2021-22,3656,576,3080,84.2,23,15,65.2
3,All Students,2022-23,3065,295,2770,90.4,21,10,47.6
4,All Students,2018-19,3274,234,3040,92.9,20,5,25.0
4,All Students,2019-20,2554,160,2394,93.7,24,3,12.5
4,All Students,2020-21,4485,426,4059,90.5,27,11,40.7
4,All Students,2021-22,3229,412,2817,87.2,19,10,52.6
4,All Students,2022-23,3932,516,3416,86.9,25,13,52.0
5,All Students,2018-19,6048,416,5632,93.1,35,7,20.0
5,All Students,2019-20,2212,167,2045,92.5,20,3,15.0
5,All Students,2020-21,3554,329,3225,90.7,23,10,43.5
5,All Students,2021-22,5104,596,4508,88.3,30,16,53.3
5,All Students,2022-23,4062,339,3723,91.7,27,10,37.0
6,All Students,2020-21,12,s,s,s,s,s,s
All Grades,All Students,2018-19,160733,8808,151925,94.5,919,154,16.8
All Grades,All Students,2019-20,101733,5250,96483,94.8,897,138,15.4
All Grades,All Students,2020-21,155778,10261,145517,93.4,895,176,19.7
All Grades,All Students,2021-22,153451,15448,138003,89.9,888,314,35.4
All Grades,All Students,2022-23,144238,13611,130627,90.6,839,287,34.2
5,All Students,2018-19,4990,s,s,s,s,s,s
5,All Students,2019-20,2565,104,2461,95.9,23,3,13.0
5,All Students,2020-21,4378,163,4215,96.3,25,2,8.0
5,All Students,2021-22,3167,172,2995,94.6,20,6,30.0
5,All Students,2022-23,2632,s,s,s,s,s,s
6,All Students,2018-19,54845,3291,51554,94.0,312,64,20.5
6,All Students,2019-20,35690,1578,34112,95.6,314,36,11.5
6,All Students,2020-21,51050,3624,47426,92.9,294,66,22.4
6,All Students,2021-22,51937,5654,46283,89.1,305,113,37.0
6,All Students,2022-23,48319,4441,43878,90.8,286,95,33.2
7,All Students,2018-19,50095,2984,47111,94.0,289,55,19.0
7,All Students,2019-20,31917,1823,30094,94.3,283,50,17.7
7,All Students,2020-21,52926,3651,49275,93.1,305,59,19.3
7,All Students,2021-22,47990,4432,43558,90.8,276,96,34.8
7,All Students,2022-23,47137,4442,42695,90.6,272,93,34.2
8,All Students,2018-19,50633,2365,48268,95.3,288,33,11.5
8,All Students,2019-20,31561,1745,29816,94.5,277,49,17.7
8,All Students,2020-21,47424,2823,44601,94.0,271,49,18.1
8,All Students,2021-22,50357,5190,45167,89.7,287,99,34.5
8,All Students,2022-23,46149,4574,41575,90.1,266,96,36.1
9,All Students,2018-19,170,s,s,s,s,s,s
9,All Students,2022-23,1,s,s,s,s,s,s
All Grades,All Students,2018-19,89734,7598,82136,91.5,533,161,30.2
All Grades,All Students,2019-20,51626,4348,47278,91.6,474,135,28.5
All Grades,All Students,2020-21,69863,8778,61085,87.4,421,160,38.0
All Grades,All Students,2021-22,67649,8998,58651,86.7,418,216,51.7
All Grades,All Students,2022-23,61844,6178,55666,90.0,379,147,38.8
PK in K-12 Schools,All Students,2018-19,5280,696,4584,86.8,32,18,56.3
PK in K-12 Schools,All Students,2019-20,3571,s,s,s,s,s,s
PK in K-12 Schools,All Students,2020-21,3534,s,s,s,s,s,s
PK in K-12 Schools,All Students,2021-22,5645,1204,4441,78.7,39,31,79.5
PK in K-12 Schools,All Students,2022-23,5117,953,4164,81.4,33,26,78.8
0K,All Students,2018-19,7748,847,6901,89.1,47,21,44.7
0K,All Students,2019-20,5355,667,4688,87.5,51,27,52.9
0K,All Students,2020-21,5750,976,4774,83.0,35,21,60.0
0K,All Students,2021-22,4577,724,3853,84.2,30,21,70.0
0K,All Students,2022-23,7458,895,6563,88.0,49,27,55.1
1,All Students,2018-19,7326,633,6693,91.4,45,14,31.1
1,All Students,2019-20,5205,555,4650,89.3,48,15,31.3
1,All Students,2020-21,7699,1228,6471,84.0,45,28,62.2
1,All Students,2021-22,5730,941,4789,83.6,36,23,63.9
1,All Students,2022-23,4034,507,3527,87.4,25,13,52.0
2,All Students,2018-19,7613,598,7015,92.1,44,15,34.1
2,All Students,2019-20,4253,310,3943,92.7,39,10,25.6
2,All Students,2020-21,7864,947,6917,88.0,46,16,34.8
2,All Students,2021-22,7587,1188,6399,84.3,45,27,60.0
2,All Students,2022-23,4574,436,4138,90.5,29,11,37.9
3,All Students,2018-19,7562,757,6805,90.0,44,14,31.8
3,All Students,2019-20,3669,226,3443,93.8,36,7,19.4
3,All Students,2020-21,5599,544,5055,90.3,34,11,32.4
3,All Students,2021-22,7928,991,6937,87.5,51,23,45.1
3,All Students,2022-23,7205,679,6526,90.6,42,20,47.6
4,All Students,2018-19,9694,451,9243,95.3,59,7,11.9
4,All Students,2019-20,4537,377,4160,91.7,40,12,30.0
4,All Students,2020-21,5533,638,4895,88.5,35,14,40.0
4,All Students,2021-22,5995,632,5363,89.5,35,17,48.6
4,All Students,2022-23,6762,518,6244,92.3,41,12,29.3
5,All Students,2018-19,11897,904,10993,92.4,69,21,30.4
5,All Students,2019-20,5872,303,5569,94.8,53,10,18.9
5,All Students,2020-21,7114,763,6351,89.3,43,14,32.6
5,All Students,2021-22,4830,591,4239,87.8,30,12,40.0
5,All Students,2022-23,6287,586,5701,90.7,36,10,27.8
6,All Students,2018-19,10479,952,9527,90.9,59,16,27.1
6,All Students,2019-20,6587,471,6116,92.8,59,10,16.9
6,All Students,2020-21,7911,697,7214,91.2,49,12,24.5
6,All Students,2021-22,7374,657,6717,91.1,44,15,34.1
6,All Students,2022-23,4241,329,3912,92.2,26,8,30.8
7,All Students,2018-19,10335,730,9605,92.9,60,15,25.0
7,All Students,2019-20,6501,537,5964,91.7,59,15,25.4
7,All Students,2020-21,9550,885,8665,90.7,57,14,24.6
7,All Students,2021-22,8400,919,7481,89.1,52,21,40.4
7,All Students,2022-23,7921,637,7284,92.0,49,12,24.5
8,All Students,2018-19,11800,1030,10770,91.3,74,20,27.0
8,All Students,2019-20,6067,451,5616,92.6,54,8,14.8
8,All Students,2020-21,9305,1078,8227,88.4,54,12,22.2
8,All Students,2021-22,9583,1151,8432,88.0,56,26,46.4
8,All Students,2022-23,8245,638,7607,92.3,49,8,16.3
9,All Students,2019-20,9,s,s,s,s,s,s
9,All Students,2020-21,4,s,s,s,s,s,s
All Grades,All Students,2018-19,40998,6665,34333,83.7,297,143,48.1
All Grades,All Students,2019-20,31425,4868,26557,84.5,300,126,42.0
All Grades,All Students,2020-21,42852,10605,32247,75.3,282,185,65.6
All Grades,All Students,2021-22,44764,5513,39251,87.7,293,132,45.1
All Grades,All Students,2022-23,46087,4913,41174,89.3,303,111,36.6
9,All Students,2018-19,11600,2213,9387,80.9,102,52,51.0
9,All Students,2019-20,11887,1722,10165,85.5,114,39,34.2
9,All Students,2020-21,10999,2695,8304,75.5,79,48,60.8
9,All Students,2021-22,16475,2016,14459,87.8,108,54,50.0
9,All Students,2022-23,12330,1249,11081,89.9,84,29,34.5
10,All Students,2018-19,10548,1723,8825,83.7,72,30,41.7
10,All Students,2019-20,6676,1287,5389,80.7,66,30,45.5
10,All Students,2020-21,15631,3816,11815,75.6,95,66,69.5
10,All Students,2021-22,9738,1231,8507,87.4,63,28,44.4
10,All Students,2022-23,15343,1477,13866,90.4,99,29,29.3
11,All Students,2018-19,10112,1148,8964,88.6,66,30,45.5
11,All Students,2019-20,6124,1000,5124,83.7,56,29,51.8
11,All Students,2020-21,9260,2298,6962,75.2,56,37,66.1
11,All Students,2021-22,9246,823,8423,91.1,57,15,26.3
11,All Students,2022-23,8391,606,7785,92.8,55,16,29.1
12,All Students,2018-19,8738,1581,7157,81.9,57,31,54.4
12,All Students,2019-20,6738,859,5879,87.3,64,28,43.8
12,All Students,2020-21,6962,1796,5166,74.2,52,34,65.4
12,All Students,2021-22,9305,1443,7862,84.5,65,35,53.8
12,All Students,2022-23,10023,1581,8442,84.2,65,37,56.9
All Grades,All Students,2018-19,79787,13551,66236,83.0,501,263,52.5
All Grades,All Students,2019-20,50628,8225,42403,83.8,477,266,55.8
All Grades,All Students,2020-21,80333,15084,65249,81.2,466,229,49.1
All Grades,All Students,2021-22,76824,15936,60888,79.3,495,331,66.9
All Grades,All Students,2022-23,67743,14013,53730,79.3,472,314,66.5
9,All Students,2018-19,18896,2163,16733,88.6,119,45,37.8
9,All Students,2019-20,12054,1444,10610,88.0,115,45,39.1
9,All Students,2020-21,20325,4775,15550,76.5,119,72,60.5
9,All Students,2021-22,19419,3656,15763,81.2,126,82,65.1
9,All Students,2022-23,16466,2555,13911,84.5,116,62,53.4
10,All Students,2018-19,20294,3341,16953,83.5,123,54,43.9
10,All Students,2019-20,12665,2064,10601,83.7,123,75,61.0
10,All Students,2020-21,19685,4092,15593,79.2,114,66,57.9
10,All Students,2021-22,21150,4372,16778,79.3,131,80,61.1
10,All Students,2022-23,19317,3789,15528,80.4,121,83,68.6
11,All Students,2018-19,21032,3553,17479,83.1,134,72,53.7
11,All Students,2019-20,12562,2233,10329,82.2,116,70,60.3
11,All Students,2020-21,20175,3102,17073,84.6,117,47,40.2
11,All Students,2021-22,19261,3888,15373,79.8,120,83,69.2
11,All Students,2022-23,18927,4609,14318,75.6,119,81,68.1
12,All Students,2018-19,19565,4494,15071,77.0,125,92,73.6
12,All Students,2019-20,13347,2484,10863,81.4,123,76,61.8
12,All Students,2020-21,20148,3115,17033,84.5,116,44,37.9
12,All Students,2021-22,16994,4020,12974,76.3,118,86,72.9
12,All Students,2022-23,13033,3060,9973,76.5,116,88,75.9
All Grades,All Students,2018-19,55029,11508,43521,79.1,363,196,54.0
All Grades,All Students,2019-20,36000,7517,28483,79.1,343,171,49.9
All Grades,All Students,2020-21,52641,11705,40936,77.8,340,217,63.8
All Grades,All Students,2021-22,48096,9871,38225,79.5,301,173,57.5
All Grades,All Students,2022-23,45615,9586,36029,79.0,297,183,61.6
9,All Students,2018-19,10413,1215,9198,88.3,81,28,34.6
9,All Students,2019-20,7424,793,6631,89.3,73,21,28.8
9,All Students,2020-21,10122,1699,8423,83.2,73,44,60.3
9,All Students,2021-22,9650,1700,7950,82.4,63,26,41.3
9,All Students,2022-23,10150,1404,8746,86.2,66,30,45.5
10,All Students,2018-19,13347,3028,10319,77.3,89,50,56.2
10,All Students,2019-20,9594,1352,8242,85.9,95,34,35.8
10,All Students,2020-21,13189,2536,10653,80.8,88,54,61.4
10,All Students,2021-22,12048,1938,10110,83.9,75,43,57.3
10,All Students,2022-23,11474,2170,9304,81.1,77,46,59.7
11,All Students,2018-19,15221,2564,12657,83.2,97,52,53.6
11,All Students,2019-20,8423,1566,6857,81.4,79,45,57.0
11,All Students,2020-21,15699,3280,12419,79.1,93,59,63.4
11,All Students,2021-22,13111,2777,10334,78.8,81,50,61.7
11,All Students,2022-23,11987,2626,9361,78.1,77,52,67.5
12,All Students,2018-19,16048,4701,11347,70.7,96,66,68.8
12,All Students,2019-20,10559,3806,6753,64.0,96,71,74.0
12,All Students,2020-21,13631,4190,9441,69.3,86,60,69.8
12,All Students,2021-22,13287,3456,9831,74.0,82,54,65.9
12,All Students,2022-23,12004,3386,8618,71.8,77,55,71.4
All Grades,All Students,2018-19,38126,3637,34489,90.5,250,81,32.4
All Grades,All Students,2019-20,31405,3165,28240,89.9,304,96,31.6
All Grades,All Students,2020-21,63589,8228,55361,87.1,370,123,33.2
All Grades,All Students,2021-22,66454,10917,55537,83.6,418,239,57.2
All Grades,All Students,2022-23,66288,6616,59672,90.0,433,128,29.6
9,All Students,2018-19,14307,813,13494,94.3,94,17,18.1
9,All Students,2019-20,10709,1039,9670,90.3,104,28,26.9
9,All Students,2020-21,21415,2344,19071,89.1,123,36,29.3
9,All Students,2021-22,19359,2633,16726,86.4,123,57,46.3
9,All Students,2022-23,17815,1302,16513,92.7,120,29,24.2
10,All Students,2018-19,10173,1180,8993,88.4,67,27,40.3
10,All Students,2019-20,10241,974,9267,90.5,99,30,30.3
10,All Students,2020-21,17043,2653,14390,84.4,98,36,36.7
10,All Students,2021-22,19245,2937,16308,84.7,121,66,54.5
10,All Students,2022-23,18693,2153,16540,88.5,122,36,29.5
11,All Students,2018-19,6321,667,5654,89.4,42,17,40.5
11,All Students,2019-20,6410,732,5678,88.6,63,27,42.9
11,All Students,2020-21,15696,2009,13687,87.2,93,32,34.4
11,All Students,2021-22,14563,2406,12157,83.5,94,57,60.6
11,All Students,2022-23,17607,1706,15901,90.3,112,36,32.1
12,All Students,2018-19,7325,977,6348,86.7,47,20,42.6
12,All Students,2019-20,4045,420,3625,89.6,38,11,28.9
12,All Students,2020-21,9435,1222,8213,87.0,56,19,33.9
12,All Students,2021-22,13287,2941,10346,77.9,80,59,73.8
12,All Students,2022-23,12173,1455,10718,88.0,79,27,34.2
All Grades,All Students,2018-19,74016,3439,70577,95.4,438,52,11.9
All Grades,All Students,2019-20,48573,2164,46409,95.5,440,54,12.3
All Grades,All Students,2020-21,75333,1999,73334,97.3,432,26,6.0
All Grades,All Students,2021-22,70784,4528,66256,93.6,425,79,18.6
All Grades,All Students,2022-23,71771,4698,67073,93.5,426,88,20.7
6,All Students,2018-19,10502,232,10270,97.8,60,1,1.7
6,All Students,2019-20,6834,140,6694,98.0,61,0,0.0
6,All Students,2020-21,10492,94,10398,99.1,60,1,1.7
6,All Students,2021-22,9645,557,9088,94.2,57,7,12.3
6,All Students,2022-23,9939,511,9428,94.9,57,7,12.3
7,All Students,2018-19,10483,275,10208,97.4,60,2,3.3
7,All Students,2019-20,6840,149,6691,97.8,61,2,3.3
7,All Students,2020-21,10317,53,10264,99.5,59,0,0.0
7,All Students,2021-22,10398,537,9861,94.8,60,6,10.0
7,All Students,2022-23,9735,496,9239,94.9,55,8,14.5
8,All Students,2018-19,10858,282,10576,97.4,61,1,1.6
8,All Students,2019-20,6832,167,6665,97.6,60,3,5.0
8,All Students,2020-21,10492,153,10339,98.5,60,1,1.7
8,All Students,2021-22,10618,415,10203,96.1,61,3,4.9
8,All Students,2022-23,10405,496,9909,95.2,59,6,10.2
9,All Students,2018-19,10922,498,10424,95.4,68,10,14.7
9,All Students,2019-20,7041,190,6851,97.3,64,5,7.8
9,All Students,2020-21,10681,215,10466,98.0,61,3,4.9
9,All Students,2021-22,9318,569,8749,93.9,59,13,22.0
9,All Students,2022-23,10674,645,10029,94.0,65,11,16.9
10,All Students,2018-19,11331,747,10584,93.4,69,11,15.9
10,All Students,2019-20,7078,376,6702,94.7,66,7,10.6
10,All Students,2020-21,10894,294,10600,97.3,63,5,7.9
10,All Students,2021-22,9823,625,9198,93.6,61,11,18.0
10,All Students,2022-23,10014,794,9220,92.1,62,15,24.2
11,All Students,2018-19,10234,638,9596,93.8,62,11,17.7
11,All Students,2019-20,7147,553,6594,92.3,66,16,24.2
11,All Students,2020-21,11375,398,10977,96.5,65,6,9.2
11,All Students,2021-22,10459,765,9694,92.7,65,15,23.1
11,All Students,2022-23,10691,741,9950,93.1,65,15,23.1
12,All Students,2018-19,9686,767,8919,92.1,58,16,27.6
12,All Students,2019-20,6801,589,6212,91.3,62,21,33.9
12,All Students,2020-21,11082,792,10290,92.9,64,10,15.6
12,All Students,2021-22,10523,1060,9463,89.9,62,24,38.7
12,All Students,2022-23,10313,1015,9298,90.2,63,26,41.3
All Grades,All Students,2018-19,49587,8318,41269,83.2,311,162,52.1
All Grades,All Students,2019-20,36902,5367,31535,85.5,344,167,48.5
All Grades,All Students,2020-21,63422,12298,51124,80.6,370,207,55.9
All Grades,All Students,2021-22,64552,12588,51964,80.5,399,242,60.7
All Grades,All Students,2022-23,60480,12768,47712,78.9,403,260,64.5
9,All Students,2018-19,16270,2026,14244,87.5,103,46,44.7
9,All Students,2019-20,12993,1547,11446,88.1,123,52,42.3
9,All Students,2020-21,16370,2627,13743,84.0,94,41,43.6
9,All Students,2021-22,18379,2968,15411,83.9,115,61,53.0
9,All Students,2022-23,13228,2284,10944,82.7,95,58,61.1
10,All Students,2018-19,13955,2578,11377,81.5,85,39,45.9
10,All Students,2019-20,10236,1581,8655,84.6,97,51,52.6
10,All Students,2020-21,20140,4265,15875,78.8,120,73,60.8
10,All Students,2021-22,14637,2857,11780,80.5,89,47,52.8
10,All Students,2022-23,15440,3299,12141,78.6,102,61,59.8
11,All Students,2018-19,10179,1883,8296,81.5,68,39,57.4
11,All Students,2019-20,7812,1176,6636,84.9,72,32,44.4
11,All Students,2020-21,14862,2839,12023,80.9,85,50,58.8
11,All Students,2021-22,18490,3606,14884,80.5,114,75,65.8
11,All Students,2022-23,15049,3014,12035,80.0,100,62,62.0
12,All Students,2018-19,9183,1831,7352,80.1,55,38,69.1
12,All Students,2019-20,5861,1063,4798,81.9,52,32,61.5
12,All Students,2020-21,12050,2567,9483,78.7,71,43,60.6
12,All Students,2021-22,13046,3157,9889,75.8,81,59,72.8
12,All Students,2022-23,16763,4171,12592,75.1,106,79,74.5
All Grades,All Students,2018-19,65652,3336,62316,94.9,389,56,14.4
All Grades,All Students,2019-20,43186,2013,41173,95.3,385,49,12.7
All Grades,All Students,2020-21,64154,1516,62638,97.6,375,22,5.9
All Grades,All Students,2021-22,61701,3955,57746,93.6,370,68,18.4
All Grades,All Students,2022-23,62646,3188,59458,94.9,376,47,12.5
6,All Students,2018-19,21353,1118,20235,94.8,128,20,15.6
6,All Students,2019-20,14390,714,13676,95.0,129,18,14.0
6,All Students,2020-21,22334,485,21849,97.8,130,5,3.8
6,All Students,2021-22,17928,1090,16838,93.9,106,13,12.3
6,All Students,2022-23,19706,826,18880,95.8,121,8,6.6
7,All Students,2018-19,22651,1113,21538,95.1,132,20,15.2
7,All Students,2019-20,14045,s,s,s,s,s,s
7,All Students,2020-21,20475,s,s,s,s,s,s
7,All Students,2021-22,21785,1511,20274,93.1,136,33,24.3
7,All Students,2022-23,20058,1154,18904,94.2,120,19,15.8
8,All Students,2018-19,21648,1105,20543,94.9,129,16,12.4
8,All Students,2019-20,14743,610,14133,95.9,131,15,11.5
8,All Students,2020-21,21317,593,20724,97.2,125,10,8.0
8,All Students,2021-22,21988,1354,20634,93.8,128,22,17.2
8,All Students,2022-23,22882,1208,21674,94.7,135,20,14.8
9,All Students,2019-20,8,s,s,s,s,s,s
9,All Students,2020-21,28,s,s,s,s,s,s
All Grades,All Students,2018-19,58612,7686,50926,86.9,351,187,53.3
All Grades,All Students,2019-20,37088,5264,31824,85.8,341,186,54.5
All Grades,All Students,2020-21,68736,12051,56685,82.5,424,238,56.1
All Grades,All Students,2021-22,68004,13462,54542,80.2,435,298,68.5
All Grades,All Students,2022-23,73789,13627,60162,81.5,449,315,70.2
PK in K-12 Schools,All Students,2018-19,4049,708,3341,82.5,27,18,66.7
PK in K-12 Schools,All Students,2019-20,1985,394,1591,80.2,23,17,73.9
PK in K-12 Schools,All Students,2020-21,2830,s,s,s,s,s,s
PK in K-12 Schools,All Students,2021-22,3248,663,2585,79.6,24,16,66.7
PK in K-12 Schools,All Students,2022-23,3444,813,2631,76.4,26,17,65.4
0K,All Students,2018-19,11272,1553,9719,86.2,69,38,55.1
0K,All Students,2019-20,3794,691,3103,81.8,40,28,70.0
0K,All Students,2020-21,20425,3188,17237,84.4,136,64,47.1
0K,All Students,2021-22,10047,2040,8007,79.7,74,54,73.0
0K,All Students,2022-23,11793,2033,9760,82.8,74,55,74.3
1,All Students,2018-19,8883,1122,7761,87.4,54,29,53.7
1,All Students,2019-20,8060,1084,6976,86.6,72,36,50.0
1,All Students,2020-21,7303,1451,5852,80.1,47,25,53.2
1,All Students,2021-22,20686,4153,16533,79.9,127,82,64.6
1,All Students,2022-23,12054,2319,9735,80.8,76,56,73.7
2,All Students,2018-19,8569,1162,7407,86.4,51,25,49.0
2,All Students,2019-20,5870,786,5084,86.6,52,28,53.8
2,All Students,2020-21,11725,1814,9911,84.5,67,38,56.7
2,All Students,2021-22,7692,1484,6208,80.7,51,34,66.7
2,All Students,2022-23,20268,3795,16473,81.3,122,85,69.7
3,All Students,2018-19,9579,1179,8400,87.7,58,36,62.1
3,All Students,2019-20,5734,776,4958,86.5,50,24,48.0
3,All Students,2020-21,8926,1377,7549,84.6,52,28,53.8
3,All Students,2021-22,10886,1841,9045,83.1,64,43,67.2
3,All Students,2022-23,7827,1557,6270,80.1,45,33,73.3
4,All Students,2018-19,8426,914,7512,89.2,48,18,37.5
4,All Students,2019-20,6386,820,5566,87.2,57,30,52.6
4,All Students,2020-21,8309,1672,6637,79.9,49,30,61.2
4,All Students,2021-22,8040,1710,6330,78.7,50,39,78.0
4,All Students,2022-23,11049,1773,9276,84.0,63,42,66.7
5,All Students,2018-19,7834,1048,6786,86.6,44,23,52.3
5,All Students,2019-20,5259,713,4546,86.4,47,23,48.9
5,All Students,2020-21,9178,1571,7607,82.9,53,34,64.2
5,All Students,2021-22,7405,1571,5834,78.8,45,30,66.7
5,All Students,2022-23,7354,1337,6017,81.8,43,27,62.8
6,All Students,2020-21,29,s,s,s,s,s,s
All Grades,All Students,2018-19,70482,11405,59077,83.8,439,271,61.7
All Grades,All Students,2019-20,45109,7306,37803,83.8,431,252,58.5
All Grades,All Students,2020-21,66301,13691,52610,79.4,397,243,61.2
All Grades,All Students,2021-22,69810,16035,53775,77.0,439,341,77.7
All Grades,All Students,2022-23,74021,13805,60216,81.3,472,316,66.9
PK in K-12 Schools,All Students,2018-19,1287,s,s,s,s,s,s
PK in K-12 Schools,All Students,2019-20,1200,320,880,73.3,15,11,73.3
PK in K-12 Schools,All Students,2020-21,1785,658,1127,63.1,12,11,91.7
PK in K-12 Schools,All Students,2021-22,1269,387,882,69.5,8,6,75.0
PK in K-12 Schools,All Students,2022-23,2136,462,1674,78.4,16,11,68.8
0K,All Students,2018-19,10438,1389,9049,86.7,66,40,60.6
0K,All Students,2019-20,3168,553,2615,82.5,32,22,68.8
0K,All Students,2020-21,3067,327,2740,89.3,20,8,40.0
0K,All Students,2021-22,10749,2105,8644,80.4,70,55,78.6
0K,All Students,2022-23,6950,1200,5750,82.7,55,35,63.6
1,All Students,2018-19,7942,1099,6843,86.2,49,26,53.1
1,All Students,2019-20,6699,858,5841,87.2,63,35,55.6
1,All Students,2020-21,6090,1014,5076,83.3,35,19,54.3
1,All Students,2021-22,5022,749,4273,85.1,36,20,55.6
1,All Students,2022-23,12395,2137,10258,82.8,75,45,60.0
2,All Students,2018-19,10543,1446,9097,86.3,66,38,57.6
2,All Students,2019-20,5583,752,4831,86.5,52,27,51.9
2,All Students,2020-21,11696,2192,9504,81.3,69,43,62.3
2,All Students,2021-22,6295,1261,5034,80.0,40,33,82.5
2,All Students,2022-23,5853,951,4902,83.8,37,26,70.3
3,All Students,2018-19,5505,889,4616,83.9,34,20,58.8
3,All Students,2019-20,5826,706,5120,87.9,54,28,51.9
3,All Students,2020-21,7340,1593,5747,78.3,43,27,62.8
3,All Students,2021-22,8466,1779,6687,79.0,52,42,80.8
3,All Students,2022-23,5172,840,4332,83.8,31,20,64.5
4,All Students,2018-19,5732,948,4784,83.5,36,22,61.1
4,All Students,2019-20,4089,656,3433,84.0,39,18,46.2
4,All Students,2020-21,8587,1702,6885,80.2,50,30,60.0
4,All Students,2021-22,6330,1341,4989,78.8,41,35,85.4
4,All Students,2022-23,8331,1674,6657,79.9,51,34,66.7
5,All Students,2018-19,5306,699,4607,86.8,33,17,51.5
5,All Students,2019-20,3917,618,3299,84.2,36,22,61.1
5,All Students,2020-21,5964,1086,4878,81.8,35,22,62.9
5,All Students,2021-22,8577,1787,6790,79.2,52,37,71.2
5,All Students,2022-23,6804,1186,5618,82.6,44,31,70.5
6,All Students,2018-19,4929,1032,3897,79.1,30,23,76.7
6,All Students,2019-20,3069,468,2601,84.8,32,19,59.4
6,All Students,2020-21,5199,1381,3818,73.4,31,23,74.2
6,All Students,2021-22,5313,912,4401,82.8,33,27,81.8
6,All Students,2022-23,6453,1119,5334,82.7,37,23,62.2
7,All Students,2018-19,3862,813,3049,78.9,24,17,70.8
7,All Students,2019-20,2380,461,1919,80.6,23,16,69.6
7,All Students,2020-21,5202,1365,3837,73.8,31,22,71.0
7,All Students,2021-22,4824,1159,3665,76.0,30,23,76.7
7,All Students,2022-23,6298,1044,5254,83.4,42,32,76.2
8,All Students,2018-19,3730,622,3108,83.3,22,15,68.2
8,All Students,2019-20,2911,520,2391,82.1,28,19,67.9
8,All Students,2020-21,3027,900,2127,70.3,19,11,57.9
8,All Students,2021-22,4625,1529,3096,66.9,29,25,86.2
8,All Students,2022-23,5207,1250,3957,76.0,33,25,75.8
9,All Students,2018-19,6209,1100,5109,82.3,38,26,68.4
9,All Students,2019-20,453,s,s,s,s,s,s
9,All Students,2020-21,787,s,s,s,s,s,s
9,All Students,2021-22,437,s,s,s,s,s,s
9,All Students,2022-23,1862,364,1498,80.5,11,7,63.6
10,All Students,2018-19,1807,326,1481,82.0,12,8,66.7
10,All Students,2019-20,3630,660,2970,81.8,32,16,50.0
10,All Students,2020-21,841,s,s,s,s,s,s
10,All Students,2021-22,1055,467,588,55.7,7,6,85.7
10,All Students,2022-23,777,s,s,s,s,s,s
11,All Students,2018-19,248,s,s,s,s,s,s
11,All Students,2019-20,714,s,s,s,s,s,s
11,All Students,2020-21,4749,744,4005,84.3,29,12,41.4
11,All Students,2021-22,550,s,s,s,s,s,s
11,All Students,2022-23,532,s,s,s,s,s,s
12,All Students,2018-19,2944,617,2327,79.0,17,11,64.7
12,All Students,2019-20,1470,473,997,67.8,13,11,84.6
12,All Students,2020-21,1967,363,1604,81.5,12,7,58.3
12,All Students,2021-22,6298,2212,4086,64.9,35,27,77.1
12,All Students,2022-23,5251,1319,3932,74.9,32,22,68.8
All Grades,All Students,2018-19,79557,9951,69606,87.5,468,226,48.3
All Grades,All Students,2019-20,51514,6567,44947,87.3,455,217,47.7
All Grades,All Students,2020-21,76785,16539,60246,78.5,445,261,58.7
All Grades,All Students,2021-22,76786,15901,60885,79.3,458,310,67.7
All Grades,All Students,2022-23,72850,12484,60366,82.9,436,281,64.4
0K,All Students,2018-19,3328,604,2724,81.9,24,18,75.0
0K,All Students,2019-20,2010,248,1762,87.7,18,11,61.1
0K,All Students,2020-21,1928,496,1432,74.3,12,9,75.0
0K,All Students,2021-22,5982,1331,4651,77.7,42,34,81.0
0K,All Students,2022-23,3998,850,3148,78.7,27,21,77.8
1,All Students,2018-19,5762,835,4927,85.5,35,21,60.0
1,All Students,2019-20,2530,412,2118,83.7,22,14,63.6
1,All Students,2020-21,3285,675,2610,79.5,19,13,68.4
1,All Students,2021-22,3307,592,2715,82.1,23,14,60.9
1,All Students,2022-23,7049,1375,5674,80.5,41,33,80.5
2,All Students,2018-19,5533,714,4819,87.1,33,19,57.6
2,All Students,2019-20,3795,503,3292,86.7,33,17,51.5
2,All Students,2020-21,4212,1246,2966,70.4,25,18,72.0
2,All Students,2021-22,3213,700,2513,78.2,20,12,60.0
2,All Students,2022-23,3292,469,2823,85.8,20,13,65.0
3,All Students,2018-19,10388,1049,9339,89.9,60,24,40.0
3,All Students,2019-20,3727,525,3202,85.9,33,17,51.5
3,All Students,2020-21,5456,1330,4126,75.6,31,22,71.0
3,All Students,2021-22,4501,1321,3180,70.7,29,24,82.8
3,All Students,2022-23,3283,636,2647,80.6,21,14,66.7
4,All Students,2018-19,1934,204,1730,89.5,11,5,45.5
4,All Students,2019-20,6257,624,5633,90.0,56,22,39.3
4,All Students,2020-21,5552,1207,4345,78.3,32,18,56.3
4,All Students,2021-22,4660,875,3785,81.2,27,18,66.7
4,All Students,2022-23,3744,835,2909,77.7,24,20,83.3
5,All Students,2018-19,3135,414,2721,86.8,18,10,55.6
5,All Students,2019-20,1261,103,1158,91.8,11,3,27.3
5,All Students,2020-21,9646,1499,8147,84.5,56,25,44.6
5,All Students,2021-22,5344,1143,4201,78.6,32,24,75.0
5,All Students,2022-23,4792,856,3936,82.1,29,20,69.0
6,All Students,2018-19,7368,928,6440,87.4,43,20,46.5
6,All Students,2019-20,4542,509,4033,88.8,42,21,50.0
6,All Students,2020-21,3713,967,2746,74.0,22,16,72.7
6,All Students,2021-22,9206,1614,7592,82.5,53,31,58.5
6,All Students,2022-23,7315,1176,6139,83.9,43,24,55.8
7,All Students,2018-19,6885,908,5977,86.8,41,21,51.2
7,All Students,2019-20,5073,698,4375,86.2,45,23,51.1
7,All Students,2020-21,6385,1172,5213,81.6,37,26,70.3
7,All Students,2021-22,3297,536,2761,83.7,20,14,70.0
7,All Students,2022-23,9052,1315,7737,85.5,55,31,56.4
8,All Students,2018-19,5903,645,5258,89.1,35,11,31.4
8,All Students,2019-20,4484,605,3879,86.5,39,22,56.4
8,All Students,2020-21,7637,1450,6187,81.0,44,20,45.5
8,All Students,2021-22,6455,1194,5261,81.5,37,22,59.5
8,All Students,2022-23,3623,512,3111,85.9,22,10,45.5
9,All Students,2018-19,4046,351,3695,91.3,24,6,25.0
9,All Students,2019-20,2541,304,2237,88.0,21,6,28.6
9,All Students,2020-21,6961,1689,5272,75.7,40,22,55.0
9,All Students,2021-22,7620,1804,5816,76.3,43,29,67.4
9,All Students,2022-23,4003,683,3320,82.9,24,17,70.8
10,All Students,2018-19,3488,565,2923,83.8,20,9,45.0
10,All Students,2019-20,2300,129,2171,94.4,20,1,5.0
10,All Students,2020-21,3694,787,2907,78.7,21,10,47.6
10,All Students,2021-22,5846,1067,4779,81.7,34,24,70.6
10,All Students,2022-23,6006,1071,4935,82.2,36,26,72.2
11,All Students,2018-19,4425,483,3942,89.1,25,11,44.0
11,All Students,2019-20,2032,320,1712,84.3,18,7,38.9
11,All Students,2020-21,3520,442,3078,87.4,20,8,40.0
11,All Students,2021-22,3123,652,2471,79.1,17,12,70.6
11,All Students,2022-23,5444,869,4575,84.0,30,17,56.7
12,All Students,2018-19,17362,2251,15111,87.0,99,51,51.5
12,All Students,2019-20,10962,1587,9375,85.5,97,53,54.6
12,All Students,2020-21,14792,3579,11213,75.8,86,54,62.8
12,All Students,2021-22,14232,3072,11160,78.4,81,52,64.2
12,All Students,2022-23,11249,1837,9412,83.7,64,35,54.7
All Grades,All Students,2018-19,49849,4693,45156,90.6,295,103,34.9
All Grades,All Students,2019-20,35530,3967,31563,88.8,317,124,39.1
All Grades,All Students,2020-21,50502,7285,43217,85.6,296,128,43.2
All Grades,All Students,2021-22,51482,8973,42509,82.6,303,183,60.4
All Grades,All Students,2022-23,55240,7445,47795,86.5,328,165,50.3
0K,All Students,2018-19,4586,488,4098,89.4,28,13,46.4
0K,All Students,2019-20,4598,516,4082,88.8,44,17,38.6
0K,All Students,2020-21,1985,258,1727,87.0,14,7,50.0
0K,All Students,2021-22,3904,758,3146,80.6,26,20,76.9
0K,All Students,2022-23,5087,764,4323,85.0,35,22,62.9
1,All Students,2018-19,4799,337,4462,93.0,28,5,17.9
1,All Students,2019-20,2350,237,2113,89.9,21,9,42.9
1,All Students,2020-21,6167,1096,5071,82.2,38,20,52.6
1,All Students,2021-22,2086,326,1760,84.4,14,9,64.3
1,All Students,2022-23,4856,683,4173,85.9,29,17,58.6
2,All Students,2018-19,1874,159,1715,91.5,12,3,25.0
2,All Students,2019-20,2628,225,2403,91.4,23,7,30.4
2,All Students,2020-21,3438,516,2922,85.0,20,12,60.0
2,All Students,2021-22,5908,1051,4857,82.2,36,26,72.2
2,All Students,2022-23,1970,322,1648,83.7,12,8,66.7
3,All Students,2018-19,2335,201,2134,91.4,15,6,40.0
3,All Students,2019-20,2555,201,2354,92.1,23,7,30.4
3,All Students,2020-21,3707,602,3105,83.8,22,11,50.0
3,All Students,2021-22,3194,424,2770,86.7,18,11,61.1
3,All Students,2022-23,5636,683,4953,87.9,33,16,48.5
4,All Students,2018-19,2896,201,2695,93.1,17,5,29.4
4,All Students,2019-20,1265,84,1181,93.4,11,4,36.4
4,All Students,2020-21,3876,636,3240,83.6,22,10,45.5
4,All Students,2021-22,3747,445,3302,88.1,22,9,40.9
4,All Students,2022-23,3432,299,3133,91.3,20,8,40.0
5,All Students,2018-19,3759,342,3417,90.9,22,10,45.5
5,All Students,2019-20,1594,138,1456,91.3,15,5,33.3
5,All Students,2020-21,1936,239,1697,87.7,11,5,45.5
5,All Students,2021-22,3581,741,2840,79.3,21,13,61.9
5,All Students,2022-23,3449,357,3092,89.6,21,9,42.9
6,All Students,2018-19,2664,274,2390,89.7,16,8,50.0
6,All Students,2019-20,2031,236,1795,88.4,19,8,42.1
6,All Students,2020-21,2479,250,2229,89.9,15,4,26.7
6,All Students,2021-22,3177,714,2463,77.5,18,11,61.1
6,All Students,2022-23,4110,720,3390,82.5,25,15,60.0
7,All Students,2018-19,3937,401,3536,89.8,22,9,40.9
7,All Students,2019-20,1840,397,1443,78.4,15,8,53.3
7,All Students,2020-21,3168,412,2756,87.0,18,8,44.4
7,All Students,2021-22,2478,363,2115,85.4,14,7,50.0
7,All Students,2022-23,2922,416,2506,85.8,17,9,52.9
8,All Students,2018-19,5461,656,4805,88.0,32,11,34.4
8,All Students,2019-20,2705,305,2400,88.7,24,10,41.7
8,All Students,2020-21,3344,421,2923,87.4,19,9,47.4
8,All Students,2021-22,2834,403,2431,85.8,16,10,62.5
8,All Students,2022-23,2492,225,2267,91.0,14,6,42.9
9,All Students,2018-19,3493,408,3085,88.3,22,10,45.5
9,All Students,2019-20,3019,349,2670,88.4,27,11,40.7
9,All Students,2020-21,3052,329,2723,89.2,18,6,33.3
9,All Students,2021-22,2953,766,2187,74.1,18,14,77.8
9,All Students,2022-23,4002,417,3585,89.6,25,10,40.0
10,All Students,2018-19,2247,331,1916,85.3,13,4,30.8
10,All Students,2019-20,1780,304,1476,82.9,15,6,40.0
10,All Students,2020-21,4400,590,3810,86.6,25,10,40.0
10,All Students,2021-22,3371,469,2902,86.1,19,11,57.9
10,All Students,2022-23,3232,577,2655,82.1,18,10,55.6
11,All Students,2018-19,3047,277,2770,90.9,18,7,38.9
11,All Students,2019-20,2290,270,2020,88.2,20,7,35.0
11,All Students,2020-21,2464,321,2143,87.0,14,5,35.7
11,All Students,2021-22,4061,732,3329,82.0,23,11,47.8
11,All Students,2022-23,3204,396,2808,87.6,18,6,33.3
12,All Students,2018-19,8751,618,8133,92.9,50,12,24.0
12,All Students,2019-20,6875,705,6170,89.7,60,25,41.7
12,All Students,2020-21,10486,1615,8871,84.6,60,21,35.0
12,All Students,2021-22,10188,1781,8407,82.5,58,31,53.4
12,All Students,2022-23,10848,1586,9262,85.4,61,29,47.5
All Grades,All Students,2018-19,62593,9005,53588,85.6,394,221,56.1
All Grades,All Students,2019-20,41663,5722,35941,86.3,389,192,49.4
All Grades,All Students,2020-21,60663,14140,46523,76.7,357,242,67.8
All Grades,All Students,2021-22,58555,12011,46544,79.5,377,277,73.5
All Grades,All Students,2022-23,60078,10094,49984,83.2,379,230,60.7
0K,All Students,2018-19,1661,157,1504,90.5,14,7,50.0
0K,All Students,2019-20,3749,695,3054,81.5,37,25,67.6
0K,All Students,2020-21,4243,1050,3193,75.3,27,20,74.1
0K,All Students,2021-22,1732,355,1377,79.5,16,12,75.0
0K,All Students,2022-23,6290,1049,5241,83.3,50,32,64.0
1,All Students,2018-19,5035,782,4253,84.5,33,26,78.8
1,All Students,2019-20,2030,s,s,s,s,s,s
1,All Students,2020-21,5847,1432,4415,75.5,35,27,77.1
1,All Students,2021-22,4560,1131,3429,75.2,29,22,75.9
1,All Students,2022-23,3470,846,2624,75.6,21,16,76.2
2,All Students,2018-19,9325,1261,8064,86.5,59,27,45.8
2,All Students,2019-20,4411,468,3943,89.4,40,16,40.0
2,All Students,2020-21,3503,702,2801,80.0,22,13,59.1
2,All Students,2021-22,6587,1464,5123,77.8,41,32,78.0
2,All Students,2022-23,5164,1040,4124,79.9,32,24,75.0
3,All Students,2018-19,7532,1016,6516,86.5,48,31,64.6
3,All Students,2019-20,6920,819,6101,88.2,65,26,40.0
3,All Students,2020-21,6427,1553,4874,75.8,37,28,75.7
3,All Students,2021-22,5028,960,4068,80.9,32,25,78.1
3,All Students,2022-23,6589,1177,5412,82.1,39,24,61.5
4,All Students,2018-19,9730,1447,8283,85.1,59,28,47.5
4,All Students,2019-20,4734,656,4078,86.1,46,22,47.8
4,All Students,2020-21,10800,2164,8636,80.0,62,40,64.5
4,All Students,2021-22,6154,1247,4907,79.7,41,31,75.6
4,All Students,2022-23,5727,907,4820,84.2,35,21,60.0
5,All Students,2018-19,9485,1315,8170,86.1,58,37,63.8
5,All Students,2019-20,6775,959,5816,85.8,61,29,47.5
5,All Students,2020-21,7653,1989,5664,74.0,45,37,82.2
5,All Students,2021-22,11144,1815,9329,83.7,68,47,69.1
5,All Students,2022-23,6069,1071,4998,82.4,37,23,62.2
6,All Students,2018-19,7255,998,6257,86.2,46,24,52.2
6,All Students,2019-20,4748,753,3995,84.1,43,23,53.5
6,All Students,2020-21,8805,1938,6867,78.0,52,27,51.9
6,All Students,2021-22,6973,1752,5221,74.9,48,37,77.1
6,All Students,2022-23,10843,1473,9370,86.4,65,34,52.3
7,All Students,2018-19,6203,854,5349,86.2,39,22,56.4
7,All Students,2019-20,4436,555,3881,87.5,41,20,48.8
7,All Students,2020-21,6895,1925,4970,72.1,40,29,72.5
7,All Students,2021-22,8710,1558,7152,82.1,54,36,66.7
7,All Students,2022-23,6509,1114,5395,82.9,42,26,61.9
8,All Students,2018-19,6367,1175,5192,81.5,38,19,50.0
8,All Students,2019-20,3831,571,3260,85.1,36,20,55.6
8,All Students,2020-21,6475,1372,5103,78.8,37,21,56.8
8,All Students,2021-22,6633,1569,5064,76.3,42,30,71.4
8,All Students,2022-23,7991,1196,6795,85.0,49,23,46.9
9,All Students,2019-20,29,s,s,s,s,s,s
9,All Students,2021-22,1034,160,874,84.5,6,5,83.3
9,All Students,2022-23,595,s,s,s,s,s,s
10,All Students,2022-23,831,s,s,s,s,s,s
All Grades,All Students,2018-19,62710,10398,52312,83.4,378,215,56.9
All Grades,All Students,2019-20,44704,7647,37057,82.9,417,247,59.2
All Grades,All Students,2020-21,66037,17702,48335,73.2,387,302,78.0
All Grades,All Students,2021-22,66705,16279,50426,75.6,415,322,77.6
All Grades,All Students,2022-23,68771,13391,55380,80.5,425,274,64.5
PK in K-12 Schools,All Students,2018-19,4253,693,3560,83.7,28,16,57.1
PK in K-12 Schools,All Students,2019-20,2444,461,1983,81.1,26,19,73.1
PK in K-12 Schools,All Students,2020-21,2960,1029,1931,65.2,19,17,89.5
PK in K-12 Schools,All Students,2021-22,3033,955,2078,68.5,25,23,92.0
PK in K-12 Schools,All Students,2022-23,4169,787,3382,81.1,27,21,77.8
0K,All Students,2018-19,4055,791,3264,80.5,26,16,61.5
0K,All Students,2019-20,5971,893,5078,85.0,58,32,55.2
0K,All Students,2020-21,7890,1948,5942,75.3,50,35,70.0
0K,All Students,2021-22,6469,1524,4945,76.4,46,37,80.4
0K,All Students,2022-23,7984,1371,6613,82.8,60,37,61.7
1,All Students,2018-19,6915,1197,5718,82.7,41,23,56.1
1,All Students,2019-20,5006,926,4080,81.5,48,31,64.6
1,All Students,2020-21,9193,2323,6870,74.7,53,37,69.8
1,All Students,2021-22,10001,2387,7614,76.1,64,51,79.7
1,All Students,2022-23,8209,1643,6566,80.0,49,29,59.2
2,All Students,2018-19,5387,876,4511,83.7,32,17,53.1
2,All Students,2019-20,5104,891,4213,82.5,47,30,63.8
2,All Students,2020-21,7600,1728,5872,77.3,43,32,74.4
2,All Students,2021-22,8043,1709,6334,78.8,48,35,72.9
2,All Students,2022-23,9322,2086,7236,77.6,57,42,73.7
3,All Students,2018-19,6048,903,5145,85.1,37,20,54.1
3,All Students,2019-20,3936,500,3436,87.3,37,21,56.8
3,All Students,2020-21,7498,1874,5624,75.0,45,32,71.1
3,All Students,2021-22,7102,1564,5538,78.0,42,33,78.6
3,All Students,2022-23,6838,1233,5605,82.0,43,26,60.5
4,All Students,2018-19,4284,685,3599,84.0,26,18,69.2
4,All Students,2019-20,4708,698,4010,85.2,41,22,53.7
4,All Students,2020-21,5942,1830,4112,69.2,33,27,81.8
4,All Students,2021-22,7016,1507,5509,78.5,42,32,76.2
4,All Students,2022-23,6376,1113,5263,82.5,38,20,52.6
5,All Students,2018-19,5774,1022,4752,82.3,37,21,56.8
5,All Students,2019-20,3204,584,2620,81.8,29,19,65.5
5,All Students,2020-21,6535,1783,4752,72.7,38,34,89.5
5,All Students,2021-22,6012,1176,4836,80.4,37,25,67.6
5,All Students,2022-23,6625,1140,5485,82.8,39,25,64.1
6,All Students,2018-19,6203,854,5349,86.2,36,17,47.2
6,All Students,2019-20,4237,904,3333,78.7,39,25,64.1
6,All Students,2020-21,3989,1178,2811,70.5,23,21,91.3
6,All Students,2021-22,6364,1904,4460,70.1,36,26,72.2
6,All Students,2022-23,6667,1301,5366,80.5,39,24,61.5
7,All Students,2018-19,7794,1257,6537,83.9,44,22,50.0
7,All Students,2019-20,3322,499,2823,85.0,31,16,51.6
7,All Students,2020-21,5986,1768,4218,70.5,35,29,82.9
7,All Students,2021-22,3618,772,2846,78.7,23,16,69.6
7,All Students,2022-23,6228,1214,5014,80.5,36,24,66.7
8,All Students,2018-19,8097,1155,6942,85.7,47,27,57.4
8,All Students,2019-20,4768,776,3992,83.7,43,20,46.5
8,All Students,2020-21,4752,1144,3608,75.9,27,25,92.6
8,All Students,2021-22,6019,1615,4404,73.2,34,28,82.4
8,All Students,2022-23,3894,785,3109,79.8,21,14,66.7
9,All Students,2018-19,1769,s,s,s,s,s,s
9,All Students,2019-20,804,s,s,s,s,s,s
9,All Students,2020-21,1723,694,1029,59.7,10,10,100.0
9,All Students,2021-22,955,453,502,52.6,5,s,s
9,All Students,2022-23,1671,395,1276,76.4,10,7,70.0
10,All Students,2018-19,1955,504,1451,74.2,13,10,76.9
10,All Students,2019-20,971,212,759,78.2,9,6,66.7
10,All Students,2020-21,1232,349,883,71.7,7,3,42.9
10,All Students,2021-22,1424,597,827,58.1,9,8,88.9
10,All Students,2022-23,708,s,s,s,s,s,s
11,All Students,2019-20,229,s,s,s,s,s,s
11,All Students,2020-21,176,s,s,s,s,s,s
11,All Students,2021-22,348,s,s,s,s,s,s
12,All Students,2018-19,176,s,s,s,s,s,s
12,All Students,2020-21,528,s,s,s,s,s,s
12,All Students,2021-22,301,s,s,s,s,s,s
12,All Students,2022-23,80,s,s,s,s,s,s
All Grades,All Students,2018-19,63638,6721,56917,89.4,377,147,39.0
All Grades,All Students,2019-20,36853,3832,33021,89.6,333,122,36.6
All Grades,All Students,2020-21,52733,6333,46400,88.0,313,125,39.9
All Grades,All Students,2021-22,53179,8421,44758,84.2,316,197,62.3
All Grades,All Students,2022-23,54277,6657,47620,87.7,322,145,45.0
0K,All Students,2018-19,8244,1080,7164,86.9,52,22,42.3
0K,All Students,2019-20,3079,458,2621,85.1,31,19,61.3
0K,All Students,2020-21,2484,s,s,s,s,s,s
0K,All Students,2021-22,4453,724,3729,83.7,28,20,71.4
0K,All Students,2022-23,2097,s,s,s,s,s,s
1,All Students,2018-19,7161,730,6431,89.8,41,15,36.6
1,All Students,2019-20,5099,640,4459,87.4,46,17,37.0
1,All Students,2020-21,5770,694,5076,88.0,35,14,40.0
1,All Students,2021-22,4239,636,3603,85.0,25,15,60.0
1,All Students,2022-23,5030,803,4227,84.0,31,21,67.7
2,All Students,2018-19,7120,685,6435,90.4,41,16,39.0
2,All Students,2019-20,3843,397,3446,89.7,35,11,31.4
2,All Students,2020-21,7934,1132,6802,85.7,46,22,47.8
2,All Students,2021-22,5895,1004,4891,83.0,34,20,58.8
2,All Students,2022-23,5304,530,4774,90.0,31,11,35.5
3,All Students,2018-19,7151,899,6252,87.4,44,26,59.1
3,All Students,2019-20,5112,454,4658,91.1,46,16,34.8
3,All Students,2020-21,7601,627,6974,91.8,45,11,24.4
3,All Students,2021-22,9098,1391,7707,84.7,54,30,55.6
3,All Students,2022-23,7729,883,6846,88.6,47,18,38.3
4,All Students,2018-19,8526,872,7654,89.8,50,15,30.0
4,All Students,2019-20,3705,415,3290,88.8,33,16,48.5
4,All Students,2020-21,7350,789,6561,89.3,42,16,38.1
4,All Students,2021-22,7601,1081,6520,85.8,44,24,54.5
4,All Students,2022-23,9884,1148,8736,88.4,57,25,43.9
5,All Students,2018-19,8956,836,8120,90.7,53,21,39.6
5,All Students,2019-20,5322,428,4894,92.0,47,13,27.7
5,All Students,2020-21,5612,787,4825,86.0,33,16,48.5
5,All Students,2021-22,6958,1145,5813,83.5,41,27,65.9
5,All Students,2022-23,8631,879,7752,89.8,52,20,38.5
6,All Students,2018-19,4622,s,s,s,s,s,s
6,All Students,2019-20,3260,351,2909,89.2,29,10,34.5
6,All Students,2020-21,6579,957,5622,85.5,40,18,45.0
6,All Students,2021-22,3890,722,3168,81.4,23,18,78.3
6,All Students,2022-23,5563,827,4736,85.1,33,18,54.5
7,All Students,2018-19,7225,805,6420,88.9,41,14,34.1
7,All Students,2019-20,2945,s,s,s,s,s,s
7,All Students,2020-21,4894,473,4421,90.3,28,9,32.1
7,All Students,2021-22,6432,951,5481,85.2,41,27,65.9
7,All Students,2022-23,3992,688,3304,82.8,23,14,60.9
8,All Students,2018-19,4630,358,4272,92.3,27,9,33.3
8,All Students,2019-20,4485,443,4042,90.1,40,13,32.5
8,All Students,2020-21,4492,489,4003,89.1,26,11,42.3
8,All Students,2021-22,4613,767,3846,83.4,26,16,61.5
8,All Students,2022-23,6046,739,5307,87.8,36,14,38.9
9,All Students,2018-19,3,s,s,s,s,s,s
9,All Students,2019-20,3,s,s,s,s,s,s
9,All Students,2020-21,17,s,s,s,s,s,s
9,All Students,2022-23,1,s,s,s,s,s,s
All Grades,All Students,2018-19,47143,10081,37062,78.6,385,272,70.6
All Grades,All Students,2019-20,31672,7414,24258,76.6,329,207,62.9
All Grades,All Students,2020-21,45326,16941,28385,62.6,279,222,79.6
All Grades,All Students,2021-22,40133,9709,30424,75.8,304,226,74.3
All Grades,All Students,2022-23,42656,9287,33369,78.2,315,236,74.9
PK in K-12 Schools,All Students,2018-19,578,s,s,s,s,s,s
PK in K-12 Schools,All Students,2019-20,1101,s,s,s,s,s,s
PK in K-12 Schools,All Students,2020-21,1232,354,878,71.3,7,5,71.4
PK in K-12 Schools,All Students,2021-22,830,s,s,s,s,s,s
PK in K-12 Schools,All Students,2022-23,1954,492,1462,74.8,15,13,86.7
0K,All Students,2018-19,1212,s,s,s,s,s,s
0K,All Students,2019-20,1882,329,1553,82.5,20,13,65.0
0K,All Students,2020-21,3393,1102,2291,67.5,20,18,90.0
0K,All Students,2021-22,1565,368,1197,76.5,9,7,77.8
0K,All Students,2022-23,2684,543,2141,79.8,17,12,70.6
1,All Students,2018-19,2093,349,1744,83.3,14,9,64.3
1,All Students,2019-20,861,s,s,s,s,s,s
1,All Students,2020-21,2706,821,1885,69.7,16,14,87.5
1,All Students,2021-22,3286,767,2519,76.7,21,19,90.5
1,All Students,2022-23,2477,444,2033,82.1,16,11,68.8
2,All Students,2018-19,2582,392,2190,84.8,17,10,58.8
2,All Students,2019-20,1620,300,1320,81.5,16,12,75.0
2,All Students,2020-21,1573,593,980,62.3,9,9,100.0
2,All Students,2021-22,2614,550,2064,79.0,16,13,81.3
2,All Students,2022-23,3011,550,2461,81.7,17,12,70.6
3,All Students,2018-19,3138,512,2626,83.7,21,15,71.4
3,All Students,2019-20,1963,324,1639,83.5,20,13,65.0
3,All Students,2020-21,3062,997,2065,67.4,18,17,94.4
3,All Students,2021-22,1362,s,s,s,s,s,s
3,All Students,2022-23,2529,396,2133,84.3,17,8,47.1
4,All Students,2018-19,3578,520,3058,85.5,27,15,55.6
4,All Students,2019-20,2036,281,1755,86.2,20,11,55.0
4,All Students,2020-21,3256,1243,2013,61.8,20,18,90.0
4,All Students,2021-22,3003,644,2359,78.6,19,15,78.9
4,All Students,2022-23,1230,243,987,80.2,9,7,77.8
5,All Students,2018-19,3792,602,3190,84.1,26,18,69.2
5,All Students,2019-20,2219,354,1865,84.0,20,9,45.0
5,All Students,2020-21,3348,939,2409,72.0,21,17,81.0
5,All Students,2021-22,2491,661,1830,73.5,14,10,71.4
5,All Students,2022-23,2850,796,2054,72.1,20,19,95.0
6,All Students,2018-19,6260,1282,4978,79.5,43,32,74.4
6,All Students,2019-20,3166,785,2381,75.2,27,15,55.6
6,All Students,2020-21,3785,1294,2491,65.8,23,19,82.6
6,All Students,2021-22,3565,822,2743,76.9,25,19,76.0
6,All Students,2022-23,2797,676,2121,75.8,20,15,75.0
7,All Students,2018-19,5552,1036,4516,81.3,43,31,72.1
7,All Students,2019-20,4487,1076,3411,76.0,41,25,61.0
7,All Students,2020-21,4721,2175,2546,53.9,29,21,72.4
7,All Students,2021-22,3174,760,2414,76.1,27,18,66.7
7,All Students,2022-23,3525,706,2819,80.0,26,22,84.6
8,All Students,2018-19,5928,1220,4708,79.4,46,33,71.7
8,All Students,2019-20,3889,1104,2785,71.6,42,32,76.2
8,All Students,2020-21,6960,2353,4607,66.2,47,35,74.5
8,All Students,2021-22,5360,1503,3857,72.0,44,33,75.0
8,All Students,2022-23,4514,1123,3391,75.1,36,26,72.2
9,All Students,2018-19,4284,1259,3025,70.6,46,33,71.7
9,All Students,2019-20,2328,1034,1294,55.6,32,23,71.9
9,All Students,2020-21,2488,1426,1062,42.7,15,10,66.7
9,All Students,2021-22,2074,431,1643,79.2,21,14,66.7
9,All Students,2022-23,3528,908,2620,74.3,27,24,88.9
10,All Students,2018-19,3696,1347,2349,63.6,35,28,80.0
10,All Students,2019-20,2927,730,2197,75.1,33,23,69.7
10,All Students,2020-21,2966,1195,1771,59.7,18,15,83.3
10,All Students,2021-22,3900,977,2923,74.9,38,27,71.1
10,All Students,2022-23,3889,1023,2866,73.7,38,31,81.6
11,All Students,2018-19,2019,728,1291,63.9,25,17,68.0
11,All Students,2019-20,1443,497,946,65.6,19,11,57.9
11,All Students,2020-21,3345,1470,1875,56.1,23,17,73.9
11,All Students,2021-22,3211,1003,2208,68.8,28,22,78.6
11,All Students,2022-23,2626,698,1928,73.4,23,17,73.9
12,All Students,2018-19,2431,478,1953,80.3,20,13,65.0
12,All Students,2019-20,1750,302,1448,82.7,18,6,33.3
12,All Students,2020-21,2491,979,1512,60.7,13,7,53.8
12,All Students,2021-22,3698,680,3018,81.6,26,14,53.8
12,All Students,2022-23,5042,689,4353,86.3,34,19,55.9
All Grades,All Students,2018-19,94705,13545,81160,85.7,576,259,45.0
All Grades,All Students,2019-20,59214,7765,51449,86.9,540,244,45.2
All Grades,All Students,2020-21,91812,18449,73363,79.9,533,275,51.6
All Grades,All Students,2021-22,85698,17394,68304,79.7,533,354,66.4
All Grades,All Students,2022-23,88307,14904,73403,83.1,533,340,63.8
0K,All Students,2018-19,4589,496,4093,89.2,28,9,32.1
0K,All Students,2019-20,3547,532,3015,85.0,32,17,53.1
0K,All Students,2020-21,2170,226,1944,89.6,13,4,30.8
0K,All Students,2021-22,3686,807,2879,78.1,26,22,84.6
0K,All Students,2022-23,5649,945,4704,83.3,37,28,75.7
1,All Students,2018-19,6953,660,6293,90.5,43,16,37.2
1,All Students,2019-20,3221,262,2959,91.9,28,7,25.0
1,All Students,2020-21,5655,1238,4417,78.1,33,17,51.5
1,All Students,2021-22,3694,528,3166,85.7,27,16,59.3
1,All Students,2022-23,4572,626,3946,86.3,28,18,64.3
2,All Students,2018-19,5260,374,4886,92.9,32,10,31.3
2,All Students,2019-20,4420,469,3951,89.4,41,15,36.6
2,All Students,2020-21,5101,841,4260,83.5,29,17,58.6
2,All Students,2021-22,5834,940,4894,83.9,35,18,51.4
2,All Students,2022-23,5264,691,4573,86.9,31,19,61.3
3,All Students,2018-19,6444,712,5732,89.0,38,16,42.1
3,All Students,2019-20,4009,322,3687,92.0,36,13,36.1
3,All Students,2020-21,7534,1292,6242,82.9,45,22,48.9
3,All Students,2021-22,5021,751,4270,85.0,30,19,63.3
3,All Students,2022-23,6356,990,5366,84.4,39,23,59.0
4,All Students,2018-19,7342,901,6441,87.7,44,20,45.5
4,All Students,2019-20,4351,477,3874,89.0,40,16,40.0
4,All Students,2020-21,6094,987,5107,83.8,36,16,44.4
4,All Students,2021-22,6725,1010,5715,85.0,44,31,70.5
4,All Students,2022-23,4759,778,3981,83.7,29,23,79.3
5,All Students,2018-19,10159,959,9200,90.6,60,18,30.0
5,All Students,2019-20,4418,612,3806,86.1,41,24,58.5
5,All Students,2020-21,7213,846,6367,88.3,41,12,29.3
5,All Students,2021-22,5195,981,4214,81.1,32,20,62.5
5,All Students,2022-23,6824,958,5866,86.0,40,23,57.5
6,All Students,2018-19,11291,1425,9866,87.4,68,31,45.6
6,All Students,2019-20,6733,765,5968,88.6,61,21,34.4
6,All Students,2020-21,9290,1617,7673,82.6,53,26,49.1
6,All Students,2021-22,8574,1803,6771,79.0,54,43,79.6
6,All Students,2022-23,6633,902,5731,86.4,39,22,56.4
7,All Students,2018-19,11470,1692,9778,85.2,71,38,53.5
7,All Students,2019-20,7289,1078,6211,85.2,66,32,48.5
7,All Students,2020-21,10238,1997,8241,80.5,59,33,55.9
7,All Students,2021-22,9246,1913,7333,79.3,58,35,60.3
7,All Students,2022-23,10176,1844,8332,81.9,62,45,72.6
8,All Students,2018-19,12485,2236,10249,82.1,75,37,49.3
8,All Students,2019-20,7459,1167,6292,84.4,68,37,54.4
8,All Students,2020-21,11043,2923,8120,73.5,64,41,64.1
8,All Students,2021-22,8945,1466,7479,83.6,57,34,59.6
8,All Students,2022-23,9638,1654,7984,82.8,57,36,63.2
9,All Students,2018-19,3586,768,2818,78.6,24,16,66.7
9,All Students,2019-20,4185,506,3679,87.9,37,13,35.1
9,All Students,2020-21,8431,1878,6553,77.7,49,27,55.1
9,All Students,2021-22,6458,1432,5026,77.8,38,25,65.8
9,All Students,2022-23,6843,1068,5775,84.4,40,24,60.0
10,All Students,2018-19,6598,1359,5239,79.4,39,19,48.7
10,All Students,2019-20,3204,543,2661,83.1,32,22,68.8
10,All Students,2020-21,7299,1503,5796,79.4,42,20,47.6
10,All Students,2021-22,7945,1829,6116,77.0,49,33,67.3
10,All Students,2022-23,6320,1148,5172,81.8,38,22,57.9
11,All Students,2018-19,4645,1005,3640,78.4,28,16,57.1
11,All Students,2019-20,3441,449,2992,87.0,32,12,37.5
11,All Students,2020-21,4690,1384,3306,70.5,27,18,66.7
11,All Students,2021-22,6148,1590,4558,74.1,35,25,71.4
11,All Students,2022-23,7634,1479,6155,80.6,46,28,60.9
12,All Students,2018-19,3883,958,2925,75.3,26,13,50.0
12,All Students,2019-20,2937,583,2354,80.1,26,15,57.7
12,All Students,2020-21,7054,1717,5337,75.7,42,22,52.4
12,All Students,2021-22,8227,2344,5883,71.5,48,33,68.8
12,All Students,2022-23,7639,1821,5818,76.2,47,29,61.7
All Grades,All Students,2018-19,44689,4826,39863,89.2,262,114,43.5
All Grades,All Students,2019-20,28703,3496,25207,87.8,264,118,44.7
All Grades,All Students,2020-21,41259,6055,35204,85.3,240,110,45.8
All Grades,All Students,2021-22,42066,6467,35599,84.6,255,152,59.6
All Grades,All Students,2022-23,44734,5130,39604,88.5,266,110,41.4
0K,All Students,2018-19,108,s,s,s,s,s,s
0K,All Students,2019-20,1525,206,1319,86.5,15,9,60.0
0K,All Students,2020-21,1045,116,929,88.9,6,1,16.7
0K,All Students,2021-22,2573,443,2130,82.8,19,14,73.7
0K,All Students,2022-23,1500,171,1329,88.6,13,5,38.5
1,All Students,2018-19,1509,138,1371,90.9,11,5,45.5
1,All Students,2019-20,376,s,s,s,s,s,s
1,All Students,2020-21,3043,440,2603,85.5,18,10,55.6
1,All Students,2021-22,1517,181,1336,88.1,10,7,70.0
1,All Students,2022-23,3153,319,2834,89.9,18,6,33.3
2,All Students,2018-19,1615,230,1385,85.8,10,7,70.0
2,All Students,2019-20,1035,s,s,s,s,s,s
2,All Students,2020-21,924,101,823,89.1,6,4,66.7
2,All Students,2021-22,3518,488,3030,86.1,21,11,52.4
2,All Students,2022-23,2020,188,1832,90.7,12,5,41.7
3,All Students,2018-19,3390,300,3090,91.2,20,10,50.0
3,All Students,2019-20,1826,253,1573,86.1,18,10,55.6
3,All Students,2020-21,2288,274,2014,88.0,13,6,46.2
3,All Students,2021-22,1692,221,1471,86.9,10,7,70.0
3,All Students,2022-23,4864,685,4179,85.9,29,15,51.7
4,All Students,2018-19,3745,411,3334,89.0,22,12,54.5
4,All Students,2019-20,2348,215,2133,90.8,22,10,45.5
4,All Students,2020-21,2281,407,1874,82.2,13,7,53.8
4,All Students,2021-22,2406,260,2146,89.2,16,9,56.3
4,All Students,2022-23,1839,183,1656,90.0,11,4,36.4
5,All Students,2018-19,1989,250,1739,87.4,12,7,58.3
5,All Students,2019-20,2660,306,2354,88.5,25,8,32.0
5,All Students,2020-21,3520,375,3145,89.3,20,7,35.0
5,All Students,2021-22,1932,488,1444,74.7,13,9,69.2
5,All Students,2022-23,2632,192,2440,92.7,16,2,12.5
6,All Students,2018-19,6559,629,5930,90.4,38,15,39.5
6,All Students,2019-20,1262,147,1115,88.4,12,4,33.3
6,All Students,2020-21,1979,300,1679,84.8,12,6,50.0
6,All Students,2021-22,3655,473,3182,87.1,21,10,47.6
6,All Students,2022-23,1880,164,1716,91.3,11,4,36.4
7,All Students,2018-19,2634,208,2426,92.1,16,6,37.5
7,All Students,2019-20,4210,493,3717,88.3,37,18,48.6
7,All Students,2020-21,2306,215,2091,90.7,14,4,28.6
7,All Students,2021-22,2077,260,1817,87.5,12,9,75.0
7,All Students,2022-23,3996,562,3434,85.9,23,15,65.2
8,All Students,2018-19,6758,737,6021,89.1,38,10,26.3
8,All Students,2019-20,2894,395,2499,86.4,26,13,50.0
8,All Students,2020-21,6845,925,5920,86.5,39,21,53.8
8,All Students,2021-22,3224,514,2710,84.1,20,10,50.0
8,All Students,2022-23,2305,245,2060,89.4,14,7,50.0
9,All Students,2018-19,6798,729,6069,89.3,40,15,37.5
9,All Students,2019-20,3299,367,2932,88.9,30,15,50.0
9,All Students,2020-21,4064,1104,2960,72.8,24,17,70.8
9,All Students,2021-22,6995,1156,5839,83.5,41,25,61.0
9,All Students,2022-23,8393,1060,7333,87.4,49,19,38.8
10,All Students,2018-19,5145,562,4583,89.1,29,14,48.3
10,All Students,2019-20,3569,431,3138,87.9,32,10,31.3
10,All Students,2020-21,5915,645,5270,89.1,34,9,26.5
10,All Students,2021-22,4986,751,4235,84.9,29,16,55.2
10,All Students,2022-23,4244,614,3630,85.5,24,14,58.3
11,All Students,2018-19,3371,412,2959,87.8,19,8,42.1
11,All Students,2019-20,2540,362,2178,85.7,23,11,47.8
11,All Students,2020-21,4593,621,3972,86.5,27,12,44.4
11,All Students,2021-22,4762,625,4137,86.9,27,14,51.9
11,All Students,2022-23,5456,541,4915,90.1,31,9,29.0
12,All Students,2018-19,1068,s,s,s,s,s,s
12,All Students,2019-20,1159,177,982,84.7,11,5,45.5
12,All Students,2020-21,2456,532,1924,78.3,14,6,42.9
12,All Students,2021-22,2729,607,2122,77.8,16,11,68.8
12,All Students,2022-23,2452,206,2246,91.6,15,5,33.3
All Grades,All Students,2018-19,44391,13161,31230,70.4,284,210,73.9
All Grades,All Students,2019-20,28603,8848,19755,69.1,263,185,70.3
All Grades,All Students,2020-21,37032,9911,27121,73.2,228,131,57.5
All Grades,All Students,2021-22,36680,12580,24100,65.7,240,182,75.8
All Grades,All Students,2022-23,39078,13730,25348,64.9,246,173,70.3
9,All Students,2018-19,13663,5511,8152,59.7,89,78,87.6
9,All Students,2019-20,7821,2877,4944,63.2,77,58,75.3
9,All Students,2020-21,6205,2487,3718,59.9,39,26,66.7
9,All Students,2021-22,11067,4563,6504,58.8,75,63,84.0
9,All Students,2022-23,10546,3860,6686,63.4,69,52,75.4
10,All Students,2018-19,17082,3929,13153,77.0,110,67,60.9
10,All Students,2019-20,10119,3000,7119,70.4,91,57,62.6
10,All Students,2020-21,9387,3000,6387,68.0,57,39,68.4
10,All Students,2021-22,5435,2461,2974,54.7,39,32,82.1
10,All Students,2022-23,10564,4502,6062,57.4,67,51,76.1
11,All Students,2018-19,9511,2689,6822,71.7,62,50,80.6
11,All Students,2019-20,6078,1636,4442,73.1,55,39,70.9
11,All Students,2020-21,10909,1789,9120,83.6,62,24,38.7
11,All Students,2021-22,9634,2199,7435,77.2,60,40,66.7
11,All Students,2022-23,8052,2292,5760,71.5,52,36,69.2
12,All Students,2018-19,4135,1032,3103,75.0,23,15,65.2
12,All Students,2019-20,4585,1335,3250,70.9,40,31,77.5
12,All Students,2020-21,10531,2635,7896,75.0,70,42,60.0
12,All Students,2021-22,10544,3357,7187,68.2,66,47,71.2
12,All Students,2022-23,9916,3076,6840,69.0,58,34,58.6
All Grades,All Students,2018-19,36616,2188,34428,94.0,213,29,13.6
All Grades,All Students,2019-20,22446,1338,21108,94.0,201,33,16.4
All Grades,All Students,2020-21,32646,2588,30058,92.1,196,44,22.4
All Grades,All Students,2021-22,31156,3217,27939,89.7,190,68,35.8
All Grades,All Students,2022-23,33711,3428,30283,89.8,206,79,38.3
0K,All Students,2018-19,5230,290,4940,94.5,32,5,15.6
0K,All Students,2019-20,3550,286,3264,91.9,32,11,34.4
0K,All Students,2020-21,5476,413,5063,92.5,33,9,27.3
0K,All Students,2021-22,2693,329,2364,87.8,19,8,42.1
0K,All Students,2022-23,5406,542,4864,90.0,34,14,41.2
1,All Students,2018-19,4840,331,4509,93.2,28,4,14.3
1,All Students,2019-20,3746,228,3518,93.9,34,3,8.8
1,All Students,2020-21,5434,629,4805,88.4,33,12,36.4
1,All Students,2021-22,6047,560,5487,90.7,37,13,35.1
1,All Students,2022-23,4130,515,3615,87.5,26,11,42.3
2,All Students,2018-19,5981,356,5625,94.0,35,5,14.3
2,All Students,2019-20,3152,176,2976,94.4,29,6,20.7
2,All Students,2020-21,5412,312,5100,94.2,33,4,12.1
2,All Students,2021-22,4808,672,4136,86.0,31,14,45.2
2,All Students,2022-23,6653,765,5888,88.5,41,16,39.0
3,All Students,2018-19,5967,323,5644,94.6,35,6,17.1
3,All Students,2019-20,3220,175,3045,94.6,28,3,10.7
3,All Students,2020-21,5281,293,4988,94.5,31,4,12.9
3,All Students,2021-22,5425,383,5042,92.9,33,7,21.2
3,All Students,2022-23,5031,454,4577,91.0,31,12,38.7
4,All Students,2018-19,5984,271,5713,95.5,34,4,11.8
4,All Students,2019-20,3239,155,3084,95.2,29,5,17.2
4,All Students,2020-21,4040,194,3846,95.2,24,3,12.5
4,All Students,2021-22,5106,517,4589,89.9,29,12,41.4
4,All Students,2022-23,5501,447,5054,91.9,33,8,24.2
5,All Students,2018-19,6122,273,5849,95.5,35,1,2.9
5,All Students,2019-20,3828,211,3617,94.5,34,4,11.8
5,All Students,2020-21,4728,336,4392,92.9,29,4,13.8
5,All Students,2021-22,4059,340,3719,91.6,24,6,25.0
5,All Students,2022-23,4759,405,4354,91.5,28,12,42.9
6,All Students,2018-19,356,s,s,s,s,s,s
6,All Students,2019-20,575,s,s,s,s,s,s
6,All Students,2020-21,1050,190,860,81.9,6,4,66.7
6,All Students,2021-22,1058,s,s,s,s,s,s
6,All Students,2022-23,531,s,s,s,s,s,s
7,All Students,2018-19,1424,214,1210,85.0,8,1,12.5
7,All Students,2019-20,331,s,s,s,s,s,s
7,All Students,2020-21,875,s,s,s,s,s,s
7,All Students,2021-22,1062,167,895,84.3,6,3,50.0
7,All Students,2022-23,638,s,s,s,s,s,s
8,All Students,2018-19,712,s,s,s,s,s,s
8,All Students,2019-20,805,s,s,s,s,s,s
8,All Students,2020-21,350,s,s,s,s,s,s
8,All Students,2021-22,898,s,s,s,s,s,s
8,All Students,2022-23,1062,171,891,83.9,6,4,66.7
All Grades,All Students,2018-19,78769,13613,65156,82.7,473,269,56.9
All Grades,All Students,2019-20,54261,8864,45397,83.7,487,251,51.5
All Grades,All Students,2020-21,84338,16284,68054,80.7,492,269,54.7
All Grades,All Students,2021-22,84009,18791,65218,77.6,506,371,73.3
All Grades,All Students,2022-23,76230,14540,61690,80.9,460,279,60.7
7,All Students,2021-22,3,s,s,s,s,s,s
9,All Students,2018-19,10891,1446,9445,86.7,68,33,48.5
9,All Students,2019-20,8341,1041,7300,87.5,76,36,47.4
9,All Students,2020-21,13161,2077,11084,84.2,79,40,50.6
9,All Students,2021-22,9538,s,s,s,s,s,s
9,All Students,2022-23,8689,1958,6731,77.5,55,36,65.5
10,All Students,2018-19,12147,1804,10343,85.1,71,37,52.1
10,All Students,2019-20,7118,983,6135,86.2,65,29,44.6
10,All Students,2020-21,12576,2093,10483,83.4,72,36,50.0
10,All Students,2021-22,12421,2798,9623,77.5,76,56,73.7
10,All Students,2022-23,10838,1950,8888,82.0,64,35,54.7
11,All Students,2018-19,8997,1829,7168,79.7,54,33,61.1
11,All Students,2019-20,8834,1318,7516,85.1,78,38,48.7
11,All Students,2020-21,10117,1780,8337,82.4,58,28,48.3
11,All Students,2021-22,11836,2567,9269,78.3,70,50,71.4
11,All Students,2022-23,11025,1947,9078,82.3,66,34,51.5
12,All Students,2018-19,46734,8534,38200,81.7,280,166,59.3
12,All Students,2019-20,29968,5522,24446,81.6,268,148,55.2
12,All Students,2020-21,48484,10334,38150,78.7,283,165,58.3
12,All Students,2021-22,50211,11400,38811,77.3,302,219,72.5
12,All Students,2022-23,45678,8685,36993,81.0,275,174,63.3
All Grades,All Students,2018-19,76731,11614,65117,84.9,469,265,56.5
All Grades,All Students,2019-20,54724,8235,46489,85.0,510,282,55.3
All Grades,All Students,2020-21,86345,17098,69247,80.2,510,317,62.2
All Grades,All Students,2021-22,82117,19891,62226,75.8,492,355,72.2
All Grades,All Students,2022-23,84345,17921,66424,78.8,509,372,73.1
0K,All Students,2018-19,9285,1596,7689,82.8,61,38,62.3
0K,All Students,2019-20,7087,1086,6001,84.7,69,42,60.9
0K,All Students,2020-21,6499,1007,5492,84.5,43,22,51.2
0K,All Students,2021-22,4291,s,s,s,s,s,s
0K,All Students,2022-23,10507,2167,8340,79.4,70,53,75.7
1,All Students,2018-19,13926,2024,11902,85.5,85,47,55.3
1,All Students,2019-20,6535,1077,5458,83.5,59,36,61.0
1,All Students,2020-21,11847,1734,10113,85.4,69,38,55.1
1,All Students,2021-22,7855,1514,6341,80.7,51,37,72.5
1,All Students,2022-23,6815,s,s,s,s,s,s
2,All Students,2018-19,7979,1091,6888,86.3,47,30,63.8
2,All Students,2019-20,8634,1206,7428,86.0,80,37,46.3
2,All Students,2020-21,10030,1921,8109,80.8,59,38,64.4
2,All Students,2021-22,11476,2660,8816,76.8,65,46,70.8
2,All Students,2022-23,7050,1079,5971,84.7,41,28,68.3
3,All Students,2018-19,10686,1507,9179,85.9,64,29,45.3
3,All Students,2019-20,5528,824,4704,85.1,53,34,64.2
3,All Students,2020-21,13023,2297,10726,82.4,76,46,60.5
3,All Students,2021-22,9308,2377,6931,74.5,57,42,73.7
3,All Students,2022-23,12101,2958,9143,75.6,71,57,80.3
4,All Students,2018-19,9210,1426,7784,84.5,57,33,57.9
4,All Students,2019-20,6014,916,5098,84.8,54,29,53.7
4,All Students,2020-21,8128,1892,6236,76.7,47,37,78.7
4,All Students,2021-22,12635,2708,9927,78.6,74,49,66.2
4,All Students,2022-23,9412,2209,7203,76.5,56,43,76.8
5,All Students,2018-19,9758,1480,8278,84.8,57,32,56.1
5,All Students,2019-20,6215,886,5329,85.7,59,29,49.2
5,All Students,2020-21,9046,1796,7250,80.1,52,30,57.7
5,All Students,2021-22,7889,1870,6019,76.3,49,38,77.6
5,All Students,2022-23,11278,2222,9056,80.3,69,40,58.0
6,All Students,2018-19,5811,929,4882,84.0,37,25,67.6
6,All Students,2019-20,7644,1289,6355,83.1,73,39,53.4
6,All Students,2020-21,10358,2289,8069,77.9,60,37,61.7
6,All Students,2021-22,8990,2541,6449,71.7,53,40,75.5
6,All Students,2022-23,10457,2443,8014,76.6,61,48,78.7
7,All Students,2018-19,4169,646,3523,84.5,25,11,44.0
7,All Students,2019-20,3986,563,3423,85.9,35,21,60.0
7,All Students,2020-21,11224,2486,8738,77.9,66,45,68.2
7,All Students,2021-22,9263,2212,7051,76.1,54,34,63.0
7,All Students,2022-23,7931,1543,6388,80.5,47,33,70.2
8,All Students,2018-19,5907,915,4992,84.5,36,20,55.6
8,All Students,2019-20,3081,388,2693,87.4,28,15,53.6
8,All Students,2020-21,6142,s,s,s,s,s,s
8,All Students,2021-22,10203,2813,7390,72.4,59,44,74.6
8,All Students,2022-23,8689,1740,6949,80.0,51,34,66.7
9,All Students,2020-21,19,s,s,s,s,s,s
9,All Students,2021-22,207,s,s,s,s,s,s
9,All Students,2022-23,105,s,s,s,s,s,s
All Grades,All Students,2018-19,84590,13209,71381,84.4,492,233,47.4
All Grades,All Students,2019-20,53349,8370,44979,84.3,467,213,45.6
All Grades,All Students,2020-21,82718,20564,62154,75.1,486,277,57.0
All Grades,All Students,2021-22,83311,16881,66430,79.7,490,305,62.2
All Grades,All Students,2022-23,80913,13794,67119,83.0,477,248,52.0
0K,All Students,2018-19,1901,233,1668,87.7,11,7,63.6
0K,All Students,2019-20,809,s,s,s,s,s,s
0K,All Students,2020-21,2911,525,2386,82.0,19,11,57.9
0K,All Students,2021-22,1945,339,1606,82.6,13,11,84.6
0K,All Students,2022-23,747,s,s,s,s,s,s
1,All Students,2018-19,2136,142,1994,93.4,12,2,16.7
1,All Students,2019-20,1380,164,1216,88.1,12,7,58.3
1,All Students,2020-21,1462,236,1226,83.9,9,5,55.6
1,All Students,2021-22,3019,425,2594,85.9,18,9,50.0
1,All Students,2022-23,2301,284,2017,87.7,13,7,53.8
2,All Students,2018-19,1427,85,1342,94.0,8,1,12.5
2,All Students,2019-20,1380,88,1292,93.6,12,3,25.0
2,All Students,2020-21,1983,476,1507,76.0,12,8,66.7
2,All Students,2021-22,1427,265,1162,81.4,9,7,77.8
2,All Students,2022-23,3379,368,3011,89.1,20,9,45.0
3,All Students,2018-19,178,s,s,s,s,s,s
3,All Students,2019-20,113,s,s,s,s,s,s
3,All Students,2020-21,176,s,s,s,s,s,s
3,All Students,2021-22,63,s,s,s,s,s,s
3,All Students,2022-23,177,s,s,s,s,s,s
4,All Students,2019-20,115,s,s,s,s,s,s
4,All Students,2020-21,176,s,s,s,s,s,s
4,All Students,2021-22,174,s,s,s,s,s,s
4,All Students,2022-23,149,s,s,s,s,s,s
5,All Students,2020-21,176,s,s,s,s,s,s
5,All Students,2021-22,174,s,s,s,s,s,s
5,All Students,2022-23,177,s,s,s,s,s,s
6,All Students,2018-19,3,s,s,s,s,s,s
6,All Students,2019-20,115,s,s,s,s,s,s
6,All Students,2020-21,10,s,s,s,s,s,s
6,All Students,2021-22,177,s,s,s,s,s,s
6,All Students,2022-23,177,s,s,s,s,s,s
7,All Students,2018-19,178,s,s,s,s,s,s
7,All Students,2019-20,115,s,s,s,s,s,s
7,All Students,2020-21,176,s,s,s,s,s,s
7,All Students,2022-23,110,s,s,s,s,s,s
8,All Students,2018-19,178,s,s,s,s,s,s
8,All Students,2019-20,115,s,s,s,s,s,s
8,All Students,2020-21,176,s,s,s,s,s,s
8,All Students,2021-22,203,s,s,s,s,s,s
9,All Students,2018-19,9209,1109,8100,88.0,54,17,31.5
9,All Students,2019-20,5138,622,4516,87.9,44,15,34.1
9,All Students,2020-21,9497,2865,6632,69.8,57,37,64.9
9,All Students,2021-22,8620,1759,6861,79.6,53,33,62.3
9,All Students,2022-23,13981,2064,11917,85.2,85,47,55.3
10,All Students,2018-19,10570,1566,9004,85.2,63,32,50.8
10,All Students,2019-20,7273,989,6284,86.4,64,23,35.9
10,All Students,2020-21,8437,1816,6621,78.5,51,29,56.9
10,All Students,2021-22,8191,2068,6123,74.8,47,33,70.2
10,All Students,2022-23,9830,1985,7845,79.8,59,30,50.8
11,All Students,2018-19,10245,1551,8694,84.9,61,26,42.6
11,All Students,2019-20,6938,1129,5809,83.7,63,36,57.1
11,All Students,2020-21,10099,2003,8096,80.2,58,23,39.7
11,All Students,2021-22,8446,1665,6781,80.3,50,27,54.0
11,All Students,2022-23,8382,1623,6759,80.6,50,26,52.0
12,All Students,2018-19,48565,8521,40044,82.5,280,148,52.9
12,All Students,2019-20,29858,5274,24584,82.3,259,124,47.9
12,All Students,2020-21,47436,12304,35132,74.1,275,159,57.8
12,All Students,2021-22,50872,10245,40627,79.9,294,179,60.9
12,All Students,2022-23,41503,7263,34240,82.5,240,125,52.1
All Grades,All Students,2018-19,44934,16005,28929,64.4,323,258,79.9
All Grades,All Students,2019-20,31072,10893,20179,64.9,310,232,74.8
All Grades,All Students,2020-21,55726,12737,42989,77.1,354,204,57.6
All Grades,All Students,2021-22,59922,20916,39006,65.1,385,303,78.7
All Grades,All Students,2022-23,61260,17401,43859,71.6,381,282,74.0
6,All Students,2018-19,5799,s,s,s,s,s,s
6,All Students,2019-20,468,s,s,s,s,s,s
6,All Students,2020-21,4390,s,s,s,s,s,s
6,All Students,2021-22,5248,1227,4021,76.6,30,21,70.0
6,All Students,2022-23,1248,175,1073,86.0,7,4,57.1
7,All Students,2018-19,451,s,s,s,s,s,s
7,All Students,2019-20,3335,576,2759,82.7,28,14,50.0
7,All Students,2020-21,880,s,s,s,s,s,s
7,All Students,2021-22,3711,595,3116,84.0,24,10,41.7
7,All Students,2022-23,4259,799,3460,81.2,26,19,73.1
8,All Students,2019-20,230,s,s,s,s,s,s
8,All Students,2020-21,5148,582,4566,88.7,30,13,43.3
8,All Students,2021-22,919,289,630,68.6,6,4,66.7
8,All Students,2022-23,4071,655,3416,83.9,23,13,56.5
9,All Students,2018-19,9629,4912,4717,49.0,77,69,89.6
9,All Students,2019-20,7282,3649,3633,49.9,77,63,81.8
9,All Students,2020-21,8797,3513,5284,60.1,59,48,81.4
9,All Students,2021-22,13326,5753,7573,56.8,90,72,80.0
9,All Students,2022-23,10221,3994,6227,60.9,68,51,75.0
10,All Students,2018-19,12465,4619,7846,62.9,93,82,88.2
10,All Students,2019-20,8671,3253,5418,62.5,92,77,83.7
10,All Students,2020-21,15129,4769,10360,68.5,99,71,71.7
10,All Students,2021-22,12334,5430,6904,56.0,81,73,90.1
10,All Students,2022-23,17666,5115,12551,71.0,110,91,82.7
11,All Students,2018-19,7794,1635,6159,79.0,52,28,53.8
11,All Students,2019-20,2747,748,1999,72.8,29,22,75.9
11,All Students,2020-21,6068,1224,4844,79.8,38,22,57.9
11,All Students,2021-22,5921,1713,4208,71.1,37,29,78.4
11,All Students,2022-23,5925,2017,3908,66.0,38,30,78.9
12,All Students,2018-19,8796,3548,5248,59.7,62,54,87.1
12,All Students,2019-20,8339,2431,5908,70.8,78,52,66.7
12,All Students,2020-21,15314,2229,13085,85.4,97,42,43.3
12,All Students,2021-22,18463,5909,12554,68.0,117,94,80.3
12,All Students,2022-23,17870,4646,13224,74.0,109,74,67.9
All Grades,All Students,2018-19,76986,10211,66775,86.7,465,209,44.9
All Grades,All Students,2019-20,53918,7392,46526,86.3,492,248,50.4
All Grades,All Students,2020-21,82094,15006,67088,81.7,481,269,55.9
All Grades,All Students,2021-22,85200,15871,69329,81.4,523,345,66.0
All Grades,All Students,2022-23,95582,16132,79450,83.1,590,356,60.3
0K,All Students,2018-19,6213,882,5331,85.8,40,21,52.5
0K,All Students,2019-20,3907,667,3240,82.9,39,26,66.7
0K,All Students,2020-21,6166,1305,4861,78.8,42,23,54.8
0K,All Students,2021-22,7819,1594,6225,79.6,54,38,70.4
0K,All Students,2022-23,18569,2880,15689,84.5,119,72,60.5
1,All Students,2018-19,7086,911,6175,87.1,43,17,39.5
1,All Students,2019-20,4568,590,3978,87.1,43,22,51.2
1,All Students,2020-21,6411,1341,5070,79.1,38,22,57.9
1,All Students,2021-22,8606,1979,6627,77.0,56,43,76.8
1,All Students,2022-23,11382,1945,9437,82.9,73,48,65.8
2,All Students,2018-19,8280,857,7423,89.6,49,19,38.8
2,All Students,2019-20,5201,790,4411,84.8,49,29,59.2
2,All Students,2020-21,7061,1207,5854,82.9,41,24,58.5
2,All Students,2021-22,7148,1464,5684,79.5,44,31,70.5
2,All Students,2022-23,9714,2216,7498,77.2,61,45,73.8
3,All Students,2018-19,9910,1412,8498,85.8,61,29,47.5
3,All Students,2019-20,5574,641,4933,88.5,50,16,32.0
3,All Students,2020-21,8183,1804,6379,78.0,48,36,75.0
3,All Students,2021-22,7811,1314,6497,83.2,51,30,58.8
3,All Students,2022-23,7684,1252,6432,83.7,46,27,58.7
4,All Students,2018-19,9892,1307,8585,86.8,62,27,43.5
4,All Students,2019-20,7101,1077,6024,84.8,65,37,56.9
4,All Students,2020-21,7656,1333,6323,82.6,46,29,63.0
4,All Students,2021-22,9497,1708,7789,82.0,57,44,77.2
4,All Students,2022-23,8893,1339,7554,84.9,54,30,55.6
5,All Students,2018-19,14486,1842,12644,87.3,82,32,39.0
5,All Students,2019-20,6591,866,5725,86.9,59,27,45.8
5,All Students,2020-21,10705,2258,8447,78.9,61,39,63.9
5,All Students,2021-22,7459,1158,6301,84.5,45,25,55.6
5,All Students,2022-23,9457,1443,8014,84.7,55,37,67.3
6,All Students,2018-19,7930,1094,6836,86.2,45,20,44.4
6,All Students,2019-20,10159,1100,9059,89.2,89,38,42.7
6,All Students,2020-21,7458,1150,6308,84.6,43,19,44.2
6,All Students,2021-22,8552,1374,7178,83.9,50,31,62.0
6,All Students,2022-23,8201,1787,6414,78.2,51,32,62.7
7,All Students,2018-19,5263,791,4472,85.0,34,17,50.0
7,All Students,2019-20,5249,835,4414,84.1,47,22,46.8
7,All Students,2020-21,15136,2626,12510,82.7,86,43,50.0
7,All Students,2021-22,7405,1396,6009,81.1,44,27,61.4
7,All Students,2022-23,8908,1267,7641,85.8,54,26,48.1
8,All Students,2018-19,4292,441,3851,89.7,25,11,44.0
8,All Students,2019-20,3119,459,2660,85.3,28,16,57.1
8,All Students,2020-21,8207,1532,6675,81.3,47,28,59.6
8,All Students,2021-22,15376,2814,12562,81.7,90,56,62.2
8,All Students,2022-23,6763,798,5965,88.2,39,14,35.9
9,All Students,2018-19,1062,162,900,84.7,7,5,71.4
9,All Students,2019-20,770,s,s,s,s,s,s
9,All Students,2020-21,1936,196,1740,89.9,11,2,18.2
9,All Students,2021-22,1387,265,1122,80.9,8,4,50.0
9,All Students,2022-23,1665,249,1416,85.0,11,5,45.5
10,All Students,2018-19,838,s,s,s,s,s,s
10,All Students,2019-20,660,s,s,s,s,s,s
10,All Students,2020-21,1232,83,1149,93.3,7,1,14.3
10,All Students,2021-22,1896,359,1537,81.1,11,8,72.7
10,All Students,2022-23,1505,291,1214,80.7,9,5,55.6
11,All Students,2018-19,669,s,s,s,s,s,s
11,All Students,2019-20,529,s,s,s,s,s,s
11,All Students,2020-21,1056,s,s,s,s,s,s
11,All Students,2021-22,1210,153,1057,87.4,7,3,42.9
11,All Students,2022-23,1665,425,1240,74.5,10,8,80.0
12,All Students,2018-19,1065,328,737,69.2,7,6,85.7
12,All Students,2019-20,490,s,s,s,s,s,s
12,All Students,2020-21,880,s,s,s,s,s,s
12,All Students,2021-22,1034,293,741,71.7,6,5,83.3
12,All Students,2022-23,1176,240,936,79.6,8,7,87.5
All Grades,All Students,2018-19,58642,10106,48536,82.8,346,193,55.8
All Grades,All Students,2019-20,38864,7089,31775,81.8,350,196,56.0
All Grades,All Students,2020-21,57962,13760,44202,76.3,342,192,56.1
All Grades,All Students,2021-22,54853,14071,40782,74.3,324,240,74.1
All Grades,All Students,2022-23,47056,9760,37296,79.3,287,187,65.2
6,All Students,2018-19,2473,479,1994,80.6,14,9,64.3
6,All Students,2019-20,979,140,839,85.7,10,5,50.0
6,All Students,2020-21,656,s,s,s,s,s,s
6,All Students,2021-22,712,s,s,s,s,s,s
6,All Students,2022-23,463,s,s,s,s,s,s
7,All Students,2018-19,1787,140,1647,92.2,11,4,36.4
7,All Students,2019-20,1442,362,1080,74.9,13,8,61.5
7,All Students,2020-21,1721,s,s,s,s,s,s
7,All Students,2021-22,826,s,s,s,s,s,s
7,All Students,2022-23,527,s,s,s,s,s,s
8,All Students,2018-19,4603,582,4021,87.4,26,9,34.6
8,All Students,2019-20,1224,90,1134,92.6,11,5,45.5
8,All Students,2020-21,2288,630,1658,72.5,13,8,61.5
8,All Students,2021-22,1196,218,978,81.8,7,4,57.1
8,All Students,2022-23,847,s,s,s,s,s,s
9,All Students,2018-19,8225,1081,7144,86.9,48,25,52.1
9,All Students,2019-20,6573,1066,5507,83.8,59,34,57.6
9,All Students,2020-21,5961,1405,4556,76.4,37,24,64.9
9,All Students,2021-22,6540,1956,4584,70.1,41,32,78.0
9,All Students,2022-23,4221,843,3378,80.0,27,16,59.3
10,All Students,2018-19,4574,1064,3510,76.7,28,19,67.9
10,All Students,2019-20,5023,606,4417,87.9,46,18,39.1
10,All Students,2020-21,9978,1838,8140,81.6,59,28,47.5
10,All Students,2021-22,5886,1586,4300,73.1,36,31,86.1
10,All Students,2022-23,5965,1421,4544,76.2,38,26,68.4
11,All Students,2018-19,8735,1677,7058,80.8,51,28,54.9
11,All Students,2019-20,4352,1212,3140,72.2,39,25,64.1
11,All Students,2020-21,7756,1493,6263,80.8,45,25,55.6
11,All Students,2021-22,9833,2249,7584,77.1,58,40,69.0
11,All Students,2022-23,6607,1508,5099,77.2,38,29,76.3
12,All Students,2018-19,28245,5083,23162,82.0,168,99,58.9
12,All Students,2019-20,19271,3613,15658,81.3,172,101,58.7
12,All Students,2020-21,29602,7955,21647,73.1,174,101,58.0
12,All Students,2021-22,29860,7722,22138,74.1,173,127,73.4
12,All Students,2022-23,28426,5711,22715,79.9,168,110,65.5
All Grades,All Students,2022-23,39989,10598,29391,73.5,496,221,44.6
PK in K-12 Schools,All Students,2022-23,6,s,s,s,s,s,s
0K,All Students,2022-23,29,s,s,s,s,s,s
1,All Students,2022-23,110,s,s,s,s,s,s
2,All Students,2022-23,179,s,s,s,s,s,s
3,All Students,2022-23,192,s,s,s,s,s,s
4,All Students,2022-23,402,s,s,s,s,s,s
5,All Students,2022-23,499,s,s,s,s,s,s
6,All Students,2022-23,564,s,s,s,s,s,s
7,All Students,2022-23,593,s,s,s,s,s,s
8,All Students,2022-23,855,s,s,s,s,s,s
9,All Students,2022-23,11585,4668,6917,59.7,115,74,64.3
10,All Students,2022-23,11633,2900,8733,75.1,121,68,56.2
11,All Students,2022-23,6235,1477,4758,76.3,77,33,42.9
12,All Students,2022-23,7107,1429,5678,79.9,67,33,49.3
All Grades,All Students,2018-19,48430,12023,36407,75.2,287,193,67.2
All Grades,All Students,2019-20,31292,8729,22563,72.1,270,185,68.5
All Grades,All Students,2020-21,47949,17286,30663,63.9,273,221,81.0
All Grades,All Students,2021-22,47957,15720,32237,67.2,288,232,80.6
All Grades,All Students,2022-23,40705,9901,30804,75.7,252,169,67.1
6,All Students,2018-19,1464,316,1148,78.4,9,6,66.7
6,All Students,2019-20,582,s,s,s,s,s,s
6,All Students,2020-21,2853,1164,1689,59.2,16,15,93.8
6,All Students,2021-22,1054,240,814,77.2,7,6,85.7
6,All Students,2022-23,861,s,s,s,s,s,s
7,All Students,2018-19,890,s,s,s,s,s,s
7,All Students,2019-20,905,215,690,76.2,8,5,62.5
7,All Students,2020-21,1056,302,754,71.4,6,s,s
7,All Students,2021-22,3142,840,2302,73.3,20,18,90.0
7,All Students,2022-23,635,s,s,s,s,s,s
8,All Students,2018-19,1162,s,s,s,s,s,s
8,All Students,2019-20,683,s,s,s,s,s,s
8,All Students,2020-21,1067,366,701,65.7,5,s,s
8,All Students,2021-22,1191,388,803,67.4,8,8,100.0
8,All Students,2022-23,3555,887,2668,75.0,21,17,81.0
9,All Students,2018-19,7836,1718,6118,78.1,46,29,63.0
9,All Students,2019-20,2926,563,2363,80.8,28,18,64.3
9,All Students,2020-21,3937,1092,2845,72.3,25,18,72.0
9,All Students,2021-22,4874,1324,3550,72.8,30,17,56.7
9,All Students,2022-23,2802,746,2056,73.4,20,14,70.0
10,All Students,2018-19,4407,1199,3208,72.8,31,21,67.7
10,All Students,2019-20,3247,903,2344,72.2,28,18,64.3
10,All Students,2020-21,4806,1774,3032,63.1,28,24,85.7
10,All Students,2021-22,4010,1481,2529,63.1,25,22,88.0
10,All Students,2022-23,4596,1087,3509,76.3,29,19,65.5
11,All Students,2018-19,9381,2390,6991,74.5,54,42,77.8
11,All Students,2019-20,4453,1429,3024,67.9,36,23,63.9
11,All Students,2020-21,4799,1989,2810,58.6,27,25,92.6
11,All Students,2021-22,5129,1505,3624,70.7,30,26,86.7
11,All Students,2022-23,5283,1664,3619,68.5,33,24,72.7
12,All Students,2018-19,23290,6047,17243,74.0,134,87,64.9
12,All Students,2019-20,18496,5276,13220,71.5,157,110,70.1
12,All Students,2020-21,29431,10599,18832,64.0,166,130,78.3
12,All Students,2021-22,28557,9942,18615,65.2,168,135,80.4
12,All Students,2022-23,22973,5195,17778,77.4,140,89,63.6
All Grades,All Students,2018-19,74172,9386,64786,87.3,448,230,51.3
All Grades,All Students,2019-20,47818,6658,41160,86.1,431,236,54.8
All Grades,All Students,2020-21,71135,10595,60540,85.1,421,216,51.3
All Grades,All Students,2021-22,69074,13262,55812,80.8,413,306,74.1
All Grades,All Students,2022-23,78194,13398,64796,82.9,473,316,66.8
0K,All Students,2018-19,5669,753,4916,86.7,35,18,51.4
0K,All Students,2019-20,2754,429,2325,84.4,28,15,53.6
0K,All Students,2020-21,4225,642,3583,84.8,27,14,51.9
0K,All Students,2021-22,6113,1048,5065,82.9,41,28,68.3
0K,All Students,2022-23,10297,1964,8333,80.9,68,52,76.5
1,All Students,2018-19,8811,1272,7539,85.6,55,32,58.2
1,All Students,2019-20,3365,420,2945,87.5,30,14,46.7
1,All Students,2020-21,5861,904,4957,84.6,36,23,63.9
1,All Students,2021-22,5931,1160,4771,80.4,37,32,86.5
1,All Students,2022-23,9668,1703,7965,82.4,62,44,71.0
2,All Students,2018-19,4228,589,3639,86.1,25,15,60.0
2,All Students,2019-20,6454,1041,5413,83.9,59,35,59.3
2,All Students,2020-21,6325,1065,5260,83.2,37,23,62.2
2,All Students,2021-22,5441,999,4442,81.6,34,24,70.6
2,All Students,2022-23,6477,1196,5281,81.5,39,29,74.4
3,All Students,2018-19,6964,752,6212,89.2,41,20,48.8
3,All Students,2019-20,2865,398,2467,86.1,26,14,53.8
3,All Students,2020-21,8932,1499,7433,83.2,53,31,58.5
3,All Students,2021-22,6859,1317,5542,80.8,41,32,78.0
3,All Students,2022-23,4960,704,4256,85.8,32,22,68.8
4,All Students,2018-19,11604,1481,10123,87.2,72,37,51.4
4,All Students,2019-20,5752,721,5031,87.5,53,28,52.8
4,All Students,2020-21,4794,755,4039,84.3,30,15,50.0
4,All Students,2021-22,8710,1642,7068,81.1,52,41,78.8
4,All Students,2022-23,8100,1470,6630,81.9,48,31,64.6
5,All Students,2018-19,10112,1161,8951,88.5,60,27,45.0
5,All Students,2019-20,7458,1081,6377,85.5,68,38,55.9
5,All Students,2020-21,9479,1459,8020,84.6,56,30,53.6
5,All Students,2021-22,4936,890,4046,82.0,29,21,72.4
5,All Students,2022-23,9289,1745,7544,81.2,55,39,70.9
6,All Students,2018-19,7212,867,6345,88.0,42,17,40.5
6,All Students,2019-20,5091,674,4417,86.8,45,26,57.8
6,All Students,2020-21,7602,1140,6462,85.0,44,22,50.0
6,All Students,2021-22,5369,1098,4271,79.5,31,24,77.4
6,All Students,2022-23,4423,674,3749,84.8,26,16,61.5
7,All Students,2018-19,6958,976,5982,86.0,41,26,63.4
7,All Students,2019-20,4187,590,3597,85.9,36,17,47.2
7,All Students,2020-21,7744,1074,6670,86.1,44,18,40.9
7,All Students,2021-22,6645,1393,5252,79.0,39,29,74.4
7,All Students,2022-23,4679,715,3964,84.7,27,14,51.9
8,All Students,2018-19,7157,829,6328,88.4,40,19,47.5
8,All Students,2019-20,4076,527,3549,87.1,36,21,58.3
8,All Students,2020-21,5879,679,5200,88.5,34,15,44.1
8,All Students,2021-22,6945,1323,5622,81.0,39,25,64.1
8,All Students,2022-23,6751,1244,5507,81.6,38,27,71.1
9,All Students,2018-19,1498,222,1276,85.2,10,6,60.0
9,All Students,2019-20,2530,334,2196,86.8,22,13,59.1
9,All Students,2020-21,2785,239,2546,91.4,16,s,s
9,All Students,2021-22,2841,376,2465,86.8,17,10,58.8
9,All Students,2022-23,3177,353,2824,88.9,18,7,38.9
10,All Students,2018-19,1897,329,1568,82.7,14,8,57.1
10,All Students,2019-20,890,s,s,s,s,s,s
10,All Students,2020-21,3696,427,3269,88.4,21,8,38.1
10,All Students,2021-22,2546,501,2045,80.3,15,12,80.0
10,All Students,2022-23,2864,307,2557,89.3,17,8,47.1
11,All Students,2018-19,1260,s,s,s,s,s,s
11,All Students,2019-20,1239,230,1009,81.4,11,7,63.6
11,All Students,2020-21,905,124,781,86.3,5,s,s
11,All Students,2021-22,3560,670,2890,81.2,20,13,65.0
11,All Students,2022-23,2337,406,1931,82.6,14,10,71.4
12,All Students,2018-19,802,s,s,s,s,s,s
12,All Students,2019-20,1157,s,s,s,s,s,s
12,All Students,2020-21,2908,588,2320,79.8,18,9,50.0
12,All Students,2021-22,3178,845,2333,73.4,18,15,83.3
12,All Students,2022-23,5172,917,4255,82.3,29,17,58.6
All Grades,All Students,2018-19,108176,18671,89505,82.7,635,365,57.5
All Grades,All Students,2019-20,72195,12808,59387,82.3,638,349,54.7
All Grades,All Students,2020-21,114564,20006,94558,82.5,672,343,51.0
All Grades,All Students,2021-22,116579,27775,88804,76.2,681,501,73.6
All Grades,All Students,2022-23,125279,26836,98443,78.6,732,529,72.3
PK in K-12 Schools,All Students,2018-19,1323,341,982,74.2,8,7,87.5
PK in K-12 Schools,All Students,2019-20,2429,501,1928,79.4,25,20,80.0
PK in K-12 Schools,All Students,2020-21,3608,840,2768,76.7,24,18,75.0
PK in K-12 Schools,All Students,2021-22,4046,1118,2928,72.4,26,25,96.2
PK in K-12 Schools,All Students,2022-23,4161,876,3285,78.9,24,19,79.2
0K,All Students,2018-19,10433,1388,9045,86.7,68,36,52.9
0K,All Students,2019-20,3949,648,3301,83.6,36,24,66.7
0K,All Students,2020-21,11475,2264,9211,80.3,74,45,60.8
0K,All Students,2021-22,9360,1466,7894,84.3,61,40,65.6
0K,All Students,2022-23,13369,2745,10624,79.5,85,68,80.0
1,All Students,2018-19,10590,2083,8507,80.3,64,40,62.5
1,All Students,2019-20,8062,1064,6998,86.8,71,35,49.3
1,All Students,2020-21,8684,1494,7190,82.8,53,33,62.3
1,All Students,2021-22,12606,2548,10058,79.8,75,48,64.0
1,All Students,2022-23,11464,2088,9376,81.8,67,47,70.1
2,All Students,2018-19,9435,1484,7951,84.3,55,31,56.4
2,All Students,2019-20,7202,1645,5557,77.2,62,42,67.7
2,All Students,2020-21,11430,2252,9178,80.3,66,39,59.1
2,All Students,2021-22,8650,1909,6741,77.9,55,38,69.1
2,All Students,2022-23,12958,2440,10518,81.2,78,56,71.8
3,All Students,2018-19,9563,1425,8138,85.1,58,41,70.7
3,All Students,2019-20,6069,894,5175,85.3,56,30,53.6
3,All Students,2020-21,10902,2046,8856,81.2,64,32,50.0
3,All Students,2021-22,11653,2547,9106,78.1,67,50,74.6
3,All Students,2022-23,9067,1859,7208,79.5,55,42,76.4
4,All Students,2018-19,9351,1534,7817,83.6,52,26,50.0
4,All Students,2019-20,6192,1200,4992,80.6,54,33,61.1
4,All Students,2020-21,9916,1479,8437,85.1,57,28,49.1
4,All Students,2021-22,11235,2676,8559,76.2,66,52,78.8
4,All Students,2022-23,11270,2203,9067,80.5,66,48,72.7
5,All Students,2018-19,9773,1644,8129,83.2,55,25,45.5
5,All Students,2019-20,5851,888,4963,84.8,53,26,49.1
5,All Students,2020-21,9501,1419,8082,85.1,54,25,46.3
5,All Students,2021-22,9539,2618,6921,72.6,54,41,75.9
5,All Students,2022-23,10999,2335,8664,78.8,65,49,75.4
6,All Students,2018-19,8591,1602,6989,81.4,51,29,56.9
6,All Students,2019-20,5391,767,4624,85.8,47,19,40.4
6,All Students,2020-21,5792,1046,4746,81.9,33,18,54.5
6,All Students,2021-22,8728,2478,6250,71.6,49,38,77.6
6,All Students,2022-23,5746,1266,4480,78.0,35,24,68.6
7,All Students,2018-19,7408,1050,6358,85.8,44,17,38.6
7,All Students,2019-20,5726,1133,4593,80.2,51,28,54.9
7,All Students,2020-21,7841,1205,6636,84.6,45,19,42.2
7,All Students,2021-22,5412,786,4626,85.5,32,19,59.4
7,All Students,2022-23,8496,1949,6547,77.1,48,36,75.0
8,All Students,2018-19,8335,1465,6870,82.4,50,29,58.0
8,All Students,2019-20,4613,741,3872,83.9,40,14,35.0
8,All Students,2020-21,8062,1562,6500,80.6,47,23,48.9
8,All Students,2021-22,6796,1452,5344,78.6,38,26,68.4
8,All Students,2022-23,4857,671,4186,86.2,30,19,63.3
9,All Students,2018-19,3635,689,2946,81.0,20,12,60.0
9,All Students,2019-20,3547,642,2905,81.9,30,14,46.7
9,All Students,2020-21,6395,842,5553,86.8,36,13,36.1
9,All Students,2021-22,4145,1557,2588,62.4,23,20,87.0
9,All Students,2022-23,6568,1413,5155,78.5,37,26,70.3
10,All Students,2018-19,3175,454,2721,85.7,18,12,66.7
10,All Students,2019-20,2364,431,1933,81.8,20,11,55.0
10,All Students,2020-21,5130,693,4437,86.5,28,11,39.3
10,All Students,2021-22,6545,1368,5177,79.1,34,20,58.8
10,All Students,2022-23,4735,1468,3267,69.0,25,18,72.0
11,All Students,2018-19,3148,734,2414,76.7,17,13,76.5
11,All Students,2019-20,1947,327,1620,83.2,18,12,66.7
11,All Students,2020-21,3223,521,2702,83.8,19,8,42.1
11,All Students,2021-22,5002,958,4044,80.8,29,23,79.3
11,All Students,2022-23,6448,1484,4964,77.0,34,18,52.9
12,All Students,2018-19,13416,2778,10638,79.3,75,47,62.7
12,All Students,2019-20,8853,1927,6926,78.2,75,41,54.7
12,All Students,2020-21,12605,2343,10262,81.4,72,31,43.1
12,All Students,2021-22,12862,4294,8568,66.6,72,61,84.7
12,All Students,2022-23,15141,4039,11102,73.3,83,59,71.1
All Grades,All Students,2018-19,65795,9750,56045,85.2,431,263,61.0
All Grades,All Students,2019-20,41811,5781,36030,86.2,405,235,58.0
All Grades,All Students,2020-21,62046,10381,51665,83.3,381,218,57.2
All Grades,All Students,2021-22,55946,12004,43942,78.5,360,273,75.8
All Grades,All Students,2022-23,55336,9841,45495,82.2,349,243,69.6
0K,All Students,2018-19,5129,686,4443,86.6,35,19,54.3
0K,All Students,2019-20,3848,555,3293,85.6,40,26,65.0
0K,All Students,2020-21,2909,503,2406,82.7,18,12,66.7
0K,All Students,2021-22,5316,1000,4316,81.2,39,27,69.2
0K,All Students,2022-23,6830,1173,5657,82.8,43,29,67.4
1,All Students,2018-19,8666,1202,7464,86.1,55,36,65.5
1,All Students,2019-20,5175,841,4334,83.7,50,32,64.0
1,All Students,2020-21,6217,938,5279,84.9,37,21,56.8
1,All Students,2021-22,3580,794,2786,77.8,26,22,84.6
1,All Students,2022-23,7462,1099,6363,85.3,44,25,56.8
2,All Students,2018-19,11115,1627,9488,85.4,69,42,60.9
2,All Students,2019-20,6245,828,5417,86.7,61,35,57.4
2,All Students,2020-21,8827,1366,7461,84.5,51,28,54.9
2,All Students,2021-22,5544,1350,4194,75.6,38,30,78.9
2,All Students,2022-23,5232,758,4474,85.5,32,20,62.5
3,All Students,2018-19,10771,1381,9390,87.2,66,35,53.0
3,All Students,2019-20,8019,1071,6948,86.6,75,47,62.7
3,All Students,2020-21,9413,1380,8033,85.3,56,31,55.4
3,All Students,2021-22,8396,1826,6570,78.3,51,38,74.5
3,All Students,2022-23,5732,1044,4688,81.8,36,29,80.6
4,All Students,2018-19,7863,1016,6847,87.1,50,28,56.0
4,All Students,2019-20,4547,521,4026,88.5,42,23,54.8
4,All Students,2020-21,10216,2143,8073,79.0,67,41,61.2
4,All Students,2021-22,7450,1526,5924,79.5,44,32,72.7
4,All Students,2022-23,6809,1299,5510,80.9,44,31,70.5
5,All Students,2018-19,6722,988,5734,85.3,42,26,61.9
5,All Students,2019-20,5446,696,4750,87.2,50,25,50.0
5,All Students,2020-21,7238,992,6246,86.3,45,23,51.1
5,All Students,2021-22,7435,1564,5871,79.0,48,32,66.7
5,All Students,2022-23,7398,1289,6109,82.6,48,33,68.8
6,All Students,2018-19,4601,683,3918,85.2,32,19,59.4
6,All Students,2019-20,3513,598,2915,83.0,37,26,70.3
6,All Students,2020-21,6999,1037,5962,85.2,45,23,51.1
6,All Students,2021-22,6204,1315,4889,78.8,38,30,78.9
6,All Students,2022-23,4336,914,3422,78.9,28,19,67.9
7,All Students,2018-19,3383,597,2786,82.4,28,20,71.4
7,All Students,2019-20,1410,196,1214,86.1,15,9,60.0
7,All Students,2020-21,5832,1198,4634,79.5,35,25,71.4
7,All Students,2021-22,4232,873,3359,79.4,28,21,75.0
7,All Students,2022-23,5225,1066,4159,79.6,35,27,77.1
8,All Students,2018-19,5503,1464,4039,73.4,42,37,88.1
8,All Students,2019-20,2342,422,1920,82.0,24,12,50.0
8,All Students,2020-21,2530,640,1890,74.7,15,11,73.3
8,All Students,2021-22,6310,1523,4787,75.9,39,34,87.2
8,All Students,2022-23,4914,1060,3854,78.4,30,26,86.7
9,All Students,2018-19,789,s,s,s,s,s,s
9,All Students,2019-20,1,s,s,s,s,s,s
9,All Students,2020-21,624,s,s,s,s,s,s
9,All Students,2021-22,531,s,s,s,s,s,s
9,All Students,2022-23,692,s,s,s,s,s,s
10,All Students,2018-19,537,s,s,s,s,s,s
10,All Students,2019-20,460,s,s,s,s,s,s
10,All Students,2021-22,354,s,s,s,s,s,s
10,All Students,2022-23,532,s,s,s,s,s,s
11,All Students,2018-19,716,s,s,s,s,s,s
11,All Students,2019-20,345,s,s,s,s,s,s
11,All Students,2020-21,880,s,s,s,s,s,s
11,All Students,2022-23,174,s,s,s,s,s,s
12,All Students,2019-20,460,s,s,s,s,s,s
12,All Students,2020-21,352,s,s,s,s,s,s
12,All Students,2021-22,594,s,s,s,s,s,s
All Grades,All Students,2018-19,53120,6464,46656,87.8,317,153,48.3
All Grades,All Students,2019-20,33133,3631,29502,89.0,299,131,43.8
All Grades,All Students,2020-21,48306,8055,40251,83.3,288,140,48.6
All Grades,All Students,2021-22,48455,8314,40141,82.8,291,185,63.6
All Grades,All Students,2022-23,49597,7798,41799,84.3,293,181,61.8
PK in K-12 Schools,All Students,2018-19,4204,460,3744,89.1,26,13,50.0
PK in K-12 Schools,All Students,2019-20,2731,329,2402,88.0,25,13,52.0
PK in K-12 Schools,All Students,2020-21,3642,820,2822,77.5,23,18,78.3
PK in K-12 Schools,All Students,2021-22,3526,731,2795,79.3,24,20,83.3
PK in K-12 Schools,All Students,2022-23,4139,711,3428,82.8,24,20,83.3
0K,All Students,2018-19,5499,743,4756,86.5,35,21,60.0
0K,All Students,2019-20,1771,222,1549,87.5,16,10,62.5
0K,All Students,2020-21,3467,1078,2389,68.9,24,17,70.8
0K,All Students,2021-22,3099,574,2525,81.5,21,15,71.4
0K,All Students,2022-23,4033,553,3480,86.3,26,16,61.5
1,All Students,2018-19,3218,286,2932,91.1,20,6,30.0
1,All Students,2019-20,3670,433,3237,88.2,33,18,54.5
1,All Students,2020-21,1813,324,1489,82.1,12,5,41.7
1,All Students,2021-22,4245,1019,3226,76.0,28,27,96.4
1,All Students,2022-23,2053,302,1751,85.3,13,9,69.2
2,All Students,2018-19,2462,468,1994,81.0,15,13,86.7
2,All Students,2019-20,1725,138,1587,92.0,15,4,26.7
2,All Students,2020-21,5266,1177,4089,77.6,32,21,65.6
2,All Students,2021-22,2007,287,1720,85.7,12,5,41.7
2,All Students,2022-23,4491,984,3507,78.1,27,21,77.8
3,All Students,2018-19,3424,557,2867,83.7,21,13,61.9
3,All Students,2019-20,1562,274,1288,82.5,15,11,73.3
3,All Students,2020-21,2261,412,1849,81.8,13,8,61.5
3,All Students,2021-22,4703,720,3983,84.7,29,18,62.1
3,All Students,2022-23,2628,473,2155,82.0,15,7,46.7
4,All Students,2018-19,3154,336,2818,89.3,20,9,45.0
4,All Students,2019-20,2040,271,1769,86.7,18,10,55.6
4,All Students,2020-21,2160,567,1593,73.8,13,9,69.2
4,All Students,2021-22,2461,227,2234,90.8,15,4,26.7
4,All Students,2022-23,4833,712,4121,85.3,28,21,75.0
5,All Students,2018-19,2310,187,2123,91.9,14,5,35.7
5,All Students,2019-20,1831,182,1649,90.1,17,5,29.4
5,All Students,2020-21,3017,708,2309,76.5,18,9,50.0
5,All Students,2021-22,2305,455,1850,80.3,13,11,84.6
5,All Students,2022-23,2205,196,2009,91.1,13,7,53.8
6,All Students,2018-19,3270,271,2999,91.7,19,7,36.8
6,All Students,2019-20,1323,124,1199,90.6,12,4,33.3
6,All Students,2020-21,3344,615,2729,81.6,19,10,52.6
6,All Students,2021-22,2653,517,2136,80.5,15,8,53.3
6,All Students,2022-23,2644,554,2090,79.0,15,10,66.7
7,All Students,2018-19,4121,429,3692,89.6,24,9,37.5
7,All Students,2019-20,2315,207,2108,91.1,21,7,33.3
7,All Students,2020-21,1835,167,1668,90.9,11,4,36.4
7,All Students,2021-22,3370,491,2879,85.4,20,12,60.0
7,All Students,2022-23,2301,338,1963,85.3,13,7,53.8
8,All Students,2018-19,2137,238,1899,88.9,12,5,41.7
8,All Students,2019-20,2448,175,2273,92.9,22,5,22.7
8,All Students,2020-21,3520,294,3226,91.6,20,6,30.0
8,All Students,2021-22,1746,273,1473,84.4,10,6,60.0
8,All Students,2022-23,2902,335,2567,88.5,17,8,47.1
9,All Students,2018-19,2133,155,1978,92.7,12,2,16.7
9,All Students,2019-20,1507,251,1256,83.3,14,5,35.7
9,All Students,2020-21,3090,311,2779,89.9,18,8,44.4
9,All Students,2021-22,3307,503,2804,84.8,19,11,57.9
9,All Students,2022-23,1627,323,1304,80.1,11,8,72.7
10,All Students,2018-19,3559,458,3101,87.1,20,10,50.0
10,All Students,2019-20,1150,101,1049,91.2,10,3,30.0
10,All Students,2020-21,1936,175,1761,91.0,11,3,27.3
10,All Students,2021-22,2848,311,2537,89.1,16,8,50.0
10,All Students,2022-23,3583,651,2932,81.8,22,13,59.1
11,All Students,2018-19,2477,299,2178,87.9,14,7,50.0
11,All Students,2019-20,2089,232,1857,88.9,19,9,47.4
11,All Students,2020-21,1917,412,1505,78.5,11,5,45.5
11,All Students,2021-22,2136,458,1678,78.6,12,5,41.7
11,All Students,2022-23,2848,283,2565,90.1,16,7,43.8
12,All Students,2018-19,11152,1577,9575,85.9,65,33,50.8
12,All Students,2019-20,6971,692,6279,90.1,62,27,43.5
12,All Students,2020-21,11038,995,10043,91.0,63,17,27.0
12,All Students,2021-22,10049,1748,8301,82.6,57,35,61.4
12,All Students,2022-23,9310,1383,7927,85.1,53,27,50.9
All Grades,All Students,2018-19,35054,5179,29875,85.2,207,110,53.1
All Grades,All Students,2019-20,22001,3223,18778,85.4,199,101,50.8
All Grades,All Students,2020-21,35007,5474,29533,84.4,208,102,49.0
All Grades,All Students,2021-22,35580,9311,26269,73.8,206,142,68.9
All Grades,All Students,2022-23,34017,7854,26163,76.9,195,124,63.6
6,All Students,2018-19,288,s,s,s,s,s,s
6,All Students,2019-20,541,s,s,s,s,s,s
6,All Students,2020-21,2614,523,2091,80.0,17,13,76.5
6,All Students,2021-22,556,s,s,s,s,s,s
6,All Students,2022-23,326,s,s,s,s,s,s
7,All Students,2018-19,2477,626,1851,74.7,15,13,86.7
7,All Students,2019-20,448,s,s,s,s,s,s
7,All Students,2020-21,846,s,s,s,s,s,s
7,All Students,2021-22,2737,670,2067,75.5,18,15,83.3
7,All Students,2022-23,530,s,s,s,s,s,s
8,All Students,2018-19,1389,s,s,s,s,s,s
8,All Students,2019-20,1430,342,1088,76.1,14,14,100.0
8,All Students,2020-21,1426,s,s,s,s,s,s
8,All Students,2021-22,871,s,s,s,s,s,s
8,All Students,2022-23,3360,597,2763,82.2,19,12,63.2
9,All Students,2018-19,3327,416,2911,87.5,21,10,47.6
9,All Students,2019-20,2630,474,2156,82.0,23,13,56.5
9,All Students,2020-21,5037,892,4145,82.3,29,15,51.7
9,All Students,2021-22,3735,645,3090,82.7,22,14,63.6
9,All Students,2022-23,4154,878,3276,78.9,25,14,56.0
10,All Students,2018-19,3856,453,3403,88.3,23,14,60.9
10,All Students,2019-20,2489,326,2163,86.9,22,11,50.0
10,All Students,2020-21,3452,586,2866,83.0,21,12,57.1
10,All Students,2021-22,5455,1753,3702,67.9,33,24,72.7
10,All Students,2022-23,2912,577,2335,80.2,18,12,66.7
11,All Students,2018-19,5261,716,4545,86.4,30,12,40.0
11,All Students,2019-20,2333,265,2068,88.6,22,9,40.9
11,All Students,2020-21,3344,442,2902,86.8,19,10,52.6
11,All Students,2021-22,3470,830,2640,76.1,22,17,77.3
11,All Students,2022-23,5330,1497,3833,71.9,32,24,75.0
12,All Students,2018-19,18456,2652,15804,85.6,107,53,49.5
12,All Students,2019-20,12130,1666,10464,86.3,108,48,44.4
12,All Students,2020-21,18288,2635,15653,85.6,108,43,39.8
12,All Students,2021-22,18756,5126,13630,72.7,101,65,64.4
12,All Students,2022-23,17405,3984,13421,77.1,96,59,61.5
All Grades,All Students,2018-19,39399,9874,29525,74.9,258,178,69.0
All Grades,All Students,2019-20,26741,6163,20578,77.0,250,162,64.8
All Grades,All Students,2020-21,41178,7795,33383,81.1,247,121,49.0
All Grades,All Students,2021-22,38138,9543,28595,75.0,235,167,71.1
All Grades,All Students,2022-23,37413,7393,30020,80.2,231,144,62.3
5,All Students,2018-19,216,s,s,s,s,s,s
6,All Students,2018-19,4203,480,3723,88.6,30,15,50.0
6,All Students,2019-20,1942,424,1518,78.2,20,15,75.0
6,All Students,2020-21,1164,139,1025,88.1,11,7,63.6
6,All Students,2021-22,3769,658,3111,82.5,25,17,68.0
6,All Students,2022-23,2455,532,1923,78.3,17,12,70.6
7,All Students,2018-19,2703,711,1992,73.7,23,19,82.6
7,All Students,2019-20,2933,522,2411,82.2,27,16,59.3
7,All Students,2020-21,2804,535,2269,80.9,16,9,56.3
7,All Students,2021-22,2067,382,1685,81.5,12,8,66.7
7,All Students,2022-23,3971,539,3432,86.4,24,13,54.2
8,All Students,2018-19,1798,s,s,s,s,s,s
8,All Students,2019-20,2003,553,1450,72.4,19,14,73.7
8,All Students,2020-21,4907,730,4177,85.1,28,11,39.3
8,All Students,2021-22,3612,1009,2603,72.1,22,17,77.3
8,All Students,2022-23,2548,345,2203,86.5,17,10,58.8
9,All Students,2018-19,5157,902,4255,82.5,35,24,68.6
9,All Students,2019-20,3836,845,2991,78.0,35,23,65.7
9,All Students,2020-21,5572,1287,4285,76.9,36,20,55.6
9,All Students,2021-22,4579,767,3812,83.2,27,19,70.4
9,All Students,2022-23,5417,1045,4372,80.7,33,21,63.6
10,All Students,2018-19,6388,2317,4071,63.7,37,28,75.7
10,All Students,2019-20,3410,659,2751,80.7,33,21,63.6
10,All Students,2020-21,7170,1998,5172,72.1,42,23,54.8
10,All Students,2021-22,5880,2012,3868,65.8,36,29,80.6
10,All Students,2022-23,4269,624,3645,85.4,27,13,48.1
11,All Students,2018-19,6147,1920,4227,68.8,37,26,70.3
11,All Students,2019-20,3607,891,2716,75.3,33,21,63.6
11,All Students,2020-21,5479,974,4505,82.2,33,16,48.5
11,All Students,2021-22,6218,1664,4554,73.2,39,29,74.4
11,All Students,2022-23,5805,1821,3984,68.6,36,28,77.8
12,All Students,2018-19,12787,2868,9919,77.6,81,53,65.4
12,All Students,2019-20,9010,2269,6741,74.8,83,52,62.7
12,All Students,2020-21,14082,2132,11950,84.9,81,35,43.2
12,All Students,2021-22,12013,3051,8962,74.6,74,48,64.9
12,All Students,2022-23,12948,2487,10461,80.8,77,47,61.0
All Grades,All Students,2018-19,66207,9695,56512,85.4,404,231,57.2
All Grades,All Students,2019-20,46956,7231,39725,84.6,448,263,58.7
All Grades,All Students,2020-21,72887,16034,56853,78.0,432,282,65.3
All Grades,All Students,2021-22,78555,15914,62641,79.7,477,347,72.7
All Grades,All Students,2022-23,84686,13861,70825,83.6,515,307,59.6
PK in K-12 Schools,All Students,2018-19,4203,1063,3140,74.7,27,24,88.9
PK in K-12 Schools,All Students,2019-20,4655,949,3706,79.6,49,35,71.4
PK in K-12 Schools,All Students,2020-21,7607,2070,5537,72.8,49,35,71.4
PK in K-12 Schools,All Students,2021-22,7805,1778,6027,77.2,49,41,83.7
PK in K-12 Schools,All Students,2022-23,8135,1619,6516,80.1,49,35,71.4
0K,All Students,2018-19,2860,551,2309,80.7,19,14,73.7
0K,All Students,2019-20,5038,954,4084,81.1,56,34,60.7
0K,All Students,2020-21,4912,1472,3440,70.0,29,25,86.2
0K,All Students,2021-22,5013,991,4022,80.2,33,22,66.7
0K,All Students,2022-23,4908,703,4205,85.7,33,23,69.7
1,All Students,2018-19,4383,686,3697,84.3,29,19,65.5
1,All Students,2019-20,1924,354,1570,81.6,21,13,61.9
1,All Students,2020-21,9258,2538,6720,72.6,53,40,75.5
1,All Students,2021-22,5445,1012,4433,81.4,34,23,67.6
1,All Students,2022-23,6119,1024,5095,83.3,39,24,61.5
2,All Students,2018-19,5603,812,4791,85.5,35,23,65.7
2,All Students,2019-20,3705,616,3089,83.4,34,21,61.8
2,All Students,2020-21,2846,493,2353,82.7,17,13,76.5
2,All Students,2021-22,9152,2168,6984,76.3,55,44,80.0
2,All Students,2022-23,6312,936,5376,85.2,38,21,55.3
3,All Students,2018-19,8203,1003,7200,87.8,50,30,60.0
3,All Students,2019-20,4359,590,3769,86.5,39,22,56.4
3,All Students,2020-21,6811,1521,5290,77.7,39,27,69.2
3,All Students,2021-22,3420,s,s,s,s,s,s
3,All Students,2022-23,8679,1559,7120,82.0,51,30,58.8
4,All Students,2018-19,7535,957,6578,87.3,45,20,44.4
4,All Students,2019-20,5719,797,4922,86.1,52,32,61.5
4,All Students,2020-21,6687,1810,4877,72.9,39,30,76.9
4,All Students,2021-22,6330,1283,5047,79.7,38,30,78.9
4,All Students,2022-23,4590,s,s,s,s,s,s
5,All Students,2018-19,8638,1047,7591,87.9,51,25,49.0
5,All Students,2019-20,4353,565,3788,87.0,42,25,59.5
5,All Students,2020-21,8861,1707,7154,80.7,53,31,58.5
5,All Students,2021-22,7289,1830,5459,74.9,44,37,84.1
5,All Students,2022-23,6047,997,5050,83.5,39,25,64.1
6,All Students,2018-19,8868,1153,7715,87.0,54,30,55.6
6,All Students,2019-20,6340,883,5457,86.1,57,31,54.4
6,All Students,2020-21,6571,1071,5500,83.7,39,19,48.7
6,All Students,2021-22,10254,1980,8274,80.7,62,43,69.4
6,All Students,2022-23,9764,1623,8141,83.4,58,36,62.1
7,All Students,2018-19,7414,1066,6348,85.6,45,19,42.2
7,All Students,2019-20,5997,723,5274,87.9,53,29,54.7
7,All Students,2020-21,10345,1597,8748,84.6,61,29,47.5
7,All Students,2021-22,7580,1436,6144,81.1,45,32,71.1
7,All Students,2022-23,10601,1775,8826,83.3,63,37,58.7
8,All Students,2018-19,8500,1357,7143,84.0,49,27,55.1
8,All Students,2019-20,4866,800,4066,83.6,45,21,46.7
8,All Students,2020-21,8989,1755,7234,80.5,53,33,62.3
8,All Students,2021-22,10703,1945,8758,81.8,63,41,65.1
8,All Students,2022-23,8238,1228,7010,85.1,49,24,49.0
9,All Students,2021-22,5324,821,4503,84.6,31,19,61.3
9,All Students,2022-23,5442,765,4677,85.9,32,18,56.3
10,All Students,2021-22,240,s,s,s,s,s,s
10,All Students,2022-23,5354,770,4584,85.6,31,14,45.2
11,All Students,2022-23,497,s,s,s,s,s,s
All Grades,All Students,2018-19,74179,6683,67496,91.0,446,155,34.8
All Grades,All Students,2019-20,53076,5491,47585,89.7,492,201,40.9
All Grades,All Students,2020-21,78439,10468,67971,86.7,469,224,47.8
All Grades,All Students,2021-22,88310,14086,74224,84.0,542,335,61.8
All Grades,All Students,2022-23,93180,13274,79906,85.8,573,314,54.8
PK in K-12 Schools,All Students,2018-19,5229,827,4402,84.2,31,18,58.1
PK in K-12 Schools,All Students,2019-20,2752,448,2304,83.7,28,15,53.6
PK in K-12 Schools,All Students,2020-21,3098,431,2667,86.1,19,9,47.4
PK in K-12 Schools,All Students,2021-22,3544,772,2772,78.2,28,22,78.6
PK in K-12 Schools,All Students,2022-23,4932,916,4016,81.4,32,25,78.1
0K,All Students,2018-19,8164,702,7462,91.4,52,16,30.8
0K,All Students,2019-20,11765,1372,10393,88.3,110,55,50.0
0K,All Students,2020-21,8180,1288,6892,84.3,52,30,57.7
0K,All Students,2021-22,18601,2728,15873,85.3,119,72,60.5
0K,All Students,2022-23,11584,1804,9780,84.4,75,45,60.0
1,All Students,2018-19,9770,847,8923,91.3,59,22,37.3
1,All Students,2019-20,6949,846,6103,87.8,67,29,43.3
1,All Students,2020-21,17881,2690,15191,85.0,105,57,54.3
1,All Students,2021-22,9075,1746,7329,80.8,55,36,65.5
1,All Students,2022-23,19017,2694,16323,85.8,114,64,56.1
2,All Students,2018-19,7754,740,7014,90.5,47,19,40.4
2,All Students,2019-20,5864,568,5296,90.3,55,21,38.2
2,All Students,2020-21,11429,1427,10002,87.5,67,30,44.8
2,All Students,2021-22,17352,2595,14757,85.0,103,62,60.2
2,All Students,2022-23,10315,1775,8540,82.8,63,38,60.3
3,All Students,2018-19,10236,921,9315,91.0,64,23,35.9
3,All Students,2019-20,4675,485,4190,89.6,43,15,34.9
3,All Students,2020-21,8438,1100,7338,87.0,51,24,47.1
3,All Students,2021-22,11947,1852,10095,84.5,73,44,60.3
3,All Students,2022-23,15827,2083,13744,86.8,98,51,52.0
4,All Students,2018-19,10685,698,9987,93.5,62,16,25.8
4,All Students,2019-20,6664,632,6032,90.5,60,26,43.3
4,All Students,2020-21,7667,849,6818,88.9,46,17,37.0
4,All Students,2021-22,8718,1311,7407,85.0,51,30,58.8
4,All Students,2022-23,11394,1334,10060,88.3,68,29,42.6
5,All Students,2018-19,8523,750,7773,91.2,52,21,40.4
5,All Students,2019-20,6892,466,6426,93.2,61,17,27.9
5,All Students,2020-21,9636,880,8756,90.9,57,19,33.3
5,All Students,2021-22,6840,820,6020,88.0,42,20,47.6
5,All Students,2022-23,8777,1038,7739,88.2,55,23,41.8
6,All Students,2018-19,3463,263,3200,92.4,20,4,20.0
6,All Students,2019-20,2500,254,2246,89.8,23,10,43.5
6,All Students,2020-21,5166,653,4513,87.4,32,15,46.9
6,All Students,2021-22,3982,662,3320,83.4,23,16,69.6
6,All Students,2022-23,3550,591,2959,83.4,22,12,54.5
7,All Students,2018-19,4870,495,4375,89.8,28,8,28.6
7,All Students,2019-20,2048,194,1854,90.5,19,7,36.8
7,All Students,2020-21,3850,570,3280,85.2,22,11,50.0
7,All Students,2021-22,4530,830,3700,81.7,27,19,70.4
7,All Students,2022-23,4129,576,3553,86.0,24,15,62.5
8,All Students,2018-19,5485,440,5045,92.0,31,8,25.8
8,All Students,2019-20,2967,226,2741,92.4,26,6,23.1
8,All Students,2020-21,3094,580,2514,81.3,18,12,66.7
8,All Students,2021-22,3721,770,2951,79.3,21,14,66.7
8,All Students,2022-23,3655,463,3192,87.3,22,12,54.5
All Grades,All Students,2018-19,115954,16367,99587,85.9,707,358,50.6
All Grades,All Students,2019-20,72724,10021,62703,86.2,683,321,47.0
All Grades,All Students,2020-21,109862,18955,90907,82.7,661,305,46.1
All Grades,All Students,2021-22,116992,22367,94625,80.9,707,467,66.1
All Grades,All Students,2022-23,120330,21559,98771,82.1,728,461,63.3
0K,All Students,2018-19,13235,1760,11475,86.7,87,46,52.9
0K,All Students,2019-20,4910,s,s,s,s,s,s
0K,All Students,2020-21,6334,1188,5146,81.2,42,26,61.9
0K,All Students,2021-22,11773,1832,9941,84.4,77,43,55.8
0K,All Students,2022-23,14712,2925,11787,80.1,95,65,68.4
1,All Students,2018-19,13163,2043,11120,84.5,79,45,57.0
1,All Students,2019-20,9169,1367,7802,85.1,85,48,56.5
1,All Students,2020-21,10800,2208,8592,79.6,65,37,56.9
1,All Students,2021-22,8352,1693,6659,79.7,52,36,69.2
1,All Students,2022-23,13179,2136,11043,83.8,79,52,65.8
2,All Students,2018-19,12102,1931,10171,84.0,73,39,53.4
2,All Students,2019-20,8790,1287,7503,85.4,84,40,47.6
2,All Students,2020-21,14503,2647,11856,81.7,88,44,50.0
2,All Students,2021-22,10510,1973,8537,81.2,66,43,65.2
2,All Students,2022-23,8989,1736,7253,80.7,54,39,72.2
3,All Students,2018-19,17229,2362,14867,86.3,106,47,44.3
3,All Students,2019-20,8667,1263,7404,85.4,82,35,42.7
3,All Students,2020-21,13729,2317,11412,83.1,80,35,43.8
3,All Students,2021-22,13076,2454,10622,81.2,82,58,70.7
3,All Students,2022-23,11167,1921,9246,82.8,70,44,62.9
4,All Students,2018-19,12635,1359,11276,89.2,76,30,39.5
4,All Students,2019-20,10952,1460,9492,86.7,101,48,47.5
4,All Students,2020-21,13721,2037,11684,85.2,80,36,45.0
4,All Students,2021-22,13902,2390,11512,82.8,81,49,60.5
4,All Students,2022-23,13922,2453,11469,82.4,83,51,61.4
5,All Students,2018-19,13479,1828,11651,86.4,81,42,51.9
5,All Students,2019-20,8064,824,7240,89.8,72,21,29.2
5,All Students,2020-21,16876,3183,13693,81.1,101,48,47.5
5,All Students,2021-22,13529,2448,11081,81.9,80,49,61.3
5,All Students,2022-23,13191,2122,11069,83.9,76,40,52.6
6,All Students,2018-19,11962,1629,10333,86.4,73,30,41.1
6,All Students,2019-20,7059,908,6151,87.1,66,33,50.0
6,All Students,2020-21,10670,1602,9068,85.0,66,22,33.3
6,All Students,2021-22,22860,4570,18290,80.0,132,90,68.2
6,All Students,2022-23,14195,2560,11635,82.0,86,49,57.0
7,All Students,2018-19,11040,s,s,s,s,s,s
7,All Students,2019-20,7308,945,6363,87.1,67,28,41.8
7,All Students,2020-21,11307,1871,9436,83.5,66,26,39.4
7,All Students,2021-22,11007,2222,8785,79.8,68,50,73.5
7,All Students,2022-23,20615,3818,16797,81.5,121,78,64.5
8,All Students,2018-19,11089,1673,9416,84.9,65,34,52.3
8,All Students,2019-20,7455,1194,6261,84.0,70,39,55.7
8,All Students,2020-21,10619,1581,9038,85.1,63,28,44.4
8,All Students,2021-22,10970,2486,8484,77.3,62,45,72.6
8,All Students,2022-23,9872,1732,8140,82.5,60,39,65.0
9,All Students,2018-19,20,s,s,s,s,s,s
9,All Students,2019-20,350,s,s,s,s,s,s
9,All Students,2020-21,951,s,s,s,s,s,s
9,All Students,2021-22,370,s,s,s,s,s,s
9,All Students,2022-23,206,s,s,s,s,s,s
10,All Students,2020-21,352,s,s,s,s,s,s
10,All Students,2021-22,407,s,s,s,s,s,s
10,All Students,2022-23,282,s,s,s,s,s,s
11,All Students,2021-22,236,s,s,s,s,s,s
All Grades,All Students,2022-23,50457,7518,42939,85.1,567,213,37.6
0K,All Students,2022-23,1553,180,1373,88.4,11,5,45.5
1,All Students,2022-23,975,90,885,90.8,6,2,33.3
2,All Students,2022-23,1148,95,1053,91.7,8,3,37.5
3,All Students,2022-23,1878,385,1493,79.5,14,8,57.1
4,All Students,2022-23,2790,278,2512,90.0,19,8,42.1
5,All Students,2022-23,3744,543,3201,85.5,30,16,53.3
6,All Students,2022-23,3679,626,3053,83.0,34,16,47.1
7,All Students,2022-23,4084,588,3496,85.6,48,18,37.5
8,All Students,2022-23,5326,927,4399,82.6,68,32,47.1
9,All Students,2022-23,8863,1381,7482,84.4,111,37,33.3
10,All Students,2022-23,6437,823,5614,87.2,97,24,24.7
11,All Students,2022-23,5519,1097,4422,80.1,75,28,37.3
12,All Students,2022-23,4461,505,3956,88.7,46,16,34.8
All Grades,All Students,2018-19,102198,12769,89429,87.5,628,306,48.7
All Grades,All Students,2019-20,64084,8181,55903,87.2,598,286,47.8
All Grades,All Students,2020-21,101412,19245,82167,81.0,615,386,62.8
All Grades,All Students,2021-22,100929,18892,82037,81.3,623,424,68.1
All Grades,All Students,2022-23,106096,18165,87931,82.9,656,440,67.1
PK in K-12 Schools,All Students,2018-19,2810,s,s,s,s,s,s
PK in K-12 Schools,All Students,2019-20,1231,s,s,s,s,s,s
PK in K-12 Schools,All Students,2020-21,1681,s,s,s,s,s,s
PK in K-12 Schools,All Students,2021-22,1262,s,s,s,s,s,s
PK in K-12 Schools,All Students,2022-23,2026,590,1436,70.9,17,16,94.1
0K,All Students,2018-19,6331,961,5370,84.8,44,25,56.8
0K,All Students,2019-20,5532,834,4698,84.9,58,33,56.9
0K,All Students,2020-21,10523,1926,8597,81.7,70,45,64.3
0K,All Students,2021-22,10686,1962,8724,81.6,69,49,71.0
0K,All Students,2022-23,14919,2759,12160,81.5,98,73,74.5
1,All Students,2018-19,10150,1263,8887,87.6,64,33,51.6
1,All Students,2019-20,4922,768,4154,84.4,47,29,61.7
1,All Students,2020-21,10034,1993,8041,80.1,60,36,60.0
1,All Students,2021-22,12061,2014,10047,83.3,73,41,56.2
1,All Students,2022-23,13105,2534,10571,80.7,79,55,69.6
2,All Students,2018-19,8036,888,7148,88.9,51,24,47.1
2,All Students,2019-20,6527,734,5793,88.8,61,24,39.3
2,All Students,2020-21,8400,1754,6646,79.1,54,40,74.1
2,All Students,2021-22,9397,1696,7701,82.0,57,37,64.9
2,All Students,2022-23,12597,2040,10557,83.8,78,55,70.5
3,All Students,2018-19,9402,1326,8076,85.9,60,32,53.3
3,All Students,2019-20,6202,659,5543,89.4,56,25,44.6
3,All Students,2020-21,9714,2004,7710,79.4,57,39,68.4
3,All Students,2021-22,8819,1817,7002,79.4,56,46,82.1
3,All Students,2022-23,9802,1443,8359,85.3,62,40,64.5
4,All Students,2018-19,9691,976,8715,89.9,59,24,40.7
4,All Students,2019-20,5158,654,4504,87.3,48,20,41.7
4,All Students,2020-21,9471,1765,7706,81.4,57,36,63.2
4,All Students,2021-22,9099,1523,7576,83.3,55,38,69.1
4,All Students,2022-23,9180,1661,7519,81.9,59,42,71.2
5,All Students,2018-19,13364,1729,11635,87.1,80,42,52.5
5,All Students,2019-20,5749,785,4964,86.3,52,20,38.5
5,All Students,2020-21,7903,1750,6153,77.9,46,32,69.6
5,All Students,2021-22,8423,1513,6910,82.0,52,33,63.5
5,All Students,2022-23,8345,1397,6948,83.3,51,37,72.5
6,All Students,2018-19,14368,1839,12529,87.2,85,35,41.2
6,All Students,2019-20,9180,1169,8011,87.3,82,39,47.6
6,All Students,2020-21,14275,2369,11906,83.4,86,51,59.3
6,All Students,2021-22,13500,2605,10895,80.7,84,58,69.0
6,All Students,2022-23,10099,1533,8566,84.8,61,36,59.0
7,All Students,2018-19,18079,2140,15939,88.2,107,47,43.9
7,All Students,2019-20,8989,1177,7812,86.9,82,39,47.6
7,All Students,2020-21,14220,2594,11626,81.8,85,48,56.5
7,All Students,2021-22,13370,2413,10957,82.0,78,51,65.4
7,All Students,2022-23,12558,1801,10757,85.7,72,40,55.6
8,All Students,2018-19,9883,1197,8686,87.9,58,31,53.4
8,All Students,2019-20,10517,1146,9371,89.1,95,47,49.5
8,All Students,2020-21,15039,2658,12381,82.3,87,49,56.3
8,All Students,2021-22,14303,3108,11195,78.3,87,62,71.3
8,All Students,2022-23,13307,2249,11058,83.1,79,46,58.2
9,All Students,2018-19,84,s,s,s,s,s,s
9,All Students,2019-20,77,s,s,s,s,s,s
9,All Students,2020-21,152,s,s,s,s,s,s
9,All Students,2021-22,9,s,s,s,s,s,s
9,All Students,2022-23,149,s,s,s,s,s,s
10,All Students,2022-23,9,s,s,s,s,s,s
All Grades,All Students,2018-19,86610,9345,77265,89.2,504,162,32.1
All Grades,All Students,2019-20,56061,6613,49448,88.2,502,180,35.9
All Grades,All Students,2020-21,86805,15628,71177,82.0,500,245,49.0
All Grades,All Students,2021-22,89151,14211,74940,84.1,521,258,49.5
All Grades,All Students,2022-23,91002,12084,78918,86.7,534,231,43.3
0K,All Students,2018-19,2567,610,1957,76.2,17,12,70.6
0K,All Students,2019-20,392,s,s,s,s,s,s
0K,All Students,2020-21,2088,383,1705,81.7,13,6,46.2
0K,All Students,2021-22,1767,364,1403,79.4,10,8,80.0
0K,All Students,2022-23,1594,154,1440,90.3,9,2,22.2
1,All Students,2018-19,2314,429,1885,81.5,13,7,53.8
1,All Students,2019-20,1386,472,914,65.9,12,10,83.3
1,All Students,2020-21,880,s,s,s,s,s,s
1,All Students,2021-22,2136,406,1730,81.0,12,8,66.7
1,All Students,2022-23,1416,252,1164,82.2,8,6,75.0
2,All Students,2018-19,2648,289,2359,89.1,16,7,43.8
2,All Students,2019-20,1702,369,1333,78.3,15,8,53.3
2,All Students,2020-21,1887,471,1416,75.0,11,6,54.5
2,All Students,2021-22,1201,281,920,76.6,7,5,71.4
2,All Students,2022-23,1771,157,1614,91.1,10,3,30.0
3,All Students,2018-19,1449,162,1287,88.8,10,2,20.0
3,All Students,2019-20,1687,152,1535,91.0,17,7,41.2
3,All Students,2020-21,2904,524,2380,82.0,17,9,52.9
3,All Students,2021-22,1416,295,1121,79.2,9,7,77.8
3,All Students,2022-23,1633,408,1225,75.0,10,8,80.0
4,All Students,2018-19,1592,220,1372,86.2,10,4,40.0
4,All Students,2019-20,930,s,s,s,s,s,s
4,All Students,2020-21,2640,337,2303,87.2,15,6,40.0
4,All Students,2021-22,2778,694,2084,75.0,16,12,75.0
4,All Students,2022-23,1608,317,1291,80.3,10,5,50.0
5,All Students,2018-19,3750,351,3399,90.6,22,9,40.9
5,All Students,2019-20,2261,270,1991,88.1,21,7,33.3
5,All Students,2020-21,1319,s,s,s,s,s,s
5,All Students,2021-22,2518,448,2070,82.2,15,9,60.0
5,All Students,2022-23,3156,592,2564,81.2,20,13,65.0
6,All Students,2018-19,6744,1028,5716,84.8,40,17,42.5
6,All Students,2019-20,2923,295,2628,89.9,28,14,50.0
6,All Students,2020-21,2304,369,1935,84.0,13,6,46.2
6,All Students,2021-22,2164,273,1891,87.4,13,6,46.2
6,All Students,2022-23,4635,598,4037,87.1,27,15,55.6
7,All Students,2018-19,2655,351,2304,86.8,17,6,35.3
7,All Students,2019-20,4702,834,3868,82.3,44,24,54.5
7,All Students,2020-21,4765,1083,3682,77.3,27,13,48.1
7,All Students,2021-22,2330,346,1984,85.2,15,9,60.0
7,All Students,2022-23,3199,335,2864,89.5,19,9,47.4
8,All Students,2018-19,8589,632,7957,92.6,49,10,20.4
8,All Students,2019-20,3190,285,2905,91.1,28,9,32.1
8,All Students,2020-21,5632,1245,4387,77.9,32,20,62.5
8,All Students,2021-22,4437,424,4013,90.4,25,9,36.0
8,All Students,2022-23,2431,279,2152,88.5,14,5,35.7
9,All Students,2018-19,11263,1023,10240,90.9,64,17,26.6
9,All Students,2019-20,5956,560,5396,90.6,54,10,18.5
9,All Students,2020-21,11786,2373,9413,79.9,68,34,50.0
9,All Students,2021-22,10371,1965,8406,81.1,61,33,54.1
9,All Students,2022-23,10966,1433,9533,86.9,65,30,46.2
10,All Students,2018-19,3698,327,3371,91.2,22,6,27.3
10,All Students,2019-20,7128,737,6391,89.7,63,20,31.7
10,All Students,2020-21,9303,1521,7782,83.7,54,22,40.7
10,All Students,2021-22,12336,2397,9939,80.6,73,44,60.3
10,All Students,2022-23,10121,1499,8622,85.2,60,26,43.3
11,All Students,2018-19,13806,1179,12627,91.5,78,16,20.5
11,All Students,2019-20,2530,279,2251,89.0,22,6,27.3
11,All Students,2020-21,10694,1861,8833,82.6,61,35,57.4
11,All Students,2021-22,8756,1163,7593,86.7,51,24,47.1
11,All Students,2022-23,12074,1875,10199,84.5,71,33,46.5
12,All Students,2018-19,25535,2744,22791,89.3,146,49,33.6
12,All Students,2019-20,21274,2056,19218,90.3,186,58,31.2
12,All Students,2020-21,30603,4725,25878,84.6,176,78,44.3
12,All Students,2021-22,36941,5155,31786,86.0,214,84,39.3
12,All Students,2022-23,36398,4185,32213,88.5,211,76,36.0
All Grades,All Students,2018-19,70968,7584,63384,89.3,428,186,43.5
All Grades,All Students,2019-20,47299,4992,42307,89.4,434,185,42.6
All Grades,All Students,2020-21,70238,9355,60883,86.7,419,207,49.4
All Grades,All Students,2021-22,70729,10623,60106,85.0,442,268,60.6
All Grades,All Students,2022-23,82315,10349,71966,87.4,492,252,51.2
PK in K-12 Schools,All Students,2018-19,12008,1600,10408,86.7,72,41,56.9
PK in K-12 Schools,All Students,2019-20,7401,884,6517,88.1,71,32,45.1
PK in K-12 Schools,All Students,2020-21,9750,1492,8258,84.7,63,40,63.5
PK in K-12 Schools,All Students,2021-22,10578,2281,8297,78.4,70,62,88.6
PK in K-12 Schools,All Students,2022-23,11455,1867,9588,83.7,72,53,73.6
0K,All Students,2018-19,4869,431,4438,91.1,31,9,29.0
0K,All Students,2019-20,7976,883,7093,88.9,73,33,45.2
0K,All Students,2020-21,8625,909,7716,89.5,51,19,37.3
0K,All Students,2021-22,5952,811,5141,86.4,39,18,46.2
0K,All Students,2022-23,10046,1256,8790,87.5,62,31,50.0
1,All Students,2018-19,9212,1083,8129,88.2,54,28,51.9
1,All Students,2019-20,4005,383,3622,90.4,35,14,40.0
1,All Students,2020-21,11159,1600,9559,85.7,66,35,53.0
1,All Students,2021-22,9359,1177,8182,87.4,60,26,43.3
1,All Students,2022-23,8656,993,7663,88.5,52,21,40.4
2,All Students,2018-19,9423,1085,8338,88.5,56,26,46.4
2,All Students,2019-20,6510,765,5745,88.2,60,33,55.0
2,All Students,2020-21,7837,1234,6603,84.3,45,24,53.3
2,All Students,2021-22,11597,1556,10041,86.6,70,43,61.4
2,All Students,2022-23,10778,1148,9630,89.3,65,25,38.5
3,All Students,2018-19,5896,600,5296,89.8,40,15,37.5
3,All Students,2019-20,5736,706,5030,87.7,54,26,48.1
3,All Students,2020-21,8116,1236,6880,84.8,48,26,54.2
3,All Students,2021-22,7427,1132,6295,84.8,45,26,57.8
3,All Students,2022-23,12080,1597,10483,86.8,71,41,57.7
4,All Students,2018-19,6050,543,5507,91.0,37,12,32.4
4,All Students,2019-20,3074,347,2727,88.7,29,13,44.8
4,All Students,2020-21,6350,1078,5272,83.0,40,25,62.5
4,All Students,2021-22,5894,754,5140,87.2,36,22,61.1
4,All Students,2022-23,6836,667,6169,90.2,39,17,43.6
5,All Students,2018-19,10331,1140,9191,89.0,62,29,46.8
5,All Students,2019-20,3996,282,3714,92.9,36,6,16.7
5,All Students,2020-21,4707,493,4214,89.5,27,12,44.4
5,All Students,2021-22,6581,1264,5317,80.8,42,31,73.8
5,All Students,2022-23,7743,872,6871,88.7,46,20,43.5
6,All Students,2018-19,4630,401,4229,91.3,26,8,30.8
6,All Students,2019-20,3304,277,3027,91.6,29,11,37.9
6,All Students,2020-21,4549,421,4128,90.7,26,10,38.5
6,All Students,2021-22,3969,511,3458,87.1,24,11,45.8
6,All Students,2022-23,5050,635,4415,87.4,29,18,62.1
7,All Students,2018-19,3732,s,s,s,s,s,s
7,All Students,2019-20,2724,222,2502,91.9,24,9,37.5
7,All Students,2020-21,4518,s,s,s,s,s,s
7,All Students,2021-22,4520,571,3949,87.4,27,15,55.6
7,All Students,2022-23,4398,447,3951,89.8,25,11,44.0
8,All Students,2018-19,4688,369,4319,92.1,27,9,33.3
8,All Students,2019-20,2569,s,s,s,s,s,s
8,All Students,2020-21,4615,418,4197,90.9,27,7,25.9
8,All Students,2021-22,4852,566,4286,88.3,29,14,48.3
8,All Students,2022-23,5273,867,4406,83.6,31,15,48.4
9,All Students,2018-19,129,s,s,s,s,s,s
9,All Students,2019-20,4,s,s,s,s,s,s
9,All Students,2020-21,12,s,s,s,s,s,s
All Grades,All Students,2018-19,88850,11001,77849,87.6,518,210,40.5
All Grades,All Students,2019-20,65127,8495,56632,87.0,591,275,46.5
All Grades,All Students,2020-21,95783,16028,79755,83.3,564,302,53.5
All Grades,All Students,2021-22,89309,15598,73711,82.5,546,344,63.0
All Grades,All Students,2022-23,87551,12219,75332,86.0,534,292,54.7
0K,All Students,2018-19,650,s,s,s,s,s,s
0K,All Students,2019-20,6769,940,5829,86.1,65,36,55.4
0K,All Students,2020-21,5253,1224,4029,76.7,32,28,87.5
0K,All Students,2021-22,4216,595,3621,85.9,30,17,56.7
0K,All Students,2022-23,4308,578,3730,86.6,31,20,64.5
1,All Students,2018-19,9623,961,8662,90.0,56,20,35.7
1,All Students,2019-20,871,s,s,s,s,s,s
1,All Students,2020-21,10329,2319,8010,77.5,62,42,67.7
1,All Students,2021-22,4628,738,3890,84.1,30,20,66.7
1,All Students,2022-23,5304,642,4662,87.9,32,20,62.5
2,All Students,2018-19,5117,601,4516,88.3,29,9,31.0
2,All Students,2019-20,6253,693,5560,88.9,55,29,52.7
2,All Students,2020-21,1759,303,1456,82.8,10,7,70.0
2,All Students,2021-22,9232,1564,7668,83.1,56,40,71.4
2,All Students,2022-23,5045,679,4366,86.5,29,14,48.3
3,All Students,2018-19,3904,334,3570,91.4,22,8,36.4
3,All Students,2019-20,3638,469,3169,87.1,32,17,53.1
3,All Students,2020-21,8761,1702,7059,80.6,51,31,60.8
3,All Students,2021-22,1351,294,1057,78.2,9,7,77.8
3,All Students,2022-23,8820,1107,7713,87.4,54,29,53.7
4,All Students,2018-19,3214,275,2939,91.4,19,7,36.8
4,All Students,2019-20,2172,196,1976,91.0,19,6,31.6
4,All Students,2020-21,5004,1094,3910,78.1,29,20,69.0
4,All Students,2021-22,8611,1140,7471,86.8,50,31,62.0
4,All Students,2022-23,1734,314,1420,81.9,11,7,63.6
5,All Students,2018-19,1246,s,s,s,s,s,s
5,All Students,2019-20,1766,s,s,s,s,s,s
5,All Students,2020-21,3438,350,3088,89.8,20,8,40.0
5,All Students,2021-22,4273,836,3437,80.4,26,19,73.1
5,All Students,2022-23,7508,807,6701,89.3,43,17,39.5
6,All Students,2018-19,4080,489,3591,88.0,24,8,33.3
6,All Students,2019-20,4275,575,3700,86.5,39,17,43.6
6,All Students,2020-21,4001,733,3268,81.7,25,14,56.0
6,All Students,2021-22,4708,597,4111,87.3,28,16,57.1
6,All Students,2022-23,5057,748,4309,85.2,31,14,45.2
7,All Students,2018-19,4780,531,4249,88.9,27,4,14.8
7,All Students,2019-20,3096,468,2628,84.9,28,13,46.4
7,All Students,2020-21,5777,731,5046,87.3,35,16,45.7
7,All Students,2021-22,3694,861,2833,76.7,21,15,71.4
7,All Students,2022-23,4000,522,3478,86.9,23,14,60.9
8,All Students,2018-19,3126,546,2580,82.5,19,9,47.4
8,All Students,2019-20,2974,368,2606,87.6,25,8,32.0
8,All Students,2020-21,4245,680,3565,84.0,25,10,40.0
8,All Students,2021-22,5804,1432,4372,75.3,34,26,76.5
8,All Students,2022-23,3660,571,3089,84.4,21,12,57.1
9,All Students,2018-19,6620,736,5884,88.9,39,17,43.6
9,All Students,2019-20,3404,559,2845,83.6,34,23,67.6
9,All Students,2020-21,7823,838,6985,89.3,45,15,33.3
9,All Students,2021-22,5584,1156,4428,79.3,36,22,61.1
9,All Students,2022-23,10328,1618,8710,84.3,63,35,55.6
10,All Students,2018-19,9549,1319,8230,86.2,59,24,40.7
10,All Students,2019-20,3483,464,3019,86.7,32,15,46.9
10,All Students,2020-21,4243,743,3500,82.5,26,14,53.8
10,All Students,2021-22,7415,1185,6230,84.0,46,25,54.3
10,All Students,2022-23,5916,1189,4727,79.9,36,24,66.7
11,All Students,2018-19,8642,1316,7326,84.8,50,26,52.0
11,All Students,2019-20,5639,638,5001,88.7,52,21,40.4
11,All Students,2020-21,5370,775,4595,85.6,32,14,43.8
11,All Students,2021-22,3529,734,2795,79.2,20,10,50.0
11,All Students,2022-23,6960,878,6082,87.4,42,21,50.0
12,All Students,2018-19,28299,3640,24659,87.1,163,72,44.2
12,All Students,2019-20,20787,2853,17934,86.3,186,81,43.5
12,All Students,2020-21,29780,4536,25244,84.8,172,83,48.3
12,All Students,2021-22,26264,4466,21798,83.0,160,96,60.0
12,All Students,2022-23,18911,2566,16345,86.4,118,65,55.1
All Grades,All Students,2018-19,75016,6049,68967,91.9,438,125,28.5
All Grades,All Students,2019-20,48260,4238,44022,91.2,432,130,30.1
All Grades,All Students,2020-21,81030,13934,67096,82.8,471,280,59.4
All Grades,All Students,2021-22,84041,12489,71552,85.1,497,292,58.8
All Grades,All Students,2022-23,96666,13596,83070,85.9,565,311,55.0
0K,All Students,2018-19,7663,665,6998,91.3,46,17,37.0
0K,All Students,2019-20,6288,722,5566,88.5,61,24,39.3
0K,All Students,2020-21,20653,3454,17199,83.3,122,77,63.1
0K,All Students,2021-22,11837,1883,9954,84.1,76,50,65.8
0K,All Students,2022-23,19282,3352,15930,82.6,119,78,65.5
1,All Students,2018-19,8291,627,7664,92.4,48,13,27.1
1,All Students,2019-20,4865,432,4433,91.1,45,14,31.1
1,All Students,2020-21,8705,1742,6963,80.0,52,31,59.6
1,All Students,2021-22,21503,3155,18348,85.3,128,77,60.2
1,All Students,2022-23,13860,1944,11916,86.0,81,49,60.5
2,All Students,2018-19,7842,819,7023,89.6,47,19,40.4
2,All Students,2019-20,5452,474,4978,91.3,48,18,37.5
2,All Students,2020-21,7554,1326,6228,82.4,45,28,62.2
2,All Students,2021-22,9034,1350,7684,85.1,52,37,71.2
2,All Students,2022-23,20644,2613,18031,87.3,119,60,50.4
3,All Students,2018-19,10753,973,9780,91.0,64,23,35.9
3,All Students,2019-20,5014,487,4527,90.3,44,11,25.0
3,All Students,2020-21,8256,1560,6696,81.1,47,28,59.6
3,All Students,2021-22,8421,1230,7191,85.4,49,31,63.3
3,All Students,2022-23,9539,1415,8124,85.2,56,34,60.7
4,All Students,2018-19,11897,974,10923,91.8,67,14,20.9
4,All Students,2019-20,7562,616,6946,91.9,66,18,27.3
4,All Students,2020-21,7417,1377,6040,81.4,43,28,65.1
4,All Students,2021-22,7953,1080,6873,86.4,49,24,49.0
4,All Students,2022-23,8497,910,7587,89.3,49,21,42.9
5,All Students,2018-19,10193,755,9438,92.6,61,18,29.5
5,All Students,2019-20,7471,678,6793,90.9,65,21,32.3
5,All Students,2020-21,10865,2036,8829,81.3,62,37,59.7
5,All Students,2021-22,7486,1266,6220,83.1,43,28,65.1
5,All Students,2022-23,6903,860,6043,87.5,39,18,46.2
6,All Students,2018-19,4667,287,4380,93.9,28,5,17.9
6,All Students,2019-20,2760,137,2623,95.0,24,2,8.3
6,All Students,2020-21,6692,1153,5539,82.8,38,22,57.9
6,All Students,2021-22,4702,744,3958,84.2,27,15,55.6
6,All Students,2022-23,4772,751,4021,84.3,27,17,63.0
7,All Students,2018-19,6765,460,6305,93.2,38,7,18.4
7,All Students,2019-20,2814,177,2637,93.7,25,5,20.0
7,All Students,2020-21,4024,419,3605,89.6,23,11,47.8
7,All Students,2021-22,6487,1100,5387,83.0,35,15,42.9
7,All Students,2022-23,4233,503,3730,88.1,24,10,41.7
8,All Students,2018-19,3919,245,3674,93.7,22,4,18.2
8,All Students,2019-20,4334,336,3998,92.2,39,10,25.6
8,All Students,2020-21,4048,570,3478,85.9,23,13,56.5
8,All Students,2021-22,4140,456,3684,89.0,24,10,41.7
8,All Students,2022-23,6341,880,5461,86.1,36,15,41.7
9,All Students,2018-19,712,s,s,s,s,s,s
9,All Students,2019-20,345,s,s,s,s,s,s
9,All Students,2020-21,880,s,s,s,s,s,s
9,All Students,2021-22,531,s,s,s,s,s,s
9,All Students,2022-23,1002,161,841,83.9,6,4,66.7
10,All Students,2018-19,1246,135,1111,89.2,7,3,42.9
10,All Students,2019-20,460,s,s,s,s,s,s
10,All Students,2020-21,528,s,s,s,s,s,s
10,All Students,2021-22,885,s,s,s,s,s,s
10,All Students,2022-23,531,s,s,s,s,s,s
11,All Students,2018-19,712,s,s,s,s,s,s
11,All Students,2019-20,780,s,s,s,s,s,s
11,All Students,2020-21,704,s,s,s,s,s,s
11,All Students,2021-22,531,s,s,s,s,s,s
11,All Students,2022-23,708,s,s,s,s,s,s
12,All Students,2018-19,356,s,s,s,s,s,s
12,All Students,2019-20,115,s,s,s,s,s,s
12,All Students,2020-21,704,s,s,s,s,s,s
12,All Students,2021-22,531,s,s,s,s,s,s
12,All Students,2022-23,354,s,s,s,s,s,s
All Grades,All Students,2022-23,93460,24987,68473,73.3,672,431,64.1
PK in K-12 Schools,All Students,2022-23,2145,373,1772,82.6,14,10,71.4
0K,All Students,2022-23,7346,1605,5741,78.2,52,34,65.4
1,All Students,2022-23,5837,906,4931,84.5,34,16,47.1
2,All Students,2022-23,6769,1379,5390,79.6,40,26,65.0
3,All Students,2022-23,7662,1430,6232,81.3,47,36,76.6
4,All Students,2022-23,6458,1088,5370,83.2,37,24,64.9
5,All Students,2022-23,5128,1189,3939,76.8,31,27,87.1
6,All Students,2022-23,5441,1243,4198,77.2,33,23,69.7
7,All Students,2022-23,5246,1011,4235,80.7,33,22,66.7
8,All Students,2022-23,5054,1082,3972,78.6,34,20,58.8
9,All Students,2022-23,13666,4606,9060,66.3,177,84,47.5
10,All Students,2022-23,8762,3693,5069,57.9,55,43,78.2
11,All Students,2022-23,4719,1771,2948,62.5,37,30,81.1
12,All Students,2022-23,9227,3611,5616,60.9,48,36,75.0
All Grades,All Students,2018-19,87377,9365,78012,89.3,527,225,42.7
All Grades,All Students,2019-20,67191,7174,60017,89.3,607,256,42.2
All Grades,All Students,2020-21,118535,16103,102432,86.4,697,329,47.2
All Grades,All Students,2021-22,119158,20568,98590,82.7,703,457,65.0
All Grades,All Students,2022-23,120128,18542,101586,84.6,720,435,60.4
0K,All Students,2018-19,16672,2231,14441,86.6,106,65,61.3
0K,All Students,2019-20,6651,765,5886,88.5,63,32,50.8
0K,All Students,2020-21,17000,2047,14953,88.0,103,44,42.7
0K,All Students,2021-22,8006,1349,6657,83.2,52,39,75.0
0K,All Students,2022-23,11953,1958,9995,83.6,77,44,57.1
1,All Students,2018-19,11012,1255,9757,88.6,68,30,44.1
1,All Students,2019-20,10851,1181,9670,89.1,96,46,47.9
1,All Students,2020-21,11484,1988,9496,82.7,67,43,64.2
1,All Students,2021-22,16759,2591,14168,84.5,103,61,59.2
1,All Students,2022-23,8870,1271,7599,85.7,56,37,66.1
2,All Students,2018-19,14528,1293,13235,91.1,85,29,34.1
2,All Students,2019-20,7050,764,6286,89.2,65,31,47.7
2,All Students,2020-21,16517,1780,14737,89.2,98,36,36.7
2,All Students,2021-22,12273,2035,10238,83.4,73,50,68.5
2,All Students,2022-23,16104,2441,13663,84.8,92,54,58.7
3,All Students,2018-19,5751,572,5179,90.1,35,14,40.0
3,All Students,2019-20,9199,791,8408,91.4,82,25,30.5
3,All Students,2020-21,10344,1422,8922,86.3,60,26,43.3
3,All Students,2021-22,15055,2076,12979,86.2,90,50,55.6
3,All Students,2022-23,11891,1578,10313,86.7,70,44,62.9
4,All Students,2018-19,6082,576,5506,90.5,35,12,34.3
4,All Students,2019-20,3516,303,3213,91.4,32,10,31.3
4,All Students,2020-21,13152,1687,11465,87.2,76,33,43.4
4,All Students,2021-22,9264,1726,7538,81.4,53,36,67.9
4,All Students,2022-23,13121,1696,11425,87.1,76,41,53.9
5,All Students,2018-19,5133,495,4638,90.4,31,9,29.0
5,All Students,2019-20,3911,421,3490,89.2,35,10,28.6
5,All Students,2020-21,5992,876,5116,85.4,34,16,47.1
5,All Students,2021-22,12533,1718,10815,86.3,73,49,67.1
5,All Students,2022-23,8027,1285,6742,84.0,48,34,70.8
6,All Students,2018-19,5453,514,4939,90.6,33,12,36.4
6,All Students,2019-20,4750,427,4323,91.0,43,16,37.2
6,All Students,2020-21,5930,956,4974,83.9,35,16,45.7
6,All Students,2021-22,5362,1041,4321,80.6,31,22,71.0
6,All Students,2022-23,12684,1984,10700,84.4,75,49,65.3
7,All Students,2018-19,4438,449,3989,89.9,26,8,30.8
7,All Students,2019-20,4017,354,3663,91.2,35,12,34.3
7,All Students,2020-21,7071,1313,5758,81.4,41,24,58.5
7,All Students,2021-22,6240,1329,4911,78.7,36,24,66.7
7,All Students,2022-23,5178,727,4451,86.0,32,16,50.0
8,All Students,2018-19,7355,797,6558,89.2,42,14,33.3
8,All Students,2019-20,3412,507,2905,85.1,30,15,50.0
8,All Students,2020-21,5983,928,5055,84.5,34,18,52.9
8,All Students,2021-22,6919,1413,5506,79.6,39,27,69.2
8,All Students,2022-23,5749,853,4896,85.2,33,18,54.5
9,All Students,2018-19,3316,345,2971,89.6,22,8,36.4
9,All Students,2019-20,6107,664,5443,89.1,56,23,41.1
9,All Students,2020-21,6161,886,5275,85.6,38,23,60.5
9,All Students,2021-22,5098,1250,3848,75.5,28,20,71.4
9,All Students,2022-23,3052,560,2492,81.7,18,12,66.7
10,All Students,2018-19,1780,144,1636,91.9,10,4,40.0
10,All Students,2019-20,2702,357,2345,86.8,26,11,42.3
10,All Students,2020-21,8807,1004,7803,88.6,52,21,40.4
10,All Students,2021-22,5320,1038,4282,80.5,31,18,58.1
10,All Students,2022-23,5293,1013,4280,80.9,32,22,68.8
11,All Students,2018-19,1550,152,1398,90.2,9,5,55.6
11,All Students,2019-20,1130,187,943,83.5,10,7,70.0
11,All Students,2020-21,3763,476,3287,87.4,22,10,45.5
11,All Students,2021-22,8413,1258,7155,85.0,48,28,58.3
11,All Students,2022-23,4779,951,3828,80.1,30,19,63.3
12,All Students,2018-19,4307,542,3765,87.4,25,15,60.0
12,All Students,2019-20,3895,453,3442,88.4,34,18,52.9
12,All Students,2020-21,6331,740,5591,88.3,37,19,51.4
12,All Students,2021-22,7916,1744,6172,78.0,46,33,71.7
12,All Students,2022-23,13427,2225,11202,83.4,81,45,55.6
All Grades,All Students,2018-19,85637,13067,72570,84.7,499,248,49.7
All Grades,All Students,2019-20,53790,8150,45640,84.8,478,237,49.6
All Grades,All Students,2020-21,86335,17679,68656,79.5,497,275,55.3
All Grades,All Students,2021-22,86167,18788,67379,78.2,489,302,61.8
All Grades,All Students,2022-23,89363,16128,73235,82.0,524,305,58.2
9,All Students,2018-19,12405,1720,10685,86.1,71,31,43.7
9,All Students,2019-20,8064,942,7122,88.3,74,35,47.3
9,All Students,2020-21,15395,2955,12440,80.8,89,42,47.2
9,All Students,2021-22,11670,2340,9330,79.9,68,38,55.9
9,All Students,2022-23,13429,2529,10900,81.2,81,52,64.2
10,All Students,2018-19,19889,3015,16874,84.8,116,58,50.0
10,All Students,2019-20,8131,1089,7042,86.6,71,31,43.7
10,All Students,2020-21,12363,1917,10446,84.5,74,36,48.6
10,All Students,2021-22,16125,3389,12736,79.0,94,58,61.7
10,All Students,2022-23,11618,1986,9632,82.9,68,33,48.5
11,All Students,2018-19,12591,1963,10628,84.4,73,32,43.8
11,All Students,2019-20,12226,1957,10269,84.0,108,55,50.9
11,All Students,2020-21,13351,2464,10887,81.5,75,43,57.3
11,All Students,2021-22,10804,2057,8747,81.0,62,35,56.5
11,All Students,2022-23,15282,2810,12472,81.6,89,48,53.9
12,All Students,2018-19,40752,6369,34383,84.4,239,127,53.1
12,All Students,2019-20,25369,4162,21207,83.6,225,116,51.6
12,All Students,2020-21,45226,10343,34883,77.1,259,154,59.5
12,All Students,2021-22,47568,11002,36566,76.9,265,171,64.5
12,All Students,2022-23,49034,8803,40231,82.0,286,172,60.1
All Grades,All Students,2018-19,68273,18299,49974,73.2,448,312,69.6
All Grades,All Students,2019-20,44815,11590,33225,74.1,424,270,63.7
All Grades,All Students,2020-21,71490,26889,44601,62.4,431,328,76.1
All Grades,All Students,2021-22,72969,22656,50313,69.0,452,339,75.0
All Grades,All Students,2022-23,66099,17329,48770,73.8,437,305,69.8
8,All Students,2021-22,4,s,s,s,s,s,s
8,All Students,2022-23,18,s,s,s,s,s,s
9,All Students,2018-19,15239,4831,10408,68.3,109,82,75.2
9,All Students,2019-20,15066,4907,10159,67.4,146,103,70.5
9,All Students,2020-21,18231,7573,10658,58.5,110,90,81.8
9,All Students,2021-22,15614,5258,10356,66.3,105,85,81.0
9,All Students,2022-23,20300,5960,14340,70.6,143,108,75.5
10,All Students,2018-19,14815,4324,10491,70.8,101,71,70.3
10,All Students,2019-20,7557,2293,5264,69.7,73,49,67.1
10,All Students,2020-21,19547,7442,12105,61.9,120,88,73.3
10,All Students,2021-22,16173,5040,11133,68.8,104,82,78.8
10,All Students,2022-23,12780,3576,9204,72.0,86,62,72.1
11,All Students,2018-19,12659,3730,8929,70.5,79,59,74.7
11,All Students,2019-20,8630,1666,6964,80.7,80,49,61.3
11,All Students,2020-21,9822,3657,6165,62.8,61,45,73.8
11,All Students,2021-22,14804,s,s,s,s,s,s
11,All Students,2022-23,12523,s,s,s,s,s,s
12,All Students,2018-19,25560,5414,20146,78.8,159,100,62.9
12,All Students,2019-20,13562,2724,10838,79.9,125,69,55.2
12,All Students,2020-21,23890,8217,15673,65.6,140,105,75.0
12,All Students,2021-22,26374,7989,18385,69.7,154,105,68.2
12,All Students,2022-23,20478,4777,15701,76.7,125,76,60.8
All Grades,All Students,2018-19,77112,9628,67484,87.5,454,207,45.6
All Grades,All Students,2019-20,48797,5844,42953,88.0,438,191,43.6
All Grades,All Students,2020-21,76593,14292,62301,81.3,454,247,54.4
All Grades,All Students,2021-22,76821,13554,63267,82.4,477,294,61.6
All Grades,All Students,2022-23,79925,11859,68066,85.2,485,272,56.1
0K,All Students,2018-19,7452,997,6455,86.6,50,24,48.0
0K,All Students,2019-20,3635,408,3227,88.8,36,17,47.2
0K,All Students,2020-21,5081,1386,3695,72.7,36,30,83.3
0K,All Students,2021-22,8529,1538,6991,82.0,59,43,72.9
0K,All Students,2022-23,7629,1111,6518,85.4,50,27,54.0
1,All Students,2018-19,3931,431,3500,89.0,22,9,40.9
1,All Students,2019-20,3839,434,3405,88.7,34,14,41.2
1,All Students,2020-21,6340,1401,4939,77.9,40,27,67.5
1,All Students,2021-22,6240,1116,5124,82.1,39,26,66.7
1,All Students,2022-23,9021,1598,7423,82.3,54,34,63.0
2,All Students,2018-19,2303,309,1994,86.6,13,8,61.5
2,All Students,2019-20,2414,261,2153,89.2,21,9,42.9
2,All Students,2020-21,5251,753,4498,85.7,31,17,54.8
2,All Students,2021-22,5567,963,4604,82.7,36,26,72.2
2,All Students,2022-23,6620,1006,5614,84.8,40,25,62.5
3,All Students,2018-19,4653,432,4221,90.7,27,11,40.7
3,All Students,2019-20,1406,238,1168,83.1,13,7,53.8
3,All Students,2020-21,3111,738,2373,76.3,19,13,68.4
3,All Students,2021-22,4596,690,3906,85.0,29,17,58.6
3,All Students,2022-23,4968,769,4199,84.5,30,18,60.0
4,All Students,2018-19,6170,782,5388,87.3,37,20,54.1
4,All Students,2019-20,2914,235,2679,91.9,26,9,34.6
4,All Students,2020-21,1597,309,1288,80.7,10,5,50.0
4,All Students,2021-22,3504,602,2902,82.8,20,13,65.0
4,All Students,2022-23,3976,581,3395,85.4,28,18,64.3
5,All Students,2018-19,4622,367,4255,92.1,27,9,33.3
5,All Students,2019-20,4238,569,3669,86.6,37,24,64.9
5,All Students,2020-21,4461,696,3765,84.4,26,16,61.5
5,All Students,2021-22,1962,s,s,s,s,s,s
5,All Students,2022-23,3927,530,3397,86.5,23,14,60.9
6,All Students,2018-19,2961,320,2641,89.2,17,6,35.3
6,All Students,2019-20,2060,215,1845,89.6,18,6,33.3
6,All Students,2020-21,5456,1018,4438,81.3,31,17,54.8
6,All Students,2021-22,796,s,s,s,s,s,s
6,All Students,2022-23,2263,s,s,s,s,s,s
7,All Students,2018-19,2139,204,1935,90.5,12,3,25.0
7,All Students,2019-20,1714,168,1546,90.2,17,7,41.2
7,All Students,2020-21,2909,401,2508,86.2,18,7,38.9
7,All Students,2021-22,4843,926,3917,80.9,28,19,67.9
7,All Students,2022-23,709,s,s,s,s,s,s
8,All Students,2018-19,2783,196,2587,93.0,17,5,29.4
8,All Students,2019-20,1738,192,1546,89.0,16,5,31.3
8,All Students,2020-21,2816,381,2435,86.5,16,5,31.3
8,All Students,2021-22,2125,305,1820,85.6,13,7,53.8
8,All Students,2022-23,4821,772,4049,84.0,29,19,65.5
9,All Students,2018-19,6139,661,5478,89.2,37,17,45.9
9,All Students,2019-20,2513,146,2367,94.2,23,8,34.8
9,All Students,2020-21,5323,954,4369,82.1,31,15,48.4
9,All Students,2021-22,6604,1418,5186,78.5,42,29,69.0
9,All Students,2022-23,5620,716,4904,87.3,36,14,38.9
10,All Students,2018-19,6864,991,5873,85.6,40,21,52.5
10,All Students,2019-20,4897,531,4366,89.2,45,19,42.2
10,All Students,2020-21,4042,515,3527,87.3,23,8,34.8
10,All Students,2021-22,5404,690,4714,87.2,34,11,32.4
10,All Students,2022-23,6975,1037,5938,85.1,41,25,61.0
11,All Students,2018-19,6476,1169,5307,81.9,38,22,57.9
11,All Students,2019-20,4233,504,3729,88.1,36,11,30.6
11,All Students,2020-21,7392,1497,5895,79.7,42,22,52.4
11,All Students,2021-22,3734,705,3029,81.1,22,12,54.5
11,All Students,2022-23,4690,680,4010,85.5,27,11,40.7
12,All Students,2018-19,20619,2769,17850,86.6,117,52,44.4
12,All Students,2019-20,13196,1943,11253,85.3,116,55,47.4
12,All Students,2020-21,22814,4243,18571,81.4,131,65,49.6
12,All Students,2021-22,22917,4073,18844,82.2,139,78,56.1
12,All Students,2022-23,18706,2665,16041,85.8,109,55,50.5
All Grades,All Students,2018-19,101975,12664,89311,87.6,599,269,44.9
All Grades,All Students,2019-20,68705,9636,59069,86.0,620,278,44.8
All Grades,All Students,2020-21,105932,14103,91829,86.7,621,247,39.8
All Grades,All Students,2021-22,102763,19701,83062,80.8,607,388,63.9
All Grades,All Students,2022-23,100160,17069,83091,83.0,603,353,58.5
0K,All Students,2018-19,9495,1226,8269,87.1,61,33,54.1
0K,All Students,2019-20,4034,716,3318,82.3,39,24,61.5
0K,All Students,2020-21,6471,954,5517,85.3,40,16,40.0
0K,All Students,2021-22,5288,714,4574,86.5,35,20,57.1
0K,All Students,2022-23,7056,1170,5886,83.4,44,26,59.1
1,All Students,2018-19,9109,1058,8051,88.4,52,20,38.5
1,All Students,2019-20,6570,752,5818,88.6,59,27,45.8
1,All Students,2020-21,7054,1272,5782,82.0,41,25,61.0
1,All Students,2021-22,8588,1625,6963,81.1,54,33,61.1
1,All Students,2022-23,7204,1182,6022,83.6,42,26,61.9
2,All Students,2018-19,8202,1022,7180,87.5,47,21,44.7
2,All Students,2019-20,5624,801,4823,85.8,53,22,41.5
2,All Students,2020-21,9541,1139,8402,88.1,57,22,38.6
2,All Students,2021-22,6709,1532,5177,77.2,38,24,63.2
2,All Students,2022-23,8979,1544,7435,82.8,54,28,51.9
3,All Students,2018-19,7556,1057,6499,86.0,44,18,40.9
3,All Students,2019-20,4769,716,4053,85.0,42,19,45.2
3,All Students,2020-21,8232,1354,6878,83.6,47,22,46.8
3,All Students,2021-22,8165,1149,7016,85.9,49,27,55.1
3,All Students,2022-23,6952,1254,5698,82.0,42,25,59.5
4,All Students,2018-19,9170,1131,8039,87.7,54,23,42.6
4,All Students,2019-20,5340,710,4630,86.7,45,14,31.1
4,All Students,2020-21,7094,1220,5874,82.8,40,20,50.0
4,All Students,2021-22,8282,1860,6422,77.5,49,37,75.5
4,All Students,2022-23,9408,1403,8005,85.1,54,31,57.4
5,All Students,2018-19,9462,1073,8389,88.7,56,31,55.4
5,All Students,2019-20,6002,908,5094,84.9,53,26,49.1
5,All Students,2020-21,7707,1359,6348,82.4,45,21,46.7
5,All Students,2021-22,6848,1361,5487,80.1,41,26,63.4
5,All Students,2022-23,8389,1400,6989,83.3,49,27,55.1
6,All Students,2018-19,6490,968,5522,85.1,39,24,61.5
6,All Students,2019-20,7267,1103,6164,84.8,67,31,46.3
6,All Students,2020-21,9971,1388,8583,86.1,62,24,38.7
6,All Students,2021-22,7662,1359,6303,82.3,42,23,54.8
6,All Students,2022-23,5691,1165,4526,79.5,39,23,59.0
7,All Students,2018-19,7069,847,6222,88.0,42,21,50.0
7,All Students,2019-20,4098,598,3500,85.4,39,17,43.6
7,All Students,2020-21,11543,1553,9990,86.5,68,29,42.6
7,All Students,2021-22,9194,1759,7435,80.9,51,37,72.5
7,All Students,2022-23,7831,1008,6823,87.1,51,25,49.0
8,All Students,2018-19,4864,736,4128,84.9,28,9,32.1
8,All Students,2019-20,4969,688,4281,86.2,47,19,40.4
8,All Students,2020-21,7066,969,6097,86.3,41,15,36.6
8,All Students,2021-22,12350,2559,9791,79.3,74,58,78.4
8,All Students,2022-23,9266,1746,7520,81.2,55,40,72.7
9,All Students,2018-19,4830,605,4225,87.5,28,11,39.3
9,All Students,2019-20,2583,258,2325,90.0,23,10,43.5
9,All Students,2020-21,4078,170,3908,95.8,24,3,12.5
9,All Students,2021-22,4903,997,3906,79.7,29,20,69.0
9,All Students,2022-23,6959,1159,5800,83.3,41,25,61.0
10,All Students,2018-19,4065,514,3551,87.4,23,9,39.1
10,All Students,2019-20,3129,422,2707,86.5,28,14,50.0
10,All Students,2020-21,3503,149,3354,95.7,21,1,4.8
10,All Students,2021-22,3882,588,3294,84.9,24,11,45.8
10,All Students,2022-23,4956,914,4042,81.6,30,18,60.0
11,All Students,2018-19,4419,426,3993,90.4,25,8,32.0
11,All Students,2019-20,2494,449,2045,82.0,21,12,57.1
11,All Students,2020-21,5090,529,4561,89.6,29,10,34.5
11,All Students,2021-22,2954,442,2512,85.0,19,10,52.6
11,All Students,2022-23,4084,788,3296,80.7,24,17,70.8
12,All Students,2018-19,17244,2001,15243,88.4,100,41,41.0
12,All Students,2019-20,11826,1515,10311,87.2,104,43,41.3
12,All Students,2020-21,18565,2030,16535,89.1,106,39,36.8
12,All Students,2021-22,17938,3756,14182,79.1,102,62,60.8
12,All Students,2022-23,13385,2336,11049,82.5,78,42,53.8
All Grades,All Students,2018-19,102438,21508,80930,79.0,668,416,62.3
All Grades,All Students,2019-20,66234,13444,52790,79.7,647,390,60.3
All Grades,All Students,2020-21,103228,27105,76123,73.7,617,401,65.0
All Grades,All Students,2021-22,97951,25336,72615,74.1,625,457,73.1
All Grades,All Students,2022-23,97145,22023,75122,77.3,627,427,68.1
PK in K-12 Schools,All Students,2018-19,2769,182,2587,93.4,20,4,20.0
PK in K-12 Schools,All Students,2019-20,1806,150,1656,91.7,17,5,29.4
PK in K-12 Schools,All Students,2020-21,2799,390,2409,86.1,16,8,50.0
PK in K-12 Schools,All Students,2021-22,2799,621,2178,77.8,16,15,93.8
PK in K-12 Schools,All Students,2022-23,2810,372,2438,86.8,17,10,58.8
0K,All Students,2018-19,3566,287,3279,92.0,22,7,31.8
0K,All Students,2019-20,810,s,s,s,s,s,s
0K,All Students,2020-21,877,s,s,s,s,s,s
0K,All Students,2021-22,1388,123,1265,91.1,9,3,33.3
0K,All Students,2022-23,1803,204,1599,88.7,12,7,58.3
1,All Students,2018-19,2220,307,1913,86.2,13,5,38.5
1,All Students,2019-20,2614,238,2376,90.9,26,9,34.6
1,All Students,2020-21,1056,s,s,s,s,s,s
1,All Students,2021-22,1184,91,1093,92.3,9,4,44.4
1,All Students,2022-23,1675,188,1487,88.8,11,4,36.4
2,All Students,2018-19,3916,623,3293,84.1,21,12,57.1
2,All Students,2019-20,1674,169,1505,89.9,16,6,37.5
2,All Students,2020-21,4400,362,4038,91.8,25,8,32.0
2,All Students,2021-22,1219,129,1090,89.4,8,4,50.0
2,All Students,2022-23,1820,126,1694,93.1,11,4,36.4
3,All Students,2018-19,2111,267,1844,87.4,13,7,53.8
3,All Students,2019-20,3029,331,2698,89.1,27,11,40.7
3,All Students,2020-21,2640,333,2307,87.4,15,5,33.3
3,All Students,2021-22,4831,663,4168,86.3,28,13,46.4
3,All Students,2022-23,1714,139,1575,91.9,10,4,40.0
4,All Students,2018-19,3301,365,2936,88.9,21,9,42.9
4,All Students,2019-20,1266,s,s,s,s,s,s
4,All Students,2020-21,4111,518,3593,87.4,24,13,54.2
4,All Students,2021-22,2939,387,2552,86.8,18,8,44.4
4,All Students,2022-23,4166,402,3764,90.4,25,9,36.0
5,All Students,2018-19,2847,260,2587,90.9,16,5,31.3
5,All Students,2019-20,2295,338,1957,85.3,21,13,61.9
5,All Students,2020-21,2098,207,1891,90.1,12,4,33.3
5,All Students,2021-22,3914,692,3222,82.3,23,12,52.2
5,All Students,2022-23,3512,529,2983,84.9,20,9,45.0
6,All Students,2018-19,10242,1379,8863,86.5,65,31,47.7
6,All Students,2019-20,6778,923,5855,86.4,65,33,50.8
6,All Students,2020-21,11335,2603,8732,77.0,68,47,69.1
6,All Students,2021-22,10601,1908,8693,82.0,67,42,62.7
6,All Students,2022-23,10466,1883,8583,82.0,64,40,62.5
7,All Students,2018-19,11084,1762,9322,84.1,67,34,50.7
7,All Students,2019-20,6894,1221,5673,82.3,67,43,64.2
7,All Students,2020-21,10217,2207,8010,78.4,61,35,57.4
7,All Students,2021-22,11206,2370,8836,78.9,72,52,72.2
7,All Students,2022-23,11758,1934,9824,83.6,75,51,68.0
8,All Students,2018-19,11943,2616,9327,78.1,73,50,68.5
8,All Students,2019-20,7467,1241,6226,83.4,71,42,59.2
8,All Students,2020-21,10653,2509,8144,76.4,61,39,63.9
8,All Students,2021-22,10125,1614,8511,84.1,60,38,63.3
8,All Students,2022-23,10774,2382,8392,77.9,66,51,77.3
9,All Students,2018-19,15772,4722,11050,70.1,111,83,74.8
9,All Students,2019-20,9722,3128,6594,67.8,108,83,76.9
9,All Students,2020-21,13245,5866,7379,55.7,84,62,73.8
9,All Students,2021-22,11140,4289,6851,61.5,76,66,86.8
9,All Students,2022-23,12329,3901,8428,68.4,90,66,73.3
10,All Students,2018-19,13953,4194,9759,69.9,102,77,75.5
10,All Students,2019-20,11035,2670,8365,75.8,109,71,65.1
10,All Students,2020-21,16202,5575,10627,65.6,95,78,82.1
10,All Students,2021-22,13332,5093,8239,61.8,89,77,86.5
10,All Students,2022-23,12093,3841,8252,68.2,83,64,77.1
11,All Students,2018-19,7338,1922,5416,73.8,48,36,75.0
11,All Students,2019-20,4882,1102,3780,77.4,44,24,54.5
11,All Students,2020-21,11242,3053,8189,72.8,65,44,67.7
11,All Students,2021-22,10136,3471,6665,65.8,63,53,84.1
11,All Students,2022-23,8246,2316,5930,71.9,57,43,75.4
12,All Students,2018-19,11376,2622,8754,77.0,76,56,73.7
12,All Students,2019-20,5962,1731,4231,71.0,58,44,75.9
12,All Students,2020-21,12304,3353,8951,72.7,79,56,70.9
12,All Students,2021-22,13137,3885,9252,70.4,87,70,80.5
12,All Students,2022-23,13979,3806,10173,72.8,86,65,75.6
All Grades,All Students,2018-19,65034,7312,57722,88.8,382,142,37.2
All Grades,All Students,2019-20,45570,5329,40241,88.3,420,182,43.3
All Grades,All Students,2020-21,81396,11257,70139,86.2,479,205,42.8
All Grades,All Students,2021-22,86663,14166,72497,83.7,508,307,60.4
All Grades,All Students,2022-23,87925,10839,77086,87.7,518,223,43.1
PK in K-12 Schools,All Students,2018-19,5699,897,4802,84.3,34,19,55.9
PK in K-12 Schools,All Students,2019-20,5309,859,4450,83.8,55,40,72.7
PK in K-12 Schools,All Students,2020-21,9672,1406,8266,85.5,59,30,50.8
PK in K-12 Schools,All Students,2021-22,9842,2224,7618,77.4,58,50,86.2
PK in K-12 Schools,All Students,2022-23,9713,1365,8348,85.9,57,28,49.1
0K,All Students,2018-19,5060,674,4386,86.7,30,16,53.3
0K,All Students,2019-20,5495,591,4904,89.2,52,21,40.4
0K,All Students,2020-21,10221,1487,8734,85.5,63,27,42.9
0K,All Students,2021-22,7743,1326,6417,82.9,48,38,79.2
0K,All Students,2022-23,12183,1725,10458,85.8,70,33,47.1
1,All Students,2018-19,9824,1048,8776,89.3,59,26,44.1
1,All Students,2019-20,3372,429,2943,87.3,30,18,60.0
1,All Students,2020-21,8694,955,7739,89.0,51,17,33.3
1,All Students,2021-22,11376,2339,9037,79.4,67,48,71.6
1,All Students,2022-23,8254,1058,7196,87.2,49,25,51.0
2,All Students,2018-19,5746,942,4804,83.6,34,14,41.2
2,All Students,2019-20,6203,603,5600,90.3,57,24,42.1
2,All Students,2020-21,5506,1027,4479,81.3,32,16,50.0
2,All Students,2021-22,8889,1062,7827,88.1,52,25,48.1
2,All Students,2022-23,10348,1755,8593,83.0,61,34,55.7
3,All Students,2018-19,6488,774,5714,88.1,40,15,37.5
3,All Students,2019-20,3686,597,3089,83.8,34,14,41.2
3,All Students,2020-21,9277,1084,8193,88.3,54,21,38.9
3,All Students,2021-22,6359,1140,5219,82.1,36,24,66.7
3,All Students,2022-23,8640,1066,7574,87.7,53,26,49.1
4,All Students,2018-19,6044,563,5481,90.7,35,10,28.6
4,All Students,2019-20,4247,501,3746,88.2,39,13,33.3
4,All Students,2020-21,6278,1133,5145,82.0,36,19,52.8
4,All Students,2021-22,8901,1203,7698,86.5,52,29,55.8
4,All Students,2022-23,6360,849,5511,86.7,38,21,55.3
5,All Students,2018-19,6072,560,5512,90.8,35,13,37.1
5,All Students,2019-20,3755,397,3358,89.4,35,12,34.3
5,All Students,2020-21,6235,813,5422,87.0,37,14,37.8
5,All Students,2021-22,6047,990,5057,83.6,36,22,61.1
5,All Students,2022-23,9136,953,8183,89.6,54,18,33.3
6,All Students,2018-19,3895,420,3475,89.2,22,7,31.8
6,All Students,2019-20,2415,178,2237,92.6,21,5,23.8
6,All Students,2020-21,5963,1028,4935,82.8,34,17,50.0
6,All Students,2021-22,5361,827,4534,84.6,32,17,53.1
6,All Students,2022-23,4080,465,3615,88.6,27,10,37.0
7,All Students,2018-19,2359,122,2237,94.8,14,2,14.3
7,All Students,2019-20,2322,175,2147,92.5,21,7,33.3
7,All Students,2020-21,3535,371,3164,89.5,21,9,42.9
7,All Students,2021-22,5244,703,4541,86.6,31,14,45.2
7,All Students,2022-23,3009,209,2800,93.1,18,4,22.2
8,All Students,2018-19,2124,322,1802,84.8,12,4,33.3
8,All Students,2019-20,1265,s,s,s,s,s,s
8,All Students,2020-21,3872,380,3492,90.2,22,8,36.4
8,All Students,2021-22,3716,395,3321,89.4,21,9,42.9
8,All Students,2022-23,3996,313,3683,92.2,23,5,21.7
9,All Students,2018-19,1247,s,s,s,s,s,s
9,All Students,2019-20,1269,278,991,78.1,10,5,50.0
9,All Students,2020-21,1760,79,1681,95.5,10,3,30.0
9,All Students,2021-22,2816,333,2483,88.2,16,7,43.8
9,All Students,2022-23,1416,75,1341,94.7,8,2,25.0
10,All Students,2018-19,2681,163,2518,93.9,16,4,25.0
10,All Students,2019-20,805,s,s,s,s,s,s
10,All Students,2020-21,1936,257,1679,86.7,11,6,54.5
10,All Students,2021-22,1770,134,1636,92.4,10,2,20.0
10,All Students,2022-23,2832,256,2576,91.0,16,5,31.3
11,All Students,2018-19,356,s,s,s,s,s,s
11,All Students,2019-20,1632,125,1507,92.3,15,6,40.0
11,All Students,2020-21,1232,75,1157,93.9,7,1,14.3
11,All Students,2021-22,1947,415,1532,78.7,10,4,40.0
11,All Students,2022-23,1940,146,1794,92.5,11,2,18.2
12,All Students,2018-19,7439,748,6691,89.9,42,11,26.2
12,All Students,2019-20,3795,478,3317,87.4,33,14,42.4
12,All Students,2020-21,7193,1142,6051,84.1,41,16,39.0
12,All Students,2021-22,6652,1075,5577,83.8,39,18,46.2
12,All Students,2022-23,6018,604,5414,90.0,33,10,30.3
All Grades,All Students,2018-19,105648,11177,94471,89.4,643,266,41.4
All Grades,All Students,2019-20,70407,7411,62996,89.5,654,253,38.7
All Grades,All Students,2020-21,107159,19525,87634,81.8,630,390,61.9
All Grades,All Students,2021-22,106079,17750,88329,83.3,656,417,63.6
All Grades,All Students,2022-23,114534,15817,98717,86.2,695,384,55.3
PK in K-12 Schools,All Students,2018-19,4941,443,4498,91.0,28,11,39.3
PK in K-12 Schools,All Students,2019-20,3205,419,2786,86.9,28,18,64.3
PK in K-12 Schools,All Students,2020-21,4710,721,3989,84.7,27,15,55.6
PK in K-12 Schools,All Students,2021-22,4787,913,3874,80.9,29,27,93.1
PK in K-12 Schools,All Students,2022-23,4845,720,4125,85.1,28,18,64.3
0K,All Students,2018-19,12090,1283,10807,89.4,79,30,38.0
0K,All Students,2019-20,8913,786,8127,91.2,90,27,30.0
0K,All Students,2020-21,10983,1873,9110,82.9,68,38,55.9
0K,All Students,2021-22,15734,3036,12698,80.7,105,69,65.7
0K,All Students,2022-23,18677,2860,15817,84.7,121,76,62.8
1,All Students,2018-19,12857,1373,11484,89.3,79,28,35.4
1,All Students,2019-20,10629,1044,9585,90.2,98,38,38.8
1,All Students,2020-21,14655,2687,11968,81.7,85,55,64.7
1,All Students,2021-22,14233,2524,11709,82.3,93,66,71.0
1,All Students,2022-23,17447,2769,14678,84.1,104,63,60.6
2,All Students,2018-19,16342,1574,14768,90.4,98,34,34.7
2,All Students,2019-20,9441,1019,8422,89.2,91,35,38.5
2,All Students,2020-21,16468,3243,13225,80.3,97,60,61.9
2,All Students,2021-22,15706,2359,13347,85.0,100,60,60.0
2,All Students,2022-23,16457,2313,14144,85.9,98,53,54.1
3,All Students,2018-19,17529,1820,15709,89.6,108,48,44.4
3,All Students,2019-20,8797,842,7955,90.4,81,30,37.0
3,All Students,2020-21,15137,3014,12123,80.1,90,62,68.9
3,All Students,2021-22,14685,2321,12364,84.2,89,46,51.7
3,All Students,2022-23,15464,1989,13475,87.1,94,46,48.9
4,All Students,2018-19,14361,1771,12590,87.7,86,42,48.8
4,All Students,2019-20,11678,1190,10488,89.8,108,46,42.6
4,All Students,2020-21,14064,2227,11837,84.2,81,41,50.6
4,All Students,2021-22,14414,2298,12116,84.1,89,58,65.2
4,All Students,2022-23,13939,1764,12175,87.3,86,48,55.8
5,All Students,2018-19,16609,1909,14700,88.5,99,46,46.5
5,All Students,2019-20,9654,1202,8452,87.5,86,31,36.0
5,All Students,2020-21,17847,3200,14647,82.1,104,68,65.4
5,All Students,2021-22,13435,2118,11317,84.2,78,44,56.4
5,All Students,2022-23,14924,2011,12913,86.5,91,48,52.7
6,All Students,2018-19,5540,484,5056,91.3,34,13,38.2
6,All Students,2019-20,3047,433,2614,85.8,27,11,40.7
6,All Students,2020-21,3169,689,2480,78.3,18,12,66.7
6,All Students,2021-22,5590,610,4980,89.1,32,19,59.4
6,All Students,2022-23,3851,330,3521,91.4,22,7,31.8
7,All Students,2018-19,2314,237,2077,89.8,13,5,38.5
7,All Students,2019-20,3437,313,3124,90.9,31,12,38.7
7,All Students,2020-21,4632,980,3652,78.8,27,21,77.8
7,All Students,2021-22,3016,535,2481,82.3,17,11,64.7
7,All Students,2022-23,5921,568,5353,90.4,34,15,44.1
8,All Students,2018-19,3065,283,2782,90.8,19,9,47.4
8,All Students,2019-20,1606,163,1443,89.9,14,5,35.7
8,All Students,2020-21,5452,889,4563,83.7,32,18,56.3
8,All Students,2021-22,4479,1036,3443,76.9,24,17,70.8
8,All Students,2022-23,3009,493,2516,83.6,17,10,58.8
All Grades,All Students,2018-19,80823,10595,70228,86.9,471,231,49.0
All Grades,All Students,2019-20,51509,7308,44201,85.8,461,222,48.2
All Grades,All Students,2020-21,74923,11844,63079,84.2,435,205,47.1
All Grades,All Students,2021-22,77365,13706,63659,82.3,460,267,58.0
All Grades,All Students,2022-23,81199,10597,70602,86.9,484,228,47.1
6,All Students,2018-19,5547,786,4761,85.8,34,17,50.0
6,All Students,2019-20,2651,393,2258,85.2,25,11,44.0
6,All Students,2020-21,2992,676,2316,77.4,17,10,58.8
6,All Students,2021-22,3144,392,2752,87.5,19,12,63.2
6,All Students,2022-23,6299,804,5495,87.2,39,18,46.2
7,All Students,2018-19,5252,830,4422,84.2,32,17,53.1
7,All Students,2019-20,4091,662,3429,83.8,36,21,58.3
7,All Students,2020-21,4692,878,3814,81.3,28,15,53.6
7,All Students,2021-22,2965,608,2357,79.5,18,11,61.1
7,All Students,2022-23,5335,652,4683,87.8,31,14,45.2
8,All Students,2018-19,5720,869,4851,84.8,33,22,66.7
8,All Students,2019-20,3031,467,2564,84.6,27,14,51.9
8,All Students,2020-21,6336,881,5455,86.1,36,17,47.2
8,All Students,2021-22,5275,1091,4184,79.3,34,22,64.7
8,All Students,2022-23,4336,616,3720,85.8,29,13,44.8
9,All Students,2018-19,9260,1224,8036,86.8,54,25,46.3
9,All Students,2019-20,5612,693,4919,87.7,50,21,42.0
9,All Students,2020-21,7040,1080,5960,84.7,41,18,43.9
9,All Students,2021-22,11553,1890,9663,83.6,69,41,59.4
9,All Students,2022-23,12307,1712,10595,86.1,74,35,47.3
10,All Students,2018-19,8001,876,7125,89.1,46,21,45.7
10,All Students,2019-20,5595,851,4744,84.8,50,24,48.0
10,All Students,2020-21,9004,1915,7089,78.7,52,27,51.9
10,All Students,2021-22,8106,1542,6564,81.0,50,32,64.0
10,All Students,2022-23,11313,1363,9950,88.0,67,32,47.8
11,All Students,2018-19,11626,1474,10152,87.3,68,33,48.5
11,All Students,2019-20,5501,592,4909,89.2,49,18,36.7
11,All Students,2020-21,8082,952,7130,88.2,49,19,38.8
11,All Students,2021-22,8453,1308,7145,84.5,48,24,50.0
11,All Students,2022-23,7804,1001,6803,87.2,46,19,41.3
12,All Students,2018-19,35417,4536,30881,87.2,204,96,47.1
12,All Students,2019-20,25028,3650,21378,85.4,224,113,50.4
12,All Students,2020-21,36777,5462,31315,85.1,212,99,46.7
12,All Students,2021-22,37869,6875,30994,81.8,222,125,56.3
12,All Students,2022-23,33805,4449,29356,86.8,198,97,49.0
All Grades,All Students,2018-19,105179,16115,89064,84.7,635,356,56.1
All Grades,All Students,2019-20,65808,10012,55796,84.8,595,326,54.8
All Grades,All Students,2020-21,111691,23511,88180,78.9,656,396,60.4
All Grades,All Students,2021-22,114007,24400,89607,78.6,702,509,72.5
All Grades,All Students,2022-23,114589,20942,93647,81.7,694,460,66.3
PK in K-12 Schools,All Students,2018-19,3104,488,2616,84.3,24,14,58.3
PK in K-12 Schools,All Students,2019-20,1999,345,1654,82.7,24,16,66.7
PK in K-12 Schools,All Students,2020-21,1969,733,1236,62.8,12,10,83.3
PK in K-12 Schools,All Students,2021-22,744,s,s,s,s,s,s
PK in K-12 Schools,All Students,2022-23,1614,273,1341,83.1,13,8,61.5
0K,All Students,2018-19,16281,2338,13943,85.6,101,53,52.5
0K,All Students,2019-20,7384,1237,6147,83.2,73,46,63.0
0K,All Students,2020-21,17644,4117,13527,76.7,112,82,73.2
0K,All Students,2021-22,15689,3438,12251,78.1,110,85,77.3
0K,All Students,2022-23,12008,2167,9841,82.0,80,56,70.0
1,All Students,2018-19,12194,2314,9880,81.0,73,47,64.4
1,All Students,2019-20,11035,1521,9514,86.2,99,56,56.6
1,All Students,2020-21,13503,3188,10315,76.4,79,52,65.8
1,All Students,2021-22,20515,4526,15989,77.9,127,94,74.0
1,All Students,2022-23,19002,3956,15046,79.2,115,83,72.2
2,All Students,2018-19,10590,1455,9135,86.3,63,37,58.7
2,All Students,2019-20,7609,1346,6263,82.3,68,40,58.8
2,All Students,2020-21,17495,3924,13571,77.6,102,64,62.7
2,All Students,2021-22,13067,2521,10546,80.7,82,59,72.0
2,All Students,2022-23,21575,4293,17282,80.1,127,93,73.2
3,All Students,2018-19,11040,1616,9424,85.4,67,38,56.7
3,All Students,2019-20,6742,975,5767,85.5,59,32,54.2
3,All Students,2020-21,11916,2549,9367,78.6,68,45,66.2
3,All Students,2021-22,15574,3553,12021,77.2,89,62,69.7
3,All Students,2022-23,12101,2017,10084,83.3,73,48,65.8
4,All Students,2018-19,13794,1823,11971,86.8,80,40,50.0
4,All Students,2019-20,6557,969,5588,85.2,58,28,48.3
4,All Students,2020-21,9978,2032,7946,79.6,58,31,53.4
4,All Students,2021-22,10316,2038,8278,80.2,62,46,74.2
4,All Students,2022-23,14156,2674,11482,81.1,82,48,58.5
5,All Students,2018-19,11591,1954,9637,83.1,71,42,59.2
5,All Students,2019-20,8174,1149,7025,85.9,73,37,50.7
5,All Students,2020-21,10359,2103,8256,79.7,59,32,54.2
5,All Students,2021-22,9601,2042,7559,78.7,57,42,73.7
5,All Students,2022-23,9819,1597,8222,83.7,59,43,72.9
6,All Students,2018-19,10233,1243,8990,87.9,60,29,48.3
6,All Students,2019-20,3769,782,2987,79.3,32,17,53.1
6,All Students,2020-21,11556,2086,9470,81.9,67,36,53.7
6,All Students,2021-22,8303,1710,6593,79.4,48,34,70.8
6,All Students,2022-23,4238,504,3734,88.1,27,13,48.1
7,All Students,2018-19,8443,1211,7232,85.7,51,28,54.9
7,All Students,2019-20,6365,767,5598,87.9,56,25,44.6
7,All Students,2020-21,6010,1368,4642,77.2,35,20,57.1
7,All Students,2021-22,10315,2122,8193,79.4,62,44,71.0
7,All Students,2022-23,7160,1458,5702,79.6,42,29,69.0
8,All Students,2018-19,6139,1465,4674,76.1,35,24,68.6
8,All Students,2019-20,5128,858,4270,83.3,44,27,61.4
8,All Students,2020-21,9504,1399,8105,85.3,54,24,44.4
8,All Students,2021-22,6152,1784,4368,71.0,36,25,69.4
8,All Students,2022-23,9256,1622,7634,82.5,55,31,56.4
9,All Students,2018-19,354,s,s,s,s,s,s
9,All Students,2019-20,241,s,s,s,s,s,s
9,All Students,2020-21,352,s,s,s,s,s,s
9,All Students,2021-22,2876,369,2507,87.2,17,9,52.9
9,All Students,2022-23,666,s,s,s,s,s,s
10,All Students,2018-19,531,s,s,s,s,s,s
10,All Students,2019-20,230,s,s,s,s,s,s
10,All Students,2020-21,176,s,s,s,s,s,s
10,All Students,2021-22,354,s,s,s,s,s,s
10,All Students,2022-23,2463,182,2281,92.6,14,3,21.4
11,All Students,2018-19,531,s,s,s,s,s,s
11,All Students,2019-20,460,s,s,s,s,s,s
11,All Students,2020-21,352,s,s,s,s,s,s
11,All Students,2021-22,177,s,s,s,s,s,s
11,All Students,2022-23,354,s,s,s,s,s,s
12,All Students,2018-19,354,s,s,s,s,s,s
12,All Students,2019-20,115,s,s,s,s,s,s
12,All Students,2020-21,877,s,s,s,s,s,s
12,All Students,2021-22,324,s,s,s,s,s,s
12,All Students,2022-23,177,s,s,s,s,s,s
All Grades,All Students,2018-19,47599,7879,39720,83.4,286,162,56.6
All Grades,All Students,2019-20,35453,6332,29121,82.1,316,186,58.9
All Grades,All Students,2020-21,53688,10507,43181,80.4,318,212,66.7
All Grades,All Students,2021-22,52575,12903,39672,75.5,316,221,69.9
All Grades,All Students,2022-23,52955,10979,41976,79.3,316,195,61.7
6,All Students,2018-19,470,s,s,s,s,s,s
6,All Students,2019-20,5858,1013,4845,82.7,52,33,63.5
6,All Students,2020-21,2191,330,1861,84.9,13,10,76.9
6,All Students,2021-22,567,s,s,s,s,s,s
6,All Students,2022-23,7539,1952,5587,74.1,44,34,77.3
7,All Students,2018-19,3797,662,3135,82.6,25,15,60.0
7,All Students,2019-20,788,s,s,s,s,s,s
7,All Students,2020-21,8286,1578,6708,81.0,48,33,68.8
7,All Students,2021-22,2296,s,s,s,s,s,s
7,All Students,2022-23,2027,308,1719,84.8,12,6,50.0
8,All Students,2018-19,4574,553,4021,87.9,26,10,38.5
8,All Students,2019-20,2464,410,2054,83.4,22,12,54.5
8,All Students,2020-21,1313,187,1126,85.8,9,6,66.7
8,All Students,2021-22,7796,2009,5787,74.2,47,32,68.1
8,All Students,2022-23,4443,811,3632,81.7,27,18,66.7
9,All Students,2018-19,3468,s,s,s,s,s,s
9,All Students,2019-20,4011,496,3515,87.6,36,13,36.1
9,All Students,2020-21,7246,1544,5702,78.7,45,31,68.9
9,All Students,2021-22,4061,1324,2737,67.4,24,21,87.5
9,All Students,2022-23,8550,1774,6776,79.3,54,34,63.0
10,All Students,2018-19,5191,1031,4160,80.1,32,21,65.6
10,All Students,2019-20,2424,s,s,s,s,s,s
10,All Students,2020-21,7013,1109,5904,84.2,42,23,54.8
10,All Students,2021-22,7734,1952,5782,74.8,47,35,74.5
10,All Students,2022-23,3651,920,2731,74.8,22,16,72.7
11,All Students,2018-19,6432,874,5558,86.4,39,19,48.7
11,All Students,2019-20,3179,759,2420,76.1,29,19,65.5
11,All Students,2020-21,3483,752,2731,78.4,20,15,75.0
11,All Students,2021-22,6313,1599,4714,74.7,38,22,57.9
11,All Students,2022-23,6256,1342,4914,78.5,36,19,52.8
12,All Students,2018-19,23667,3954,19713,83.3,138,77,55.8
12,All Students,2019-20,16729,2936,13793,82.4,147,89,60.5
12,All Students,2020-21,24156,5007,19149,79.3,141,94,66.7
12,All Students,2021-22,23808,5286,18522,77.8,140,94,67.1
12,All Students,2022-23,20489,3872,16617,81.1,121,68,56.2
All Grades,All Students,2018-19,81658,11421,70237,86.0,497,257,51.7
All Grades,All Students,2019-20,57579,8331,49248,85.5,551,301,54.6
All Grades,All Students,2020-21,94219,13772,80447,85.4,568,303,53.3
All Grades,All Students,2021-22,89530,17770,71760,80.2,545,373,68.4
All Grades,All Students,2022-23,99457,17319,82138,82.6,607,399,65.7
0K,All Students,2018-19,6693,1076,5617,83.9,47,29,61.7
0K,All Students,2019-20,11015,1625,9390,85.2,114,63,55.3
0K,All Students,2020-21,9338,1568,7770,83.2,62,40,64.5
0K,All Students,2021-22,6308,1336,4972,78.8,48,41,85.4
0K,All Students,2022-23,7119,1367,5752,80.8,50,38,76.0
1,All Students,2018-19,5933,1146,4787,80.7,35,23,65.7
1,All Students,2019-20,5666,825,4841,85.4,59,33,55.9
1,All Students,2020-21,18089,3301,14788,81.8,108,73,67.6
1,All Students,2021-22,10345,2161,8184,79.1,64,41,64.1
1,All Students,2022-23,8259,1625,6634,80.3,51,39,76.5
2,All Students,2018-19,5079,612,4467,88.0,33,12,36.4
2,All Students,2019-20,4184,801,3383,80.9,40,29,72.5
2,All Students,2020-21,7589,1270,6319,83.3,44,29,65.9
2,All Students,2021-22,15592,3159,12433,79.7,95,67,70.5
2,All Students,2022-23,9152,1604,7548,82.5,56,37,66.1
3,All Students,2018-19,6959,768,6191,89.0,41,21,51.2
3,All Students,2019-20,3483,425,3058,87.8,32,15,46.9
3,All Students,2020-21,6606,1204,5402,81.8,39,24,61.5
3,All Students,2021-22,6677,1237,5440,81.5,40,28,70.0
3,All Students,2022-23,14082,2191,11891,84.4,87,50,57.5
4,All Students,2018-19,9114,796,8318,91.3,53,17,32.1
4,All Students,2019-20,4388,535,3853,87.8,39,17,43.6
4,All Students,2020-21,5103,782,4321,84.7,30,18,60.0
4,All Students,2021-22,6281,1439,4842,77.1,39,30,76.9
4,All Students,2022-23,6825,972,5853,85.8,41,28,68.3
5,All Students,2018-19,15265,1667,13598,89.1,86,38,44.2
5,All Students,2019-20,6070,724,5346,88.1,53,28,52.8
5,All Students,2020-21,6205,747,5458,88.0,36,16,44.4
5,All Students,2021-22,4814,832,3982,82.7,31,23,74.2
5,All Students,2022-23,7024,1357,5667,80.7,42,33,78.6
6,All Students,2018-19,11904,1852,10052,84.4,74,38,51.4
6,All Students,2019-20,6075,516,5559,91.5,54,19,35.2
6,All Students,2020-21,6707,571,6136,91.5,40,11,27.5
6,All Students,2021-22,8127,1858,6269,77.1,46,31,67.4
6,All Students,2022-23,7854,1200,6654,84.7,47,29,61.7
7,All Students,2018-19,7365,1258,6107,82.9,44,26,59.1
7,All Students,2019-20,7546,1027,6519,86.4,69,38,55.1
7,All Students,2020-21,9366,782,8584,91.7,54,18,33.3
7,All Students,2021-22,6964,1085,5879,84.4,40,26,65.0
7,All Students,2022-23,7684,1585,6099,79.4,44,30,68.2
8,All Students,2018-19,10385,1651,8734,84.1,66,40,60.6
8,All Students,2019-20,5599,1038,4561,81.5,58,37,63.8
8,All Students,2020-21,11757,1295,10462,89.0,68,28,41.2
8,All Students,2021-22,9496,1272,8224,86.6,55,23,41.8
8,All Students,2022-23,7368,998,6370,86.5,43,25,58.1
9,All Students,2018-19,1225,285,940,76.7,7,6,85.7
9,All Students,2019-20,1759,458,1301,74.0,17,15,88.2
9,All Students,2020-21,8765,1506,7259,82.8,57,32,56.1
9,All Students,2021-22,4435,899,3536,79.7,25,16,64.0
9,All Students,2022-23,11053,1936,9117,82.5,65,37,56.9
10,All Students,2018-19,1090,s,s,s,s,s,s
10,All Students,2019-20,759,s,s,s,s,s,s
10,All Students,2020-21,2166,400,1766,81.5,13,7,53.8
10,All Students,2021-22,7645,1709,5936,77.6,43,31,72.1
10,All Students,2022-23,4162,707,3455,83.0,26,16,61.5
11,All Students,2018-19,646,s,s,s,s,s,s
11,All Students,2019-20,690,s,s,s,s,s,s
11,All Students,2020-21,1056,82,974,92.2,6,1,16.7
11,All Students,2021-22,1597,513,1084,67.9,10,9,90.0
11,All Students,2022-23,6783,1257,5526,81.5,40,27,67.5
12,All Students,2019-20,345,s,s,s,s,s,s
12,All Students,2020-21,1384,249,1135,82.0,9,5,55.6
12,All Students,2021-22,1249,270,979,78.4,9,7,77.8
12,All Students,2022-23,2092,520,1572,75.1,15,10,66.7
All Grades,All Students,2018-19,96100,14131,81969,85.3,589,337,57.2
All Grades,All Students,2019-20,60314,8473,51841,86.0,560,298,53.2
All Grades,All Students,2020-21,91241,23065,68176,74.7,537,375,69.8
All Grades,All Students,2021-22,101522,20850,80672,79.5,643,475,73.9
All Grades,All Students,2022-23,106111,19287,86824,81.8,657,468,71.2
PK in K-12 Schools,All Students,2018-19,2895,510,2385,82.4,18,10,55.6
PK in K-12 Schools,All Students,2019-20,1577,234,1343,85.2,16,12,75.0
PK in K-12 Schools,All Students,2020-21,2263,637,1626,71.9,13,10,76.9
PK in K-12 Schools,All Students,2021-22,2071,421,1650,79.7,15,13,86.7
PK in K-12 Schools,All Students,2022-23,2500,536,1964,78.6,17,16,94.1
0K,All Students,2018-19,4564,762,3802,83.3,32,24,75.0
0K,All Students,2019-20,2539,426,2113,83.2,26,17,65.4
0K,All Students,2020-21,9724,2800,6924,71.2,62,48,77.4
0K,All Students,2021-22,19764,3923,15841,80.2,130,102,78.5
0K,All Students,2022-23,14952,2675,12277,82.1,97,78,80.4
1,All Students,2018-19,9268,967,8301,89.6,59,26,44.1
1,All Students,2019-20,4219,583,3636,86.2,42,20,47.6
1,All Students,2020-21,3927,1141,2786,70.9,24,19,79.2
1,All Students,2021-22,10356,2265,8091,78.1,67,52,77.6
1,All Students,2022-23,21018,3682,17336,82.5,125,81,64.8
2,All Students,2018-19,9925,1081,8844,89.1,60,30,50.0
2,All Students,2019-20,6083,662,5421,89.1,58,28,48.3
2,All Students,2020-21,7216,1556,5660,78.4,41,27,65.9
2,All Students,2021-22,4578,781,3797,82.9,32,21,65.6
2,All Students,2022-23,10991,2102,8889,80.9,67,52,77.6
3,All Students,2018-19,12841,1696,11145,86.8,78,40,51.3
3,All Students,2019-20,6942,730,6212,89.5,64,26,40.6
3,All Students,2020-21,9234,2222,7012,75.9,53,35,66.0
3,All Students,2021-22,6950,1122,5828,83.9,43,31,72.1
3,All Students,2022-23,6345,1053,5292,83.4,39,26,66.7
4,All Students,2018-19,10263,1471,8792,85.7,61,35,57.4
4,All Students,2019-20,8677,1220,7457,85.9,81,44,54.3
4,All Students,2020-21,10362,2256,8106,78.2,61,43,70.5
4,All Students,2021-22,9135,1692,7443,81.5,55,39,70.9
4,All Students,2022-23,6432,982,5450,84.7,39,27,69.2
5,All Students,2018-19,16097,1977,14120,87.7,93,46,49.5
5,All Students,2019-20,7382,1076,6306,85.4,67,37,55.2
5,All Students,2020-21,12776,4018,8758,68.6,73,53,72.6
5,All Students,2021-22,10012,1706,8306,83.0,59,37,62.7
5,All Students,2022-23,9718,1481,8237,84.8,62,37,59.7
6,All Students,2018-19,9111,1636,7475,82.0,59,40,67.8
6,All Students,2019-20,10115,1264,8851,87.5,91,44,48.4
6,All Students,2020-21,9141,2190,6951,76.0,54,38,70.4
6,All Students,2021-22,10969,2911,8058,73.5,70,55,78.6
6,All Students,2022-23,8726,1468,7258,83.2,57,38,66.7
7,All Students,2018-19,7988,1409,6579,82.4,49,30,61.2
7,All Students,2019-20,5253,837,4416,84.1,47,28,59.6
7,All Students,2020-21,14952,3801,11151,74.6,87,64,73.6
7,All Students,2021-22,10374,2304,8070,77.8,66,50,75.8
7,All Students,2022-23,10383,2017,8366,80.6,61,43,70.5
8,All Students,2018-19,10492,2165,8327,79.4,64,46,71.9
8,All Students,2019-20,5640,1163,4477,79.4,50,31,62.0
8,All Students,2020-21,8687,2344,6343,73.0,51,37,72.5
8,All Students,2021-22,14622,3050,11572,79.1,89,61,68.5
8,All Students,2022-23,12298,2480,9818,79.8,76,53,69.7
9,All Students,2018-19,707,s,s,s,s,s,s
9,All Students,2019-20,491,s,s,s,s,s,s
9,All Students,2020-21,425,s,s,s,s,s,s
9,All Students,2021-22,1014,206,808,79.7,6,4,66.7
9,All Students,2022-23,615,s,s,s,s,s,s
10,All Students,2018-19,1614,293,1321,81.8,10,5,50.0
10,All Students,2019-20,563,s,s,s,s,s,s
10,All Students,2020-21,604,s,s,s,s,s,s
10,All Students,2021-22,338,s,s,s,s,s,s
10,All Students,2022-23,860,s,s,s,s,s,s
11,All Students,2019-20,833,s,s,s,s,s,s
11,All Students,2020-21,528,s,s,s,s,s,s
11,All Students,2021-22,633,s,s,s,s,s,s
11,All Students,2022-23,665,s,s,s,s,s,s
12,All Students,2018-19,335,s,s,s,s,s,s
12,All Students,2020-21,1402,34,1368,97.6,8,0,0.0
12,All Students,2021-22,706,s,s,s,s,s,s
12,All Students,2022-23,608,s,s,s,s,s,s
All Grades,All Students,2018-19,97427,10126,87301,89.6,562,205,36.5
All Grades,All Students,2019-20,64749,6361,58388,90.2,576,192,33.3
All Grades,All Students,2020-21,95710,10313,85397,89.2,555,193,34.8
All Grades,All Students,2021-22,99665,16246,83419,83.7,573,301,52.5
All Grades,All Students,2022-23,106238,14610,91628,86.2,613,300,48.9
PK in K-12 Schools,All Students,2018-19,6,s,s,s,s,s,s
6,All Students,2018-19,15291,1469,13822,90.4,89,35,39.3
6,All Students,2019-20,8153,765,7388,90.6,73,25,34.2
6,All Students,2020-21,6354,728,5626,88.5,39,18,46.2
6,All Students,2021-22,12618,1780,10838,85.9,71,41,57.7
6,All Students,2022-23,11308,1450,9858,87.2,65,31,47.7
7,All Students,2018-19,8877,s,s,s,s,s,s
7,All Students,2019-20,9450,891,8559,90.6,84,28,33.3
7,All Students,2020-21,13145,1429,11716,89.1,76,26,34.2
7,All Students,2021-22,9869,1285,8584,87.0,60,30,50.0
7,All Students,2022-23,13024,1594,11430,87.8,74,35,47.3
8,All Students,2018-19,9944,903,9041,90.9,56,17,30.4
8,All Students,2019-20,5665,610,5055,89.2,49,19,38.8
8,All Students,2020-21,14009,1376,12633,90.2,80,23,28.8
8,All Students,2021-22,12423,1680,10743,86.5,71,36,50.7
8,All Students,2022-23,9380,1267,8113,86.5,55,30,54.5
9,All Students,2018-19,15663,1588,14075,89.9,92,31,33.7
9,All Students,2019-20,5255,551,4704,89.5,49,13,26.5
9,All Students,2020-21,7727,916,6811,88.1,44,17,38.6
9,All Students,2021-22,12023,2006,10017,83.3,72,40,55.6
9,All Students,2022-23,19147,2596,16551,86.4,113,52,46.0
10,All Students,2018-19,9968,1055,8913,89.4,58,20,34.5
10,All Students,2019-20,10174,1052,9122,89.7,92,32,34.8
10,All Students,2020-21,7964,850,7114,89.3,46,19,41.3
10,All Students,2021-22,6744,1485,5259,78.0,41,29,70.7
10,All Students,2022-23,12520,1745,10775,86.1,73,41,56.2
11,All Students,2018-19,9423,1006,8417,89.3,53,18,34.0
11,All Students,2019-20,6047,615,5432,89.8,54,18,33.3
11,All Students,2020-21,13293,1345,11948,89.9,76,25,32.9
11,All Students,2021-22,7679,997,6682,87.0,42,15,35.7
11,All Students,2022-23,5675,1082,4593,80.9,33,22,66.7
12,All Students,2018-19,28255,3088,25167,89.1,163,60,36.8
12,All Students,2019-20,20005,1877,18128,90.6,175,57,32.6
12,All Students,2020-21,33218,3669,29549,89.0,194,65,33.5
12,All Students,2021-22,38309,7013,31296,81.7,216,110,50.9
12,All Students,2022-23,35184,4876,30308,86.1,200,89,44.5
All Grades,All Students,2018-19,129577,22631,106946,82.5,845,557,65.9
All Grades,All Students,2019-20,88750,15183,73567,82.9,821,516,62.9
All Grades,All Students,2020-21,123903,21287,102616,82.8,744,460,61.8
All Grades,All Students,2021-22,116020,30359,85661,73.8,714,578,81.0
All Grades,All Students,2022-23,123511,27215,96296,78.0,789,572,72.5
0K,All Students,2018-19,16476,2858,13618,82.7,113,70,61.9
0K,All Students,2019-20,7091,1406,5685,80.2,69,57,82.6
0K,All Students,2020-21,5326,848,4478,84.1,36,25,69.4
0K,All Students,2021-22,7299,1868,5431,74.4,45,38,84.4
0K,All Students,2022-23,18582,4247,14335,77.1,124,91,73.4
1,All Students,2018-19,8962,1699,7263,81.0,61,45,73.8
1,All Students,2019-20,12750,2160,10590,83.1,115,69,60.0
1,All Students,2020-21,12282,2351,9931,80.9,73,52,71.2
1,All Students,2021-22,7727,2189,5538,71.7,46,39,84.8
1,All Students,2022-23,8848,1913,6935,78.4,58,37,63.8
2,All Students,2018-19,12182,2033,10149,83.3,78,46,59.0
2,All Students,2019-20,8087,1382,6705,82.9,77,51,66.2
2,All Students,2020-21,20381,3128,17253,84.7,119,68,57.1
2,All Students,2021-22,12951,3314,9637,74.4,83,64,77.1
2,All Students,2022-23,8456,1859,6597,78.0,56,43,76.8
3,All Students,2018-19,16475,2763,13712,83.2,104,73,70.2
3,All Students,2019-20,9287,1471,7816,84.2,87,49,56.3
3,All Students,2020-21,12549,2222,10327,82.3,78,49,62.8
3,All Students,2021-22,19844,4856,14988,75.5,119,83,69.7
3,All Students,2022-23,13950,2581,11369,81.5,87,60,69.0
4,All Students,2018-19,16495,2523,13972,84.7,101,60,59.4
4,All Students,2019-20,11296,1827,9469,83.8,107,66,61.7
4,All Students,2020-21,14544,2711,11833,81.4,87,61,70.1
4,All Students,2021-22,12134,3343,8791,72.4,76,65,85.5
4,All Students,2022-23,18971,3674,15297,80.6,120,78,65.0
5,All Students,2018-19,15968,2721,13247,83.0,101,66,65.3
5,All Students,2019-20,11380,1678,9702,85.3,104,60,57.7
5,All Students,2020-21,18130,3220,14910,82.2,108,68,63.0
5,All Students,2021-22,13044,3463,9581,73.5,79,70,88.6
5,All Students,2022-23,11800,2819,8981,76.1,75,59,78.7
6,All Students,2018-19,14371,2648,11723,81.6,92,65,70.7
6,All Students,2019-20,9619,1719,7900,82.1,87,56,64.4
6,All Students,2020-21,14693,2592,12101,82.4,87,49,56.3
6,All Students,2021-22,16295,4417,11878,72.9,103,87,84.5
6,All Students,2022-23,14437,3134,11303,78.3,91,69,75.8
7,All Students,2018-19,16794,2861,13933,83.0,104,70,67.3
7,All Students,2019-20,8434,1511,6923,82.1,76,49,64.5
7,All Students,2020-21,14355,2236,12119,84.4,85,47,55.3
7,All Students,2021-22,13611,3808,9803,72.0,80,65,81.3
7,All Students,2022-23,15502,3485,12017,77.5,100,73,73.0
8,All Students,2018-19,10265,2061,8204,79.9,66,43,65.2
8,All Students,2019-20,10575,1960,8615,81.5,93,57,61.3
8,All Students,2020-21,11583,1953,9630,83.1,70,40,57.1
8,All Students,2021-22,13059,3081,9978,76.4,82,66,80.5
8,All Students,2022-23,12965,3503,9462,73.0,78,62,79.5
9,All Students,2018-19,429,s,s,s,s,s,s
9,All Students,2019-20,47,s,s,s,s,s,s
9,All Students,2021-22,55,s,s,s,s,s,s
10,All Students,2018-19,572,s,s,s,s,s,s
10,All Students,2019-20,148,s,s,s,s,s,s
10,All Students,2021-22,1,s,s,s,s,s,s
11,All Students,2018-19,269,s,s,s,s,s,s
11,All Students,2019-20,36,s,s,s,s,s,s
12,All Students,2018-19,319,s,s,s,s,s,s
All Grades,All Students,2018-19,89007,12014,76993,86.5,524,290,55.3
All Grades,All Students,2019-20,59371,8056,51315,86.4,543,301,55.4
All Grades,All Students,2020-21,99413,17229,82184,82.7,584,326,55.8
All Grades,All Students,2021-22,93163,18103,75060,80.6,551,388,70.4
All Grades,All Students,2022-23,89484,14243,75241,84.1,542,327,60.3
PK in K-12 Schools,All Students,2018-19,5477,1142,4335,79.1,35,27,77.1
PK in K-12 Schools,All Students,2019-20,3552,691,2861,80.5,32,23,71.9
PK in K-12 Schools,All Students,2020-21,4258,541,3717,87.3,27,16,59.3
PK in K-12 Schools,All Students,2021-22,3693,551,3142,85.1,25,14,56.0
PK in K-12 Schools,All Students,2022-23,4022,583,3439,85.5,24,17,70.8
0K,All Students,2018-19,4616,743,3873,83.9,27,17,63.0
0K,All Students,2019-20,2748,299,2449,89.1,26,11,42.3
0K,All Students,2020-21,11941,2112,9829,82.3,72,51,70.8
0K,All Students,2021-22,5451,1033,4418,81.0,33,27,81.8
0K,All Students,2022-23,5417,842,4575,84.5,33,21,63.6
1,All Students,2018-19,3463,449,3014,87.0,21,12,57.1
1,All Students,2019-20,2808,428,2380,84.8,28,16,57.1
1,All Students,2020-21,4314,642,3672,85.1,25,14,56.0
1,All Students,2021-22,10619,1835,8784,82.7,62,41,66.1
1,All Students,2022-23,6433,1120,5313,82.6,42,30,71.4
2,All Students,2018-19,4653,558,4095,88.0,28,11,39.3
2,All Students,2019-20,1891,259,1632,86.3,17,10,58.8
2,All Students,2020-21,4329,740,3589,82.9,25,12,48.0
2,All Students,2021-22,3945,563,3382,85.7,23,14,60.9
2,All Students,2022-23,10077,1587,8490,84.3,63,39,61.9
3,All Students,2018-19,3494,491,3003,85.9,20,11,55.0
3,All Students,2019-20,2732,339,2393,87.6,25,13,52.0
3,All Students,2020-21,3000,794,2206,73.5,18,9,50.0
3,All Students,2021-22,4551,828,3723,81.8,26,19,73.1
3,All Students,2022-23,4196,631,3565,85.0,24,11,45.8
4,All Students,2018-19,2978,328,2650,89.0,17,8,47.1
4,All Students,2019-20,2483,314,2169,87.4,22,14,63.6
4,All Students,2020-21,4125,721,3404,82.5,24,16,66.7
4,All Students,2021-22,2996,603,2393,79.9,19,14,73.7
4,All Students,2022-23,4598,740,3858,83.9,26,17,65.4
5,All Students,2018-19,3977,686,3291,82.8,24,18,75.0
5,All Students,2019-20,2229,254,1975,88.6,21,13,61.9
5,All Students,2020-21,3655,462,3193,87.4,21,10,47.6
5,All Students,2021-22,3495,682,2813,80.5,22,16,72.7
5,All Students,2022-23,3386,735,2651,78.3,21,15,71.4
6,All Students,2018-19,12994,1701,11293,86.9,79,43,54.4
6,All Students,2019-20,10593,1569,9024,85.2,98,61,62.2
6,All Students,2020-21,9794,1883,7911,80.8,57,32,56.1
6,All Students,2021-22,10930,2522,8408,76.9,63,47,74.6
6,All Students,2022-23,9322,1395,7927,85.0,59,39,66.1
7,All Students,2018-19,11282,1422,9860,87.4,66,34,51.5
7,All Students,2019-20,8794,1075,7719,87.8,84,44,52.4
7,All Students,2020-21,16148,3014,13134,81.3,95,59,62.1
7,All Students,2021-22,9533,2289,7244,76.0,54,43,79.6
7,All Students,2022-23,10859,1807,9052,83.4,65,40,61.5
8,All Students,2018-19,13690,1762,11928,87.1,78,42,53.8
8,All Students,2019-20,6851,921,5930,86.6,61,33,54.1
8,All Students,2020-21,13920,2523,11397,81.9,80,44,55.0
8,All Students,2021-22,15464,2977,12487,80.7,91,64,70.3
8,All Students,2022-23,10349,1868,8481,81.9,62,36,58.1
9,All Students,2018-19,8336,999,7337,88.0,47,26,55.3
9,All Students,2019-20,2714,301,2413,88.9,24,11,45.8
9,All Students,2020-21,3343,238,3105,92.9,19,7,36.8
9,All Students,2021-22,1025,139,886,86.4,6,3,50.0
9,All Students,2022-23,3866,439,3427,88.6,22,12,54.5
10,All Students,2018-19,4806,549,4257,88.6,28,15,53.6
10,All Students,2019-20,5584,770,4814,86.2,49,23,46.9
10,All Students,2020-21,4048,436,3612,89.2,23,6,26.1
10,All Students,2021-22,3143,395,2748,87.4,18,7,38.9
10,All Students,2022-23,1226,135,1091,89.0,7,2,28.6
11,All Students,2018-19,3754,445,3309,88.1,22,12,54.5
11,All Students,2019-20,2728,323,2405,88.2,24,13,54.2
11,All Students,2020-21,8333,1426,6907,82.9,49,23,46.9
11,All Students,2021-22,4169,558,3611,86.6,24,15,62.5
11,All Students,2022-23,2783,319,2464,88.5,16,6,37.5
12,All Students,2018-19,5487,739,4748,86.5,32,14,43.8
12,All Students,2019-20,3664,513,3151,86.0,32,16,50.0
12,All Students,2020-21,8205,1697,6508,79.3,49,27,55.1
12,All Students,2021-22,14149,3128,11021,77.9,85,64,75.3
12,All Students,2022-23,12950,2042,10908,84.2,78,42,53.8
All Grades,All Students,2018-19,92164,13402,78762,85.5,574,354,61.7
All Grades,All Students,2019-20,67528,10577,56951,84.3,640,409,63.9
All Grades,All Students,2020-21,97062,4310,92752,95.6,579,83,14.3
All Grades,All Students,2021-22,89229,15726,73503,82.4,553,382,69.1
All Grades,All Students,2022-23,85777,11150,74627,87.0,537,279,52.0
PK in K-12 Schools,All Students,2019-20,2399,811,1588,66.2,24,22,91.7
PK in K-12 Schools,All Students,2020-21,2992,208,2784,93.0,21,6,28.6
PK in K-12 Schools,All Students,2021-22,1322,268,1054,79.7,12,9,75.0
PK in K-12 Schools,All Students,2022-23,3128,427,2701,86.3,24,11,45.8
0K,All Students,2018-19,13858,1958,11900,85.9,94,53,56.4
0K,All Students,2019-20,9076,1444,7632,84.1,88,59,67.0
0K,All Students,2020-21,6411,231,6180,96.4,41,3,7.3
0K,All Students,2021-22,11223,2435,8788,78.3,79,57,72.2
0K,All Students,2022-23,12240,1655,10585,86.5,83,47,56.6
1,All Students,2018-19,15981,2086,13895,86.9,98,53,54.1
1,All Students,2019-20,11669,1463,10206,87.5,111,66,59.5
1,All Students,2020-21,14563,585,13978,96.0,86,9,10.5
1,All Students,2021-22,6970,1313,5657,81.2,44,36,81.8
1,All Students,2022-23,12481,1735,10746,86.1,79,42,53.2
2,All Students,2018-19,15572,2267,13305,85.4,96,59,61.5
2,All Students,2019-20,12337,1746,10591,85.8,118,67,56.8
2,All Students,2020-21,19528,821,18707,95.8,113,16,14.2
2,All Students,2021-22,13537,2204,11333,83.7,82,57,69.5
2,All Students,2022-23,7582,1263,6319,83.3,49,31,63.3
3,All Students,2018-19,10780,1855,8925,82.8,70,57,81.4
3,All Students,2019-20,10331,1669,8662,83.8,96,62,64.6
3,All Students,2020-21,19213,804,18409,95.8,112,14,12.5
3,All Students,2021-22,17874,2556,15318,85.7,111,69,62.2
3,All Students,2022-23,13352,1643,11709,87.7,79,37,46.8
4,All Students,2018-19,14008,2167,11841,84.5,84,51,60.7
4,All Students,2019-20,8502,1572,6930,81.5,77,57,74.0
4,All Students,2020-21,15675,732,14943,95.3,91,15,16.5
4,All Students,2021-22,17032,2929,14103,82.8,102,67,65.7
4,All Students,2022-23,16168,1848,14320,88.6,97,47,48.5
5,All Students,2018-19,16029,2227,13802,86.1,94,59,62.8
5,All Students,2019-20,9464,1358,8106,85.7,89,54,60.7
5,All Students,2020-21,12616,696,11920,94.5,75,17,22.7
5,All Students,2021-22,15297,2645,12652,82.7,87,59,67.8
5,All Students,2022-23,15987,2104,13883,86.8,95,52,54.7
6,All Students,2018-19,1766,274,1492,84.5,11,6,54.5
6,All Students,2019-20,1191,197,994,83.5,12,8,66.7
6,All Students,2020-21,1890,77,1813,95.9,13,0,0.0
6,All Students,2021-22,1807,441,1366,75.6,12,11,91.7
6,All Students,2022-23,2362,304,2058,87.1,15,8,53.3
7,All Students,2018-19,1908,272,1636,85.7,13,7,53.8
7,All Students,2019-20,1522,180,1342,88.2,16,9,56.3
7,All Students,2020-21,2317,88,2229,96.2,14,1,7.1
7,All Students,2021-22,1866,399,1467,78.6,11,6,54.5
7,All Students,2022-23,1392,101,1291,92.7,9,3,33.3
8,All Students,2018-19,2262,296,1966,86.9,14,9,64.3
8,All Students,2019-20,1035,s,s,s,s,s,s
8,All Students,2020-21,1772,s,s,s,s,s,s
8,All Students,2021-22,2301,536,1765,76.7,13,11,84.6
8,All Students,2022-23,1085,70,1015,93.5,7,1,14.3
9,All Students,2019-20,2,s,s,s,s,s,s
9,All Students,2020-21,7,s,s,s,s,s,s
All Grades,All Students,2018-19,58680,8253,50427,85.9,347,193,55.6
All Grades,All Students,2019-20,47009,6809,40200,85.5,439,236,53.8
All Grades,All Students,2020-21,92570,14304,78266,84.5,555,276,49.7
All Grades,All Students,2021-22,91924,17359,74565,81.1,565,391,69.2
All Grades,All Students,2022-23,104525,16213,88312,84.5,640,365,57.0
0K,All Students,2018-19,2789,567,2222,79.7,20,13,65.0
0K,All Students,2019-20,4544,722,3822,84.1,46,24,52.2
0K,All Students,2020-21,16434,2473,13961,85.0,107,55,51.4
0K,All Students,2021-22,2618,429,2189,83.6,21,10,47.6
0K,All Students,2022-23,10436,1523,8913,85.4,69,43,62.3
1,All Students,2018-19,8183,1287,6896,84.3,50,34,68.0
1,All Students,2019-20,2940,541,2399,81.6,30,22,73.3
1,All Students,2020-21,9665,1524,8141,84.2,58,31,53.4
1,All Students,2021-22,15417,3190,12227,79.3,96,69,71.9
1,All Students,2022-23,9401,1532,7869,83.7,60,40,66.7
2,All Students,2018-19,12235,1585,10650,87.0,70,37,52.9
2,All Students,2019-20,4917,647,4270,86.8,44,27,61.4
2,All Students,2020-21,5027,833,4194,83.4,29,18,62.1
2,All Students,2021-22,9888,1681,8207,83.0,59,46,78.0
2,All Students,2022-23,16152,2487,13665,84.6,94,55,58.5
3,All Students,2018-19,12478,1623,10855,87.0,72,40,55.6
3,All Students,2019-20,7598,1052,6546,86.2,70,32,45.7
3,All Students,2020-21,7247,1489,5758,79.5,42,24,57.1
3,All Students,2021-22,5351,1158,4193,78.4,35,23,65.7
3,All Students,2022-23,10285,1435,8850,86.0,61,32,52.5
4,All Students,2018-19,11259,1590,9669,85.9,65,33,50.8
4,All Students,2019-20,7149,791,6358,88.9,64,29,45.3
4,All Students,2020-21,11898,1677,10221,85.9,70,28,40.0
4,All Students,2021-22,7128,1074,6054,84.9,45,33,73.3
4,All Students,2022-23,6541,1277,5264,80.5,38,27,71.1
5,All Students,2018-19,1734,285,1449,83.6,10,6,60.0
5,All Students,2019-20,7321,885,6436,87.9,64,29,45.3
5,All Students,2020-21,11098,1788,9310,83.9,64,36,56.3
5,All Students,2021-22,12412,1879,10533,84.9,71,51,71.8
5,All Students,2022-23,7147,887,6260,87.6,41,20,48.8
6,All Students,2018-19,1933,245,1688,87.3,11,5,45.5
6,All Students,2019-20,4532,815,3717,82.0,44,30,68.2
6,All Students,2020-21,19225,2227,16998,88.4,114,44,38.6
6,All Students,2021-22,16045,3235,12810,79.8,96,63,65.6
6,All Students,2022-23,10836,1881,8955,82.6,66,40,60.6
7,All Students,2018-19,6936,946,5990,86.4,42,21,50.0
7,All Students,2019-20,2367,s,s,s,s,s,s
7,All Students,2020-21,7520,1357,6163,82.0,45,27,60.0
7,All Students,2021-22,13068,2846,10222,78.2,80,58,72.5
7,All Students,2022-23,12413,1972,10441,84.1,74,41,55.4
8,All Students,2018-19,1133,125,1008,89.0,7,4,57.1
8,All Students,2019-20,5639,870,4769,84.6,53,28,52.8
8,All Students,2020-21,4285,s,s,s,s,s,s
8,All Students,2021-22,5158,1037,4121,79.9,31,23,74.2
8,All Students,2022-23,14135,1803,12332,87.2,85,41,48.2
9,All Students,2019-20,2,s,s,s,s,s,s
9,All Students,2020-21,171,s,s,s,s,s,s
9,All Students,2021-22,4688,765,3923,83.7,28,12,42.9
9,All Students,2022-23,3398,841,2557,75.3,26,14,53.8
10,All Students,2021-22,139,s,s,s,s,s,s
10,All Students,2022-23,3484,539,2945,84.5,23,11,47.8
11,All Students,2021-22,12,s,s,s,s,s,s
11,All Students,2022-23,120,s,s,s,s,s,s
12,All Students,2022-23,177,s,s,s,s,s,s
All Grades,All Students,2018-19,73469,6759,66710,90.8,422,160,37.9
All Grades,All Students,2019-20,47259,5029,42230,89.4,425,191,44.9
All Grades,All Students,2020-21,70888,8460,62428,88.1,414,176,42.5
All Grades,All Students,2021-22,66642,11042,55600,83.4,394,253,64.2
All Grades,All Students,2022-23,72577,9431,63146,87.0,429,234,54.5
PK in K-12 Schools,All Students,2018-19,4217,527,3690,87.5,26,15,57.7
PK in K-12 Schools,All Students,2019-20,2744,493,2251,82.0,24,19,79.2
PK in K-12 Schools,All Students,2020-21,4165,1006,3159,75.8,24,19,79.2
PK in K-12 Schools,All Students,2021-22,4160,895,3265,78.5,25,23,92.0
PK in K-12 Schools,All Students,2022-23,4445,s,s,s,s,s,s
0K,All Students,2018-19,6900,749,6151,89.1,42,20,47.6
0K,All Students,2019-20,6939,762,6177,89.0,61,30,49.2
0K,All Students,2020-21,7510,853,6657,88.6,45,21,46.7
0K,All Students,2021-22,11643,2049,9594,82.4,70,44,62.9
0K,All Students,2022-23,13044,1615,11429,87.6,79,44,55.7
1,All Students,2018-19,13135,1263,11872,90.4,74,32,43.2
1,All Students,2019-20,5203,537,4666,89.7,46,21,45.7
1,All Students,2020-21,10412,1170,9242,88.8,61,23,37.7
1,All Students,2021-22,7767,1285,6482,83.5,46,30,65.2
1,All Students,2022-23,12206,1667,10539,86.3,71,39,54.9
2,All Students,2018-19,11268,1012,10256,91.0,64,17,26.6
2,All Students,2019-20,8358,898,7460,89.3,76,29,38.2
2,All Students,2020-21,7856,904,6952,88.5,46,18,39.1
2,All Students,2021-22,10986,1504,9482,86.3,63,34,54.0
2,All Students,2022-23,9272,1340,7932,85.5,53,32,60.4
3,All Students,2018-19,12547,1107,11440,91.2,71,24,33.8
3,All Students,2019-20,7283,710,6573,90.3,67,29,43.3
3,All Students,2020-21,12784,1467,11317,88.5,75,33,44.0
3,All Students,2021-22,7288,1138,6150,84.4,44,26,59.1
3,All Students,2022-23,11411,1302,10109,88.6,69,31,44.9
4,All Students,2018-19,12066,955,11111,92.1,69,25,36.2
4,All Students,2019-20,8368,841,7527,89.9,77,34,44.2
4,All Students,2020-21,11008,929,10079,91.6,63,17,27.0
4,All Students,2021-22,13285,2248,11037,83.1,79,53,67.1
4,All Students,2022-23,8090,1082,7008,86.6,47,26,55.3
5,All Students,2018-19,12982,1120,11862,91.4,74,26,35.1
5,All Students,2019-20,8134,761,7373,90.6,72,28,38.9
5,All Students,2020-21,13245,1569,11676,88.2,77,35,45.5
5,All Students,2021-22,10961,1824,9137,83.4,63,40,63.5
5,All Students,2022-23,13578,1709,11869,87.4,78,41,52.6
6,All Students,2018-19,177,s,s,s,s,s,s
6,All Students,2019-20,115,s,s,s,s,s,s
6,All Students,2020-21,3558,489,3069,86.3,21,9,42.9
6,All Students,2021-22,531,s,s,s,s,s,s
6,All Students,2022-23,531,s,s,s,s,s,s
7,All Students,2019-20,115,s,s,s,s,s,s
7,All Students,2020-21,175,s,s,s,s,s,s
8,All Students,2018-19,177,s,s,s,s,s,s
8,All Students,2020-21,175,s,s,s,s,s,s
8,All Students,2021-22,21,s,s,s,s,s,s
All Grades,All Students,2018-19,95618,14689,80929,84.6,569,301,52.9
All Grades,All Students,2019-20,65619,10277,55342,84.3,594,308,51.9
All Grades,All Students,2020-21,102465,21267,81198,79.2,598,330,55.2
All Grades,All Students,2021-22,94550,22499,72051,76.2,570,425,74.6
All Grades,All Students,2022-23,86719,16690,70029,80.8,524,342,65.3
6,All Students,2022-23,7,s,s,s,s,s,s
9,All Students,2018-19,12373,1621,10752,86.9,74,35,47.3
9,All Students,2019-20,12927,2008,10919,84.5,117,66,56.4
9,All Students,2020-21,14759,3639,11120,75.3,85,53,62.4
9,All Students,2021-22,10995,1920,9075,82.5,67,49,73.1
9,All Students,2022-23,9984,s,s,s,s,s,s
10,All Students,2018-19,15911,2253,13658,85.8,93,45,48.4
10,All Students,2019-20,8073,1157,6916,85.7,77,43,55.8
10,All Students,2020-21,19738,4489,15249,77.3,115,70,60.9
10,All Students,2021-22,14214,3930,10284,72.4,87,65,74.7
10,All Students,2022-23,10554,1658,8896,84.3,66,38,57.6
11,All Students,2018-19,14383,2243,12140,84.4,87,39,44.8
11,All Students,2019-20,10667,1589,9078,85.1,97,44,45.4
11,All Students,2020-21,12340,2568,9772,79.2,72,42,58.3
11,All Students,2021-22,17850,4246,13604,76.2,108,80,74.1
11,All Students,2022-23,14128,2899,11229,79.5,84,53,63.1
12,All Students,2018-19,52951,8572,44379,83.8,315,182,57.8
12,All Students,2019-20,33952,5523,28429,83.7,303,155,51.2
12,All Students,2020-21,55628,10571,45057,81.0,326,165,50.6
12,All Students,2021-22,51491,12403,39088,75.9,308,231,75.0
12,All Students,2022-23,52046,10225,41821,80.4,311,214,68.8
All Grades,All Students,2022-23,71394,13193,58201,81.5,499,341,68.3
0K,All Students,2022-23,3370,470,2900,86.1,22,13,59.1
1,All Students,2022-23,5703,1108,4595,80.6,36,27,75.0
2,All Students,2022-23,6922,1065,5857,84.6,45,28,62.2
3,All Students,2022-23,8582,1232,7350,85.6,52,27,51.9
4,All Students,2022-23,6441,994,5447,84.6,38,24,63.2
5,All Students,2022-23,5280,1126,4154,78.7,35,26,74.3
6,All Students,2022-23,5652,1097,4555,80.6,38,26,68.4
7,All Students,2022-23,6272,1039,5233,83.4,47,35,74.5
8,All Students,2022-23,9330,2413,6917,74.1,71,53,74.6
9,All Students,2022-23,3637,671,2966,81.6,33,23,69.7
10,All Students,2022-23,7624,1376,6248,82.0,56,39,69.6
11,All Students,2022-23,1942,s,s,s,s,s,s
12,All Students,2022-23,639,s,s,s,s,s,s
All Grades,All Students,2018-19,83728,32644,51084,61.0,544,443,81.4
All Grades,All Students,2019-20,52689,20836,31853,60.5,505,403,79.8
All Grades,All Students,2020-21,84421,43443,40978,48.5,471,399,84.7
All Grades,All Students,2021-22,73841,32453,41388,56.1,463,408,88.1
All Grades,All Students,2022-23,60444,24060,36384,60.2,395,326,82.5
8,All Students,2018-19,28,s,s,s,s,s,s
9,All Students,2018-19,29295,14362,14933,51.0,207,189,91.3
9,All Students,2019-20,16879,9026,7853,46.5,177,158,89.3
9,All Students,2020-21,33190,20891,12299,37.1,184,169,91.8
9,All Students,2021-22,17190,9942,7248,42.2,120,116,96.7
9,All Students,2022-23,16563,9275,7288,44.0,119,110,92.4
10,All Students,2018-19,15839,6469,9370,59.2,102,85,83.3
10,All Students,2019-20,11884,4634,7250,61.0,113,91,80.5
10,All Students,2020-21,15378,9458,5920,38.5,79,72,91.1
10,All Students,2021-22,21520,10231,11289,52.5,133,118,88.7
10,All Students,2022-23,10676,4871,5805,54.4,73,63,86.3
11,All Students,2018-19,12989,s,s,s,s,s,s
11,All Students,2019-20,7027,2316,4711,67.0,64,49,76.6
11,All Students,2020-21,10917,4085,6832,62.6,65,53,81.5
11,All Students,2021-22,9317,3829,5488,58.9,59,48,81.4
11,All Students,2022-23,12215,3676,8539,69.9,76,57,75.0
12,All Students,2018-19,25577,7239,18338,71.7,153,107,69.9
12,All Students,2019-20,16899,4860,12039,71.2,151,105,69.5
12,All Students,2020-21,24936,9009,15927,63.9,143,105,73.4
12,All Students,2021-22,25814,8451,17363,67.3,151,126,83.4
12,All Students,2022-23,20990,6238,14752,70.3,127,96,75.6
All Grades,All Students,2018-19,112306,18753,93553,83.3,666,373,56.0
All Grades,All Students,2019-20,73228,12417,60811,83.0,652,354,54.3
All Grades,All Students,2020-21,112857,24696,88161,78.1,655,365,55.7
All Grades,All Students,2021-22,103648,28690,74958,72.3,609,443,72.7
All Grades,All Students,2022-23,104140,23851,80289,77.1,621,421,67.8
6,All Students,2021-22,1,s,s,s,s,s,s
7,All Students,2018-19,178,s,s,s,s,s,s
8,All Students,2018-19,260,s,s,s,s,s,s
8,All Students,2019-20,345,s,s,s,s,s,s
8,All Students,2020-21,13,s,s,s,s,s,s
9,All Students,2018-19,14077,2446,11631,82.6,88,55,62.5
9,All Students,2019-20,10753,2000,8753,81.4,98,54,55.1
9,All Students,2020-21,12489,s,s,s,s,s,s
9,All Students,2021-22,13689,3966,9723,71.0,81,57,70.4
9,All Students,2022-23,18448,3798,14650,79.4,112,71,63.4
10,All Students,2018-19,20342,3121,17221,84.7,124,64,51.6
10,All Students,2019-20,9799,s,s,s,s,s,s
10,All Students,2020-21,16801,3513,13288,79.1,98,57,58.2
10,All Students,2021-22,12894,s,s,s,s,s,s
10,All Students,2022-23,14611,3251,11360,77.7,88,55,62.5
11,All Students,2018-19,15051,2430,12621,83.9,88,52,59.1
11,All Students,2019-20,12531,1971,10560,84.3,113,55,48.7
11,All Students,2020-21,14784,3358,11426,77.3,84,45,53.6
11,All Students,2021-22,16430,4828,11602,70.6,93,61,65.6
11,All Students,2022-23,14784,3923,10861,73.5,87,66,75.9
12,All Students,2018-19,62398,10686,51712,82.9,363,200,55.1
12,All Students,2019-20,39800,6585,33215,83.5,352,194,55.1
12,All Students,2020-21,68770,15327,53443,77.7,398,224,56.3
12,All Students,2021-22,60634,16098,44536,73.5,355,263,74.1
12,All Students,2022-23,56297,12879,43418,77.1,334,229,68.6
